34f25ffaf4b3e45f3bc529062a4506e8e163c87c;Thu Jun 13 15:15:11 EDT 2013;Committer;svn;1;2;2;4;0
65575bab02a2ff13b1b41f2c47b934f0c8b44002;Thu Jun 13 15:15:07 EDT 2013;Committer;akr;2;10;3;13;0
51c43dba6aa19c8998032f7a1ba730743dbaafed;Thu Jun 13 14:44:25 EDT 2013;Committer;zzak;5;32;7;39;0
2b83a57fcb81e14252a0922ac2fa5d460f9b06ab;Thu Jun 13 14:07:28 EDT 2013;Committer;kou;2;13;0;13;0
16d5c80678042e7d9f42c022ba7b1816f15611ad;Thu Jun 13 13:46:54 EDT 2013;Committer;kou;3;28;3;31;0
102e2cd5633b3e7f685a2dc6d3339d4598638585;Thu Jun 13 13:36:52 EDT 2013;Committer;kou;2;12;7;19;0
4b5267018abbc600b63784c7d163af2ef8d24429;Thu Jun 13 13:12:35 EDT 2013;Committer;nobu;3;7;0;7;0
d479419ad30afaf3c13ca3a895f9779858f4587c;Thu Jun 13 13:03:30 EDT 2013;Committer;nobu;1;8;0;8;0
b4bafcb41652d3a6f3c02891603f867fa0d11d23;Thu Jun 13 13:02:34 EDT 2013;Committer;akr;1;1;1;2;0
f28ec8da8c08a90b19c85ceef0ee717c886d7841;Thu Jun 13 12:30:24 EDT 2013;Committer;nobu;3;11;3;14;0
e6226e2c9d6baafd4ba3efbdd0464ce28c3b2b0d;Thu Jun 13 12:30:19 EDT 2013;Committer;nobu;1;1;1;2;0
63dd3e7ef9c1f2b839072003cb1696282520ffd1;Thu Jun 13 12:26:33 EDT 2013;Committer;akr;2;28;21;49;0
138bc4c0c4904b1370d4d178c74597ad4a3bdfae;Thu Jun 13 09:56:52 EDT 2013;Committer;usa;2;7;1;8;0
3e3080ef5854ac6a0ae8cc18d2cffd3832afa35b;Thu Jun 13 09:54:02 EDT 2013;Committer;akr;2;5;2;7;0
db3b317ca74c075e49264bf21b71a85280a26890;Thu Jun 13 09:35:05 EDT 2013;Committer;akr;2;6;5;11;0
392d7a797a8fab2933d1eab96fee13d1457b4ff7;Thu Jun 13 07:33:12 EDT 2013;Committer;nobu;1;2;2;4;0
3dbf227ed0423c71e5a3f9b2952dcd8a1b3ccc58;Thu Jun 13 05:51:14 EDT 2013;Committer;nobu;3;20;1;21;0
0e76c1408517b943a855240489c1afdb502284dc;Thu Jun 13 05:44:31 EDT 2013;Committer;nobu;1;7;5;12;0
1474dd064b28e4a813a79342c5523cede60f83c7;Thu Jun 13 05:41:44 EDT 2013;Committer;shugo;9;87;154;241;0
90026ab53f89304438d907c0c7cc23afccc6edb7;Thu Jun 13 03:20:28 EDT 2013;Committer;akr;1;15;11;26;0
c8151d123506d34384d8a7cd856ec43b14a3dd5a;Thu Jun 13 02:01:42 EDT 2013;Committer;shugo;4;11;87;98;0
23ab11f14af70ce9546836daee9e48e561fde742;Thu Jun 13 00:30:00 EDT 2013;Committer;kazu;1;1;1;2;0
2b1c2b7223de78de5d8b855d62b89623ed930744;Wed Jun 12 21:13:56 EDT 2013;Committer;akr;2;8;2;10;0
d341276561accd598d91bfdb736378c72ec41ab3;Wed Jun 12 20:32:42 EDT 2013;Committer;drbrain;2;10;0;10;0
80a474a1e53576ed1c2d5adaa1263fc999744839;Wed Jun 12 15:18:05 EDT 2013;Committer;svn;1;2;2;4;0
aaa1461d7b1508c12e9aaa3f2c2681ddc82fa0f4;Wed Jun 12 15:18:00 EDT 2013;Committer;akr;6;191;69;260;0
17f1cdaa00ff51470b934c99f6e54a24bf377b71;Wed Jun 12 14:33:59 EDT 2013;Committer;shugo;3;96;9;105;0
1f828497d1e8df2b7b68ac2a093ab4439585d88a;Wed Jun 12 14:20:51 EDT 2013;Committer;shugo;73;95;978;1073;0
b53a183c009b3cb72b5964cf5652763b4cebf0f6;Wed Jun 12 13:25:00 EDT 2013;Committer;akr;2;57;57;114;0
007fb3b160d36f66427536150342640481dade3f;Wed Jun 12 11:19:18 EDT 2013;Committer;kou;2;10;4;14;0
4e0685faeaba694641c30c5d93fd6be0e8b875f8;Wed Jun 12 09:21:11 EDT 2013;Committer;akr;2;26;3;29;0
2a23bd620223e6ee4825220bcac39b69ffa6d0fe;Wed Jun 12 08:48:01 EDT 2013;Committer;knu;1;4;0;4;0
2eadce6743ffa0609a4c6968935815d9fc966f87;Wed Jun 12 08:05:56 EDT 2013;Committer;nobu;1;21;1;22;0
221496de7cb970c67de14766c4aecb314626ded1;Wed Jun 12 07:41:40 EDT 2013;Committer;nobu;2;7;4;11;0
c3b81910196894e486fec0c0a5a1273fc35955ea;Wed Jun 12 07:08:08 EDT 2013;Committer;knu;1;7;3;10;0
bccf874ceb648f8f680f79db2737c8592086c2af;Wed Jun 12 06:41:11 EDT 2013;Committer;knu;1;25;14;39;0
ab64f237714a72228096ae87aa6672583120595f;Wed Jun 12 03:44:48 EDT 2013;Committer;nobu;3;21;2;23;0
ff6104ba62164a4808ac96839a7201c2bec16ff7;Wed Jun 12 03:35:54 EDT 2013;Committer;akr;2;8;23;31;0
174e3fb6e40e517275c0acf3cda0e991c47fa572;Wed Jun 12 03:09:28 EDT 2013;Committer;akr;2;7;6;13;0
7fa5e608d33d7b87763b37b4dc7793e2ae58c882;Wed Jun 12 03:04:11 EDT 2013;Committer;nobu;3;15;0;15;0
da786437a7be37f8807410a82071ace6089df97e;Wed Jun 12 03:03:46 EDT 2013;Committer;nobu;3;22;0;22;0
ff7bb4723b88ce6461ef6276a441fae4c69bd71d;Wed Jun 12 03:00:24 EDT 2013;Committer;nobu;2;8;2;10;0
299d96cadd2015b0f40ceae322c7551bf55a0223;Wed Jun 12 03:00:22 EDT 2013;Committer;nobu;1;3;3;6;0
6ff25d132de8676d6df5b4f70508a2adfdb55e45;Wed Jun 12 03:00:17 EDT 2013;Committer;nobu;1;2;1;3;0
a5acd8c8d3a1b5446e377db2c82a2eb483ebe89c;Wed Jun 12 03:00:00 EDT 2013;Committer;kazu;1;1;1;2;0
e39523b77b6d27a59950c741b46f0b7c8bb5539a;Tue Jun 11 22:33:01 EDT 2013;Committer;akr;2;5;2;7;0
28d975a6330c6111a99f5f7530f0a56709a98a50;Tue Jun 11 22:17:02 EDT 2013;Committer;drbrain;2;97;92;189;0
0c9a719d7728e026e2bd4dfef61d940d3ca7248f;Tue Jun 11 21:39:55 EDT 2013;Committer;akr;8;62;41;103;0
a338c4ed5d519f05bf1f9fcd6a7b237a3101df0a;Tue Jun 11 16:37:37 EDT 2013;Committer;akr;1;0;1;1;0
72eed1fdbf29b39b4eb0776e4f50dfdecf2fad26;Tue Jun 11 15:09:06 EDT 2013;Committer;svn;1;2;2;4;0
3acd222fa5dd5f6a8aff2793ac64ebbc052ca552;Tue Jun 11 15:08:59 EDT 2013;Committer;kou;2;13;0;13;0
83c02765e1e19907ea64fe14fb2342e8422639f6;Tue Jun 11 14:57:05 EDT 2013;Committer;kou;2;6;0;6;0
b23d9a8a637e5e63a93ea6a620b3dab3450f15e2;Tue Jun 11 14:40:16 EDT 2013;Committer;akr;5;19;7;26;0
c4b12333f770039fa4f189b3ac9ca015707836c3;Tue Jun 11 14:02:46 EDT 2013;Committer;akr;2;12;2;14;0
06b1671107875eaba7099cf6cb4411ccc33fe052;Tue Jun 11 13:28:33 EDT 2013;Committer;akr;2;12;7;19;0
17a5321c40ea3405487cee40fc7ed04ecc4c1635;Tue Jun 11 13:15:56 EDT 2013;Committer;akr;2;57;39;96;0
d5a3818f8e3d096a4e192b61008f886f940192df;Tue Jun 11 12:06:40 EDT 2013;Committer;akr;6;326;156;482;0
b7597efb48126e28dd0bbb12ef07a5e1066093fc;Tue Jun 11 08:25:40 EDT 2013;Committer;knu;2;26;8;34;0
832525515a21ee15ccd5800839ed6203c6e0d2f4;Tue Jun 11 08:01:38 EDT 2013;Committer;knu;1;1;1;2;0
c5c201f6242b15e00a2f158c30bb196c0455f87f;Tue Jun 11 07:15:24 EDT 2013;Committer;nobu;2;19;1;20;0
4cdd6f6ab8abb1b960a7cdbe3f932b6a792787a5;Tue Jun 11 06:57:04 EDT 2013;Committer;nobu;1;3;2;5;0
df4abd9b3b4d5ac061f098adedbf185ecd223909;Tue Jun 11 03:50:33 EDT 2013;Committer;zzak;4;659;654;1313;0
c0ce87736511ca51e453509c25fe3c00abb08059;Mon Jun 10 22:14:27 EDT 2013;Committer;tarui;2;7;3;10;0
33e6f434edd95e1d2711ae5fe4d0e04300b1c736;Mon Jun 10 20:06:58 EDT 2013;Committer;svn;1;2;2;4;0
8c6674ef036f7cc223646cfd60ff965a145141e6;Mon Jun 10 20:06:53 EDT 2013;Committer;eregon;2;29;23;52;0
0ab44dbc3cf92c459c045d4b8272380e417f4552;Mon Jun 10 14:54:21 EDT 2013;Committer;kazu;2;7;1;8;0
46bb1a9f922b4a201f754e2050332529e4629379;Mon Jun 10 13:51:20 EDT 2013;Committer;akr;1;1;1;2;0
baabb76cd745d2ed9b4dba6c33710944321ded98;Mon Jun 10 13:28:58 EDT 2013;Committer;ktsj;1;1;0;1;0
780ab06a0ef626225aa2182a18b6e009a6bc45a8;Mon Jun 10 13:10:11 EDT 2013;Committer;akr;1;3;1;4;0
e214b1b6d374b5b68b757b16fbc13fa11fe17807;Mon Jun 10 12:51:48 EDT 2013;Committer;kou;2;5;2;7;0
f6921a3cd1d6daa3a8d5965a77c1a95f8ac20384;Mon Jun 10 12:50:45 EDT 2013;Committer;kou;2;6;1;7;0
52a802a4285647a8dfce77c0dd5ded1c4532fd73;Mon Jun 10 11:59:36 EDT 2013;Committer;naruse;2;15;1;16;0
6735633663cdb39c95075f0f92f34c6d8f5c4ec6;Mon Jun 10 10:55:08 EDT 2013;Committer;akr;1;10;5;15;0
0e8caa7d0f79c9514b4b4dbe9ac88b08e822e387;Mon Jun 10 10:37:39 EDT 2013;Committer;akr;8;54;33;87;0
a8aaf133921e5cfcf6e0ee88dc6b69e9c52ecf75;Mon Jun 10 08:21:08 EDT 2013;Committer;ko1;2;5;5;10;0
a03ac78b2c7f48d5e0f9bf2504385a8d24a836ab;Mon Jun 10 08:15:31 EDT 2013;Committer;ko1;2;11;4;15;0
d917e65143f08c88b1c83a71132b66c0a4c2db87;Mon Jun 10 08:00:04 EDT 2013;Committer;kazu;1;1;1;2;0
1188d9291c60ccc1852af4c6f0e459f15e4e7e0c;Mon Jun 10 08:00:01 EDT 2013;Committer;kazu;1;1;1;2;0
f8ba9a1f605b264069591664eae866b643c74db4;Mon Jun 10 07:23:36 EDT 2013;Committer;ko1;2;6;0;6;0
dd96561f76f8c3ae7d60f5ace40ce32f4f1d73c8;Mon Jun 10 07:12:14 EDT 2013;Committer;ko1;2;6;1;7;0
09de2b0544e2615bada18b1418efd1948bc7f869;Mon Jun 10 06:36:02 EDT 2013;Committer;nobu;2;7;4;11;0
b82ded24cc856435a87b289890c8954d96ecea66;Mon Jun 10 06:35:37 EDT 2013;Committer;nobu;3;20;1;21;0
222d028808b839f911db718d34ff8c133a57c8ea;Mon Jun 10 06:34:28 EDT 2013;Committer;nobu;2;14;7;21;0
c2b4f88fcb8c981ee8a0b7cf88b54e71036bf555;Mon Jun 10 06:33:58 EDT 2013;Committer;nobu;1;2;2;4;0
8c239f35de2a30ef3585c5a7cb9aaba7271a70cc;Mon Jun 10 03:12:44 EDT 2013;Committer;akr;2;99;24;123;0
192085bad3471ed7442a147f86a3c85c1958307c;Sun Jun 09 20:39:05 EDT 2013;Committer;akr;2;30;2;32;0
79042beeced5bc70183c405a8e2debbf6cd0bf70;Sun Jun 09 16:08:59 EDT 2013;Committer;svn;1;2;2;4;0
f30d662c24a7f799b67cc5f99470ce9da39b89cf;Sun Jun 09 16:08:54 EDT 2013;Committer;akr;2;107;25;132;0
d395be138c0661c38f903017c365a30c561c8548;Sun Jun 09 13:03:45 EDT 2013;Committer;akr;1;1;1;2;0
9cb1452318a311af3937356ba7e5fc00c4aefc3d;Sun Jun 09 12:37:38 EDT 2013;Committer;akr;3;75;24;99;0
f5ad120b9798d58d20e67dc458a5f5005482a1d8;Sun Jun 09 07:53:20 EDT 2013;Committer;akr;5;17;6;23;0
837392b45260785a8ccc13aceba5be90e067a974;Sun Jun 09 05:53:00 EDT 2013;Committer;akr;9;58;73;131;0
f6757f080c9201de6fbd1d25b663c37341ef2305;Sun Jun 09 00:36:58 EDT 2013;Committer;akr;2;42;0;42;0
4ff3b7cf05cc409216f248860c3c1312443943cf;Sat Jun 08 16:49:49 EDT 2013;Committer;naruse;1;1;1;2;0
e3bc7eec5f8ea62586eb1dfe2b3c021a5a9f1f8e;Sat Jun 08 16:00:16 EDT 2013;Committer;akr;2;15;1;16;0
893a8bb65386fb56d0c445bd87c8bd0e96c611c3;Sat Jun 08 15:57:09 EDT 2013;Committer;svn;1;2;2;4;0
58e67628ae19a9235bcc9bbba6d5a8e0858121f4;Sat Jun 08 15:57:05 EDT 2013;Committer;akr;1;1;1;2;0
633e4949bda73c7e6fdbc330dd48b46884e5f548;Sat Jun 08 14:57:28 EDT 2013;Committer;akr;2;6;2;8;0
ceb6d94265afd8bc41d8b845036b85d3e862796e;Sat Jun 08 14:26:04 EDT 2013;Committer;kazu;1;1;1;2;0
5a9984d7aa30f0d6febc3415d189fa81563d70a5;Sat Jun 08 14:14:46 EDT 2013;Committer;akr;2;8;33;41;0
874f10cbf214e915dfc38930d03b251379bd4202;Sat Jun 08 13:31:35 EDT 2013;Committer;akr;2;5;1;6;0
e431c67ea71a067eeb5ece0d2e64d1791af4d141;Sat Jun 08 13:00:42 EDT 2013;Committer;naruse;1;1;1;2;0
f1a6b64b1d47e04a338f7d3d6f3c5dfaf13cdb2e;Sat Jun 08 12:48:39 EDT 2013;Committer;akr;2;19;37;56;0
747894a32d6ea2b123b2abc292fd903c53a7aa36;Sat Jun 08 12:05:57 EDT 2013;Committer;akr;4;58;21;79;0
af612be8e0e54ffa602cede04d355a1399a02b81;Sat Jun 08 11:25:07 EDT 2013;Committer;akr;2;14;36;50;0
b512e61ca02ad5ebdfb08581e87bbc0791009684;Sat Jun 08 10:48:33 EDT 2013;Committer;charliesome;3;29;0;29;0
6c5000b5f1a00bb1d21215aeb1881e8c66d4676d;Sat Jun 08 10:33:05 EDT 2013;Committer;charliesome;2;9;3;12;0
1ba82b765c17dac9bbd4a02ec51c0f36e94e1342;Sat Jun 08 10:26:36 EDT 2013;Committer;naruse;2;8;0;8;0
14140eb16b301c1b305b94d6271e8b72242685f6;Sat Jun 08 10:07:05 EDT 2013;Committer;akr;2;4;9;13;0
a76abae51db93662e4e58517a792e57779d2c669;Sat Jun 08 10:05:37 EDT 2013;Committer;akr;2;29;27;56;0
483cbff8dc9abb278c5feb038d98861dcaaefa45;Sat Jun 08 08:15:51 EDT 2013;Committer;akr;2;6;1;7;0
d35616e69456305c78fd72c35aaf6a1beefc49f1;Sat Jun 08 07:40:03 EDT 2013;Committer;akr;3;54;35;89;0
8a1609040e959ffb370c121840cf1fdfb144616a;Sat Jun 08 07:01:19 EDT 2013;Committer;akr;2;9;1;10;0
ccce83c454880c9a0414f8b750ca0808e1f40ccc;Sat Jun 08 06:46:45 EDT 2013;Committer;akr;2;26;46;72;0
90b1a8f4310db9b46f76fa549f981b7deef93f47;Sat Jun 08 06:00:23 EDT 2013;Committer;akr;1;1;1;2;0
0056591f50502c58616f3ea5249e92a174ab86c6;Sat Jun 08 06:00:04 EDT 2013;Committer;akr;4;20;3;23;0
4d6ac81117360a3b11f6a950ae1776a24bc49bcc;Sat Jun 08 05:40:46 EDT 2013;Committer;akr;1;167;0;167;0
5713c5953180f8a89536e855ea3620dd93f4cd82;Sat Jun 08 05:17:04 EDT 2013;Committer;nobu;3;11;165;176;0
6b5be413bbef7e32c331cfacbf55d1aa7b747822;Sat Jun 08 03:01:33 EDT 2013;Committer;akr;2;6;1;7;0
8ca1e1238e626ccb2e371bd4e1043d95aea03930;Sat Jun 08 02:18:14 EDT 2013;Committer;akr;2;9;15;24;0
479b17ed12c749eb2e6716672b0c0765ad87267a;Sat Jun 08 00:50:40 EDT 2013;Committer;akr;2;23;22;45;0
9ebd008f324aeb2f4b7017e30c75629fe7441d19;Fri Jun 07 23:12:55 EDT 2013;Committer;akr;2;7;44;51;0
97b5a9c1025e583099aa624bcab0251f2e7aae96;Fri Jun 07 22:16:15 EDT 2013;Committer;akr;1;2;2;4;0
b0f14c8b58e8fd56f0e4b22dc3b91b4e6162e44e;Fri Jun 07 21:16:12 EDT 2013;Committer;akr;2;4;1;5;0
8bc16423cc6c5a85b0ec36575c869409a843bf28;Fri Jun 07 21:01:42 EDT 2013;Committer;akr;3;10;18;28;0
8ce912bdb3554ea7bd75c360dbaac39a29c61c35;Fri Jun 07 15:56:59 EDT 2013;Committer;akr;2;17;21;38;0
3dcea601c77f5396aa8d44d615a617332147c78b;Fri Jun 07 15:39:07 EDT 2013;Committer;akr;2;23;14;37;0
dac364dbe190acff7db79df27bf4ad6220df6ba9;Fri Jun 07 15:10:26 EDT 2013;Committer;akr;1;0;1;1;0
860c83a5c25bd5924e49452ef6cf205f912313f8;Fri Jun 07 15:02:44 EDT 2013;Committer;svn;1;2;2;4;0
f31aed6255a67be4f7c83d231ab4697f4f92821d;Fri Jun 07 15:02:39 EDT 2013;Committer;akr;6;174;110;284;0
fb4c8c3a2aea1993dacaafef454e1f12e0341e05;Fri Jun 07 14:22:53 EDT 2013;Committer;ktsj;1;1;1;2;0
083e7e397c12fb402b94428ca008c34d7cd27cf5;Fri Jun 07 13:25:41 EDT 2013;Committer;nobu;1;2;2;4;0
bcd5328c706ac3dd71408180a765e86b99651db8;Fri Jun 07 13:17:33 EDT 2013;Committer;naruse;2;7;1;8;0
a08b001100734a3db4efbe9d38d3226950a538e0;Fri Jun 07 12:41:02 EDT 2013;Committer;akr;11;166;176;342;0
07b72b8c856353096fad39a7f628e9076533dc18;Fri Jun 07 12:16:32 EDT 2013;Committer;akr;1;2;4;6;0
8f7a3075881cc057fa70639729e0073a12bfe55c;Fri Jun 07 12:06:09 EDT 2013;Committer;akr;2;87;72;159;0
de1b0c96f0a2f00c8bd3cc5d5fb054bff9905680;Fri Jun 07 10:49:12 EDT 2013;Committer;akr;2;25;22;47;0
84d8e582494ef6d0a8581a4d42d41c68ba07bf0b;Fri Jun 07 10:24:07 EDT 2013;Committer;akr;2;9;4;13;0
bd15d4ca78dd8a9c60e0edf8814fb8e971d35097;Fri Jun 07 10:01:19 EDT 2013;Committer;akr;18;10;32;42;0
8e65ff7e312b1d18f7aec9d8bac066ef13cb6705;Fri Jun 07 09:40:56 EDT 2013;Committer;akr;1;1;1;2;0
e54d70882c3a72d3a6a87a069e34251371306168;Fri Jun 07 09:25:47 EDT 2013;Committer;akr;2;19;8;27;0
f8cf43706a4e4ac33a2223ed1d2d3405eea1d64e;Fri Jun 07 08:41:48 EDT 2013;Committer;charliesome;2;10;3;13;0
97b825bdcf0144e12f9079c66d547a56aa86d2f7;Fri Jun 07 08:31:48 EDT 2013;Committer;charliesome;2;10;5;15;0
e8c6835faa1c10cee2c6b3d72454b929483ed28f;Fri Jun 07 06:57:10 EDT 2013;Committer;kazu;1;1;1;2;0
7f0a24792f9c2ef72a44a8993896a1a111985b04;Fri Jun 07 06:57:07 EDT 2013;Committer;kazu;1;1;1;2;0
cac2f455a9ed5df1827ebfa1ea6fd54ce41f178f;Fri Jun 07 04:45:16 EDT 2013;Committer;naruse;2;7;2;9;0
b309a3698de74e3cf97b5c3d9393c9d3e735f469;Fri Jun 07 04:25:20 EDT 2013;Committer;naruse;2;6;1;7;0
83db393e489cc48783d19a81c3a1a9448caf847f;Fri Jun 07 02:52:42 EDT 2013;Committer;nobu;2;6;6;12;0
5385ae9af43208c014040ed1025b09415d48b36f;Fri Jun 07 02:50:32 EDT 2013;Committer;mrkn;4;43;21;64;0
0b87f8d4cfa627173037c00712e28eb0d5df8307;Fri Jun 07 02:49:53 EDT 2013;Committer;nobu;1;2;2;4;0
147775ac2b21b6591d24cc2af23b8fccb3daf3fa;Fri Jun 07 02:41:45 EDT 2013;Committer;nobu;5;19;12;31;0
432321d78006d32af8f3cda0eb65c4c98ed603ae;Fri Jun 07 02:36:07 EDT 2013;Committer;nobu;1;1;1;2;0
f37d0629afa85e16b96d3d1e12d0eeaa4072dba5;Fri Jun 07 02:32:57 EDT 2013;Committer;tarui;2;77;89;166;0
1f23dca96739aa52cfdd19ba81f710fac13c1ce4;Fri Jun 07 02:28:03 EDT 2013;Committer;tarui;2;39;13;52;0
5a06ae3bf9a4c1bc81e4f9f6cd35659334749f50;Fri Jun 07 02:25:19 EDT 2013;Committer;tarui;2;11;6;17;0
2af3621ab53b5c55285bcd9a8f503e569bf2cdd8;Fri Jun 07 02:21:05 EDT 2013;Committer;nobu;1;1;1;2;0
7185eac56a353b3767c2444564f1446b404d9af4;Fri Jun 07 02:20:05 EDT 2013;Committer;tarui;2;11;10;21;0
b1bbe884cd5e6554017b5c6b610acf653db23a04;Fri Jun 07 02:18:05 EDT 2013;Committer;tarui;2;5;0;5;0
f1a8f228c87292dd0795d221d33dcb9dd95e4f62;Fri Jun 07 01:23:30 EDT 2013;Committer;zzak;1;1;1;2;0
e7dfa869c0a0f55c64510035611c48e85c9ec72f;Fri Jun 07 01:17:19 EDT 2013;Committer;ko1;2;26;22;48;0
3ebd1ff022f08e254f93c0ccfeacbff780726083;Fri Jun 07 00:29:43 EDT 2013;Committer;mrkn;2;6;1;7;0
a8c4a952767d0f554b3ac4ea999dbeb5f54ae6eb;Thu Jun 06 23:05:59 EDT 2013;Committer;akr;2;5;5;10;0
e0bb10be50fa23cb0ef9941750e874cc469cda86;Thu Jun 06 23:05:27 EDT 2013;Committer;akr;1;1;1;2;0
d1f3d41f11a5b0d47a85182a4c55e39def0f08f4;Thu Jun 06 22:31:23 EDT 2013;Committer;akr;5;26;20;46;0
7ba52b04a4a2024488b2ba4201421805d714334c;Thu Jun 06 22:18:24 EDT 2013;Committer;mrkn;2;9;0;9;0
b465a2b4ad8ef084e3fb4dbc533423ec85e993de;Thu Jun 06 22:16:43 EDT 2013;Committer;mrkn;2;6;3;9;0
896619c77b4fd32826644deecd308a21683f827e;Thu Jun 06 21:49:45 EDT 2013;Committer;eregon;2;5;2;7;0
a3b833c0c6c703bd4186769e4fb392d2fd5062f3;Thu Jun 06 21:20:09 EDT 2013;Committer;svn;1;2;2;4;0
c9c67d2fe0d8d502d444c477d3272c4092513a53;Thu Jun 06 21:20:04 EDT 2013;Committer;akr;7;249;27;276;0
64ed7df5434bc2978d5a92a1e750bab39b11edfa;Thu Jun 06 14:40:35 EDT 2013;Committer;nobu;1;3;3;6;0
7708560bb1c4686668268a2bca05da481b7c3132;Thu Jun 06 13:31:22 EDT 2013;Committer;mrkn;3;25;3;28;0
58eac2494f4914701294f1a79084fe84f220ce5e;Thu Jun 06 12:58:25 EDT 2013;Committer;akr;1;3;0;3;0
9fea8758e98eed379bf406f2fea6c8403efe2590;Thu Jun 06 11:57:35 EDT 2013;Committer;akr;8;467;41;508;0
c247e62808211a8e3ef0f54718b4dfea3bc46e13;Thu Jun 06 10:33:48 EDT 2013;Committer;tadf;2;15;10;25;0
fbece268c7c58c32970b581712c8c3d662b20ed1;Thu Jun 06 05:18:40 EDT 2013;Committer;nari;2;12;6;18;0
15d26c3fd9a95f6fa14bc4faae7e1b8e9a07e2b3;Thu Jun 06 05:10:31 EDT 2013;Committer;nari;2;6;1;7;0
907e3885e5568e4d2cc890e3f5dc851d8d831ede;Thu Jun 06 03:00:02 EDT 2013;Committer;kazu;1;1;1;2;0
37fe2987c4db53710ee49fe22970f3e0e53e12b8;Thu Jun 06 02:27:23 EDT 2013;Committer;nobu;1;12;0;12;0
febc42d05c6b8a401fff2361bf03fe338eb4d1b0;Thu Jun 06 01:04:11 EDT 2013;Committer;mrkn;4;26;9;35;0
b43d6331cbf218583ddd1db3a388e5b8d46362f7;Wed Jun 05 16:16:05 EDT 2013;Committer;nobu;1;2;2;4;0
3a17a592da8415433ee58960e266d16a8b0cd048;Wed Jun 05 16:15:26 EDT 2013;Committer;tarui;2;23;19;42;0
2b78c3256158a1bec5426b149be0480ffeae917c;Wed Jun 05 16:01:05 EDT 2013;Committer;nobu;1;1;1;2;0
5d10f35142762ecfdf9a7996eb31217d13c0f251;Wed Jun 05 15:57:12 EDT 2013;Committer;tarui;2;30;20;50;0
6e4cfd9475e4287df2e9cd5bfdad6bd82aaaacd6;Wed Jun 05 15:32:28 EDT 2013;Committer;naruse;2;7;1;8;0
dcd8cdbf113c0b0b2ffe1b2f6463e6f8fcb145aa;Wed Jun 05 15:05:53 EDT 2013;Committer;svn;1;2;2;4;0
91538a3882bcb23f9f93f7738da34d4370f54558;Wed Jun 05 15:05:48 EDT 2013;Committer;knu;3;9;1;10;0
61b8250adc1bca756e92174aa90a49e55efd2804;Wed Jun 05 13:44:17 EDT 2013;Committer;shugo;3;19;0;19;0
13bba43d641a0f7042264a800902f5105cc7d3c6;Wed Jun 05 12:17:30 EDT 2013;Committer;akr;2;9;27;36;0
4a97761c1a571e9475c782b758e513cfe6a505ae;Wed Jun 05 11:53:02 EDT 2013;Committer;kazu;1;3;0;3;0
27e92c66499384653955de64122dc129da73738f;Wed Jun 05 11:35:50 EDT 2013;Committer;mrkn;2;5;1;6;0
3264042eb9a6cfe4089f33ff4578328dcabcfb1d;Wed Jun 05 11:32:07 EDT 2013;Committer;charliesome;1;1;1;2;0
99638b5d1fbb8e4a95408b97719a57acb68eab4c;Wed Jun 05 11:07:05 EDT 2013;Committer;akr;2;37;41;78;0
3fb267e5016ee00e536faca3b9999ef2f01f255f;Wed Jun 05 06:36:06 EDT 2013;Committer;nobu;1;1;1;2;0
c0089b4d104cdac3fa7408615ae28a9f8c78c992;Wed Jun 05 06:31:43 EDT 2013;Committer;naruse;1;1;5;6;0
77857bfc879377dc726b84173ec849c549e5b470;Wed Jun 05 06:27:43 EDT 2013;Committer;naruse;2;13;0;13;0
2ae30c3fa212e979f950e8e7bbcadf0334e671d4;Wed Jun 05 01:43:09 EDT 2013;Committer;nobu;2;2;2;4;0
0094cd8c6413a6af824ef2f25f143a626af4aa52;Wed Jun 05 00:48:24 EDT 2013;Committer;naruse;2;7;2;9;0
14ec81b0a26458e0099472cbb0e768b0411016cb;Tue Jun 04 23:15:30 EDT 2013;Committer;akr;2;8;20;28;0
4eabe8193a801fca0a6456b465217baae472ee7a;Tue Jun 04 22:18:12 EDT 2013;Committer;tadf;2;6;115;121;0
551bcc63643271c9eb64d64afcb25c3d749fa462;Tue Jun 04 22:09:36 EDT 2013;Committer;tadf;3;119;43;162;0
091c24d51b962745bf887a729c81e847b257dc11;Tue Jun 04 21:54:58 EDT 2013;Committer;drbrain;12;62;26;88;0
0454c0a2818ffc1df72e0672e4e272486b2ba536;Tue Jun 04 21:35:31 EDT 2013;Committer;drbrain;2;317;0;317;0
ed318080ade5159a0b1d99acbd22950bf16e9841;Tue Jun 04 16:16:36 EDT 2013;Committer;eregon;2;8;2;10;0
ee9c279e9b001f905c04fd4bd87e7a0878a95107;Tue Jun 04 15:33:34 EDT 2013;Committer;ayumin;2;21;4;25;0
a76f5eb0e09b7bb4cd8451658995b187c7d60f18;Tue Jun 04 15:10:32 EDT 2013;Committer;svn;1;2;2;4;0
5eab13c377a60869d89e770f163323efeaff8da2;Tue Jun 04 15:10:28 EDT 2013;Committer;akr;2;7;2;9;0
aff64b94786b51d105a93ae3c635b5afca853554;Tue Jun 04 14:47:33 EDT 2013;Committer;ayumin;2;6;1;7;0
5f55e23f9c2feb774aaffde8c9e20213c7b97497;Tue Jun 04 14:17:17 EDT 2013;Committer;eregon;2;24;21;45;0
71b6077a5354335f5f04b7e852a22b3290b9f528;Tue Jun 04 14:09:25 EDT 2013;Committer;eregon;2;14;20;34;0
d89308284195390278ccb4a2ea896b6424adc3e7;Tue Jun 04 09:42:25 EDT 2013;Committer;akr;2;5;1;6;0
5c11384416fb55fc2bc4ef40fb47285ba6cf1e56;Tue Jun 04 08:23:26 EDT 2013;Committer;nobu;1;2;2;4;0
1699396fe502d929ced019dc0dd3463a35fbf6d3;Tue Jun 04 06:37:44 EDT 2013;Committer;mrkn;3;13;4;17;0
dd87e463106ade202e3b04e7703a91e438c027d6;Tue Jun 04 03:47:02 EDT 2013;Committer;naruse;1;7;3;10;0
5be464239560765b08fa6379b3f6b902c9236877;Mon Jun 03 15:46:29 EDT 2013;Committer;kazu;2;7;1;8;0
441873745517923a1ceecac901331dfea3afd2cd;Mon Jun 03 15:01:47 EDT 2013;Committer;svn;1;2;2;4;0
1739ecda3b16a2d7c9bd5e845d2209f6e984313e;Mon Jun 03 15:01:42 EDT 2013;Committer;kazu;3;14;1;15;0
935d39a5b82aebdb1af7763311590655ff2adf4c;Mon Jun 03 14:49:33 EDT 2013;Committer;akr;2;24;1;25;0
bf386e580ff48d5bcdd7bc5a49c4515c6865afdb;Mon Jun 03 14:46:45 EDT 2013;Committer;naruse;1;2;2;4;0
2b46322688588563430278acdf5ee646f6e8b922;Mon Jun 03 14:22:53 EDT 2013;Committer;kazu;1;1;1;2;0
cef3f2ebd45c10823a60a70448b8400accbdaf38;Mon Jun 03 14:20:15 EDT 2013;Committer;ayumin;3;19;2;21;0
482f0e6b97330a1321bccdc5c80b988b5068a5b8;Mon Jun 03 10:02:39 EDT 2013;Committer;nobu;2;8;4;12;0
c120db4547592a0b96b14d1fcd372968442032b2;Mon Jun 03 08:16:27 EDT 2013;Committer;nobu;1;2;0;2;0
7a8a7864b1d83e6d17a42f4c015b81b62a02fbe2;Mon Jun 03 02:38:32 EDT 2013;Committer;xibbar;1;5;0;5;0
94b120fe7558f1b0dac644e096d8addf0e7f720a;Mon Jun 03 02:37:34 EDT 2013;Committer;naruse;1;6;0;6;0
523bd6737ea97bce1f92d2e171a09cc564b50125;Sun Jun 02 22:38:11 EDT 2013;Committer;kosaki;3;29;82;111;0
284d7463924b313f12da8de5184af3407c3612ac;Sun Jun 02 18:44:33 EDT 2013;Committer;naruse;3;19;0;19;0
233f7d09e3b5a46917023da7b152b5062036e25a;Sun Jun 02 16:37:14 EDT 2013;Committer;ayumin;2;6;2;8;0
260f6bed23b968ffa14daa79ed1da7077e312116;Sun Jun 02 16:15:51 EDT 2013;Committer;ayumin;2;7;3;10;0
aa32168b5e3e53463bae0e13c42573e3c14e7a5b;Sun Jun 02 15:59:23 EDT 2013;Committer;svn;1;2;2;4;0
aa26e9d9c0ea1567f24ea02b007c4b8debb82b52;Sun Jun 02 15:59:18 EDT 2013;Committer;naruse;1;4;4;8;0
dffcadb4eaf4620c144ad813ddec6ed7c014e971;Sun Jun 02 14:46:43 EDT 2013;Committer;naruse;1;11;10;21;0
166d8dc2d62efbbfcbb6c708c920ddd53f96ebc5;Sun Jun 02 14:36:41 EDT 2013;Committer;ktsj;4;117;111;228;0
e2582ca28ddc2885f07f002cf53e3178f472204b;Sun Jun 02 14:24:34 EDT 2013;Committer;naruse;2;35;31;66;0
5615bf5f79e6d55666f798a08d12c409c27dbf01;Sun Jun 02 07:15:55 EDT 2013;Committer;nobu;3;5;16;21;0
d8069572f8ebf2cb4124a39cc15b6e4f26a221a3;Sun Jun 02 07:15:42 EDT 2013;Committer;nobu;1;0;8;8;0
012dc9d099db8b500e319894b4ed2cd0e7ad3f42;Sun Jun 02 06:06:00 EDT 2013;Committer;zzak;3;7;3;10;0
021c2102dc64ef86c142051bd0d20fc0ff2814fb;Sun Jun 02 05:59:40 EDT 2013;Committer;nobu;1;11;11;22;0
78c04602ad31d47d66c5d3fec703d05e6ac116ad;Sun Jun 02 05:11:16 EDT 2013;Committer;zzak;2;22;8;30;0
6db56c86c9eecc4075d3a281be28e4fcdfacd5e4;Sun Jun 02 03:12:04 EDT 2013;Committer;nobu;8;40;3;43;0
eb5f361937c6e4307ac34afa93a4ffbd447ef4e0;Sun Jun 02 03:05:26 EDT 2013;Committer;zzak;2;6;2;8;0
bc7a6dbb976882b86cf547a1f8e44cc02bd73cca;Sat Jun 01 17:11:53 EDT 2013;Committer;svn;1;2;2;4;0
b285af6468bf58398f12b740819c0b8ff6f1b219;Sat Jun 01 17:11:48 EDT 2013;Committer;naruse;2;8;4;12;0
8b1b2638f333267723e6909ee101de11777aa8f3;Sat Jun 01 14:17:14 EDT 2013;Committer;charliesome;2;7;0;7;0
6bdfe415df2ef15487ba932762c028640b8ff71a;Sat Jun 01 09:01:16 EDT 2013;Committer;knu;3;29;6;35;0
4a223fb67f31a1a85a0b4fb019a1106532a541ce;Sat Jun 01 08:25:05 EDT 2013;Committer;nobu;3;8;2;10;0
06c7ede25923582b7f61c85920cd195b3c0447ce;Sat Jun 01 08:21:39 EDT 2013;Committer;nobu;3;18;6;24;0
767c502252daf751a2efbd0acc5766cd5492e9fb;Sat Jun 01 08:21:37 EDT 2013;Committer;nobu;1;3;4;7;0
a10ea5b94db88c78ec04af7b8861a22d90a9ce67;Sat Jun 01 02:25:47 EDT 2013;Committer;kazu;1;0;5;5;0
e71d501ee0091e493f9eeefd8cb755ce315d70a1;Sat Jun 01 02:16:25 EDT 2013;Committer;nobu;3;15;7;22;0
d956526a76cd3b5aece69cbb444225c4d46d536e;Sat Jun 01 01:13:21 EDT 2013;Committer;nobu;3;5;35;40;0
8663df2f2031e6286cd293415a140c8e685f88cc;Sat Jun 01 01:00:10 EDT 2013;Committer;mrkn;1;75;1;76;0
aa8cc01aa398d231c9839bc24b7b138f2c75952f;Fri May 31 23:00:48 EDT 2013;Committer;nobu;3;18;72;90;0
488f478d24019de88aa96944a0b91987ced37e12;Fri May 31 22:53:58 EDT 2013;Committer;nobu;1;2;0;2;0
ce20b98b143bda528d87c14128b8e977baece2a9;Fri May 31 22:32:55 EDT 2013;Committer;akr;2;10;5;15;0
b77f98aac2534add70f4535b0ed5d329829f82a2;Fri May 31 22:17:04 EDT 2013;Committer;nobu;1;29;1;30;0
984a34bc3ff7cfc77d06b3d0219171d49b0bff7e;Fri May 31 18:21:00 EDT 2013;Committer;naruse;1;3;3;6;0
a78e45b5fe018f98e03e4bbf8e036822349980cb;Fri May 31 17:37:55 EDT 2013;Committer;naruse;3;242;0;242;0
1db209763a70b825db775e684ef3a21a6b5b9757;Fri May 31 16:59:09 EDT 2013;Committer;mrkn;2;11;1;12;0
e337c7f9793ae9fc883d7a86f5954c3ba83566dc;Fri May 31 15:24:51 EDT 2013;Committer;svn;1;3;3;6;0
25e5a75863a111d102f5efff1f9431d7b6c55867;Fri May 31 15:24:47 EDT 2013;Committer;akr;2;11;6;17;0
2a38d9043e2eb16d7f3fcf3460dec5995a3195c6;Fri May 31 14:57:03 EDT 2013;Committer;akr;2;22;6;28;0
fc1f9d2cb2ad4592530f0130d75682a6c8b8c6a7;Fri May 31 14:24:31 EDT 2013;Committer;akr;2;18;8;26;0
1d80ad6a391610bb9225127d388ec96dd31c20ba;Fri May 31 08:58:06 EDT 2013;Committer;zzak;2;55;35;90;0
0544c097614be34df946f40a87946690272f46ea;Fri May 31 08:27:06 EDT 2013;Committer;nobu;5;29;4;33;0
97498d179e4109e844d45b19853aa3bed328136d;Fri May 31 08:27:01 EDT 2013;Committer;nobu;1;1;1;2;0
2339191c399dc2feadb0656297cfc1f12c2d6c97;Fri May 31 08:08:42 EDT 2013;Committer;nobu;1;3;0;3;0
1c5cdc62cc34a92ae612beeb5fd9f12abaf5e6f6;Fri May 31 08:04:56 EDT 2013;Committer;nobu;4;20;9;29;0
58bec3e2cbfee9757fc48e8a5f7abf6dec5cc848;Fri May 31 07:36:19 EDT 2013;Committer;nobu;2;6;0;6;0
acae96deb7a7f21f1178cd9b8f22f664e49f7f94;Fri May 31 07:04:33 EDT 2013;Committer;zzak;3;7;3;10;0
ee0478bce90fb48964490487c8182f819d8e57a7;Fri May 31 07:02:11 EDT 2013;Committer;zzak;2;5;1;6;0
8ea0e6f1fd9abee5b429803365a6dc895446cfd6;Fri May 31 06:18:08 EDT 2013;Committer;nobu;1;1;1;2;0
da51094cf5d30645fa833e7b67d975a194fee319;Fri May 31 02:58:50 EDT 2013;Committer;svn;1;2;2;4;0
6f017366adc1ad465057f9945c24d15c2c3a2106;Fri May 31 02:58:45 EDT 2013;Committer;nobu;2;20;51;71;0
6f9f8d2ef7d9c19e39194e6914e4cf39eaa5d473;Thu May 30 10:50:41 EDT 2013;Committer;mame;3;24;5;29;0
89a452c7c1883607f16ae20e940ec537b69a67df;Thu May 30 08:55:41 EDT 2013;Committer;zzak;2;7;1;8;0
38a14c68e003d30e7a3d12fe0bcce9639d14e39c;Thu May 30 07:59:27 EDT 2013;Committer;xibbar;1;1;1;2;0
10e44b568fcd593caaeb1be9d29903d8057ea16c;Thu May 30 07:59:21 EDT 2013;Committer;xibbar;1;3;0;3;0
c394688567d461b3c96c333708cf37384cec3bdf;Thu May 30 06:58:15 EDT 2013;Committer;xibbar;1;19;0;19;0
184bfbba7fa80c4f8c624c14b364d63d7005f161;Thu May 30 03:57:46 EDT 2013;Committer;akr;1;4;1;5;0
4f66fb14427eb6d1b9ae1b8be3b03e648841e8fb;Wed May 29 23:57:25 EDT 2013;Committer;nobu;1;4;6;10;0
725188d8dcdcf14709b68bff89fbc1a01dd421df;Wed May 29 15:10:33 EDT 2013;Committer;svn;1;2;2;4;0
6e19585ac7dc38810a39f597413279afc1c92bf0;Wed May 29 15:10:28 EDT 2013;Committer;ko1;2;8;2;10;0
f85733a7ce27f28756509462a5d3302854d375c7;Wed May 29 04:38:38 EDT 2013;Committer;naruse;1;1;0;1;0
76300fbae2717a6da9b625db863b6b62797aa90a;Wed May 29 01:44:24 EDT 2013;Committer;kazu;1;1;1;2;0
68f96f6c3c05385a5b47395b82e619f9c06b0437;Wed May 29 01:38:52 EDT 2013;Committer;ko1;2;41;5;46;0
1999571e60d301e01dc4ff041f31ac58ae89fa38;Tue May 28 20:57:18 EDT 2013;Committer;svn;1;2;2;4;0
0a814e9b137bc280723a2ee5da3b0f6db8787d19;Tue May 28 20:57:14 EDT 2013;Committer;tmm1;1;1;1;2;0
57edd09603217193ad0d40cdbbc16626c5a4f3bf;Tue May 28 12:15:31 EDT 2013;Committer;kazu;1;1;1;2;0
7d3fbdeacb9641a7efe11a1f128193e68bfe3889;Tue May 28 04:52:07 EDT 2013;Committer;nobu;1;1;1;2;0
7453c53b08655e9d17c0419716ffad1c41663b6d;Tue May 28 03:36:34 EDT 2013;Committer;ko1;3;119;38;157;0
b0e7ec8c9a06fa975cff864107af1e1c0780f19f;Tue May 28 02:30:13 EDT 2013;Committer;nobu;2;8;3;11;0
c9f982d4e8d47b840378f349e680a20bc140a505;Tue May 28 02:23:52 EDT 2013;Committer;nobu;2;2;2;4;0
40fe524bf33625bcf07953a48c6622328929e7ca;Mon May 27 18:16:05 EDT 2013;Committer;nobu;1;80;80;160;0
30dbed383786362eaf70ad584a8b382a12b68fef;Mon May 27 18:14:28 EDT 2013;Committer;ko1;3;95;0;95;0
b01c4ddfce5faa7e0bb982a41319c7e44141c5e3;Mon May 27 17:57:08 EDT 2013;Committer;ko1;2;4;2;6;0
8a81b54a2b9cf5349c882659fd3b2bc7995bc633;Mon May 27 17:46:20 EDT 2013;Committer;ko1;2;11;4;15;0
c180e0d8801a8fb1f4d900d6a7e36ccb7d4f557e;Mon May 27 17:08:25 EDT 2013;Committer;ko1;4;30;0;30;0
f79ddbebe390cd4216bfe35e2b33aae764dee648;Mon May 27 16:48:18 EDT 2013;Committer;nobu;1;1;1;2;0
462804fce43b15d0ffda8d37a0eee66d33b78246;Mon May 27 16:48:15 EDT 2013;Committer;nobu;4;6;3;9;0
f72bd6e720ec0a75a3d3e64daef1536297c53967;Mon May 27 15:46:09 EDT 2013;Committer;ko1;1;8;1;9;0
e4c58251b736ba362774b24787dff672fd3ee41b;Mon May 27 15:40:27 EDT 2013;Committer;ko1;5;38;4;42;0
c5b6c189d2933a030e68cc410b4e2deb255bba1a;Mon May 27 15:19:41 EDT 2013;Committer;svn;1;2;2;4;0
eccb729a3fb840dc9b45103a19fe62d23b3d5e6c;Mon May 27 15:19:36 EDT 2013;Committer;ko1;2;5;1;6;0
783cffce1dc7a440f4cb04695961fc7349de3024;Mon May 27 13:11:06 EDT 2013;Committer;akr;2;7;1;8;0
f0b6cb6fc7e476dc162a907c021d52831383ba34;Mon May 27 10:28:25 EDT 2013;Committer;ko1;6;15;6;21;0
050dd10d6f8933268ed0fd211eb5bcc8ad49f678;Mon May 27 10:01:45 EDT 2013;Committer;ko1;6;242;1;243;0
14f6c8ca8ae785b14718cac1ad8891ca20e604e1;Mon May 27 08:33:47 EDT 2013;Committer;nobu;2;14;3;17;0
75b9218f25f4f63bf23fdc118eb40c5d712684ee;Mon May 27 08:33:44 EDT 2013;Committer;nobu;1;1;1;2;0
084df96eb1d76a41c0e1eb5c7cd9ed26eee43a23;Mon May 27 07:55:59 EDT 2013;Committer;tmm1;1;1;1;2;0
a1b1b6f7fb22fddcb7843a021e16553f96aea137;Mon May 27 07:17:30 EDT 2013;Committer;ko1;2;7;2;9;0
308d5d0cf3e11a529a55669c7b54d04e5e3fb1af;Mon May 27 05:46:42 EDT 2013;Committer;kazu;1;3;3;6;0
696d3046d1e0a81ccd616cd181f067e392182930;Mon May 27 02:16:00 EDT 2013;Committer;nobu;1;1;1;2;0
662cbf22fa5c3914fe04ced1b2b413aa6fc426b4;Mon May 27 00:24:23 EDT 2013;Committer;ko1;2;6;2;8;0
680f0b5ba4eb4ba4f542ebc8d1204da61b71eb92;Mon May 27 00:21:02 EDT 2013;Committer;ko1;10;207;11;218;0
96090c083dafd99b77405aa97692483f6a6ab9a4;Sun May 26 23:40:01 EDT 2013;Committer;ko1;2;5;1;6;0
7f4d09d6a6af109a63c4220be0379a7424d0813a;Sun May 26 21:31:05 EDT 2013;Committer;nobu;1;1;1;2;0
e2793a908e23dd1dde5eaf553c5bb7ed5e8533c9;Sun May 26 21:30:44 EDT 2013;Committer;ko1;10;179;13;192;0
767debf92e7f21f48631ebb4764ba16cfaf1d7f0;Sun May 26 17:27:42 EDT 2013;Committer;ko1;2;27;4;31;0
ca2ca7d32b7ac53b9c28fac36dfe0bc539df85c6;Sun May 26 16:43:21 EDT 2013;Committer;ko1;2;43;9;52;0
c4c821a7d7f2229a7c8d2c36cdc6b20668101081;Sun May 26 16:19:04 EDT 2013;Committer;ko1;10;48;19;67;0
9ae121d6df75c50bf114aaa3127715ad3194c047;Sun May 26 15:51:17 EDT 2013;Committer;svn;1;2;2;4;0
22415d4ff99e4591b8f176d173639a1be4df9962;Sun May 26 15:51:13 EDT 2013;Committer;naruse;2;7;1;8;0
4ae72030f2b31e047290d3919d80a886d8073629;Sun May 26 12:37:15 EDT 2013;Committer;svn;1;2;2;4;0
a20a14727f4c15fad7a07b8bd7c39074895aa845;Sun May 26 12:37:11 EDT 2013;Committer;ko1;6;101;43;144;0
ea54c59a8e7daf3f0a05eead6415f39c52e3a0fc;Sat May 25 14:55:18 EDT 2013;Committer;nobu;1;5;4;9;0
9421b186620ed31e75fbd546cb2f93f9c4d6deff;Sat May 25 14:29:05 EDT 2013;Committer;ktsj;1;4;4;8;0
1dafd4ebf1a88e0a8298fe60e7632af8584da29a;Sat May 25 14:29:02 EDT 2013;Committer;ktsj;8;49;21;70;0
2ee7d727900c023bc31a30efdb763dfa31a1404c;Sat May 25 12:36:05 EDT 2013;Committer;nobu;1;1;1;2;0
0ea40b2294e162c0183ba3ed07b186a4499fe082;Sat May 25 12:34:50 EDT 2013;Committer;naruse;2;13;2;15;0
9b119ab4563b9d18b16caa6abbc97ab1f211fc97;Sat May 25 11:37:35 EDT 2013;Committer;naruse;1;1;1;2;0
458b79e47b704ad0241a67ad7fe5a111502986b3;Sat May 25 09:55:17 EDT 2013;Committer;mame;2;9;0;9;0
a0b3e032020b77898cbc4be04559456a3cb6f10b;Sat May 25 09:32:47 EDT 2013;Committer;mame;3;13;1;14;0
7b5a42f0fa54dbb0d381ffbe3b8de6601577c518;Sat May 25 08:11:04 EDT 2013;Committer;ko1;2;8;4;12;0
675ba20cea54714b90b20ba2e465b92e29ba8360;Sat May 25 02:28:51 EDT 2013;Committer;nobu;3;9;0;9;0
9abf09133d2f4561801308234023e9405139f705;Sat May 25 02:27:34 EDT 2013;Committer;nobu;2;6;1;7;0
8a4fb4acba170bae08b2d3c29f380b7a7983efd8;Sat May 25 02:24:33 EDT 2013;Committer;nobu;3;33;8;41;0
165db57cdc91ba422448b1be228a9f70bff08f15;Fri May 24 23:58:35 EDT 2013;Committer;nobu;2;7;1;8;0
10a726d9e35308a40f478afceed58e6186366637;Fri May 24 22:04:19 EDT 2013;Committer;svn;1;2;2;4;0
37b862c6371f3fa4b8201ce0a3420e3f75d899e0;Fri May 24 22:03:41 EDT 2013;Committer;nobu;2;9;6;15;0
bea632a0168ca1238342e93809f3889336b889e7;Fri May 24 14:08:37 EDT 2013;Committer;kazu;1;1;1;2;0
2fb8799e6e0839267c13820c0e5bf8fca79c483e;Fri May 24 12:27:12 EDT 2013;Committer;charliesome;1;1;1;2;0
988552998662dedde9e5175f733dd31f0332abf7;Fri May 24 10:33:05 EDT 2013;Committer;charliesome;3;17;1;18;0
f38a0630908c17056e150f5ecaf3e3ecf73e0273;Fri May 24 10:21:04 EDT 2013;Committer;ko1;2;58;29;87;0
de8cb828f555145191d6cc96a864e39424798299;Fri May 24 08:07:01 EDT 2013;Committer;charliesome;2;5;1;6;0
c43dd625b672589778ab6f2fe9c3e665c4199245;Fri May 24 07:32:45 EDT 2013;Committer;naruse;3;32;7;39;0
755f669316b5d1ea5c618754e7c432ac1baf5b0e;Fri May 24 06:54:25 EDT 2013;Committer;nobu;2;8;0;8;0
db41a18845d1578797a2b5baab6d9cbb76e29e42;Fri May 24 06:54:17 EDT 2013;Committer;nobu;2;3;3;6;0
b84f7fda07a8e7bfad80a9faae69f071b736f144;Fri May 24 06:52:38 EDT 2013;Committer;ko1;2;32;8;40;0
717c5f94aaa2fd268f7c5602185111ae37bc31d6;Fri May 24 03:59:17 EDT 2013;Committer;naruse;1;1;1;2;0
d3298468d0844594d07b3a6581b723b648d37dbd;Fri May 24 02:04:27 EDT 2013;Committer;nobu;2;9;1;10;0
20442b9c4496ee2f0f988f3a58917259e959ea0e;Thu May 23 21:46:43 EDT 2013;Committer;zzak;1;24;14;38;0
b8b26d05cef49eb671ba5b69895d8987a6275c3a;Thu May 23 18:01:46 EDT 2013;Committer;ko1;2;9;2;11;0
28eb5913956bced2429cb5362ed6d6bb28ebb350;Thu May 23 15:29:31 EDT 2013;Committer;kazu;1;1;1;2;0
ef6fb99ebe93ea2861991d149c42bab89b58ced6;Thu May 23 15:18:09 EDT 2013;Committer;svn;1;2;2;4;0
4ea690ea3b19680ef168f5b32d7a132cc4d05a5c;Thu May 23 15:18:05 EDT 2013;Committer;nobu;1;3;1;4;0
d07439d5fdbcec497dc251c5c4e77d1660cd195b;Thu May 23 13:49:10 EDT 2013;Committer;akr;1;16;0;16;0
f8180b8963a693d92a2be906a06ef2ffc204c284;Thu May 23 08:35:34 EDT 2013;Committer;nobu;2;11;5;16;0
699e06a88421cf325f8d191dc8582ab8cb7aa92f;Thu May 23 08:22:05 EDT 2013;Committer;nobu;2;3;4;7;0
95170c704cdb84c318399e47c2867e3ce6034ba3;Thu May 23 07:58:06 EDT 2013;Committer;nobu;2;6;0;6;0
09c348239927dd6a09cfc747b746fa1087b0ba1c;Thu May 23 04:09:42 EDT 2013;Committer;zzak;1;14;24;38;0
ec04fecda53da871016240ae2b9ba08a6c66e2d5;Thu May 23 03:00:52 EDT 2013;Committer;nobu;1;2;2;4;0
8a867f91334fd1e9aa8fcd881a5eef56bb5bac21;Thu May 23 02:14:12 EDT 2013;Committer;svn;1;2;2;4;0
ded54cb8608ac277a7fbf9d8ff1825bbb25c650a;Thu May 23 02:14:07 EDT 2013;Committer;nobu;1;24;4;28;0
a4eaf5f37c2364c5daada0e8d5aa3462501f2d0c;Wed May 22 10:38:37 EDT 2013;Committer;naruse;1;4;0;4;0
7a32434fb6f209e0fab3521eab4c19d0f0e9f355;Wed May 22 10:36:28 EDT 2013;Committer;naruse;1;1;1;2;0
f02c2b9cfaf426b7d78e68ec5b76e4aba21f8872;Wed May 22 08:03:53 EDT 2013;Committer;nobu;1;7;0;7;0
22c0397a2071a2032397225b91b27502c09ff1b7;Wed May 22 08:03:51 EDT 2013;Committer;nobu;1;4;2;6;0
11650a6ab90f2c6de97840bab4837802c91f7e5e;Wed May 22 07:50:20 EDT 2013;Committer;nobu;2;12;8;20;0
a815b56d84e1876c5f6e5fc9f4b3bc46a1a3cfb3;Wed May 22 06:19:03 EDT 2013;Committer;nobu;3;22;3;25;0
38302ca7195981b7f4994526378d9c90320d350f;Wed May 22 06:17:33 EDT 2013;Committer;nobu;2;49;56;105;0
5aece50163fc3636ef06a78b055c2ccea3e0b353;Wed May 22 05:21:06 EDT 2013;Committer;ko1;2;9;1;10;0
daf752b105fc0c60f1ca79fd199d2b2fc8e3c483;Tue May 21 23:09:27 EDT 2013;Committer;svn;1;2;2;4;0
9e64703ec87ca5dd3c234942d865330ff9c47cf0;Tue May 21 23:09:22 EDT 2013;Committer;ko1;2;134;92;226;0
e12df5ef40ff52d7428e89048c2424b57e26a907;Tue May 21 13:54:31 EDT 2013;Committer;akr;1;18;0;18;0
3188b4695b917781563d72580943de8675072142;Tue May 21 13:51:25 EDT 2013;Committer;naruse;1;4;0;4;0
ecd5bbe82a925ad7154bc7a16b689b4ae383e44d;Tue May 21 13:48:57 EDT 2013;Committer;naruse;3;50;1;51;0
9662e3ded501f8df72e7ba80e6eb35ae86bbecc9;Tue May 21 12:50:21 EDT 2013;Committer;kou;2;6;1;7;0
07a6b4cbb509f113747cf2f77a6a6a34c9a7e7d2;Tue May 21 12:41:34 EDT 2013;Committer;knu;3;35;2;37;0
51d586c64e19c13a6fdfc75a860247f0835ef1a7;Tue May 21 08:21:59 EDT 2013;Committer;ko1;2;9;8;17;0
9578bb7831201c6c4b8eb03d7352f116046b33c1;Tue May 21 08:19:07 EDT 2013;Committer;ko1;2;89;35;124;0
2e011442e531b2f8b841d6b5d2a9d62b3c435ae7;Tue May 21 07:52:03 EDT 2013;Committer;ko1;2;61;53;114;0
0fd2c7e67b7f3da8e48372da7e03ee4f437bb8e8;Tue May 21 07:43:40 EDT 2013;Committer;nobu;1;1;0;1;0
28a4c88f3a97ba06a4e9dd48f26de5d770a15bf5;Tue May 21 07:41:05 EDT 2013;Committer;nobu;1;1;1;2;0
6f7c9e2ecb20d138565f17286620fc656dd5ffbd;Tue May 21 07:36:34 EDT 2013;Committer;ko1;3;37;0;37;0
f3cdb9f3fbd9ae6965b921314b5becedb6517994;Tue May 21 07:31:05 EDT 2013;Committer;nobu;1;1;1;2;0
3f2cb86ef325217af8205571996179fee0a7ee40;Tue May 21 07:27:32 EDT 2013;Committer;ko1;2;22;15;37;0
32c5c675f2e38ab1bb40b9310b63a535a73cb116;Tue May 21 06:08:04 EDT 2013;Committer;naruse;1;4;0;4;0
1891b60f268780fe4e9d970ffa759c3d7dd0e00b;Mon May 20 18:11:23 EDT 2013;Committer;nobu;3;42;1;43;0
a7092270da3528a09ca4e2249e55ab12cb7f4c11;Mon May 20 18:10:34 EDT 2013;Committer;nobu;1;82;64;146;0
80db7cc4fe74c20bcc1ea9e7fa7e01cc46ad3ec5;Mon May 20 18:08:55 EDT 2013;Committer;nobu;2;7;1;8;0
cbab48f754661a68f95845ea5ef76ec447bc97e4;Mon May 20 18:07:37 EDT 2013;Committer;svn;1;2;2;4;0
c4a8d40ca1d182125d2c17d76eac2e02af9072a5;Mon May 20 18:07:31 EDT 2013;Committer;nobu;2;5;0;5;0
c2496683823b69f521cc4c738f421eb278eeba61;Mon May 20 14:29:55 EDT 2013;Committer;zzak;1;24;14;38;0
8fb4108bb7aa0d23fb53d46bab749240a8838976;Mon May 20 13:41:21 EDT 2013;Committer;nobu;1;26;8;34;0
31c2e85e5109f1529bc3155063b772a5dfda2c86;Mon May 20 13:41:19 EDT 2013;Committer;nobu;1;19;10;29;0
b6f42822fd71c364f99f9ad817e216c2463645e6;Mon May 20 13:41:16 EDT 2013;Committer;nobu;1;7;1;8;0
83fa035d242a01f9af5a04dc6703cecc53d936a5;Mon May 20 13:41:10 EDT 2013;Committer;nobu;1;5;2;7;0
57d8faeab4440e21b5a750ee346dc422a8745e89;Mon May 20 13:33:08 EDT 2013;Committer;zzak;1;14;24;38;0
dcb4ceeac68e32be46016930f0dc82b18e4694e6;Mon May 20 13:28:32 EDT 2013;Committer;knu;2;9;3;12;0
b416c661e80b917fd316c7d758d1b60c0a638991;Mon May 20 13:01:24 EDT 2013;Committer;zzak;2;14;6;20;0
c09172f3951cfc26a5490a4bec04197fd1561229;Mon May 20 12:42:02 EDT 2013;Committer;zzak;2;6;0;6;0
275eb63b1a000f3da87c3ec22b5fdb9d31d1ee97;Mon May 20 11:44:10 EDT 2013;Committer;zzak;2;4;2;6;0
e3436d2957d396ef25eaa1c75092580cc90b1fe9;Mon May 20 11:37:04 EDT 2013;Committer;zzak;2;25;27;52;0
46cb75db9bbb5b7d79fa55b5e2813ad7c2d4ba08;Mon May 20 10:35:26 EDT 2013;Committer;eregon;2;13;9;22;0
3786bd6096302218ef618d005c4e280c38f612d3;Mon May 20 10:35:01 EDT 2013;Committer;eregon;2;7;3;10;0
a3672d4bf4ddc5e39622e606df808b3954e18849;Mon May 20 02:52:29 EDT 2013;Committer;zzak;2;6;29;35;0
596cecb0579f8e04cafdc52e0bd1ea6f18de7715;Mon May 20 02:22:35 EDT 2013;Committer;nobu;1;2;0;2;0
88bcccd4333fee37e90dc524ccb7cc20745e0332;Mon May 20 01:40:30 EDT 2013;Committer;nobu;5;31;6;37;0
bcddf03238140babb6112d289fd88e118390d4ce;Mon May 20 00:53:40 EDT 2013;Committer;nobu;2;7;4;11;0
eb9cd6b11eb4bca2df2ea355b4c53e87f51862ff;Mon May 20 00:43:27 EDT 2013;Committer;nobu;1;1;1;2;0
fdfc52151916b67d44be459afc674ab82f27004e;Sun May 19 23:04:36 EDT 2013;Committer;zzak;2;13;0;13;0
caca17a8987d53f47822c63120047ca6de4984ea;Sun May 19 23:03:25 EDT 2013;Committer;zzak;2;5;1;6;0
e87c6b192d14a27ae173aa449ecdd073fcee8b2e;Sun May 19 22:49:29 EDT 2013;Committer;zzak;2;21;14;35;0
c1f176974c7fbbec7f5d9e178bb655deaad3dbce;Sun May 19 22:29:26 EDT 2013;Committer;zzak;2;223;96;319;0
2439bc9e69e57244ec7af77cc3bc899d78c3a0b4;Sun May 19 21:00:43 EDT 2013;Committer;zzak;3;72;26;98;0
dbefdb434d43f99dfc4b8b558591ef63377ea43e;Sun May 19 19:58:56 EDT 2013;Committer;zzak;2;29;14;43;0
ba84738d44384760faa32dd6525a6f0e1c9e9565;Sun May 19 18:36:37 EDT 2013;Committer;zzak;2;6;2;8;0
d6d457378232a417064f44b654b8357ae757836d;Sun May 19 18:21:05 EDT 2013;Committer;nobu;1;5;5;10;0
18ffba64bdee370edf93de115215d15019e54f17;Sun May 19 18:17:51 EDT 2013;Committer;zzak;2;32;0;32;0
df425a015a6a84cc85fa8c9e37f0e4b8e067a62c;Sun May 19 15:44:09 EDT 2013;Committer;naruse;1;1;1;2;0
4fb73c8fb4fed5cd93c64f640f647f7a54421349;Sun May 19 15:01:08 EDT 2013;Committer;svn;1;2;2;4;0
a920927afd8e136e72344ada1b68939b5e9acf88;Sun May 19 14:58:00 EDT 2013;Committer;ayumin;2;20;0;20;0
c54733e1206c2d7434610c8f7f2875f082231cfd;Sun May 19 14:50:47 EDT 2013;Committer;kazu;12;22;22;44;0
66795c47745698b30d42b35831f359aa3c07bf2c;Sun May 19 14:15:42 EDT 2013;Committer;ayumin;2;6;1;7;0
11c7566aa38222c8120c076cf328c847d62b9a85;Sun May 19 08:33:27 EDT 2013;Committer;knu;2;8;0;8;0
b4795cdbba22ace10ca91eb15b9793abea6c56e6;Sun May 19 03:11:09 EDT 2013;Committer;nobu;5;91;91;182;0
edb98f8b910b00be16868b21116924cffad785b9;Sun May 19 03:10:21 EDT 2013;Committer;ktsj;62;132;132;264;0
67964f299b671c9b29257c7a62000bfbadb4c556;Sun May 19 02:42:16 EDT 2013;Committer;ktsj;2;5;0;5;0
0687ed1e59130f905c440828df5005397f62a28c;Sun May 19 01:41:47 EDT 2013;Committer;knu;2;7;1;8;0
30f813ddf2d9f29a10ed9a5e3de3dbb1f2cae4c4;Sat May 18 21:23:15 EDT 2013;Committer;eregon;1;2;2;4;0
42b8654bf08f7f0fc51d2da2b40c6c80ca77c15c;Sat May 18 19:00:11 EDT 2013;Committer;naruse;2;55;24;79;0
53fdb30e7f83fcaacb480a1e7c08a9288cd30bd7;Sat May 18 18:58:13 EDT 2013;Committer;naruse;3;16;13;29;0
2849ee5d18360f26b55643a2643a1c597376865d;Sat May 18 17:48:18 EDT 2013;Committer;knu;3;19;2;21;0
041224017c5a865ad0ea0d360bce1709b39d2255;Sat May 18 17:38:08 EDT 2013;Committer;knu;2;7;2;9;0
616084fd976a4e083722e32818f95c304903534f;Sat May 18 17:38:04 EDT 2013;Committer;knu;2;35;2;37;0
30034b5536207c5a3fbc5ef8b8670cc74b96f382;Sat May 18 17:38:02 EDT 2013;Committer;knu;2;19;1;20;0
54fef60273af8fa1173aa84cf7fe434893695435;Sat May 18 16:40:14 EDT 2013;Committer;svn;1;2;2;4;0
9c0ff0c1c817ca27665efb4233f91f1916d8f45b;Sat May 18 16:40:10 EDT 2013;Committer;nobu;3;12;2;14;0
344db69c452565dd20022093ff67874d420e55fe;Sat May 18 14:57:59 EDT 2013;Committer;nobu;3;27;5;32;0
9cc1cc2045469323fdd97aaf0a17585db5686d69;Sat May 18 11:28:51 EDT 2013;Committer;akr;2;12;6;18;0
05c0a22854312d528965ef5866cf5d840b42bdad;Sat May 18 11:16:56 EDT 2013;Committer;naruse;4;45;1;46;0
bfec5ad41f808b37d5bc248fdcbc595c367be9e6;Sat May 18 08:17:03 EDT 2013;Committer;akr;2;8;4;12;0
2c7c4b2e7b6c9400329885d146af5ca2ab557748;Sat May 18 07:58:36 EDT 2013;Committer;akr;2;7;2;9;0
e38a2399d21bd8c6f104a1b522a82ae0b75b34de;Sat May 18 07:38:55 EDT 2013;Committer;nobu;3;36;1;37;0
3e8bba2fc1138fb072935b3f935810a78ce71a8c;Sat May 18 06:49:19 EDT 2013;Committer;nobu;3;10;12;22;0
8a28e97ae999bf26fc59651db581ca90a9206eba;Sat May 18 02:05:17 EDT 2013;Committer;nobu;3;25;17;42;0
6b6ca88925668a7608768740fe85978a6f3ca942;Sat May 18 02:03:07 EDT 2013;Committer;nobu;2;24;15;39;0
15b88811d6dfb1a406dc5c01282850ad9952fd29;Sat May 18 01:58:00 EDT 2013;Committer;nobu;1;2;1;3;0
94dfc14ed87f969e84cc1896be56433ede7fe369;Sat May 18 00:01:10 EDT 2013;Committer;akr;2;10;2;12;0
e0a459762d7e617aa5eb6496f54b3d76aefb19bb;Fri May 17 15:40:03 EDT 2013;Committer;svn;1;2;2;4;0
a7acc99193857da45837b52a1ffb73888b05d9f0;Fri May 17 15:39:59 EDT 2013;Committer;akr;2;19;13;32;0
9d099423e784be8a5df88db9b6ea839db99c4765;Fri May 17 13:04:17 EDT 2013;Committer;akr;2;24;4;28;0
24acab6543933e1e0c6a02af3c35f57867150548;Fri May 17 12:49:25 EDT 2013;Committer;zzak;2;8;3;11;0
53fa01d0608d82fc6edffe59ade5d081d7138c8e;Fri May 17 10:27:32 EDT 2013;Committer;knu;2;19;10;29;0
fbe45fdfa2a3dd461adfe82e13e97c7717b34dca;Fri May 17 09:10:16 EDT 2013;Committer;akr;2;12;1;13;0
baa65ad10878385dc47caebdb6c482f1dea71b98;Fri May 17 08:35:26 EDT 2013;Committer;nobu;3;16;2;18;0
4621799d3d8345b44ae650b88be1ae19502bd85b;Fri May 17 03:39:40 EDT 2013;Committer;nobu;1;2;1;3;0
d05010f6a4c0ce0473b815d0c8c5f3839a37e541;Fri May 17 03:11:42 EDT 2013;Committer;akr;1;1;1;2;0
37659d8fc5ae1978a4373492654f763324c407e7;Fri May 17 02:07:04 EDT 2013;Committer;svn;1;2;2;4;0
f7624d984bb8c2d879606f1257b317331ad3d7d2;Fri May 17 02:07:00 EDT 2013;Committer;nobu;2;16;0;16;0
de03518cc7bb2f95df75fd56079b1b8e757436b8;Thu May 16 13:35:44 EDT 2013;Committer;nobu;1;5;1;6;0
8416b57943539ab5267021e8cf1f61bcb5d1bcff;Thu May 16 10:29:05 EDT 2013;Committer;akr;1;1;1;2;0
612143ddc15515e685427b23f598d285d812be35;Thu May 16 10:26:57 EDT 2013;Committer;xibbar;1;1;1;2;0
75cbab7fe1fd820afa83d79eccafd50db68acc86;Thu May 16 10:14:45 EDT 2013;Committer;xibbar;1;5;5;10;0
2829cbacc34e120636f0ee37a86f12f590b4de02;Thu May 16 10:01:07 EDT 2013;Committer;xibbar;1;1;1;2;0
940a99ac7c76f986e338bb2a75086d467940b162;Thu May 16 08:17:00 EDT 2013;Committer;naruse;2;8;1;9;0
67f562a417e988d06c1d81885d8f3ab271cbf85d;Thu May 16 07:54:04 EDT 2013;Committer;nobu;3;10;3;13;0
87e352c5a3be4697c7783d311657de4e27666bf1;Thu May 16 07:20:00 EDT 2013;Committer;nobu;2;6;9;15;0
49d37e6edc41d58208f671da0a4697a271eedb9d;Thu May 16 07:15:48 EDT 2013;Committer;nobu;3;24;18;42;0
f13a0a4ddaad8131e9fe0a4e74108578d8a098a3;Thu May 16 07:15:45 EDT 2013;Committer;nobu;2;2;6;8;0
d5cb69007b45e090f3c61b8d34346f0a668b1e4a;Thu May 16 05:59:58 EDT 2013;Committer;usa;2;6;2;8;0
434f0abd0290cc5f1f59ad8fd146e43a8ebd42bd;Thu May 16 04:13:40 EDT 2013;Committer;nobu;5;71;58;129;0
ae9dbb6ce1aca03a8d35c7e1afd1011bc9b52caf;Thu May 16 04:13:36 EDT 2013;Committer;nobu;1;3;1;4;0
7b5a819308245393e282198de6580da021395d26;Thu May 16 04:13:22 EDT 2013;Committer;nobu;1;1;1;2;0
a1cc022e79d6d5ea2c7d8f80ad00d4a7dcff47e2;Wed May 15 20:48:15 EDT 2013;Committer;tenderlove;2;6;1;7;0
e213a7228f88d83ecf8253ea1fb939c6f2384136;Wed May 15 18:07:12 EDT 2013;Committer;ko1;2;5;8;13;0
0f3206c65b7c080d0c28354840a367f87ce43a2f;Wed May 15 17:37:55 EDT 2013;Committer;nobu;1;2;0;2;0
a84c2941c22b165777667aeddad892c4ee99a45e;Wed May 15 17:04:03 EDT 2013;Committer;akr;2;5;0;5;0
ad6ae1db0a3658b9dce34693744f85ba0dd44619;Wed May 15 16:51:54 EDT 2013;Committer;nobu;1;1;1;2;0
04198615902effb4d45d2e69020a286147649b10;Wed May 15 16:50:05 EDT 2013;Committer;nobu;1;1;1;2;0
fa827c8b5a870ac586c18bf711cdaa8dc4028762;Wed May 15 16:44:55 EDT 2013;Committer;nobu;3;15;6;21;0
4616913dc5a23132bafe60ea36d07bd3b440316f;Wed May 15 16:25:39 EDT 2013;Committer;tenderlove;2;8;1;9;0
dec4e1cd2db6c11143900f017c8d6453a33c1161;Wed May 15 16:08:56 EDT 2013;Committer;svn;1;2;2;4;0
83b1c8da9bec49b24b2f2c29ce6bb6784456d04a;Wed May 15 16:08:48 EDT 2013;Committer;nobu;1;1;1;2;0
85ed9ca7e06dc88bcd6c8b35307d74f00d851d64;Wed May 15 10:31:05 EDT 2013;Committer;nobu;1;1;1;2;0
f1ccdf98cae8e02d156968b1a8f67ac72f9857de;Wed May 15 10:26:22 EDT 2013;Committer;ko1;2;34;27;61;0
1ad7cbbf640f7af4be6d0a348f6f1fcab0628e2a;Wed May 15 08:56:28 EDT 2013;Committer;nobu;2;9;6;15;0
5780d881757aebf82b8398c40b8a7f4134973e44;Wed May 15 08:09:14 EDT 2013;Committer;nobu;1;1;1;2;0
4a9ec30601e6ac639aec25d93dede1de845b3b61;Wed May 15 08:07:30 EDT 2013;Committer;ko1;2;43;6;49;0
17bce7d0c4f90cde2216063df7d010aba2bca785;Wed May 15 08:06:10 EDT 2013;Committer;nobu;2;3;3;6;0
d780d49b9c1a3794c9894e341d8d34b0a290d31e;Wed May 15 08:06:07 EDT 2013;Committer;nobu;1;1;1;2;0
b38e3f953c6e105ea214237e215c93a123a24738;Wed May 15 07:58:28 EDT 2013;Committer;nobu;5;54;84;138;0
57531305bcafdf37f91a48684d49fd2718ec5ca3;Wed May 15 07:56:39 EDT 2013;Committer;nobu;6;103;77;180;0
4425e21343f532cc9bc3d36b77189a20807c2d37;Wed May 15 07:52:53 EDT 2013;Committer;nobu;1;2;2;4;0
262529fdfb34630cc4702bd607191d1b6c719abb;Wed May 15 07:51:32 EDT 2013;Committer;nobu;1;8;0;8;0
3f51cff4f9c3babdc0d641ffa8467ceabe5a5e26;Tue May 14 18:57:23 EDT 2013;Committer;tenderlove;2;12;0;12;0
9ecdb32144243d3bc8b8cf37cd3c44d003ef120e;Tue May 14 18:28:13 EDT 2013;Committer;nagachika;1;0;2;2;0
7ceafcbdf5bd2155704839f97b869e689f66feeb;Tue May 14 17:26:41 EDT 2013;Committer;tenderlove;19;383;60;443;0
d7f06a665c8e5b4ec83b6baa4a7532fc7ad7f24a;Tue May 14 17:07:51 EDT 2013;Committer;tenderlove;4;42;5;47;0
0b8f727d7b3cd162ccba570d17ebf1ae72bd120a;Tue May 14 16:58:50 EDT 2013;Committer;tenderlove;1;3;3;6;0
a6df3a98abb49398ffcaeef0af35a37e27e9d411;Tue May 14 15:53:31 EDT 2013;Committer;usa;1;1;1;2;0
50146213e257295141083454a54b60257bf503b3;Tue May 14 15:44:19 EDT 2013;Committer;svn;1;2;2;4;0
ccf07bde231057ea5736fb6608447bb845c69125;Tue May 14 15:44:14 EDT 2013;Committer;usa;2;9;0;9;0
1e5a64261fd2f41eb49b20a3f4f2acaabffc5c7c;Tue May 14 14:48:00 EDT 2013;Committer;akr;2;5;0;5;0
d70a806a176b6bd1d667d8d2c86276b93783637e;Tue May 14 14:27:25 EDT 2013;Committer;nobu;1;1;1;2;0
5ec5c6d52c69517d97cddd5daeb0b5c9af80ff81;Tue May 14 14:24:42 EDT 2013;Committer;nobu;4;37;1;38;0
b6decf289fb90e579733ed29571f0870c7a7c169;Tue May 14 11:35:50 EDT 2013;Committer;akr;1;18;18;36;0
c7d7ff45f1e0d6fad28e53c02108d4b067e843c3;Tue May 14 11:06:58 EDT 2013;Committer;nagachika;4;30;0;30;0
912c16db3dae29fb473152d8861ec7afcf2964b7;Tue May 14 09:15:33 EDT 2013;Committer;kazu;1;1;1;2;0
c3f4598683d3e6c5c657d893bed5a5f2c45d8952;Tue May 14 08:42:58 EDT 2013;Committer;naruse;1;4;0;4;0
cd9165458ba25a815c01d29ff1ce4ce88b599499;Tue May 14 08:24:58 EDT 2013;Committer;nobu;3;9;1;10;0
e6589b2b552f1fb7fe601cce7dda7b86fb4d873d;Tue May 14 08:24:55 EDT 2013;Committer;nobu;1;1;1;2;0
f83c42d970916f8c2d8b30cb252ce09709c10b60;Tue May 14 05:52:06 EDT 2013;Committer;nobu;2;20;4;24;0
77753bd9ec9f40e49d7bed633778f365e96a102a;Tue May 14 03:22:06 EDT 2013;Committer;usa;2;6;1;7;0
bb5212d395ae2a65f40ee1a17c8eaa56ccb38c95;Tue May 14 01:54:48 EDT 2013;Committer;nobu;2;6;6;12;0
b4d0f63529deabda2aa42581f6bd2a4e9f4e0565;Tue May 14 00:37:39 EDT 2013;Committer;kazu;1;1;3;4;0
f254b689f22588d8ffa6f2600ad771a7561a82b1;Mon May 13 18:34:10 EDT 2013;Committer;ko1;2;4;3;7;0
b8c0ff86d5a8c860f692159ebbc41f84eb2dec5c;Mon May 13 18:23:35 EDT 2013;Committer;ko1;2;7;2;9;0
5016b37ae4960708aa111a8b13b07b32b5abb3fd;Mon May 13 18:22:17 EDT 2013;Committer;ko1;2;6;1;7;0
305382bd69339206249db008003baef1bb9461f1;Mon May 13 18:21:32 EDT 2013;Committer;ko1;2;6;1;7;0
1829147fb58982bf31549e4377f171fd18da8919;Mon May 13 18:19:30 EDT 2013;Committer;ko1;2;9;4;13;0
9b6b3672cc1556791225aa9663ded2ac24e9cd1c;Mon May 13 18:14:01 EDT 2013;Committer;ko1;2;7;1;8;0
4f401816ffaf9b641cfbc8ad12203eedcdb527de;Mon May 13 18:07:47 EDT 2013;Committer;ko1;18;985;135;1120;0
7958c71ee57b0e394ed5e99f724161eacadf3056;Mon May 13 17:02:50 EDT 2013;Committer;ko1;2;32;10;42;0
b597df707e529381e70ece71e74d4a2c296e9ef3;Mon May 13 16:52:49 EDT 2013;Committer;ko1;2;9;2;11;0
7d0a90e9b494dd0897e4a5a3b5d219b9c9c891e8;Mon May 13 16:34:25 EDT 2013;Committer;ko1;2;87;63;150;0
e23941ff35277f3043f4de355ea2b10a8d1c6fe5;Mon May 13 15:55:13 EDT 2013;Committer;svn;1;2;2;4;0
89e6910f04bb7dcb4d1b3879b8e98295bc20271d;Mon May 13 15:55:09 EDT 2013;Committer;ko1;4;34;12;46;0
8ccd658e5467da884f40260e695268965f8d5d06;Mon May 13 14:41:08 EDT 2013;Committer;eregon;1;1;1;2;0
b86ebc1fd41f5c7ff9a76af2af872f3e61f04282;Mon May 13 13:39:21 EDT 2013;Committer;kazu;1;6;6;12;0
2ad4c65b545e095d36c66074422ce2e41b9d0278;Mon May 13 12:51:38 EDT 2013;Committer;akr;2;6;0;6;0
dd4687313cf62f43fca2d9a8ceeb56ec5fa6841c;Mon May 13 12:21:53 EDT 2013;Committer;usa;2;71;4;75;0
cb3fcdcdc3eeb4612c78d1fac10438214184642f;Mon May 13 11:29:32 EDT 2013;Committer;usa;6;122;14;136;0
f1eadb0fb446418ac7b607a609cf19d9fd943f83;Mon May 13 11:11:53 EDT 2013;Committer;ko1;2;4;1;5;0
83aba0486298d61b39f3ed3492042690a889807f;Mon May 13 10:49:11 EDT 2013;Committer;ko1;34;190;112;302;0
aacd7710462142df7397618ffff4279e495f10f9;Mon May 13 09:56:22 EDT 2013;Committer;ko1;33;217;212;429;0
12bf73637b960cf0ef463f966554595ff2c37ecd;Mon May 13 09:41:48 EDT 2013;Committer;ko1;2;11;0;11;0
c8fc37a99c7d04937c586fe6aad9b4cf421219e1;Mon May 13 06:43:08 EDT 2013;Committer;ko1;1;1;0;1;0
b6b85f6eaf51d4a258cc228319721367cd1f2e0c;Mon May 13 06:33:48 EDT 2013;Committer;ko1;3;18;5;23;0
8ac05ae500332d7fb8a86f9da7d87424915ab0ca;Mon May 13 06:25:33 EDT 2013;Committer;ko1;2;5;1;6;0
925c936bb1f362cb806184afddf2dbac40b21ffc;Mon May 13 06:03:00 EDT 2013;Committer;ko1;2;8;8;16;0
0824f9f224117ce26973df3ebc6216d03723dd0e;Mon May 13 05:52:03 EDT 2013;Committer;nobu;3;76;5;81;0
304850801475722c686e31c93f82e18ede93ba05;Mon May 13 05:51:14 EDT 2013;Committer;nobu;3;11;1;12;0
609c7420d77aed3492648b6dae7adf118d3a8ab9;Mon May 13 05:50:38 EDT 2013;Committer;nobu;3;26;0;26;0
111c791c3730608a0a961ab86d153c824e26db9f;Mon May 13 05:49:47 EDT 2013;Committer;nobu;1;1;1;2;0
ee22fad45d394818690c4a7586d7bb576ba67c56;Mon May 13 02:08:59 EDT 2013;Committer;yugui;2;18;3;21;0
0dc6dcfb6a3ecc25ac673c728645ab98925b8411;Mon May 13 01:31:27 EDT 2013;Committer;zzak;2;12;5;17;0
793c5ae865ce1d426506593d9ed627838de8e107;Mon May 13 01:07:55 EDT 2013;Committer;svn;1;2;2;4;0
4813d8713cd88fa8aa8d403d5d0eb84d1ad73ac9;Mon May 13 01:07:50 EDT 2013;Committer;zzak;2;5;0;5;0
00096bdf0dfd2f98f9265449a17f23374975eb3c;Sun May 12 13:51:54 EDT 2013;Committer;nagachika;1;1;1;2;0
d2b4011a9424a8d74c9fed97382c3a29eccd8125;Sun May 12 12:13:01 EDT 2013;Committer;nobu;2;7;0;7;0
fa1e2d957eb2e1d5efba8d836612ea4e77175fa8;Sun May 12 09:47:02 EDT 2013;Committer;kazu;1;2;2;4;0
2b881310f8b14066f696275ae3811a0bc87dc30b;Sun May 12 09:02:10 EDT 2013;Committer;kosaki;2;5;2;7;0
f3c9bb063e37cdedd888f9d755c7303793e56962;Sun May 12 09:01:57 EDT 2013;Committer;kosaki;2;6;6;12;0
6591e26eb24ddf89e93941f1207511bb85ef54ae;Sun May 12 08:53:40 EDT 2013;Committer;kosaki;2;5;1;6;0
96ffcf557bb93f891ab9f75053a0b9edda62d064;Sun May 12 08:42:30 EDT 2013;Committer;kosaki;3;16;2;18;0
93d061a8fd774022f654f4d8fd72963647381920;Sun May 12 08:42:19 EDT 2013;Committer;kosaki;3;6;4;10;0
82330e919b3897a49e11a031f7a080718231a5f1;Sun May 12 08:42:09 EDT 2013;Committer;kosaki;2;5;5;10;0
3f6b5aa2f80515f30f4db46a07da85dbfdcadbed;Sun May 12 08:41:57 EDT 2013;Committer;kosaki;2;4;1;5;0
c0a30fcbf93178fafe5b7a12fd5f3ad186b3535a;Sun May 12 08:41:46 EDT 2013;Committer;kosaki;2;5;1;6;0
59a3943a6786a9357ea8221f197ca839247cf42f;Sun May 12 08:41:36 EDT 2013;Committer;kosaki;2;9;1;10;0
05628d3b6d49bd301f16acdb882442c81d97475d;Sun May 12 08:41:24 EDT 2013;Committer;kosaki;4;25;6;31;0
e79f7907987d9dc2445892b7b571a621208d29bf;Sun May 12 08:41:12 EDT 2013;Committer;kosaki;5;11;55;66;0
2d0c7e37bf51191f20f06362763f3e8661641217;Sun May 12 08:40:59 EDT 2013;Committer;kosaki;2;5;1;6;0
f15d3ff927daa77e86abf726eec1baedcffbb48d;Sun May 12 08:40:47 EDT 2013;Committer;kosaki;2;16;9;25;0
a79cccb5c6797437a319a8834a8b68243d63fe86;Sun May 12 08:40:35 EDT 2013;Committer;kosaki;2;14;9;23;0
7776ca930b0b72a95d453481d942c4069d088dc6;Sun May 12 08:40:24 EDT 2013;Committer;kosaki;3;8;1;9;0
fa5db01644420b903549f69e99767995a62cbc65;Sun May 12 08:40:12 EDT 2013;Committer;kosaki;2;106;104;210;0
2f6cab0f59a07194a6a6d1a9cba68062613b1e6d;Sun May 12 08:40:00 EDT 2013;Committer;kosaki;2;4;3;7;0
5aa618819b43af091ab823c2f51bd3fefa20c410;Sun May 12 07:09:26 EDT 2013;Committer;naruse;2;6;1;7;0
7da6744329bdebf66fe491c55f32df66e3b7598e;Sun May 12 02:33:48 EDT 2013;Committer;kazu;1;1;1;2;0
6210fc9fe56ad176e07b3462381315775cca31cc;Sun May 12 02:33:45 EDT 2013;Committer;kazu;1;1;1;2;0
b9a34fd717d1e23ddb2f53cf52e1a655fd917591;Sun May 12 01:44:06 EDT 2013;Committer;hsbt;1;0;5;5;0
8f88edf0f926bc06921d713b25d31514c9d57fc8;Sat May 11 18:28:36 EDT 2013;Committer;svn;1;2;2;4;0
5b20e5e1fee1848ce59bc1e03109cc6daa717610;Sat May 11 18:28:32 EDT 2013;Committer;nobu;1;2;2;4;0
037ce7f6bc29b2eeb4f40f0c28376c1aca8be844;Sat May 11 14:07:20 EDT 2013;Committer;naruse;2;11;1;12;0
975e43b8cb8d4cdd3e4ac126db894d1053cb8a02;Sat May 11 13:08:59 EDT 2013;Committer;akr;2;6;3;9;0
26cb14f846006ed4739af1153aae1f87e4678b3e;Sat May 11 13:04:39 EDT 2013;Committer;akr;2;17;12;29;0
e3a2145d22df6e6627247dcb8410a2c934706256;Sat May 11 12:02:08 EDT 2013;Committer;akr;1;3;0;3;0
ae17f7ab7d2d4bf0c3f5b58e58a08b9be15cc792;Sat May 11 10:51:22 EDT 2013;Committer;naruse;1;5;8;13;0
2977c53b219b3513e2ba795aa25eadb92f5293ce;Sat May 11 10:20:38 EDT 2013;Committer;akr;1;4;0;4;0
b323d7d54c1f9d22799f636014a438f9da951f3f;Sat May 11 08:32:26 EDT 2013;Committer;akr;9;756;32;788;0
fade664f916d001d1e2d53cbccd132f6b039fb7d;Sat May 11 02:50:35 EDT 2013;Committer;akr;1;1;0;1;0
690b663c54b990da769e2c50307b04362b915b55;Fri May 10 15:50:02 EDT 2013;Committer;svn;1;2;2;4;0
b1dd4c92ce95bc0deaf7ab34524f239953434ecb;Fri May 10 15:49:56 EDT 2013;Committer;akr;2;7;1;8;0
ecddb9678592e9c34e89494377a09d84c5306379;Fri May 10 14:56:40 EDT 2013;Committer;nobu;3;98;32;130;0
0542f05b321ef4f0d0083cc442ee1f347753f529;Fri May 10 14:56:37 EDT 2013;Committer;nobu;1;5;5;10;0
980bf275fae4b50b06f330d854aa326444916a46;Fri May 10 11:24:06 EDT 2013;Committer;akr;2;18;14;32;0
695ad02d1bf0fe00c188d50d4c81af0ad3fa2087;Fri May 10 10:33:18 EDT 2013;Committer;akr;2;143;21;164;0
093beeda90631de7c1d82abb1be4ef0f7bde06c2;Fri May 10 03:01:51 EDT 2013;Committer;akr;2;18;2;20;0
14c9944e88d8c03aeb26f450c72c4d9a6e6632e1;Fri May 10 01:48:20 EDT 2013;Committer;nobu;1;11;7;18;0
95b690d2a76f9911662161a4a5f95bba8688546f;Fri May 10 00:55:08 EDT 2013;Committer;svn;1;2;2;4;0
8daa0d49cfa4c20f778a6f07f8f242f443c66b31;Fri May 10 00:55:03 EDT 2013;Committer;ryan;3;6;7;13;0
2ffbe0345dd606cffcc30cbfce437762f5fcb496;Thu May 09 13:01:08 EDT 2013;Committer;akr;2;6;1;7;0
bfb334eefa6fdebcf95af0b44f27117b754d93c7;Thu May 09 12:12:17 EDT 2013;Committer;akr;6;39;33;72;0
adb575e21e176f73caa79838e98c8720269f12e2;Thu May 09 11:48:29 EDT 2013;Committer;akr;4;16;6;22;0
a5e6d48dfbd13f245eaa063c794e83c91aa5606a;Thu May 09 03:08:58 EDT 2013;Committer;akr;4;28;22;50;0
029ad63b0b1f1a4d41678d1e42540ccef6affcb4;Thu May 09 02:30:47 EDT 2013;Committer;zzak;2;6;1;7;0
119f67518971ae28e0e008c6ab1c902e2ac43828;Thu May 09 02:15:24 EDT 2013;Committer;zzak;2;349;0;349;0
f9feb22f1a93a4f4dcd840f7d2441385dd4185a8;Wed May 08 19:58:38 EDT 2013;Committer;akr;1;1;1;2;0
18646d74ddbcd6443196aeccf8492ae609c84372;Wed May 08 19:57:37 EDT 2013;Committer;akr;2;6;0;6;0
86d5a05c478561be55d56926dee5a5f61672d281;Wed May 08 16:55:59 EDT 2013;Committer;akr;1;1;1;2;0
6d313a387ab91fd3a0f83a5e5992336dc492d223;Wed May 08 16:52:16 EDT 2013;Committer;akr;2;6;2;8;0
53175b09f1fd93c0c2770c790e62a0d09105f471;Wed May 08 16:05:55 EDT 2013;Committer;svn;1;2;2;4;0
e8bdef657a5502786c1eb9fe100b29c67a9a21c2;Wed May 08 16:05:50 EDT 2013;Committer;nobu;3;17;2;19;0
3fd0000c0cf8fedad3b8130b11c2f93a6426d6b0;Wed May 08 13:47:11 EDT 2013;Committer;nobu;3;14;1;15;0
6359460610c0a43d515f3da71b4e8901759d855f;Wed May 08 12:39:38 EDT 2013;Committer;akr;1;1;1;2;0
4834aa5307d8c4750b7598b6b2ef8728d01d98b4;Wed May 08 08:47:26 EDT 2013;Committer;naruse;4;51;2;53;0
ce573f3166d8b80d6a0b9c6c027b0c5e10f05c4b;Wed May 08 05:00:02 EDT 2013;Committer;naruse;2;7;2;9;0
279c7bdd884e5e158d3599750fe4d10177132296;Wed May 08 04:59:52 EDT 2013;Committer;naruse;3;14;2;16;0
85280f4b555a7f69692a5a469402c433a36b5eca;Wed May 08 04:07:22 EDT 2013;Committer;nobu;4;31;12;43;0
4dfd3739055388f0395eee81b3297966498f49d5;Wed May 08 04:07:21 EDT 2013;Committer;nobu;1;22;22;44;0
b8bcd920591a1398d68517dc121362302ea9e77a;Wed May 08 04:06:34 EDT 2013;Committer;nobu;2;5;0;5;0
2816e53988b521f82c1cbdd191e654d1ca7b46a2;Tue May 07 22:51:20 EDT 2013;Committer;svn;1;2;2;4;0
bbcf97fad6408739a945b1452f9bcb05b2d08755;Tue May 07 22:51:16 EDT 2013;Committer;naruse;2;10;1;11;0
42642407591bd76d2f68eed559e42deef9adc157;Tue May 07 13:15:13 EDT 2013;Committer;akr;2;7;1;8;0
593c24f87c388e607a23d56b8941ca6cb4ebf866;Tue May 07 03:19:52 EDT 2013;Committer;akr;2;9;1;10;0
cb2f3c1b876d22e53708eef602c0d3a50dcddf46;Tue May 07 03:14:47 EDT 2013;Committer;akr;2;7;1;8;0
2b792abd69e38334d8b02f6fbd45e04e389b341b;Tue May 07 03:12:32 EDT 2013;Committer;akr;2;6;1;7;0
301821bd458421218e9f8c33af53a9870f5c628a;Tue May 07 03:10:46 EDT 2013;Committer;akr;2;10;0;10;0
f4fd77903f35e91410deba44a92a141419c850d7;Tue May 07 03:09:20 EDT 2013;Committer;svn;1;2;2;4;0
570015a18b38792f3ced4c1d53945fd46d3ebe17;Tue May 07 03:09:15 EDT 2013;Committer;akr;2;16;3;19;0
9e08404b8a60487ab0d5ba9643a2e02f05d76310;Mon May 06 11:51:07 EDT 2013;Committer;akr;2;26;0;26;0
85bfd7308f11b581f10bb07f34a1bfb4ab64cdbb;Mon May 06 06:40:23 EDT 2013;Committer;eregon;1;1;1;2;0
ef07aa791ba5b79349f1bdf1bdeed86e0ff31ac5;Mon May 06 01:22:43 EDT 2013;Committer;svn;1;2;2;4;0
912f9dcc22e309f50ea46f4041b13c0e50f1f627;Mon May 06 01:22:37 EDT 2013;Committer;kazu;1;1;1;2;0
3957501d134723a46a0419a13297e1830cb78483;Sun May 05 13:27:26 EDT 2013;Committer;xibbar;1;1;1;2;0
96e14ad25228a5aa06cfaeaa0e01fc62148dd91f;Sun May 05 11:49:53 EDT 2013;Committer;eregon;1;1;1;2;0
f620e9e7d31720cade6ebfc9919657d3777e2cfb;Sun May 05 10:02:41 EDT 2013;Committer;nobu;1;5;0;5;0
babae0496048b117b0767350e895ca82afaf6849;Sun May 05 09:57:02 EDT 2013;Committer;nobu;3;32;21;53;0
08fbd2cee2f4892d28b925065b3b69b3614d5929;Sun May 05 07:29:44 EDT 2013;Committer;nobu;3;32;0;32;0
13bd7afc6eddcba1df765ac6c63981f6d203fd43;Sun May 05 06:54:32 EDT 2013;Committer;nobu;1;2;2;4;0
38ea534c344d3de7437fc142067072182a6f28d7;Sun May 05 04:37:48 EDT 2013;Committer;nobu;1;2;2;4;0
36de5e4db5f1f9feb0c31085571713acf8a95428;Sun May 05 04:29:01 EDT 2013;Committer;nobu;2;9;1;10;0
f259b8849ba527c2a6c3d85cb17a456d832d95f9;Sun May 05 02:40:38 EDT 2013;Committer;svn;1;2;2;4;0
4bbd1d9df71e4b212f59c068f294b64f3d6b1371;Sun May 05 02:40:33 EDT 2013;Committer;kazu;1;1;1;2;0
5835461b16376e2e26b0c35201fbd54dbe8c36b6;Fri May 03 22:21:34 EDT 2013;Committer;zzak;2;9;0;9;0
b2580fb21d0bd7472e248dce0cdd236ccbed6bc3;Fri May 03 21:04:03 EDT 2013;Committer;svn;1;2;2;4;0
9b89888ddafcfd8f13f3f7535ce1744e005bac3b;Fri May 03 21:03:58 EDT 2013;Committer;kosaki;3;21;6;27;0
b35529bb4e9b7c1f328e4515106b4b96aec94167;Fri May 03 11:23:23 EDT 2013;Committer;xibbar;3;47;17;64;0
86d4511fe6944f5517ead2679a0a4900d2db8ee5;Fri May 03 05:11:06 EDT 2013;Committer;akr;2;7;1;8;0
d0b7b41e59690a27d8268a64acf7975ca973e094;Fri May 03 04:50:15 EDT 2013;Committer;nobu;1;2;0;2;0
8202d6266fed5b411bc6584a0083ef5747bded9e;Fri May 03 04:35:37 EDT 2013;Committer;nobu;3;13;0;13;0
3b62e8e78b682c2eb2d1b5bcea34b49bb3201dfc;Fri May 03 04:29:18 EDT 2013;Committer;nobu;2;11;0;11;0
6d32a4e32b334195c0439bd09bfc9b9e7e560b9c;Fri May 03 04:22:24 EDT 2013;Committer;nobu;2;8;0;8;0
c61af2041178c9b0ccbf8c42fb89382d8ec9b411;Fri May 03 04:22:20 EDT 2013;Committer;nobu;1;2;3;5;0
4aa97ae698499039b5e3810d902fa936bdaa37d4;Thu May 02 15:22:44 EDT 2013;Committer;svn;1;2;2;4;0
b5d877e62c0c61664a448814eebded63bba866b3;Thu May 02 15:22:27 EDT 2013;Committer;ayumin;2;6;2;8;0
a58c224dcff50eec3149df0f91b8a0f2e8099db6;Thu May 02 14:23:56 EDT 2013;Committer;nobu;3;19;2;21;0
908e70185162e31fc716a8ff7895f221f70ff97c;Thu May 02 13:11:55 EDT 2013;Committer;nobu;2;5;10;15;0
5e79c1a543135d474addc9898e3246fe36ff37fd;Thu May 02 08:32:48 EDT 2013;Committer;nobu;3;29;8;37;0
b996367eb50402cfb343e671a2ea2cf1450a8ec4;Thu May 02 08:30:56 EDT 2013;Committer;nobu;1;13;13;26;0
31457774a88cae0fcf95d1e2ca517b6c2e8f91ee;Thu May 02 07:55:50 EDT 2013;Committer;nobu;3;12;6;18;0
97982e823fd6772ce475c250676a73c03fbf3d94;Thu May 02 07:54:17 EDT 2013;Committer;nobu;9;41;34;75;0
149f8f17efbe4e4dfde350af7b1bf5b54cfb5c1a;Thu May 02 06:30:56 EDT 2013;Committer;naruse;1;2;1;3;0
078ffd0ec8beac4cd420f9fe4db6c8c123d53281;Thu May 02 06:07:17 EDT 2013;Committer;naruse;1;1;1;2;0
f8e5c7c79e720d3b0af3cb96f27d421f08eb7744;Thu May 02 04:48:43 EDT 2013;Committer;ryan;12;886;487;1373;0
ce3029cd19dc40f4ffe09b8c6633500bd182b324;Thu May 02 04:02:32 EDT 2013;Committer;nobu;1;0;4;4;0
30afde959bf6434e9cdd31330fdaedd6d070be61;Thu May 02 03:35:37 EDT 2013;Committer;usa;1;1;1;2;0
50cc7057af5495c8c50715720de1f3c48918f011;Thu May 02 03:34:15 EDT 2013;Committer;usa;4;11;7;18;0
25acda257cdc336a83372acc21fb8b899bd25635;Thu May 02 02:34:11 EDT 2013;Committer;usa;2;38;1;39;0
fe2177fddc1d8f5d68b9deac5229f9e5130b52ec;Thu May 02 02:24:37 EDT 2013;Committer;svn;1;2;2;4;0
0b9b99c12c0c4a7405f6cfc45a8de197dbb112c2;Thu May 02 02:24:33 EDT 2013;Committer;zzak;2;24;5;29;0
a4460ddb484979df59a1ff813c32cdf0861821d6;Wed May 01 12:12:25 EDT 2013;Committer;akr;2;9;1;10;0
bd14f5bf948d09497c8cad94164f472bbbe94db1;Wed May 01 10:04:21 EDT 2013;Committer;eregon;2;7;2;9;0
f0a5e1fc3cd6e6bde9e8c8c25d3b85aa4a2559b4;Wed May 01 07:48:06 EDT 2013;Committer;nobu;2;16;12;28;0
262669e6c68e28322c1ab2b9323977548d46c09a;Wed May 01 07:17:53 EDT 2013;Committer;nobu;2;17;2;19;0
84c8319c8d14b6e75cc6af995118a7a26cb394ea;Wed May 01 04:43:00 EDT 2013;Committer;nobu;1;12;10;22;0
bb35edf33c97184672fdc3e5fd70a86c45534d18;Wed May 01 03:21:45 EDT 2013;Committer;zzak;2;5;1;6;0
cdce1dd4efc2ee6bf8f1b0186aa9be755a5bfa89;Wed May 01 03:14:55 EDT 2013;Committer;nobu;1;9;16;25;0
93f83417928d0b12020949cd02deb96340e70448;Wed May 01 03:03:58 EDT 2013;Committer;nobu;1;0;1;1;0
7ef7a65df6ca41aa0dd02703f2e4447395775cad;Wed May 01 02:40:41 EDT 2013;Committer;nobu;3;8;4;12;0
84ad7e65ef0136911a5666b00a3ac6cd604a9421;Wed May 01 02:38:55 EDT 2013;Committer;svn;1;3;3;6;0
9644f9b57217c606d6ba845d8f789a0799c2e5a5;Wed May 01 02:38:44 EDT 2013;Committer;nobu;4;18;6;24;0
c322f10ad99f9cc964dca4e42179f52450516b74;Tue Apr 30 14:19:20 EDT 2013;Committer;zzak;2;42;40;82;0
787cdae5df0c7f5b09c9581702334f8f4029b3c1;Tue Apr 30 03:31:43 EDT 2013;Committer;nobu;4;22;3;25;0
e9fa3108f19d2c7a33664744444f8cd7af0043a9;Tue Apr 30 03:30:25 EDT 2013;Committer;svn;1;2;2;4;0
3a0641a89674df7e3e50e1ff069b23a00ed5a6f8;Tue Apr 30 03:30:23 EDT 2013;Committer;nobu;2;6;1;7;0
71a68705138920d7fe36f914fc62b30b75a4f036;Tue Apr 30 03:30:21 EDT 2013;Committer;nobu;1;9;15;24;0
df9991fe2b785d6e77c8b616d41dd6cf8bd87ad9;Mon Apr 29 18:33:28 EDT 2013;Committer;nagai;4;743;743;1486;0
e3e9c5682e36a1a3602b66052da797c7fb5b7ca5;Mon Apr 29 09:01:44 EDT 2013;Committer;akr;1;4;0;4;0
c81f5fd3260ba1b21b343be487d4865e068f47ff;Mon Apr 29 08:44:16 EDT 2013;Committer;nobu;1;2;4;6;0
6a8808011f93c81f11ddffa9131689968a70ad75;Mon Apr 29 08:06:06 EDT 2013;Committer;nobu;1;1;1;2;0
ecf017a9a02b8d1f3af50a7191f0d95a79c2b863;Mon Apr 29 08:05:13 EDT 2013;Committer;naruse;2;7;1;8;0
fb5d3a0afc1e6d78f83e54f25f6841883504c5f0;Mon Apr 29 00:20:56 EDT 2013;Committer;nagai;4;743;743;1486;0
6fb5140dd6fa398d6f09804e3c035254958763c0;Sun Apr 28 21:58:36 EDT 2013;Committer;nobu;2;18;9;27;0
312a5a8cb47d903f43129bd226a11c96c7e21011;Sun Apr 28 15:40:57 EDT 2013;Committer;svn;1;2;2;4;0
bdc8087f33a1ee6ed4eaf28efb904ac57f33e23a;Sun Apr 28 15:40:53 EDT 2013;Committer;eregon;2;16;22;38;0
253f49dbc25df81653cfcfe8f2421e082051cea0;Sun Apr 28 14:34:22 EDT 2013;Committer;eregon;2;9;2;11;0
531d47d6c1c6d60cf4631121708977383f2e3aa2;Sun Apr 28 14:19:18 EDT 2013;Committer;zzak;2;30;13;43;0
be4aa330374d42cdead52a94144be189b5054e67;Sun Apr 28 13:20:11 EDT 2013;Committer;shirosaki;2;10;2;12;0
1e51f3046301c41e23b51aa75aa205dd14a440c0;Sun Apr 28 03:54:26 EDT 2013;Committer;nobu;1;13;5;18;0
66c0e01220bd2855b860fd0f7a4b9b4b64669de8;Sun Apr 28 03:38:27 EDT 2013;Committer;nobu;3;18;4;22;0
9ef25d883ddf9b8fa62a47f5c551d3d6e84ec541;Sun Apr 28 01:35:56 EDT 2013;Committer;zzak;2;13;8;21;0
2068f3cedb8aa5b1e11bec519b7a6b7ff8f7ab71;Sun Apr 28 01:11:55 EDT 2013;Committer;zzak;2;5;1;6;0
6fe3e9e48877d4a7d373f8db476f0855f69b605f;Sun Apr 28 00:51:46 EDT 2013;Committer;zzak;2;43;8;51;0
e7316275263e327b369d836474c8670f5606a5e3;Sun Apr 28 00:42:10 EDT 2013;Committer;zzak;2;7;0;7;0
7e70b8ac52a8f4939d65cab96a005187a637d9ed;Sat Apr 27 23:30:11 EDT 2013;Committer;zzak;2;12;3;15;0
e781aeef96667db678b9e852349a7f01bf6f9ff2;Sat Apr 27 23:11:19 EDT 2013;Committer;zzak;2;6;1;7;0
817dda53edfa985ba429aaac0b8574b79da4702e;Sat Apr 27 23:04:12 EDT 2013;Committer;zzak;2;6;0;6;0
d7b32fb4c1a312cee1bb7e9b0fd607eb331d2515;Sat Apr 27 17:48:28 EDT 2013;Committer;akr;2;8;3;11;0
8583a7df7be1f97e1c8adbda00f11d4cbf9101e7;Sat Apr 27 15:38:41 EDT 2013;Committer;svn;1;2;2;4;0
1a67580eb5ddbb6f81c635740614c48eb6cccd14;Sat Apr 27 15:38:36 EDT 2013;Committer;akr;3;11;3;14;0
b5e8e33ddc880c98c30a1abe644c6af2e57b5496;Sat Apr 27 14:54:37 EDT 2013;Committer;charliesome;2;8;0;8;0
3e1fad843e29d8004aabf2f30a9bb031b02ca209;Sat Apr 27 14:26:20 EDT 2013;Committer;zzak;2;28;1;29;0
ab750920b9dfdab1117bc39e14bb28195b2b9830;Sat Apr 27 11:21:10 EDT 2013;Committer;akr;2;7;0;7;0
5c1d4c2adea918a8345893c9cdcf8bbc64887eb6;Sat Apr 27 10:33:44 EDT 2013;Committer;eregon;2;27;23;50;0
5cbc3e15d87eac643a698f72b62d760d9734279c;Sat Apr 27 10:06:20 EDT 2013;Committer;akr;2;16;1;17;0
ef215077bc5d682a86a91d2a7c80e153896b87a7;Sat Apr 27 08:23:21 EDT 2013;Committer;akr;2;5;2;7;0
fbbd7e29e7b7cb6a38cc3fa05a11c869f9fe028c;Sat Apr 27 07:00:26 EDT 2013;Committer;akr;2;54;48;102;0
d907adecd9267d6cddb77d1fd7c4c6fcb878772e;Sat Apr 27 06:52:17 EDT 2013;Committer;akr;3;25;8;33;0
e88a692a884a2c9d5349e1e94da3b0d77247adc2;Sat Apr 27 03:30:50 EDT 2013;Committer;akr;2;19;3;22;0
825a892330a0a9829011c59eabb212da31761711;Sat Apr 27 00:02:21 EDT 2013;Committer;nobu;1;9;3;12;0
e38b66fc982044e40ec2122809d96b07cba1dd7b;Fri Apr 26 16:14:02 EDT 2013;Committer;svn;1;2;2;4;0
b22fa276e9ebe3fa7c15bfee703745a498a48ae3;Fri Apr 26 16:13:56 EDT 2013;Committer;kazu;1;1;1;2;0
4e44eeaeb103f9ad43acc991918a4ae3cd1049cf;Fri Apr 26 14:36:30 EDT 2013;Committer;kou;3;29;1;30;0
562648e48ca42e6a263d52677638683add7327a6;Fri Apr 26 13:56:34 EDT 2013;Committer;kou;3;32;1;33;0
b486e50434df45d6e161eb359f576964a783e9e7;Fri Apr 26 12:48:59 EDT 2013;Committer;kou;2;6;2;8;0
2df0d9a1819c046cda51167e1d8a751d99b1c2cb;Fri Apr 26 12:21:45 EDT 2013;Committer;kou;2;8;4;12;0
56e982d447624a9cef62e2d676719ed190f8c206;Fri Apr 26 09:42:14 EDT 2013;Committer;akr;2;54;45;99;0
847fe27e3144db48fefcce9b0271a460795f3294;Fri Apr 26 09:16:14 EDT 2013;Committer;akr;2;9;0;9;0
6d2662d45a6971805a773b5e7ba9e2f97eec43bf;Fri Apr 26 08:45:02 EDT 2013;Committer;akr;1;5;0;5;0
ed9e1f9ad9e437c5b6822ea6d3f9dfe7c6c6c6cb;Fri Apr 26 08:43:37 EDT 2013;Committer;akr;2;6;0;6;0
1eb500466092961f2e8ee6a5afa5920615162de3;Fri Apr 26 05:36:51 EDT 2013;Committer;zzak;3;114;1;115;0
66938f38a309f6649fa29b62266b0992c391b2f3;Fri Apr 26 03:51:01 EDT 2013;Committer;akr;1;2;0;2;0
a36cd96c2a01b5cc4e569fba5c7d7c0da0c30664;Fri Apr 26 03:43:19 EDT 2013;Committer;akr;3;78;66;144;0
93ed9f08ad9e9aa1aa44d83e6dc850721e1fd112;Thu Apr 25 15:43:22 EDT 2013;Committer;shirosaki;3;111;9;120;0
0cfa2e54a237069da4f1c8a1ccc92c05d2ab6983;Thu Apr 25 15:36:34 EDT 2013;Committer;svn;1;2;2;4;0
b721c38f34ad3200563a4d0ab06bbf6cdaa24a04;Thu Apr 25 15:36:33 EDT 2013;Committer;shirosaki;2;11;1;12;0
e9c8509e87dccb22640cf09f3c72f59180429789;Thu Apr 25 15:36:30 EDT 2013;Committer;shirosaki;2;9;2;11;0
5e9dc52be520c976bcba1c5932a2ef9e567972eb;Thu Apr 25 14:17:33 EDT 2013;Committer;akr;2;54;30;84;0
a0fa43b0948f1811f3965d0965afc9b5b3bbb9f0;Thu Apr 25 09:17:54 EDT 2013;Committer;akr;2;6;2;8;0
0ff2e1d531b9975574591aa79982076eecdeb4d2;Thu Apr 25 08:57:15 EDT 2013;Committer;akr;2;5;7;12;0
79b807118f82c7ebbb4a5e06315e6a9127ccaa3d;Thu Apr 25 08:45:58 EDT 2013;Committer;akr;2;82;3;85;0
adb492406ce489cae104e743bbd77684fa67da48;Thu Apr 25 07:57:17 EDT 2013;Committer;nobu;1;2;2;4;0
91fb5bc88992dd7f4edae20934f814f052b516d6;Thu Apr 25 07:11:20 EDT 2013;Committer;nobu;3;57;18;75;0
8b29525dadeaba1ba6dc2a9ea5e590aa9d1d825a;Thu Apr 25 07:02:31 EDT 2013;Committer;naruse;5;79;6;85;0
4a50d447d9618b2e3df126e159aa1d735e429a70;Thu Apr 25 05:27:41 EDT 2013;Committer;naruse;4;340;38;378;0
5a3fab5918ccb38cfe464a4a10c60597cd1b5afa;Thu Apr 25 05:25:53 EDT 2013;Committer;nobu;1;0;1;1;0
5d7b5481ca60260ef05ee969c8b142143c4aa8c2;Thu Apr 25 05:03:30 EDT 2013;Committer;charliesome;5;64;17;81;0
ed33fcae5a1e6fca6fc7e10776b579c668d35451;Thu Apr 25 03:03:59 EDT 2013;Committer;akr;2;249;240;489;0
017f0ffe1822264a8ead114f0b6055805185c0ac;Wed Apr 24 22:12:31 EDT 2013;Committer;marcandre;1;1;1;2;0
2667cb2d9841c52c474033a9f8f728c687635f46;Wed Apr 24 17:23:36 EDT 2013;Committer;nobu;2;11;1;12;0
096d52733b78df9e75837ff8ffc4f4d1010abd04;Wed Apr 24 16:22:44 EDT 2013;Committer;nobu;2;5;11;16;0
181a4ea8c6fce1c0388050ab4c914a0f1281926b;Wed Apr 24 16:21:54 EDT 2013;Committer;nobu;2;21;10;31;0
7dd8c1f20fe89b3fdf19778c5f6e970503b23a9e;Wed Apr 24 16:19:07 EDT 2013;Committer;svn;1;2;2;4;0
9e97f6ca6324060e309f8cb020da71f9ad49dbaa;Wed Apr 24 16:19:00 EDT 2013;Committer;nobu;2;10;1;11;0
66ad210df88207d0aefcdd19cfd60b83157a2068;Wed Apr 24 13:22:27 EDT 2013;Committer;akr;1;1;0;1;0
4ddce7a68bf974c124ed15cf364e0ea0eb1a5f15;Wed Apr 24 12:52:26 EDT 2013;Committer;akr;3;12;2;14;0
2265bdfac32d4551d76ab1da4fc2c891057c9916;Wed Apr 24 12:50:12 EDT 2013;Committer;akr;1;6;6;12;0
83c10e890529f9c557977c0e1932280268914d96;Wed Apr 24 12:41:06 EDT 2013;Committer;akr;1;38;0;38;0
498c8763fe658b8fdba8401c53f0d3ebfae95d9c;Wed Apr 24 05:22:00 EDT 2013;Committer;nobu;1;14;19;33;0
6edde68b5d4c66a33325191311b97081720433cd;Wed Apr 24 05:15:56 EDT 2013;Committer;kosaki;2;5;2;7;0
704abdc3d2914fb474bd86eee92b8de8db2ac461;Wed Apr 24 05:08:47 EDT 2013;Committer;zzak;2;6;1;7;0
531329a29166b75a303da3ac2072278ad081dd08;Wed Apr 24 05:04:01 EDT 2013;Committer;nobu;3;19;13;32;0
c262fda9eb8fd750989f2588378b366378398f7b;Wed Apr 24 05:01:59 EDT 2013;Committer;zzak;1;1;1;2;0
6dc1ee17c523e070568c4e4efe940eaa6f023820;Wed Apr 24 04:55:07 EDT 2013;Committer;zzak;2;7;2;9;0
6500760bd35bd14fb9ffaf35fa5aa8f85c0846f0;Wed Apr 24 04:51:05 EDT 2013;Committer;nobu;1;1;1;2;0
0b4214ad9b53c2978cbca3ac08d467f03bdabd8d;Wed Apr 24 04:47:31 EDT 2013;Committer;zzak;3;27;8;35;0
360843ef752f961d66e1b835f19a5ab4af6299dc;Wed Apr 24 03:55:02 EDT 2013;Committer;zzak;2;10;6;16;0
00ecebe6a97fd3a77a54f4bc4959ca0cb570f005;Wed Apr 24 03:28:06 EDT 2013;Committer;zzak;2;6;2;8;0
913f3204d0891ca53ab1adb9688b59e9afeb477f;Tue Apr 23 20:29:30 EDT 2013;Committer;svn;1;2;2;4;0
cd9e93d469dbfa42ec73761f91902aef13ab130b;Tue Apr 23 20:29:24 EDT 2013;Committer;headius;1;1;1;2;0
a5fadaadd368d0a96d7e3bc3edfdc92ae22f44ce;Tue Apr 23 12:24:56 EDT 2013;Committer;naruse;4;12;9;21;0
bac8fa5f9db55f8f7a9100fcb0e9cc43846442f0;Tue Apr 23 11:27:07 EDT 2013;Committer;akr;2;20;0;20;0
e5ce9579ecb93316d71eacf6c16a187767f05f68;Tue Apr 23 08:41:56 EDT 2013;Committer;duerst;4;12;11;23;0
8541ed6df6a0082cb5f319dcfccd628f8d1d755f;Tue Apr 23 05:07:21 EDT 2013;Committer;shugo;3;22;3;25;0
3ae96e8c6bffe0e58d7bf9a5efb7259745368c7d;Tue Apr 23 04:02:57 EDT 2013;Committer;zzak;1;1;1;2;0
596ca948b1d6f2d22b39a4a9c042cc3d164eae13;Tue Apr 23 02:58:51 EDT 2013;Committer;nobu;3;24;14;38;0
eae1366b3867fe304b54c2adcc87fdd583990077;Tue Apr 23 02:58:48 EDT 2013;Committer;nobu;1;6;4;10;0
0a13d383be19c7feb57989e431744a937be832a0;Tue Apr 23 01:27:23 EDT 2013;Committer;knu;2;8;2;10;0
8c5b6ca580a224b701ced54de630a4bf535e579d;Tue Apr 23 00:54:07 EDT 2013;Committer;knu;1;2;2;4;0
ade2ba57a2659600a5cc2987461538bebeed8f5e;Tue Apr 23 00:52:17 EDT 2013;Committer;knu;3;16;1;17;0
1f4e5348154cd59435fca6ac18e923130309fdd8;Mon Apr 22 19:40:15 EDT 2013;Committer;svn;1;2;2;4;0
5d85df5d761f73d805bf65ed7e1b546202107673;Mon Apr 22 19:40:10 EDT 2013;Committer;tmm1;2;3;3;6;0
4f683e16781ea6c856a02bc42b1b57f66a0019fb;Mon Apr 22 13:57:21 EDT 2013;Committer;charliesome;2;11;4;15;0
e9b63c1a225f039b90faf16c5969c658d925dd37;Mon Apr 22 09:35:27 EDT 2013;Committer;hsbt;1;2;2;4;0
67b180748b7e8e551f46a072013162db83ac703f;Mon Apr 22 08:09:44 EDT 2013;Committer;nobu;3;64;14;78;0
16dc6c29554d9ea0cc3c01592646cceec827bba3;Mon Apr 22 03:13:50 EDT 2013;Committer;akr;1;19;0;19;0
18adfc7d40ab12b01989e583211d166cca82ddab;Mon Apr 22 02:59:16 EDT 2013;Committer;svn;1;2;2;4;0
ca57db4c3e958ea5df0a988b037d566888623696;Mon Apr 22 02:59:12 EDT 2013;Committer;naruse;1;2;2;4;0
f544ca4e4e817dd722d96f09e15b0170a5b392cd;Mon Apr 22 02:59:09 EDT 2013;Committer;naruse;2;8;5;13;0
e9679c9ad49c1969a9aded71e194e249aa8b8547;Sun Apr 21 14:23:48 EDT 2013;Committer;charliesome;2;8;3;11;0
c032cf6efee4aea01aa434198fc539cdbdc97184;Sun Apr 21 12:35:23 EDT 2013;Committer;charliesome;2;20;4;24;0
595825dc577616862b271ffac4c58eb27f0610af;Sun Apr 21 10:04:54 EDT 2013;Committer;hsbt;1;1;1;2;0
8f671120f1d99b47f28d67183855d634d006389a;Sat Apr 20 23:03:52 EDT 2013;Committer;akr;24;1174;1209;2383;0
65261bda4d964c081fc3a510bfaa094a7647e8bc;Sat Apr 20 15:16:24 EDT 2013;Committer;akr;2;5;0;5;0
45e02258c0415e44296c3d3a783238f248d3035e;Sat Apr 20 15:10:35 EDT 2013;Committer;svn;1;2;2;4;0
5fb8bb16e6ee98b1e5c7c657c0d0fe8b16e6dada;Sat Apr 20 15:10:29 EDT 2013;Committer;akr;3;18;6;24;0
5388fb64d991db9c094d1972176c4f5794e3555f;Sat Apr 20 13:50:47 EDT 2013;Committer;akr;4;76;0;76;0
8c77e58b97465ebfef0d94497a5eecd78f5bef3c;Sat Apr 20 05:22:25 EDT 2013;Committer;nobu;3;24;6;30;0
1e8a05c1dfee94db9b6b825097e1d192ad32930a;Fri Apr 19 20:21:26 EDT 2013;Committer;naruse;1;4;0;4;0
394d5dfa9ba625c99a1e6a411f81b628bfebd60a;Fri Apr 19 17:50:38 EDT 2013;Committer;naruse;5;334;4;338;0
57ffc79c4561b9249ef6b81101f1887f16f29e19;Fri Apr 19 16:36:45 EDT 2013;Committer;svn;1;2;2;4;0
2ea4ed63955f6b6bd5ae58472a2628013717623a;Fri Apr 19 16:36:42 EDT 2013;Committer;marcandre;1;1;1;2;0
af58fd445270052fbf24960e7ba627b84a1249a2;Fri Apr 19 14:40:13 EDT 2013;Committer;zzak;1;1;1;2;0
ff6eb8fe9ab9b3822f38840e6adc1875eaaaeaf0;Fri Apr 19 14:32:29 EDT 2013;Committer;zzak;1;1;1;2;0
17817e9da6dd88ebf0b7f850c4b1f32291d17e9e;Fri Apr 19 13:06:06 EDT 2013;Committer;nobu;1;6;6;12;0
46e17f4c4dd06f232a8c71353b2882b7e9dd0c4c;Fri Apr 19 13:02:33 EDT 2013;Committer;kou;2;17;5;22;0
d6674f8f82f8d54e1f117c1a22268c050d3deb03;Fri Apr 19 10:41:57 EDT 2013;Committer;naruse;1;1;1;2;0
3f927dec87b53f733a2713d4c5351df0d88c774d;Fri Apr 19 09:02:31 EDT 2013;Committer;shugo;3;70;20;90;0
3c1b8a1b68f6309fbdb3d0e4be4e91c65c51386e;Fri Apr 19 08:09:42 EDT 2013;Committer;nobu;1;1;1;2;0
0e102a66580d48b43b2846171fa2d7d373601d33;Fri Apr 19 06:17:01 EDT 2013;Committer;xibbar;1;3;3;6;0
683c5fdfeceeebc4b38b347bd9dff96e15d7bcf0;Fri Apr 19 05:46:05 EDT 2013;Committer;nobu;1;1;1;2;0
6c3a57a19b921678c27fcb99573509f46a70436d;Fri Apr 19 05:43:46 EDT 2013;Committer;xibbar;1;3;4;7;0
4254686922f836ac1648e3ccdff4756cb3f7e99c;Fri Apr 19 05:25:51 EDT 2013;Committer;xibbar;1;4;3;7;0
1dd06612a5fe377d191f5d88ffd598d9f39d6f1b;Fri Apr 19 04:03:29 EDT 2013;Committer;nobu;3;26;2;28;0
597aa8bafb91d648edad356db8748f724c6db1ed;Fri Apr 19 03:52:36 EDT 2013;Committer;nobu;1;0;2;2;0
526ffc53e9cd27ec1d9d28790cfff81afde1866f;Fri Apr 19 02:37:06 EDT 2013;Committer;nobu;2;16;7;23;0
1f12e40736e195cfa944c1bb33dfcbefa1452579;Thu Apr 18 23:47:07 EDT 2013;Committer;xibbar;1;27;27;54;0
1f2c3b8aa30fc25d69c7242ec2ebc8e3027dd53e;Thu Apr 18 23:38:24 EDT 2013;Committer;xibbar;1;1;0;1;0
053e85e2be2bfa6e5e963c577b61d69cdd287edd;Thu Apr 18 22:45:12 EDT 2013;Committer;naruse;2;9;3;12;0
46d19a3a9528c8dde535b20693e2fb9f87552de4;Thu Apr 18 18:04:11 EDT 2013;Committer;naruse;1;14;14;28;0
38dccee13e053a8a1757dcc53a513b7ba2351e21;Thu Apr 18 15:29:38 EDT 2013;Committer;svn;1;2;2;4;0
df9e72b22e45b5ce05d45c05c1f6b7268a62d5d0;Thu Apr 18 15:29:32 EDT 2013;Committer;nobu;1;9;5;14;0
4987e84932293f1488e192c25517cd3ff1554c8e;Thu Apr 18 14:45:42 EDT 2013;Committer;kazu;1;1;1;2;0
a1d59a60657a45a7a1cc4d6ac29fa0e0acabb323;Thu Apr 18 13:58:49 EDT 2013;Committer;naruse;1;0;38;38;0
26e9234309f79fa6bf358dc8b4087916c9488950;Thu Apr 18 13:56:09 EDT 2013;Committer;naruse;1;7;0;7;0
9d72f26584b3b996727d8e298fcd323fd703eaea;Thu Apr 18 13:56:07 EDT 2013;Committer;naruse;1;4;0;4;0
6e24f177e1c30cd9fac3f9db9d4629bdda9649d7;Thu Apr 18 13:56:04 EDT 2013;Committer;naruse;1;4;0;4;0
3f75750c2b40f3900ec6bf78503ede12378adb91;Thu Apr 18 13:56:02 EDT 2013;Committer;naruse;1;1;1;2;0
b69f1fb69402eea2cf8a1a92e535dbefcb493f1a;Thu Apr 18 13:55:59 EDT 2013;Committer;naruse;1;15;0;15;0
5f628a07897e09c99c25b94d7dc03f9fab1e64f3;Thu Apr 18 13:55:56 EDT 2013;Committer;naruse;1;5;0;5;0
226e145e3105a76f75ce0c31ce080d14666d7361;Thu Apr 18 13:55:53 EDT 2013;Committer;naruse;1;5;0;5;0
b2fcb9da4d4f1c65c7afde07c22553a95871377d;Thu Apr 18 13:55:48 EDT 2013;Committer;naruse;1;5;0;5;0
08a6ef733a0b71b6b77488266e9d3ba39cec9622;Thu Apr 18 13:55:45 EDT 2013;Committer;naruse;1;16;14;30;0
335dfa1255eb38d765d3b35d8b9f9d176eb5e830;Thu Apr 18 07:59:06 EDT 2013;Committer;nobu;3;15;2;17;0
a4188556d3735aec2fba15372f73826c16d1af05;Thu Apr 18 07:20:53 EDT 2013;Committer;nobu;3;17;4;21;0
c3db44dc35a0ea43a0a79c487b852b200aed73ae;Thu Apr 18 07:20:25 EDT 2013;Committer;nobu;2;8;1;9;0
ca7431965b41da76a9d63024b325edc2d127e97e;Thu Apr 18 06:11:31 EDT 2013;Committer;naruse;1;1;1;2;0
3e2fdaf1dd76dc39177dce7937897f4dc70e875d;Thu Apr 18 05:03:00 EDT 2013;Committer;naruse;3;11;2;13;0
2446c9654753f985f183476e3b46c9660b32c5b2;Wed Apr 17 23:21:17 EDT 2013;Committer;svn;1;2;2;4;0
97dae8b0ab7ffe1705b428214664430fe013f962;Wed Apr 17 23:21:13 EDT 2013;Committer;naruse;2;5;0;5;0
80e4d412d39c00b06adbdd951fcbad43e0977087;Wed Apr 17 13:08:13 EDT 2013;Committer;akr;2;5;1;6;0
aebb6889980a644ea4a14faaab692a5e2cbec3c1;Wed Apr 17 11:43:27 EDT 2013;Committer;tmm1;1;1;1;2;0
cbd8b099200d9cd19df770dbabeb698b08135800;Wed Apr 17 11:20:23 EDT 2013;Committer;tmm1;5;31;7;38;0
ce6db8f286160fbf71c409416bd43c229b874601;Wed Apr 17 11:01:17 EDT 2013;Committer;akr;3;16;1;17;0
cef6a377fcae99d062b2c7d9e0db2c07719c6975;Wed Apr 17 10:55:29 EDT 2013;Committer;tmm1;2;9;1;10;0
626235a6d7f0808dd83baae73913efea4f71fa57;Wed Apr 17 06:39:41 EDT 2013;Committer;nobu;1;1;1;2;0
385de15d5534ed43597319fd926e033449cc4e68;Wed Apr 17 05:20:18 EDT 2013;Committer;nobu;1;18;1;19;0
a24b6d3f67a4eb1a163db2a9879b862d68ce898a;Wed Apr 17 05:20:14 EDT 2013;Committer;nobu;1;1;1;2;0
9efcd10371979a33b790a168b175e59e4a12142a;Wed Apr 17 02:39:02 EDT 2013;Committer;nobu;2;10;9;19;0
9e39bc1a088e0ac8cb6433c4daab03136253bf9d;Wed Apr 17 01:58:25 EDT 2013;Committer;nobu;2;17;11;28;0
08f52b05b2eac1eec3bc568f7b2cf4c730ebc462;Wed Apr 17 01:17:02 EDT 2013;Committer;svn;1;2;2;4;0
e9a61266fcf9604cdae335d7d10a7a38c545db00;Wed Apr 17 01:16:58 EDT 2013;Committer;hsbt;1;1;1;2;0
a294d45808d9115d16df064cc501fee4fe8fffb3;Tue Apr 16 14:07:50 EDT 2013;Committer;akr;2;9;4;13;0
da91385f2c242ac2fbf9f2f3e64e27a78096de11;Tue Apr 16 06:28:35 EDT 2013;Committer;hsbt;1;1;1;2;0
45b3c3ac39f7135b47c15224985a2a5fd3a086ee;Tue Apr 16 03:28:19 EDT 2013;Committer;zzak;2;23;19;42;0
3a7a773aeb3a3d01151f5624c04f3f57379be687;Tue Apr 16 03:25:50 EDT 2013;Committer;zzak;11;44;13;57;0
bbf0ea6bfb1f2cad0a85d458fdaf9662674b2f9a;Tue Apr 16 02:31:55 EDT 2013;Committer;hsbt;1;1;1;2;0
13d18f2775459c1e2a9cf0993c285390d6a0cd72;Tue Apr 16 02:24:14 EDT 2013;Committer;svn;1;2;2;4;0
a152c41e53574b83f46f1d759131fa8b873a50cc;Tue Apr 16 02:24:09 EDT 2013;Committer;zzak;9;20;9;29;0
582ba0a57c40be0dcda5f66fa18d28188d6d66f1;Mon Apr 15 13:22:20 EDT 2013;Committer;akr;2;8;0;8;0
7190cc5df9a83db388311a6958b6449fbe23ca8b;Mon Apr 15 13:15:20 EDT 2013;Committer;knu;2;44;5;49;0
ed3b657d7db2b62bd7bf80495417aea73d1ddd1e;Mon Apr 15 13:15:17 EDT 2013;Committer;knu;2;56;51;107;0
d6b1ab91dcf83536ea7d94f2b855e8ce21802136;Mon Apr 15 02:04:07 EDT 2013;Committer;emboss;3;45;4;49;0
e4f6efcc4a830b94634e2461ffbc564040344058;Mon Apr 15 01:24:37 EDT 2013;Committer;naruse;3;8;1;9;0
37a350dbb6c82954c79e5b9700cb51eb83d3d2c2;Sun Apr 14 22:38:26 EDT 2013;Committer;eregon;1;1;1;2;0
3759c13742c73107361e2244856e04e5b55b52cd;Sun Apr 14 22:38:05 EDT 2013;Committer;svn;1;2;2;4;0
f861a74ec4aea8ecc14610befd6b3a2061f03ea8;Sun Apr 14 22:38:01 EDT 2013;Committer;eregon;1;1;1;2;0
6f23ad6a5a7b8649c03b30ea4826abfed869c433;Sun Apr 14 11:48:54 EDT 2013;Committer;kazu;1;1;1;2;0
788b45da3e7d94dbaa5d7054ef7ecb5a79d4abe3;Sun Apr 14 10:48:08 EDT 2013;Committer;akr;13;75;0;75;0
03eab41dfb142ee55f85635f96b4a5dca591e988;Sat Apr 13 21:39:23 EDT 2013;Committer;naruse;1;6;0;6;0
dfdbfb6d5f9d7ef5a04c31c77f311542a79bb740;Sat Apr 13 18:00:29 EDT 2013;Committer;svn;1;2;2;4;0
34f5700a0947243198dea5461b80fa8be5ba19ea;Sat Apr 13 18:00:25 EDT 2013;Committer;naruse;3;10;3;13;0
34b706ff0ac53c2c4322f113fe0ad464a7b302dd;Sat Apr 13 14:06:33 EDT 2013;Committer;nobu;2;7;1;8;0
b77d1a4f3404261b5fbf588c1311adc51c859d96;Sat Apr 13 12:14:37 EDT 2013;Committer;usa;3;10;2;12;0
f9ba0dcaa41b85fbecd9c51010adb0bd81bb432d;Sat Apr 13 11:44:05 EDT 2013;Committer;naruse;1;5;5;10;0
536a3274c9dab6290ce370bc432f761f23a2f52e;Sat Apr 13 11:30:35 EDT 2013;Committer;naruse;6;16;11;27;0
0869d460ba75fe17a987701608a3b24e162ed78a;Sat Apr 13 09:57:02 EDT 2013;Committer;usa;2;6;2;8;0
6e41c7c559f826fdd55d4b240770570c8b18bd89;Sat Apr 13 04:31:15 EDT 2013;Committer;marcandre;1;1;1;2;0
2106aa1990a5b6a81c0883d8732741de51e449cd;Sat Apr 13 03:08:28 EDT 2013;Committer;marcandre;3;20;0;20;0
4123b0d9db2353b629ad6be14bb884ecf5408524;Sat Apr 13 02:33:58 EDT 2013;Committer;nobu;1;2;2;4;0
aa34b3a5b3d4c2b455f7caa3ee7135339847a806;Sat Apr 13 01:23:05 EDT 2013;Committer;nobu;1;236;9;245;0
a69c74be723a8eace6c9d14f3ad0759ca96b3bbf;Sat Apr 13 01:20:39 EDT 2013;Committer;nobu;2;7;4;11;0
5e5690781ccbc92eebea5f9e64fbf69e3d8088ed;Sat Apr 13 01:20:34 EDT 2013;Committer;nobu;2;65;268;333;0
b47138580c486fc67c53292f6be35ed290520889;Sat Apr 13 00:46:29 EDT 2013;Committer;akr;30;163;65;228;0
6e9c02515dd31049c675cfa9d7a5512a07e20e4f;Fri Apr 12 15:23:22 EDT 2013;Committer;nobu;1;1;1;2;0
1657cbab0d7666ed9a32a0f6662b2f0d1707e906;Fri Apr 12 15:16:07 EDT 2013;Committer;svn;1;2;2;4;0
1e4b2f9bd1be777b980563c78647a649f9c4ffe4;Fri Apr 12 15:16:00 EDT 2013;Committer;nobu;2;15;6;21;0
3033b3ae2f2f7eb89d9b512a7c83017f6356881c;Fri Apr 12 12:07:27 EDT 2013;Committer;akr;2;5;1;6;0
16a2acca20c3ddc0454331df4c6a0cd2a8a0807c;Fri Apr 12 12:01:51 EDT 2013;Committer;akr;4;32;19;51;0
3da834800e40980d7a75b82cc1a3b1abd9539e99;Fri Apr 12 09:42:06 EDT 2013;Committer;akr;2;8;1;9;0
2674f9a8158b521d22867415db5fd49ebe615c98;Fri Apr 12 06:21:35 EDT 2013;Committer;nobu;3;44;6;50;0
9ef4e13459c95922e7384194c90b91bf67dd785a;Fri Apr 12 02:59:07 EDT 2013;Committer;zzak;11;32;2;34;0
c37d5e7c778cad02c606cd90992743e8bb4a0185;Fri Apr 12 00:32:17 EDT 2013;Committer;kazu;1;2;2;4;0
af4c2b3b4b0c7590f1f063d7d2c126cefdb45a19;Thu Apr 11 16:47:49 EDT 2013;Committer;zzak;1;1;1;2;0
4a1b95ca7a6776590b3fc2ed52ed24274e1f665e;Thu Apr 11 15:52:46 EDT 2013;Committer;svn;1;2;2;4;0
89bda514c24734618ee610c74f2b3bd024dfaad0;Thu Apr 11 15:52:41 EDT 2013;Committer;naruse;1;1;1;2;0
96d811efacb577482f3c680fad8e3e5e03e07cfc;Thu Apr 11 14:42:33 EDT 2013;Committer;akr;3;13;6;19;0
656abe3920d397157db8d78d9884ecf65ae6b3e4;Thu Apr 11 14:27:44 EDT 2013;Committer;xibbar;1;6;30;36;0
ce100d36902887bfcd3ac7a6acb18cbd6091e9ec;Thu Apr 11 14:27:40 EDT 2013;Committer;xibbar;1;2;4;6;0
639356eacd78c7e528057310584202aba42def39;Thu Apr 11 14:22:04 EDT 2013;Committer;akr;2;6;1;7;0
bf4739ffdca2b9d3ca1d13b52ee87be357aabd09;Thu Apr 11 13:23:01 EDT 2013;Committer;xibbar;2;2;1;3;0
3e84b2204ae3f53d99b57fc285dc2210babcfd04;Thu Apr 11 13:22:58 EDT 2013;Committer;xibbar;1;1;1;2;0
28c8e57ca422e61b2ae1b3f32826eede7aefbe80;Thu Apr 11 12:03:23 EDT 2013;Committer;akr;3;194;166;360;0
c0c86b55a807a06926e38ee37a5de1206f8cca21;Thu Apr 11 11:03:21 EDT 2013;Committer;naruse;2;11;4;15;0
91d5cda26d5a836eb23c869ebfdaca668faa164d;Thu Apr 11 09:32:42 EDT 2013;Committer;hsbt;1;1;1;2;0
f75da76ffced0fa99c217646685c8069e5526d14;Thu Apr 11 08:04:27 EDT 2013;Committer;xibbar;2;120;143;263;0
3ae53e494322acba3804cd22d2209f0315be26f7;Thu Apr 11 07:53:26 EDT 2013;Committer;naruse;1;1;0;1;0
83e951d8c0ecc6a205d3ebac104026f65835a792;Thu Apr 11 07:51:54 EDT 2013;Committer;usa;1;1;0;1;0
cddd37aae2c23ce30ddaa4580d065e6d5c8c6406;Thu Apr 11 07:10:39 EDT 2013;Committer;naruse;2;6;1;7;0
91fe36e99a75835d7100816c4368284558cf28d2;Thu Apr 11 06:35:43 EDT 2013;Committer;naruse;2;10;0;10;0
13fb747c376c2c8e46bb3df13e81aaa52988a4f4;Thu Apr 11 04:21:34 EDT 2013;Committer;usa;2;26;6;32;0
43c93dbdd930745b0c7e461aa949e420d4cc9b6f;Thu Apr 11 02:12:15 EDT 2013;Committer;knu;2;5;1;6;0
c0e0a684d75f53c2606d3f793491bc723372b3fe;Thu Apr 11 01:40:11 EDT 2013;Committer;naruse;2;6;1;7;0
09d4be59b52ded308baa9ff3621e124bcf3173b7;Thu Apr 11 01:11:27 EDT 2013;Committer;nobu;1;6;6;12;0
0daf538ab48070d42be999b0fdb5344fcf6eb840;Thu Apr 11 00:27:39 EDT 2013;Committer;zzak;2;10;1;11;0
af869274867dcdf7199279449357462eb3c8cb22;Thu Apr 11 00:18:05 EDT 2013;Committer;zzak;2;6;2;8;0
dad98e5798018ad2229f9a7839f7ba6175856e63;Wed Apr 10 21:59:13 EDT 2013;Committer;naruse;1;1;0;1;0
29f347af110eb98127fc7c005136ff355e063474;Wed Apr 10 21:16:44 EDT 2013;Committer;naruse;4;11;3;14;0
a0f7f2921518443a60c807d272f0345aed61dc21;Wed Apr 10 21:15:37 EDT 2013;Committer;naruse;3;22;5;27;0
c607493e48c9f3dbf957a4bb5f0be2e8aa288442;Wed Apr 10 21:15:32 EDT 2013;Committer;naruse;2;10;2;12;0
e79d4b363c93c2c976a98dc4265cdb6bac216188;Wed Apr 10 18:35:26 EDT 2013;Committer;svn;1;2;2;4;0
2570f838da7ca82d586304d4669de49ced758bb6;Wed Apr 10 18:35:21 EDT 2013;Committer;naruse;2;11;1;12;0
3f9e0e43c3a8f5db37f671ad3f957e4fddba0bcb;Wed Apr 10 08:39:53 EDT 2013;Committer;akr;2;8;1;9;0
fa9b5bf223c6dc81ae3f128bfb02a7f69cb7f3b6;Wed Apr 10 03:34:38 EDT 2013;Committer;akr;3;40;2;42;0
ea16ec561fb022a204b876be4e3dfb0e08afac58;Wed Apr 10 02:38:29 EDT 2013;Committer;nobu;1;6;11;17;0
5cbf827a2ed551991236298bc9896fcc3f02abb6;Wed Apr 10 02:10:07 EDT 2013;Committer;kazu;1;8;8;16;0
1acc9062bca73f6246773a941d3df2741a74c134;Tue Apr 09 22:47:51 EDT 2013;Committer;akr;1;8;12;20;0
164e04ba4a4d661937befc551859b94a5840edb6;Tue Apr 09 21:37:09 EDT 2013;Committer;svn;1;2;2;4;0
e699df95d0a4d91d150e696079784befa4e3c1e6;Tue Apr 09 21:37:04 EDT 2013;Committer;akr;3;14;3;17;0
712c7168bf55f61df33efa2a7552e4b3c25b306c;Tue Apr 09 11:39:53 EDT 2013;Committer;akr;8;105;53;158;0
4329b14cfbe4c91561c12ba7d1b40c66faea30b5;Tue Apr 09 10:53:41 EDT 2013;Committer;akr;4;48;11;59;0
56486e00ecd02007787620e814c991f94d68ff49;Tue Apr 09 07:21:50 EDT 2013;Committer;nobu;2;31;31;62;0
f4c52b483cb4794e3e0e526a084cdbd32da8086c;Tue Apr 09 06:26:15 EDT 2013;Committer;nobu;3;31;0;31;0
0a4ed02461f9a7fee0da33282a6ede600b90e928;Tue Apr 09 01:02:53 EDT 2013;Committer;nobu;2;20;7;27;0
74ba9c248890b2395131bccb92fb099a8512ab63;Tue Apr 09 00:42:33 EDT 2013;Committer;nobu;1;39;34;73;0
e0b523d1a9fcd0a51c28c4601f76860e4169a921;Tue Apr 09 00:29:54 EDT 2013;Committer;hsbt;1;3;1;4;0
43a162962505207daf2da558117ca01e1221600f;Tue Apr 09 00:26:22 EDT 2013;Committer;hsbt;1;2;2;4;0
66aa6aa500a8f146a79cea51b8ebb854f8b1b74e;Tue Apr 09 00:24:24 EDT 2013;Committer;hsbt;1;1;1;2;0
fc7c2faab331f570239dc8b782150791b434113a;Mon Apr 08 20:51:52 EDT 2013;Committer;naruse;1;2;3;5;0
fa93be2f054cfb71fde486e8690edb7e702d85cb;Mon Apr 08 20:27:01 EDT 2013;Committer;nobu;4;6;6;12;0
0626d9b91c8e64dbbe90fd966ea95d2c80f9632e;Mon Apr 08 19:58:55 EDT 2013;Committer;headius;10;152;14;166;0
46eddae1b486ae73480d00ebd99adb94ea04eb57;Mon Apr 08 18:10:04 EDT 2013;Committer;nobu;1;3;2;5;0
53fdb9e190110afeb318b6bb7b0a8f17a9873fe8;Mon Apr 08 17:44:35 EDT 2013;Committer;nobu;2;5;2;7;0
f12df1a7528a89ddc49a8791be2ae194fba842f3;Mon Apr 08 17:42:48 EDT 2013;Committer;nobu;2;8;1;9;0
99ad10df3238b2572c35be4a20e52c58ee334e5a;Mon Apr 08 17:40:58 EDT 2013;Committer;nobu;2;4;2;6;0
72524b60059c21f4fdea60bb2bf1dd68b9bd9e22;Mon Apr 08 15:28:47 EDT 2013;Committer;svn;1;2;2;4;0
65adadedcda7847298cbd43b0df32b7c01ebb2a7;Mon Apr 08 15:28:43 EDT 2013;Committer;nobu;2;5;1;6;0
f507cce0214c94546dda499108453817a87aec32;Mon Apr 08 14:57:29 EDT 2013;Committer;nobu;2;35;61;96;0
a436540271ab1faaeea1644c381bae1bb153d33b;Mon Apr 08 14:56:01 EDT 2013;Committer;nobu;2;6;3;9;0
1d42889c4eac6cdaee6f5b6c7beb6510efe7368d;Mon Apr 08 14:09:42 EDT 2013;Committer;nobu;2;8;2;10;0
4fe59003f046332e416515c8d5faaffe30898ff9;Mon Apr 08 11:31:38 EDT 2013;Committer;yugui;2;6;2;8;0
311960cdaf4e884643235fe83a3970b5e1f5ba47;Mon Apr 08 08:19:32 EDT 2013;Committer;nobu;3;14;0;14;0
418b8e121c1e8312cdead70e5acb2d14e1a40639;Mon Apr 08 07:10:18 EDT 2013;Committer;yugui;2;13;7;20;0
6779f24eb5fc49805b65a7a5b270e0130269754b;Mon Apr 08 05:12:08 EDT 2013;Committer;nobu;1;3;1;4;0
5865e7604c1f2e5d04f4d8ff5ec5f1449da26e59;Mon Apr 08 04:06:39 EDT 2013;Committer;xibbar;2;5;1;6;0
a48f99ce5c88ea07ba0fae1df970103e8b9af328;Mon Apr 08 03:08:03 EDT 2013;Committer;naruse;1;3;6;9;0
0851b4c0fc2ae4e9bd6e7546d13828fa708b6b22;Mon Apr 08 03:05:21 EDT 2013;Committer;svn;1;2;2;4;0
ae13ab24669e787a73a98a533d4bd7db8c4b49ab;Mon Apr 08 03:05:15 EDT 2013;Committer;naruse;4;69;10;79;0
6cb682a48005f43f3f1599d6c510523de237040d;Sun Apr 07 12:28:21 EDT 2013;Committer;naruse;2;16;5;21;0
d9ff5c2230fbdb0aa76462df1e23c4d9cc646150;Sun Apr 07 12:18:26 EDT 2013;Committer;naruse;3;17;5;22;0
875bba3fc5fb5ee6f1b56bc8c36fa2afa76dc055;Sun Apr 07 05:11:24 EDT 2013;Committer;kazu;2;7;1;8;0
1f32d09523be89556b5e0d06f431b852b992a177;Sun Apr 07 02:00:46 EDT 2013;Committer;akr;3;13;4;17;0
672490d08cd7b67d05f6834844f79f890abf21f9;Sun Apr 07 01:42:18 EDT 2013;Committer;akr;2;4;1;5;0
c73c876d54104757435a49dca877b7f8ef81d8f4;Sat Apr 06 19:27:04 EDT 2013;Committer;naruse;2;25;26;51;0
59eacb45e5576b6f304e66ba4ed8a89382921c9c;Sat Apr 06 16:43:32 EDT 2013;Committer;knu;2;81;21;102;0
14e72b1cded783884ca2ebbefd8d46087e46f6c7;Sat Apr 06 16:02:46 EDT 2013;Committer;akr;2;7;1;8;0
387b42053f8458657c846b38fe829326654c914f;Sat Apr 06 15:00:48 EDT 2013;Committer;svn;1;2;2;4;0
f70a7cd20f5087867d0d6f61c9df180e6eccdf23;Sat Apr 06 15:00:44 EDT 2013;Committer;ngoto;3;9;2;11;0
c4d8cc4eae6ae3ae10576a8396864baed3292b70;Sat Apr 06 14:52:48 EDT 2013;Committer;akr;3;315;1;316;0
5427a5df05264eb07f295861a1cc5c64222127b5;Sat Apr 06 14:45:06 EDT 2013;Committer;ngoto;2;19;0;19;0
9791353555d0cc691c1197699e5332d2da014740;Sat Apr 06 14:32:34 EDT 2013;Committer;akr;3;118;2;120;0
4c1e97226fee947895c476344afffac391c4ea41;Sat Apr 06 13:16:36 EDT 2013;Committer;akr;3;17;1;18;0
d818a6ab40bca1fc874a06cb851ca1f2fa371331;Sat Apr 06 11:21:05 EDT 2013;Committer;akr;3;18;9;27;0
67fe038d8f27a71b81a71048abd4174ded45a551;Sat Apr 06 11:04:45 EDT 2013;Committer;akr;3;18;8;26;0
c7135ddd2dcd59ca46ea3307b21f68dea7504ac8;Sat Apr 06 07:58:51 EDT 2013;Committer;nobu;6;20;13;33;0
7e4a95cd062ac961a91b7b7185b75c103bc7496d;Sat Apr 06 07:58:47 EDT 2013;Committer;nobu;1;1;1;2;0
cb302bf35109d69063ac589dd75f6356257a7fda;Sat Apr 06 05:50:42 EDT 2013;Committer;akr;5;84;15;99;0
b1fd376cbfbccc523921a950b1bc6bcaa01c0f99;Sat Apr 06 04:35:29 EDT 2013;Committer;akr;3;13;6;19;0
8c6c73745ec6ace79e2fbb3655439acfb2d82f62;Sat Apr 06 04:14:57 EDT 2013;Committer;akr;2;18;8;26;0
24ee6971cc7405dd504aff16d7964687e510d00d;Sat Apr 06 03:41:01 EDT 2013;Committer;akr;2;9;3;12;0
11a9d772860d8123d9284ab11535fe6398742576;Sat Apr 06 02:50:08 EDT 2013;Committer;akr;2;15;3;18;0
d933fb2296e4ace25c5eb558be56cd23a8fcc88f;Sat Apr 06 02:39:44 EDT 2013;Committer;akr;11;182;28;210;0
e4283fd39d9e8c508ce5ee2dc069b6f5545cd3d8;Sat Apr 06 02:30:52 EDT 2013;Committer;shirosaki;2;8;1;9;0
8ee121d060ed7b3191e86c981fe144be2e19953a;Sat Apr 06 00:59:12 EDT 2013;Committer;nobu;1;9;2;11;0
8483e9bd58620460b261a2c47ede8237ab219651;Sat Apr 06 00:56:06 EDT 2013;Committer;nobu;1;0;5;5;0
c3fcd1b871596e31d5f5c5f4274db8e637d2cd96;Sat Apr 06 00:54:23 EDT 2013;Committer;nobu;2;16;6;22;0
37872dbf2b040d6cc22c962f3e30bad3e14460cb;Sat Apr 06 00:10:22 EDT 2013;Committer;akr;1;1;0;1;0
0667aac9145c48753e950a891f21beced5648116;Fri Apr 05 23:00:59 EDT 2013;Committer;akr;1;13;12;25;0
2a58706e2d31abd5f708942254d46cda35aa60dd;Fri Apr 05 18:12:52 EDT 2013;Committer;tenderlove;3;9;3;12;0
0cb251e079310d5f013f0be9b3777e6801a67861;Fri Apr 05 18:02:22 EDT 2013;Committer;tenderlove;1;2;2;4;0
476a62fbbec0c8b7dafb74827447cfb4ebd7dd06;Fri Apr 05 17:55:53 EDT 2013;Committer;tenderlove;5;19;10;29;0
40370296c761ff7ba3d0b6c29a71ab7a8a472314;Fri Apr 05 17:30:42 EDT 2013;Committer;nobu;3;30;2;32;0
7a7bb6446410c239c7f92bd8e94f235f349206ea;Fri Apr 05 17:11:21 EDT 2013;Committer;tenderlove;3;49;7;56;0
fbb29bc08c76c00b963e5587e8e9e4b7c580ea95;Fri Apr 05 16:40:36 EDT 2013;Committer;akr;2;11;1;12;0
07636ed42ebc9b690846813b492d75bcf32bb62c;Fri Apr 05 15:30:52 EDT 2013;Committer;shirosaki;3;33;3;36;0
21d47b7381ae6da9e6ffe1aa288b295af8e3b3d1;Fri Apr 05 15:21:07 EDT 2013;Committer;svn;1;2;2;4;0
11391aa01b2953a196828bfc46f0a75bed614c23;Fri Apr 05 15:21:02 EDT 2013;Committer;nobu;1;4;3;7;0
23335c78d35921483df65a7cd8cd462f08ddbdcb;Fri Apr 05 14:08:27 EDT 2013;Committer;nobu;1;2;8;10;0
b493f30a42c889f4ef724057abd56dbed5fc3497;Fri Apr 05 14:08:21 EDT 2013;Committer;nobu;1;8;1;9;0
647dc4fd49f542dfec72a72818908191dce76b2b;Fri Apr 05 12:34:43 EDT 2013;Committer;nobu;1;1;0;1;0
5ec185c86b7f5c4f6087075d38ae1b5ce2f9a67f;Fri Apr 05 12:06:34 EDT 2013;Committer;akr;1;12;12;24;0
e9382c7332645a790e855a5aa4a43c5c8d9dae91;Fri Apr 05 11:57:59 EDT 2013;Committer;akr;1;1;1;2;0
755e09ebf1e020e8a3f329ba32d6bb7cabd0a8a4;Fri Apr 05 11:44:56 EDT 2013;Committer;akr;3;18;7;25;0
d966f1b2f38c5f380f3a71d4ce698dac155a4bb8;Fri Apr 05 11:31:50 EDT 2013;Committer;nobu;1;1;1;2;0
702250a412bb9bd3b83e755aaa1cacd8a5b364d5;Fri Apr 05 11:23:36 EDT 2013;Committer;akr;2;5;0;5;0
0c5d73e80be89a6de2aeba9556277f8740256ff9;Fri Apr 05 10:40:03 EDT 2013;Committer;nobu;3;16;1;17;0
7862695406ce7b62981ab62681b4da97a86c437a;Fri Apr 05 10:29:42 EDT 2013;Committer;nobu;1;1;1;2;0
bff997e02b5b5f96d742be84c6e15f85aa728d29;Fri Apr 05 10:29:38 EDT 2013;Committer;nobu;31;75;191;266;0
c3f2cc5335bdb6eb858a499054db07d2a8bf2387;Fri Apr 05 07:46:29 EDT 2013;Committer;nobu;1;1;0;1;0
d0536f651414556b2e7836bc4adcb1ff27fa6547;Fri Apr 05 07:46:26 EDT 2013;Committer;nobu;1;1;1;2;0
e3b9ed7649a62d37fce1f588cd84802c93331520;Fri Apr 05 04:23:05 EDT 2013;Committer;nobu;3;12;1;13;0
7cd3fcfbaa8efabe756f52ef36c91469be525d5d;Fri Apr 05 04:23:02 EDT 2013;Committer;nobu;1;42;0;42;0
b0446f37a61c5e5164b73248a7aaf1f92d30b8de;Fri Apr 05 03:10:14 EDT 2013;Committer;zzak;2;6;1;7;0
3d42f0076d96a65a9b4407efba73a3be5141ecb1;Thu Apr 04 21:36:45 EDT 2013;Committer;svn;1;2;2;4;0
672b8bf1c038fc12d799ad56da3ac860890fe055;Thu Apr 04 21:36:38 EDT 2013;Committer;nobu;3;28;4;32;0
dc5b184b1f9c5ab8212b28cee07f5b0edf7aa3c2;Thu Apr 04 14:55:36 EDT 2013;Committer;akr;2;8;1;9;0
b2a1339f2457166e2ef9ffe16f7f4bdb46bb5bf8;Thu Apr 04 14:25:19 EDT 2013;Committer;akr;3;7;3;10;0
61b245cc4044bfda14fa66a4a3fce457d7b43b21;Thu Apr 04 13:54:10 EDT 2013;Committer;akr;2;5;1;6;0
f674d8623df4392bdcb34800f39ee529e6e341b4;Thu Apr 04 13:37:22 EDT 2013;Committer;akr;2;9;0;9;0
a4587840cc2b002321af227ee2cb315a94158d67;Thu Apr 04 13:26:39 EDT 2013;Committer;akr;2;10;14;24;0
c3d1fde2b528413f5be2f936a9d7ea899a777fc7;Thu Apr 04 11:12:12 EDT 2013;Committer;akr;4;71;0;71;0
12bf1de1dda78e8fb69d7cc1dda24e7e09eb8806;Thu Apr 04 08:23:16 EDT 2013;Committer;nobu;1;6;1;7;0
fd7dc1b6eaf13be7e8270558d12e17864a7446b1;Thu Apr 04 08:23:10 EDT 2013;Committer;nobu;3;27;34;61;0
5e2c39ed226d084a340c6f860344062bd32d56b9;Thu Apr 04 08:18:54 EDT 2013;Committer;nobu;1;41;6;47;0
75b4c8f490a882619e83a448c0a23fdd64080202;Thu Apr 04 08:01:27 EDT 2013;Committer;yugui;2;8;6;14;0
360edb1c04dfc7552dc053d837a8320c46910147;Thu Apr 04 08:01:23 EDT 2013;Committer;yugui;2;34;21;55;0
112a3b1fcaebbabf744c0a1c0e5cf14e7f9d0e5c;Thu Apr 04 07:55:11 EDT 2013;Committer;nobu;3;50;7;57;0
4e59c822a07f85c79fbcbac40cba5a591512258c;Thu Apr 04 07:54:44 EDT 2013;Committer;nobu;3;39;18;57;0
9f87297c21e2e375990166214327634b212e50fb;Thu Apr 04 06:46:53 EDT 2013;Committer;nobu;3;27;3;30;0
80748440654f93d40a97d0f4fb287f5d268c7cfd;Thu Apr 04 05:37:21 EDT 2013;Committer;nobu;3;49;7;56;0
f00035a4f7842b9cccbb43fc65d567ca2630d742;Thu Apr 04 05:37:19 EDT 2013;Committer;nobu;1;1;1;2;0
106595827ad33295d2f5bd1c1255c87293215a54;Thu Apr 04 02:35:07 EDT 2013;Committer;naruse;2;7;2;9;0
da39199964fe8d8e87ac94c737376835f3cec2d1;Wed Apr 03 22:24:57 EDT 2013;Committer;akr;2;30;23;53;0
a8f95d6646c11bdf5bfead14af3c5122c83449aa;Wed Apr 03 18:29:00 EDT 2013;Committer;svn;1;2;2;4;0
7b58445ebd3218011c1cebdc0e6693cb008bb006;Wed Apr 03 18:28:56 EDT 2013;Committer;naruse;3;12;2;14;0
7181490def5ad5670e2503e91c526eab1039b008;Wed Apr 03 13:10:04 EDT 2013;Committer;akr;2;25;21;46;0
694207c73745eddae910c4239fe76b654c980eff;Wed Apr 03 12:36:57 EDT 2013;Committer;akr;1;1;0;1;0
b81ea661dbc3c31073de782a8b0b9f3f86e3de5e;Wed Apr 03 12:25:09 EDT 2013;Committer;akr;4;54;8;62;0
2767139e056cb9b8585634f8eb9d174589f85905;Wed Apr 03 11:55:18 EDT 2013;Committer;akr;2;12;0;12;0
b87ba9f87264a7acad0cfb203180ce3315554feb;Wed Apr 03 11:43:42 EDT 2013;Committer;kazu;1;1;1;2;0
ee2b218293c1749e4b857c4a018050c0315d0456;Wed Apr 03 11:28:10 EDT 2013;Committer;akr;2;6;2;8;0
1d339ff212747d5bcd4fcbf65750f078c64c7367;Wed Apr 03 10:00:49 EDT 2013;Committer;akr;3;21;13;34;0
9089f57207b2f6ff9a48bc50b1ea67c92b17895e;Wed Apr 03 08:11:27 EDT 2013;Committer;nobu;1;6;0;6;0
111f4a8fe5cb6a9197fa79a693629757b31ab30d;Wed Apr 03 08:11:24 EDT 2013;Committer;nobu;1;11;1;12;0
adf1c94ffe75cea7d6b12ac10809656c15d33079;Wed Apr 03 07:35:35 EDT 2013;Committer;nobu;4;18;1;19;0
b30a6b8d1d194528a2c84b7e2c73d23a4d25cc42;Wed Apr 03 07:34:31 EDT 2013;Committer;nobu;6;52;0;52;0
8ab35353a75a7ee9e908ff32e68327e77ad85af2;Tue Apr 02 15:09:41 EDT 2013;Committer;svn;1;2;2;4;0
c3c4ffa9725947a1c150880502399c3309a4fb31;Tue Apr 02 15:09:36 EDT 2013;Committer;akr;2;8;1;9;0
90e588777f9634821739526941fa9692c0065bc7;Tue Apr 02 14:58:32 EDT 2013;Committer;nobu;1;1;1;2;0
ff9c262f6ca8e42627cdf8cda98dd4c9b82703ff;Tue Apr 02 14:58:06 EDT 2013;Committer;nobu;1;1;0;1;0
0af16197817a183ae9d2f042c612264784f1c35d;Tue Apr 02 11:31:44 EDT 2013;Committer;akr;1;1;0;1;0
583c8e89153dc5fab189d24b6688c31a70a63dbb;Tue Apr 02 11:28:57 EDT 2013;Committer;akr;4;65;17;82;0
6d0c59f156da08a6a669a3187f86b424ce147626;Tue Apr 02 10:26:02 EDT 2013;Committer;akr;3;28;19;47;0
817a96a45d686571c97892aa7c0b287539a5ecbd;Tue Apr 02 10:08:10 EDT 2013;Committer;akr;2;6;1;7;0
e89c029f2b038a67b6d9b9dfc6bc9e429cab69b3;Tue Apr 02 09:48:34 EDT 2013;Committer;akr;1;9;20;29;0
5fd798d1ed52dde16f71ea7540c96a82b0d921da;Tue Apr 02 08:44:16 EDT 2013;Committer;naruse;3;16;0;16;0
a1a6fd90bb4045b95963788fb923a9a54fdaf502;Tue Apr 02 07:02:54 EDT 2013;Committer;naruse;3;36;25;61;0
5376610d0c671fd9076cd8347e2aac388b93dde2;Tue Apr 02 06:28:20 EDT 2013;Committer;naruse;1;1;1;2;0
1ee9f3759db908682504685ee1825db436cafa73;Tue Apr 02 06:28:17 EDT 2013;Committer;naruse;1;20;42;62;0
a26d663b70af61824bbb722d22d13d068e19cccd;Tue Apr 02 06:28:15 EDT 2013;Committer;naruse;2;28;4;32;0
63f33c5e461dc7c84bdb31f5d5fb4f163ada9157;Tue Apr 02 06:28:13 EDT 2013;Committer;naruse;3;6;4;10;0
4046585a206a8002d6dab192f00b4c03786a3d0e;Tue Apr 02 06:28:10 EDT 2013;Committer;naruse;1;1;1;2;0
7a77e124882f925fe8c7e51a28bac7f15e8ad868;Tue Apr 02 02:14:21 EDT 2013;Committer;naruse;3;21;26;47;0
0fb23a9449fbdb858be4df90e84214cf0916845d;Tue Apr 02 02:02:33 EDT 2013;Committer;naruse;1;1;1;2;0
662d67f13f75ce4e99b86e00c7d85f0fa12e4bf5;Mon Apr 01 22:59:05 EDT 2013;Committer;akr;1;1;4;5;0
17cf784d78a6f034a539c391175a3bda2b5048af;Mon Apr 01 22:45:29 EDT 2013;Committer;akr;1;2;2;4;0
e47f41fb9dccd61ba6901081c49e51226ca27a74;Mon Apr 01 22:41:13 EDT 2013;Committer;akr;1;18;8;26;0
d40335aa36a0acbe85dde987deaeac6eb0a27e40;Mon Apr 01 21:49:55 EDT 2013;Committer;akr;3;24;23;47;0
7d3db3cc8187e57ab8801051189f81cb8ff9d3c3;Mon Apr 01 15:10:33 EDT 2013;Committer;nobu;2;26;26;52;0
bd67f48e5164be509440d6918d3fa3e4dd30b6fa;Mon Apr 01 15:00:41 EDT 2013;Committer;svn;1;2;2;4;0
b5550361c9398b75578ea07a65ffb0b00f27524e;Mon Apr 01 15:00:36 EDT 2013;Committer;nobu;1;2;1;3;0
87877eb04f5376b651e501cd7aa451c870df7411;Mon Apr 01 13:34:52 EDT 2013;Committer;akr;2;15;7;22;0
f4eeca1d161d398971ef7da1c3765f206b35f477;Mon Apr 01 13:08:28 EDT 2013;Committer;eregon;2;8;2;10;0
809a7618f0ded5347d90597beb189da65bd98d90;Mon Apr 01 12:22:56 EDT 2013;Committer;akr;2;10;0;10;0
d6daffbbf0350dbb6a164ec6264d5d2ea2f05c25;Mon Apr 01 12:14:30 EDT 2013;Committer;akr;2;12;1;13;0
0cbe2f4902aa3de9a082776d4fcc574bc50d5aa5;Mon Apr 01 11:58:55 EDT 2013;Committer;akr;3;56;103;159;0
4e52c3c60c3b012631493d1ba6254d448e0eb7c5;Mon Apr 01 11:08:44 EDT 2013;Committer;akr;2;19;11;30;0
ecb9b98774b01b2eff22fe4a9832ce469f3552e8;Mon Apr 01 09:41:42 EDT 2013;Committer;nobu;2;6;2;8;0
3eb4b0aa0633e1aa6161e86eb0215e267c905a96;Mon Apr 01 09:39:19 EDT 2013;Committer;nobu;1;6;3;9;0
318e8835d0d075ce399cb40f6e6c085cc723b049;Mon Apr 01 07:00:24 EDT 2013;Committer;kazu;1;1;1;2;0
39626559944ac960b21cc1ce3c740a0ab61b1648;Mon Apr 01 05:41:27 EDT 2013;Committer;nobu;1;5;4;9;0
90e8a9b4bd583d7b65edf97343dd7d8317f091a6;Mon Apr 01 05:22:57 EDT 2013;Committer;nobu;2;11;3;14;0
92f59c6d7937b14bb5eefb052099ef0a3ef3bcd0;Mon Apr 01 03:06:09 EDT 2013;Committer;akr;2;16;16;32;0
6a23960f3fe722050d29cf91022d14ad949fa6d3;Sun Mar 31 23:16:19 EDT 2013;Committer;ayumin;1;1;1;2;0
ec61b0794a04b5b341d3ba8a0e394976c104341b;Sun Mar 31 22:19:55 EDT 2013;Committer;ayumin;2;5;1;6;0
45334da911b188516189082f889ec3a3e2badc46;Sun Mar 31 19:24:08 EDT 2013;Committer;naruse;1;1;1;2;0
a6b625c538e23a09334a276d551aba1921b135a1;Sun Mar 31 19:18:41 EDT 2013;Committer;naruse;2;11;0;11;0
1e7bd7d93687fb18ea17e1472450ea3182c6cd51;Sun Mar 31 16:14:20 EDT 2013;Committer;svn;1;3;3;6;0
a7526797a65a2f51bc93561c9545fddcd3c3e012;Sun Mar 31 16:14:15 EDT 2013;Committer;akr;4;151;1;152;0
c68234f7d1fa9f2e9a1874b547f1f3e48eff5ae1;Sun Mar 31 08:18:09 EDT 2013;Committer;nobu;3;44;1;45;0
651c561b488ac97eed507a431a51c32214234597;Sun Mar 31 08:18:04 EDT 2013;Committer;nobu;1;4;0;4;0
31af17963d6dd30c88360d79f70505af916e3272;Sun Mar 31 07:51:35 EDT 2013;Committer;akr;1;17;10;27;0
8825a084eb57893b7e1951e76ce299bd41535c24;Sun Mar 31 06:40:37 EDT 2013;Committer;nobu;3;36;31;67;0
0423c207c65a0c9910521a33627cecbd38ad38a1;Sun Mar 31 05:28:19 EDT 2013;Committer;nobu;1;1;1;2;0
59182ccf69b5c0bcbf3a939a3595956bc592f234;Sun Mar 31 04:51:29 EDT 2013;Committer;akr;3;52;11;63;0
18affefbe5e7d0d940e7f924b375c4bde00ac380;Sun Mar 31 02:21:07 EDT 2013;Committer;hsbt;1;1;0;1;0
e8e7e1aae2feb1de74add23dc9d97d60fb04d810;Sun Mar 31 02:01:17 EDT 2013;Committer;hsbt;1;4;3;7;0
c25aa9f5d6b81d406a0a009f90a6cd87d62ccc1c;Sun Mar 31 01:47:47 EDT 2013;Committer;hsbt;4;11;10;21;0
c5fe7eb6f688c90208ff95da5bf4e86e54f62edf;Sat Mar 30 21:27:27 EDT 2013;Committer;nobu;3;22;1;23;0
b5583577d46e8aa1725840186e0f609cacec1bda;Sat Mar 30 21:08:42 EDT 2013;Committer;nobu;2;34;5;39;0
77ff241fa0bc5f9db2606486f486a3de39f70718;Sat Mar 30 21:08:36 EDT 2013;Committer;nobu;6;23;42;65;0
f2e1bfb89762fe4f98d0467299ec046cf75fb51d;Sat Mar 30 21:08:34 EDT 2013;Committer;nobu;2;4;4;8;0
ae422dda781388d16ee8333867e913ba0b7b174d;Sat Mar 30 21:08:30 EDT 2013;Committer;nobu;1;1;0;1;0
30feef61443b8758116afa022239001f9d93eae4;Sat Mar 30 17:07:36 EDT 2013;Committer;svn;1;2;2;4;0
c9d0a328efed4bd999edb50d9de6171b81252de6;Sat Mar 30 17:07:32 EDT 2013;Committer;naruse;1;2;6;8;0
ca76bb087757848af6e13f59b473037fd8e27a6b;Sat Mar 30 05:14:54 EDT 2013;Committer;kazu;6;5;1115;1120;0
bcb5c27fc44375cde4d045f06254c58aa929e883;Sat Mar 30 04:33:28 EDT 2013;Committer;marcandre;4;21;43;64;0
246102b536ddd46f33162c81fa7d3e639128efbe;Sat Mar 30 03:03:58 EDT 2013;Committer;marcandre;1;2;1;3;0
b7d708c3f182b95fdec2b7c870c30424f8b1a2a2;Fri Mar 29 19:00:05 EDT 2013;Committer;usa;2;9;3;12;0
33be01ca4d714d03cdb721abf6bdc6fd58e362d9;Fri Mar 29 18:52:56 EDT 2013;Committer;svn;1;2;2;4;0
35cc29c872adf66b97f7707cec54601dd1ae3698;Fri Mar 29 18:52:51 EDT 2013;Committer;usa;2;9;10;19;0
99155e20a0077e423a2c44551a70f6b01746f36f;Fri Mar 29 13:09:52 EDT 2013;Committer;nobu;3;12;1;13;0
2418b20897ee9a4077cb98aab10249d1d1843cf9;Fri Mar 29 12:02:16 EDT 2013;Committer;nobu;1;1;0;1;0
7b6badcebeb1b505a51380ed04cb377c661fa8cf;Fri Mar 29 09:00:12 EDT 2013;Committer;kazu;1;2;2;4;0
824cb6905896131031c4f712e6cb55f76fc9ad1f;Fri Mar 29 07:51:43 EDT 2013;Committer;nobu;3;17;5;22;0
8d7c52dbe21f1bbd423860c7bab21a9f8ce487c2;Fri Mar 29 07:51:08 EDT 2013;Committer;nobu;3;79;14;93;0
2e26edb633606f1e99d22817678e11c25f7d2882;Fri Mar 29 02:09:51 EDT 2013;Committer;nobu;2;8;2;10;0
cea3a73f19c2f6124dbf04af6c8160d872d19bfc;Fri Mar 29 01:24:14 EDT 2013;Committer;nobu;2;8;0;8;0
0cfc4866d4eb7f16e650ab3262515c02fc6725ab;Fri Mar 29 00:42:32 EDT 2013;Committer;hsbt;3;1;4;5;0
1950c1ce6c43449017abf9e3d3310ee4892d9a95;Thu Mar 28 21:49:55 EDT 2013;Committer;akr;2;10;1;11;0
023c7f6a37c56ed7d0865edb12d1428558f060ea;Thu Mar 28 15:55:10 EDT 2013;Committer;svn;1;2;2;4;0
56f2447e5a9b8f28a4ca72a9290e8e2eac86bea3;Thu Mar 28 15:55:05 EDT 2013;Committer;nobu;2;14;2;16;0
80466df690e1fc952d661686baaa6f3b245d42a0;Thu Mar 28 14:11:35 EDT 2013;Committer;akr;2;8;2;10;0
05f5cbeb7588fca122e92d9e9fe8a9d1e07e3abc;Thu Mar 28 14:10:21 EDT 2013;Committer;nobu;2;13;0;13;0
f25e55cb875b64a84c2e1f9e24722b129ba07ce0;Thu Mar 28 13:11:00 EDT 2013;Committer;nobu;1;1;5;6;0
f526fc2cfa4ae37ed392410a4e6597ffe5bc0db3;Thu Mar 28 10:07:17 EDT 2013;Committer;kazu;1;1;1;2;0
29e5699992c417e934f2b6ec0b559db454f9d0db;Thu Mar 28 09:23:51 EDT 2013;Committer;akr;2;30;17;47;0
bb6a7778fef943731f3f8daf67b75f60f4d4fe6c;Thu Mar 28 04:50:15 EDT 2013;Committer;nobu;1;25;10;35;0
78598ebf51eb0923b32b790db1a05b29c56efd56;Thu Mar 28 04:50:12 EDT 2013;Committer;nobu;2;21;77;98;0
7d672f3e3733683e41b7137a8fa488340033ce0c;Wed Mar 27 22:13:06 EDT 2013;Committer;akr;5;13;37;50;0
6537dc309962c7fefcb8d698bbebe4e4f78d0096;Wed Mar 27 21:56:20 EDT 2013;Committer;akr;2;42;0;42;0
cbdbc9107b59c435317b745434b849c0158a6d7f;Wed Mar 27 17:14:01 EDT 2013;Committer;svn;1;2;2;4;0
45e866c18adc6612f3866f696b7adfa687afc264;Wed Mar 27 17:13:57 EDT 2013;Committer;kazu;2;62;62;124;0
83f1be1bc3a627620b6a7e95afef98a2cb1df5d5;Wed Mar 27 13:12:27 EDT 2013;Committer;akr;3;36;4;40;0
7379116878c25b6411ce080268ed8e3a7e885f2f;Wed Mar 27 12:01:40 EDT 2013;Committer;akr;2;80;169;249;0
c64f26a28171e3e9400f027e63d02dc5af5f8ca5;Wed Mar 27 11:37:59 EDT 2013;Committer;akr;3;10;1;11;0
2f1e7f6a71a1eaaa753c3ed2e897fd4d4771f2ea;Wed Mar 27 07:40:43 EDT 2013;Committer;nobu;1;1;0;1;0
57123fb2f1a3a869c158840afa358423b7a07a21;Wed Mar 27 06:17:36 EDT 2013;Committer;nobu;1;0;3;3;0
6b7478c4bd7cc844079f2b02fd350975fb7a0bba;Wed Mar 27 03:42:19 EDT 2013;Committer;nobu;1;3;0;3;0
bb945c3722383747a02214bc0a64c47af8e68a31;Wed Mar 27 03:08:25 EDT 2013;Committer;akr;2;7;2;9;0
b4d05fb0cce58a806ff0425f8353368e9f9eb471;Wed Mar 27 03:03:36 EDT 2013;Committer;akr;2;5;4;9;0
89b49d45989845cb196a5b9ce4dc0147a867a4c6;Tue Mar 26 21:39:50 EDT 2013;Committer;nobu;2;17;6;23;0
aa25b1e7403840a4ac3bf1ee0e2318d8cb473260;Tue Mar 26 21:39:47 EDT 2013;Committer;nobu;1;1;2;3;0
7b2c7b620c9d124d5d676a09acf6799f57627b0d;Tue Mar 26 20:15:44 EDT 2013;Committer;nobu;3;21;6;27;0
5426842df30fcf2d3251e9235bfb54d7c848602f;Tue Mar 26 20:15:41 EDT 2013;Committer;nobu;1;1;1;2;0
7cb47a315edd1c9317c11568fc8adc446b3e3b00;Tue Mar 26 16:01:42 EDT 2013;Committer;kazu;1;1;1;2;0
6f003e469dba0d7adb4cec796706a1e8fe7d7a99;Tue Mar 26 16:01:39 EDT 2013;Committer;kazu;1;1;1;2;0
3dcdfcf884479107efb1c4007a592a1f086a4ce9;Tue Mar 26 15:30:27 EDT 2013;Committer;akr;3;22;8;30;0
bdc42b0ef3e92fb4a9467500a5af5fb662a35355;Tue Mar 26 15:24:08 EDT 2013;Committer;kazu;1;1;1;2;0
6a5911828b652f6d1b88e7de1eb9ba399ed4dee8;Tue Mar 26 15:22:55 EDT 2013;Committer;svn;1;2;2;4;0
6708e96bcdc15349092a88b92366411c5783edc7;Tue Mar 26 15:22:51 EDT 2013;Committer;kazu;1;1;1;2;0
d85bf93776e18e55a5fccddb649d4e5081702314;Tue Mar 26 14:55:04 EDT 2013;Committer;xibbar;37;37;37;74;0
bfb0edbad29074ff186840731069fb202456a7aa;Tue Mar 26 14:45:55 EDT 2013;Committer;akr;6;15;10;25;0
9b3d6ad13a8a38e4e85d9a77cee2c4bbfa8f3f66;Tue Mar 26 14:37:24 EDT 2013;Committer;xibbar;2;2;2;4;0
7371736e49bcb7066651139654f91f0e0cb9ec5a;Tue Mar 26 14:34:20 EDT 2013;Committer;akr;2;6;1;7;0
b0b460925cf990ebd368f19816877657ca38f630;Tue Mar 26 14:31:31 EDT 2013;Committer;xibbar;11;11;11;22;0
79f7521e9be53324581b5b469d1717081e67f80e;Tue Mar 26 13:16:31 EDT 2013;Committer;akr;2;15;3;18;0
e1540cd74da39418ebc04fe2e3e04c78204b9e7a;Tue Mar 26 12:22:12 EDT 2013;Committer;akr;1;1;1;2;0
eed73918f72ec2569ac1ee610b43a8b19e50c7c3;Tue Mar 26 12:16:49 EDT 2013;Committer;usa;1;1;1;2;0
4c276d0c8b505377f4cd06c413b5ea10adaca8cb;Tue Mar 26 06:24:26 EDT 2013;Committer;nobu;1;1;0;1;0
94a6df786926a61c7099fb338ecb208818b31c02;Tue Mar 26 06:24:24 EDT 2013;Committer;nobu;1;5;4;9;0
b6a6fa0af47f9e1647b17aedc2e4269498b0f086;Tue Mar 26 02:59:09 EDT 2013;Committer;nobu;1;1;1;2;0
4fa7a0d8df9dd4dd623261087180d40bd457ff83;Tue Mar 26 01:42:33 EDT 2013;Committer;naruse;1;2;2;4;0
76ba59645c0078f03775ac766e1483529064808b;Tue Mar 26 01:13:41 EDT 2013;Committer;naruse;1;2;0;2;0
ed90272e000c293b57fbfba4c6b6ea133860929a;Mon Mar 25 18:50:52 EDT 2013;Committer;svn;1;2;2;4;0
a850dc62e939b5dac5062a28e706dbb715f1400a;Mon Mar 25 18:50:50 EDT 2013;Committer;naruse;1;22;22;44;0
eaad7bedc9367396d6229dbd42b55194faa39e3b;Mon Mar 25 18:50:48 EDT 2013;Committer;naruse;2;3;3;6;0
2149c313f4306925903eba207616d895a37f850c;Mon Mar 25 09:13:08 EDT 2013;Committer;nobu;1;6;3;9;0
f4ac735476535dcc0acbfbc507009fc67ddeaffa;Mon Mar 25 09:03:54 EDT 2013;Committer;nobu;1;7;3;10;0
8e10ee739b2d09ee2deb89980591843c93d9dc97;Mon Mar 25 09:03:51 EDT 2013;Committer;nobu;1;2;1;3;0
6f8e5cc821c2c118ff2997fbcaf3c269ae454a8c;Mon Mar 25 05:39:32 EDT 2013;Committer;nobu;2;13;11;24;0
985deb62ebb0b6d5ca6f3b6469b5860d00869d93;Mon Mar 25 05:39:29 EDT 2013;Committer;nobu;2;5;5;10;0
e37f8c0f0b7e429f89d53d7f31318f0941f6b735;Sun Mar 24 22:09:35 EDT 2013;Committer;drbrain;2;9;2;11;0
77b885264bda990e13fe385199f31c90e0ae668a;Sun Mar 24 22:01:56 EDT 2013;Committer;drbrain;2;22;0;22;0
b95336b2fe56585ab585ca7c17fbad4c145e9e2b;Sun Mar 24 21:00:03 EDT 2013;Committer;kosaki;2;8;1;9;0
b63580b50f6d9102db873e20fc38695fa613991f;Sun Mar 24 17:15:59 EDT 2013;Committer;svn;1;2;2;4;0
02ff09770569a4ed74daab731376cb01925312e5;Sun Mar 24 17:15:54 EDT 2013;Committer;nari;2;6;0;6;0
7a8329737aa011dd5624a1151c392d913457961e;Sun Mar 24 14:36:26 EDT 2013;Committer;naruse;1;13;1;14;0
c4d2d856b85dd8e8314c82a1f7904acd18d37448;Sun Mar 24 14:08:08 EDT 2013;Committer;nagachika;1;1;1;2;0
ed77aff154497bd7fc9941277842481a8d0d00d4;Sun Mar 24 13:18:54 EDT 2013;Committer;naruse;3;11;3;14;0
f001a450f2263a74cc38e650361da161305d776f;Sun Mar 24 10:43:39 EDT 2013;Committer;nobu;1;3;3;6;0
cedfed5e8d6371c66f9f664e0c49f5d051dad033;Sun Mar 24 10:43:37 EDT 2013;Committer;nobu;1;4;10;14;0
014236612a0be2f07ac6e645bd5a32ddbe4c8b0f;Sun Mar 24 09:32:06 EDT 2013;Committer;knu;3;15;2;17;0
b4a2e268ea165c0b4321d76b68467ca6ca61a9aa;Sun Mar 24 05:13:54 EDT 2013;Committer;nobu;1;1;1;2;0
e54daddac4e5583e62ef9d665d4f3d4a859478c9;Sun Mar 24 04:53:44 EDT 2013;Committer;nari;2;9;1;10;0
3ad60679e37ac36b2d76b12f31036864733bb59f;Sun Mar 24 04:20:32 EDT 2013;Committer;nari;2;15;2;17;0
052c0e67d99552aeb2091d1ae7133465a5aa7291;Sun Mar 24 02:06:32 EDT 2013;Committer;akr;9;64;3;67;0
61f50e317e3bfea90cf1b8e9ce8e4e6f704173a4;Sun Mar 24 00:04:43 EDT 2013;Committer;nobu;1;1;2;3;0
7a64cdeb5588ab8e00d4fdb15bcd4b228e6c21c7;Sat Mar 23 20:36:42 EDT 2013;Committer;drbrain;3;60;4;64;0
f70e0e628b03f3e96fa284bd139045f13fcee2ec;Sat Mar 23 20:32:59 EDT 2013;Committer;drbrain;2;582;577;1159;0
646bcaa71742b78c6999fcecf133183a8a28a414;Sat Mar 23 20:10:11 EDT 2013;Committer;drbrain;4;759;520;1279;0
362208c041ee8feed9262d0c7f2c78bf3caea6e5;Sat Mar 23 19:50:49 EDT 2013;Committer;naruse;1;7;4;11;0
20219afd83a34cf4f09424f5d18d39db2b6dedba;Sat Mar 23 19:50:47 EDT 2013;Committer;naruse;1;4;14;18;0
71012b3aa7906ec00eab1e815c059199234b134b;Sat Mar 23 19:13:37 EDT 2013;Committer;drbrain;2;5;4;9;0
90d9413391ea3f7d05b5cf38e6eef676ec68a529;Sat Mar 23 18:35:23 EDT 2013;Committer;drbrain;2;87;3;90;0
ebca3dd3c3fbc903511122078df910362347b5fa;Sat Mar 23 18:34:16 EDT 2013;Committer;drbrain;1;7;0;7;0
c09287bdaa025382982cc9881d6dd936bc06a5c9;Sat Mar 23 17:16:21 EDT 2013;Committer;akr;2;6;0;6;0
668f6c7bc64e815ed6577308c3287a871c03da49;Sat Mar 23 16:05:52 EDT 2013;Committer;svn;1;2;2;4;0
3de18117885c4849430a9dcb1e8395777fe4bb63;Sat Mar 23 16:05:51 EDT 2013;Committer;naruse;2;449;13;462;0
e8f9b6647aead1dc3e2ccd7e6bea05dd2b67ea86;Sat Mar 23 16:05:47 EDT 2013;Committer;naruse;1;0;1;1;0
bc43842252acc3d62b83f6352c601c5b5253cf60;Sat Mar 23 14:30:56 EDT 2013;Committer;mrkn;2;15;4;19;0
338456ad94708c0ff4f057ed9e66da8cd34f69ae;Sat Mar 23 14:21:22 EDT 2013;Committer;naruse;1;4;1;5;0
813ba53bbc3529940d914c016126152496137935;Sat Mar 23 08:46:10 EDT 2013;Committer;nobu;1;8;0;8;0
b79ba4a745e54e1767e770a45fb141eeb48bb1ed;Sat Mar 23 08:45:32 EDT 2013;Committer;nobu;1;2;2;4;0
04c9bdb19098678e245fa2a0d4173cc6f2d4ca59;Sat Mar 23 08:39:55 EDT 2013;Committer;nobu;3;21;17;38;0
1a56e716b1c555e7ab717e3f8ab3a552391065a2;Fri Mar 22 23:01:10 EDT 2013;Committer;marcandre;1;1;1;2;0
e25f03a6a5c7f7b923fd87e31baf81699a414ea6;Fri Mar 22 22:56:13 EDT 2013;Committer;marcandre;1;1;1;2;0
d90128833b04d61c17f13513bccc6fcc79e44c48;Fri Mar 22 22:30:51 EDT 2013;Committer;svn;1;2;2;4;0
cb0093d54552cff4c1c914973ffe30e7d175cd64;Fri Mar 22 22:30:45 EDT 2013;Committer;marcandre;3;26;10;36;0
4edd787b140737172ff8f74ac556ce7b9c58e8d6;Fri Mar 22 11:57:51 EDT 2013;Committer;hsbt;2;1;2;3;0
cfe937b9b20fb356cf820c932616b6cdb603d4a1;Fri Mar 22 08:48:44 EDT 2013;Committer;nobu;2;13;4;17;0
228b29a697f719f60f0a62e3cdf1bb8c991beba3;Fri Mar 22 08:38:51 EDT 2013;Committer;nobu;4;35;14;49;0
81cb1f63946ef5ba8847ac06019fc2d98a52c544;Fri Mar 22 07:57:09 EDT 2013;Committer;nobu;3;9;0;9;0
e52a4a70a95e3d334608ab7534cda83b03512365;Fri Mar 22 01:38:55 EDT 2013;Committer;mrkn;2;1724;1659;3383;0
c60c0503782d68a1ba8a7b675f6e53713c5b67da;Thu Mar 21 20:34:37 EDT 2013;Committer;nobu;1;2;3;5;0
9150340b9bcbe305c2647a8d6f6f8e754769f3e7;Thu Mar 21 20:30:53 EDT 2013;Committer;nobu;3;27;1;28;0
79f7dfabb69ec435b6b0be5ccb5157cb85e71580;Thu Mar 21 19:51:19 EDT 2013;Committer;nobu;3;28;3;31;0
7e052c7b81d22fe4556e313c1f24ccda15502ab1;Thu Mar 21 16:11:32 EDT 2013;Committer;kazu;3;12;5;17;0
f7108c5d1a10cacfbb79a0b370c8136bed74af66;Thu Mar 21 15:05:02 EDT 2013;Committer;svn;1;2;2;4;0
65a277d71726c9d1aeb9329cfff2776ff103cead;Thu Mar 21 15:04:57 EDT 2013;Committer;naruse;2;9;5;14;0
035838147231983fb448b84ef5d4d08d4d3bbdf3;Thu Mar 21 14:55:26 EDT 2013;Committer;naruse;1;6;2;8;0
7f7621e734dc697ab8e1f018c0013f27d77e6cbb;Thu Mar 21 14:32:17 EDT 2013;Committer;nobu;3;8;11;19;0
ccde88c1f173732f64e026c733bc3e9dffc50344;Thu Mar 21 14:17:46 EDT 2013;Committer;nobu;1;1;1;2;0
5de144f3a56eaee430680bc83d80a8a3e8134fdc;Thu Mar 21 14:17:10 EDT 2013;Committer;nobu;3;15;3;18;0
042594bb502f4199a3e4e676c01c8375f6cdcb48;Thu Mar 21 14:14:19 EDT 2013;Committer;nobu;3;12;9;21;0
82b8467e23757a01805698bf0e982fa3b93d9310;Thu Mar 21 13:50:20 EDT 2013;Committer;ngoto;2;8;2;10;0
ebd866348254f245f6d689ece6781499489aa411;Thu Mar 21 07:48:11 EDT 2013;Committer;nobu;3;15;4;19;0
1dfb5bb7fc6ff3b32dbf70ed02936a98980ed19d;Thu Mar 21 05:26:32 EDT 2013;Committer;nobu;1;1;1;2;0
634779e62fac7154657cf73990fe7caafe1c2a21;Thu Mar 21 05:13:59 EDT 2013;Committer;nobu;1;2;1;3;0
69d5f4ab53577fb4fb1a866ba74e5dbfe909e48d;Thu Mar 21 04:50:52 EDT 2013;Committer;nobu;2;8;1;9;0
91194dfd38ac716ec5f4f17a1add3099014eb112;Wed Mar 20 22:35:43 EDT 2013;Committer;svn;1;2;2;4;0
5d402803ee81b5942bbec1e93661278baa1d9c1e;Wed Mar 20 22:35:38 EDT 2013;Committer;zzak;2;6;1;7;0
9cbd4ac367a94d2782a0c81500987d554807a849;Wed Mar 20 13:53:16 EDT 2013;Committer;nobu;2;6;1;7;0
7e1d5045943835ff906850e7b3bc71f985ae5f36;Wed Mar 20 13:52:54 EDT 2013;Committer;nobu;2;21;14;35;0
dd210d8fbc87dc6473c300822a405c3786b6e60b;Wed Mar 20 08:52:04 EDT 2013;Committer;usa;2;9;2;11;0
f4274129eefc8f8c2d9c688e93ef692310268d83;Wed Mar 20 07:49:14 EDT 2013;Committer;shirosaki;2;7;0;7;0
7f2a13ea10f043a5e64b958b6c92805a3e367840;Wed Mar 20 07:49:09 EDT 2013;Committer;shirosaki;2;7;0;7;0
46048d6d1b629ddb5f1bef36ad27229bc8d8e7f9;Wed Mar 20 06:24:14 EDT 2013;Committer;usa;2;11;4;15;0
119aa9d295cc779fbf6d5af1ac899d8371ea3816;Wed Mar 20 06:21:46 EDT 2013;Committer;usa;1;1;2;3;0
dcbc7b01a3c3bf6d74f6971fab256a995e842103;Tue Mar 19 19:41:30 EDT 2013;Committer;ayumin;2;9;4;13;0
49636da49059c4c227380c39015c60cf5c68c379;Tue Mar 19 19:23:15 EDT 2013;Committer;ayumin;1;1;1;2;0
6f072a36c0e27e99194158fd9cf87abda7853fe1;Tue Mar 19 19:19:46 EDT 2013;Committer;ayumin;2;6;1;7;0
62565929b35484fd9d4d6adf7cea8f71a12f71b6;Tue Mar 19 18:34:13 EDT 2013;Committer;kosaki;2;8;0;8;0
8c52515eaa82330581e06751631f07e8ebed180e;Tue Mar 19 18:26:27 EDT 2013;Committer;kosaki;2;8;0;8;0
df4fcd343f973aee316677d40035c02be4a61a19;Tue Mar 19 18:26:16 EDT 2013;Committer;svn;1;2;2;4;0
c9073822c2837bc51d47f1b90e2dae0701c08281;Tue Mar 19 18:26:11 EDT 2013;Committer;kosaki;2;6;0;6;0
d617690a65f82eeb82c8bdb1bec8f07be8f8979e;Tue Mar 19 10:51:49 EDT 2013;Committer;usa;3;7;2;9;0
e0b74f8a4d44c7f4304f89b99d4a26cc3c295a76;Tue Mar 19 08:40:39 EDT 2013;Committer;usa;1;2;1;3;0
10f5312de081a9fb593d880620bd876e470b9bad;Tue Mar 19 08:09:33 EDT 2013;Committer;nobu;2;36;13;49;0
29dc980e6562b4083f72f121465eca2f5427af39;Tue Mar 19 08:06:53 EDT 2013;Committer;nobu;3;87;2;89;0
353cd01e2f926d4290784adced100d850f862d77;Tue Mar 19 08:04:26 EDT 2013;Committer;nobu;1;6;5;11;0
4ea96ece8400f1c6caa8a2429f6d93f15434238f;Tue Mar 19 04:40:22 EDT 2013;Committer;kosaki;6;55;2;57;0
b945ad289f14c1b1ba65bdd9a4e1106f3cee134c;Tue Mar 19 03:17:34 EDT 2013;Committer;kosaki;2;7;2;9;0
3ee89c6277975db0a09f903b96da8f7fecfef8a6;Tue Mar 19 01:09:46 EDT 2013;Committer;sorah;2;6;1;7;0
ab31e97c4475ae179f4a64b36e989fdfbfaa1d6d;Mon Mar 18 17:39:39 EDT 2013;Committer;naruse;1;6;1;7;0
357b8c06c35e3b20c2746ce63b622e6564b80b63;Mon Mar 18 17:15:43 EDT 2013;Committer;mrkn;2;5;0;5;0
5ef1525b5ed596060f985fce06e0a228c6988fab;Mon Mar 18 16:22:15 EDT 2013;Committer;mrkn;2;6;1;7;0
65a709aea8b43447d0cdabc249049c8d36a2dab9;Mon Mar 18 15:30:10 EDT 2013;Committer;svn;1;2;2;4;0
80329d3a66bf007d85a35c624d6514b0ddc814ca;Mon Mar 18 15:30:02 EDT 2013;Committer;nari;3;16;6;22;0
1bc93a15912ab418bd54c0c064a47c557798eae9;Mon Mar 18 12:44:55 EDT 2013;Committer;nari;3;24;2;26;0
03c7f0ca43a65b18d81387f82bf91e5d5bc14bee;Mon Mar 18 09:03:07 EDT 2013;Committer;nari;2;8;1;9;0
ac454412abff3e4ba084c987802f61dcc4914dae;Mon Mar 18 05:47:37 EDT 2013;Committer;usa;2;17;11;28;0
aa24857f12718d1fa81d77695f6f5af319334d24;Mon Mar 18 04:31:59 EDT 2013;Committer;naruse;3;68;0;68;0
f8eaf3c625e7a57509d74ce26a82593698fafad0;Mon Mar 18 02:06:44 EDT 2013;Committer;naruse;2;5;12;17;0
9b113a0d6bec8e61e72171d98843b4d58f8dbf53;Mon Mar 18 01:45:12 EDT 2013;Committer;naruse;2;6;1;7;0
d883d756d109d6d54201311fb0de85ee4967db3b;Sun Mar 17 18:19:56 EDT 2013;Committer;zzak;2;6;1;7;0
ade879ec7622ec0e9e5bd2a81df2a2d405842dfb;Sun Mar 17 16:25:26 EDT 2013;Committer;svn;1;2;2;4;0
a9cbf64137b846ba28ae0e7a0bb9d607e37fb710;Sun Mar 17 16:25:21 EDT 2013;Committer;naruse;2;12;1;13;0
e4811dc6976534e790e2b588521c1d273419c83a;Sun Mar 17 01:34:20 EDT 2013;Committer;ktsj;1;1;1;2;0
326dd6e0ccb98141ef8578d429d113e8f714b4c6;Sat Mar 16 17:40:16 EDT 2013;Committer;kosaki;2;8;0;8;0
28d3acb045cc1f5dec7fbaf9f71ac1ee1256e7d8;Sat Mar 16 15:58:25 EDT 2013;Committer;kosaki;2;5;1;6;0
6b83f5e6a552c6856cc0b61796ef94d1e0b541ef;Sat Mar 16 15:16:36 EDT 2013;Committer;svn;1;2;2;4;0
7c14f03c0cd5ed10581c4657604df94bd6e0f2be;Sat Mar 16 15:16:32 EDT 2013;Committer;nobu;1;3;1;4;0
090a6ca4e9382e811404a15e099d55d1c1bd833d;Sat Mar 16 14:48:35 EDT 2013;Committer;nobu;1;5;8;13;0
de9911f5970bae5072a82ac33e054b5cf4bb7dac;Sat Mar 16 14:48:33 EDT 2013;Committer;nobu;1;2;0;2;0
4002be60c010c6b7eb3bcb7b8857553b286bbf85;Sat Mar 16 08:05:45 EDT 2013;Committer;nobu;1;2;0;2;0
cab124776e911cc509598464831a0106ba975808;Sat Mar 16 07:28:32 EDT 2013;Committer;nobu;2;8;8;16;0
af24f5ff6a9df492ac699dfc2d8158adaa4369df;Sat Mar 16 07:28:20 EDT 2013;Committer;nobu;1;7;5;12;0
92b367e0696785540143707af4093108d6d98c79;Sat Mar 16 05:07:28 EDT 2013;Committer;kosaki;3;46;1;47;0
c824d47ebc829560d022df74d355f69c601ea102;Sat Mar 16 05:07:14 EDT 2013;Committer;kosaki;4;19;9;28;0
03a6ce80d04dd386a8514faf4abc86b3ea290a68;Sat Mar 16 05:07:02 EDT 2013;Committer;kosaki;2;7;0;7;0
798ff850e41752834bd27081c2e85f874b2cc4aa;Sat Mar 16 05:06:47 EDT 2013;Committer;kosaki;8;43;3;46;0
2e544471ae719757a0fec2a686bdeb7a97540c90;Sat Mar 16 05:06:32 EDT 2013;Committer;kosaki;2;8;0;8;0
e1807e59951d4280895dd3f2c2fc4a774ad3fe6a;Fri Mar 15 21:26:36 EDT 2013;Committer;kosaki;2;8;3;11;0
4bfea99d1131482b6f28b5dd8d0a622de9231156;Fri Mar 15 17:50:30 EDT 2013;Committer;naruse;1;0;1;1;0
00d9f130b03c5fd7dece69b5de11b07e5b19c3ad;Fri Mar 15 16:55:48 EDT 2013;Committer;svn;1;2;2;4;0
a4010f4f7fce9cb52c903429faa7485499b81c41;Fri Mar 15 16:55:43 EDT 2013;Committer;headius;1;6;0;6;0
84085167f813294250a5e45b8584bcd8aa009ecd;Fri Mar 15 14:06:21 EDT 2013;Committer;nobu;3;53;7;60;0
55549b85f19a518a65a16918829a0c8f6480c78f;Fri Mar 15 11:36:25 EDT 2013;Committer;nobu;1;1;1;2;0
d4c1418aab79d3da41433632a1f8966136a472c1;Fri Mar 15 11:20:00 EDT 2013;Committer;nobu;1;1;1;2;0
c7c3a275f33ca1f2485a0a496fac8b076f38beed;Fri Mar 15 11:19:56 EDT 2013;Committer;nobu;3;30;22;52;0
b5a9cd8fb82c33d03e8487d24825690de1697cc0;Fri Mar 15 08:29:41 EDT 2013;Committer;kazu;1;1;1;2;0
a7e5f0b5ee2f53c7ad903fbb50296523f8af11a3;Fri Mar 15 06:08:13 EDT 2013;Committer;nobu;2;6;2;8;0
0d3d9eff4d59d36f1545c4fe9f00916bcfd417ac;Fri Mar 15 05:51:37 EDT 2013;Committer;nobu;5;21;25;46;0
bfd52c985ccc3b2e245c87c197d73150d2b8d5df;Thu Mar 14 23:25:09 EDT 2013;Committer;naruse;2;18;1;19;0
1b179216a945abba11a9906e12b8068481c12566;Thu Mar 14 19:08:57 EDT 2013;Committer;zzak;2;5;1;6;0
3a3581d586d24a300cc3dd2ee16d3c858a97a95f;Thu Mar 14 16:21:56 EDT 2013;Committer;svn;1;2;2;4;0
2642e0203a33614af5945a976bdf97eefa9213e6;Thu Mar 14 16:21:54 EDT 2013;Committer;nobu;1;3;0;3;0
d24540f5bbf42cf6b93c3174aaa780c581954ec1;Thu Mar 14 16:21:52 EDT 2013;Committer;nobu;1;1;0;1;0
844c04f462e0677c2723789325366f233cbd0a01;Thu Mar 14 07:59:16 EDT 2013;Committer;nobu;3;26;2;28;0
fb34a2600326f6ba3ba116c35d1395e90d10fd00;Thu Mar 14 05:59:53 EDT 2013;Committer;naruse;2;10;2;12;0
3bda122ab9387b05f99808e6f3415a7346ecb80a;Thu Mar 14 04:01:39 EDT 2013;Committer;naruse;2;18;1;19;0
2caf0bc820b4be3956b8f26a81d279d815eaea2d;Thu Mar 14 03:56:09 EDT 2013;Committer;luislavena;2;52;25;77;0
ca4397ad2c8a89593e60b1d20bae88a983f79388;Thu Mar 14 03:49:30 EDT 2013;Committer;akr;1;8;0;8;0
8283be280c62c15e04fa8d4c2c5145ceaa39de18;Thu Mar 14 02:54:30 EDT 2013;Committer;nari;2;8;0;8;0
5f92934e728dcdcdf61b1f2318cc8a6a96bd9455;Thu Mar 14 01:01:24 EDT 2013;Committer;svn;1;2;2;4;0
2e3b394dcac2d564beaca74d33fae7c275015e68;Thu Mar 14 01:01:20 EDT 2013;Committer;drbrain;2;6;1;7;0
2f7ca893a35abcde7e994c582055bd672c459058;Wed Mar 13 14:52:00 EDT 2013;Committer;nari;3;29;2;31;0
b1f2460f8dcffa9184ab916a10e1236d9b60f886;Wed Mar 13 10:50:21 EDT 2013;Committer;kazu;4;22;14;36;0
99126a4c88d3ddb9ea76edf948307c7bfa0fe971;Wed Mar 13 06:13:08 EDT 2013;Committer;nobu;3;21;6;27;0
be909b5e95e5ba56eadb42e6dbc9102c1188ae48;Wed Mar 13 05:51:32 EDT 2013;Committer;nobu;3;20;1;21;0
49a22e173b8d8e95eb3b891669329b8a07c43e70;Wed Mar 13 05:51:29 EDT 2013;Committer;nobu;1;7;1;8;0
120e2219f318241bb1a75a763cc37b42ccc9b772;Wed Mar 13 04:06:47 EDT 2013;Committer;nobu;2;43;35;78;0
fc82b5f4c0f7a3b908ee47836195066c27432c9b;Wed Mar 13 02:58:52 EDT 2013;Committer;nobu;1;1;1;2;0
c851bd00a379d43bb842ce66f7eee2f61d60d2fd;Wed Mar 13 02:43:09 EDT 2013;Committer;shugo;2;5;1;6;0
ee2884ff3d9d95dc5af840e6962a68891e21b3f9;Wed Mar 13 02:09:18 EDT 2013;Committer;nobu;1;1;1;2;0
4c1a39e59d8e4f11cac284038ef315f561eedd57;Tue Mar 12 20:49:48 EDT 2013;Committer;svn;1;2;2;4;0
0fb6a44da9b2ed607f80bfd1cd92f7d3e8ab0578;Tue Mar 12 20:49:44 EDT 2013;Committer;drbrain;2;5;1;6;0
34a95669dad8843e3e9a4af683682ab2f50856dd;Tue Mar 12 13:20:50 EDT 2013;Committer;nobu;7;121;13;134;0
976a3041ef38711b84c6a35db25f189d31903e38;Tue Mar 12 08:05:16 EDT 2013;Committer;takano32;2;5;1;6;0
8f73480c3d9b1497b6ddebdf92b79b480d365670;Tue Mar 12 08:02:17 EDT 2013;Committer;takano32;2;5;1;6;0
5e04bb66973015fa0edfe4881dd46fd7f4f72a7e;Tue Mar 12 08:00:16 EDT 2013;Committer;takano32;2;16;6;22;0
10c5d6ee2593f5b6a0361009201464c248158da6;Mon Mar 11 21:29:32 EDT 2013;Committer;drbrain;12;82;152;234;0
21c1e2da06c76e825feeeec9233c3e5a9f0345a0;Mon Mar 11 17:27:07 EDT 2013;Committer;svn;1;2;2;4;0
f2a13e60d95c7be55de2fa793a186f5a63a9c142;Mon Mar 11 17:27:03 EDT 2013;Committer;drbrain;4;42;0;42;0
b1f2effda85efd03bd4ad5c06e0aae5e14f3f864;Mon Mar 11 13:47:04 EDT 2013;Committer;akr;2;8;1;9;0
79ea4d627ffc38c9754123c7535dc264dfc8e74e;Mon Mar 11 12:12:15 EDT 2013;Committer;nobu;2;2;2;4;0
2f20defa7abaa77f92e0a7c1a6dad789c9963391;Mon Mar 11 10:23:12 EDT 2013;Committer;usa;2;5;1;6;0
5f257cf403a0316ee005b5cc476b04dbf9ca86ec;Mon Mar 11 09:47:15 EDT 2013;Committer;naruse;3;19;0;19;0
7590de68e2102d586a1fb4e34642643b3c731269;Mon Mar 11 08:29:46 EDT 2013;Committer;naruse;3;51;20;71;0
756cd2852d8faea5139b01bfd5e596d6f9e35b14;Mon Mar 11 08:02:36 EDT 2013;Committer;naruse;3;15;3;18;0
a82d24aa8237d50a8c7d7178d0535327e7ec645c;Mon Mar 11 05:25:06 EDT 2013;Committer;nobu;2;7;8;15;0
407bcb4bc6207a2668c2c801711a5eb0bcbfc100;Mon Mar 11 03:46:55 EDT 2013;Committer;naruse;3;13;4;17;0
76d8cc33f9ef4f8d17bb8516a26e1d41e10cbc0f;Mon Mar 11 02:53:47 EDT 2013;Committer;nobu;3;37;4;41;0
c0035ed35141b2675ec0f395b3a214f967ad7190;Mon Mar 11 00:50:31 EDT 2013;Committer;nobu;1;7;2;9;0
3176b04d22aaf046bdcc05161a11a1f653dd80e4;Mon Mar 11 00:29:00 EDT 2013;Committer;nobu;1;1;1;2;0
f407b14167082c16a48a87fcb1272326d7640547;Sun Mar 10 23:03:52 EDT 2013;Committer;kosaki;1;3;2;5;0
1c47bd88c13a19ce0b0a184d6e552f4d26433ac4;Sun Mar 10 23:01:21 EDT 2013;Committer;kosaki;3;35;0;35;0
0b1ff939455a96bb2e715d029c0d412af8de593a;Sun Mar 10 23:01:07 EDT 2013;Committer;kosaki;2;8;1;9;0
11125bf46aac1099912133d84e304eefd5a8f841;Sun Mar 10 20:02:47 EDT 2013;Committer;headius;1;3;3;6;0
cbd15bdb95e6d9825a2ef8f08d2d6ed62d4ec9e1;Sun Mar 10 18:23:00 EDT 2013;Committer;kosaki;2;9;0;9;0
2aabb9aed2e026c14ce45543c797cfd6fc05d6d9;Sun Mar 10 15:26:48 EDT 2013;Committer;nobu;1;3;3;6;0
4fdb1fbdbfe6449cb8a0d252d76f0072ba9a6806;Sun Mar 10 15:11:16 EDT 2013;Committer;nagachika;1;1;1;2;0
7d7481d5f6a074cf34cf32adce60d86ca6da8a94;Sun Mar 10 15:08:08 EDT 2013;Committer;svn;1;2;2;4;0
92dce6fbcae76a7703d3d132f0252b111f2a58fa;Sun Mar 10 15:08:04 EDT 2013;Committer;nagachika;1;0;7;7;0
ee90455a447aaafe1985ba365d0357ba8f524146;Sun Mar 10 14:39:09 EDT 2013;Committer;luislavena;3;52;4;56;0
4cbb8ea83650af5de9f058955f6ef7f713b0977f;Sun Mar 10 14:27:56 EDT 2013;Committer;nobu;2;15;1;16;0
9a4f037502254f50475f0b48d37fe84d5e8e4813;Sun Mar 10 08:01:32 EDT 2013;Committer;tadf;3;19;2;21;0
de6d82f90703bde85bfd419aeb343ef0fd94044b;Sun Mar 10 06:04:51 EDT 2013;Committer;kosaki;2;5;26;31;0
d71a8880b4d6765294468e94834aeabdf72af6bf;Sun Mar 10 05:12:09 EDT 2013;Committer;kosaki;2;109;0;109;0
c38469f453d8857f56ab18ad7cf2c2507558bcd8;Sun Mar 10 05:11:56 EDT 2013;Committer;kosaki;2;8;3;11;0
117b51a3fa02de5aa82d5de80d36af8aff559640;Sun Mar 10 05:06:58 EDT 2013;Committer;kosaki;2;24;20;44;0
19e0d7c18ef614d65a279eaf427dea8786f659ac;Sun Mar 10 04:00:44 EDT 2013;Committer;kosaki;2;15;2;17;0
235546ba049fe1e13517d075ec3ba9721af8cb54;Sun Mar 10 04:00:33 EDT 2013;Committer;kosaki;2;11;1;12;0
bcf12936810465caa1e6b019652ae42bf9fc22f0;Sun Mar 10 04:00:21 EDT 2013;Committer;kosaki;2;42;9;51;0
9c021064a28639fbb9ccb6a9877fc504f377624c;Sun Mar 10 04:00:10 EDT 2013;Committer;kosaki;2;56;30;86;0
0eeb116923171e73876d286e9573cb21cae057ae;Sun Mar 10 04:00:00 EDT 2013;Committer;kosaki;2;14;1;15;0
383a2579c3027e579f64e08597bae1097619baf4;Sun Mar 10 03:59:49 EDT 2013;Committer;kosaki;3;81;38;119;0
368fdf9cc164caef3ea08cdd9226542de943479f;Sun Mar 10 03:59:39 EDT 2013;Committer;kosaki;2;19;7;26;0
27f25728e69274fd226007bd6765d3819b0449c7;Sun Mar 10 03:59:29 EDT 2013;Committer;kosaki;2;18;11;29;0
3887a34c9040ae6f29eea592073d4dcc283cea4e;Sun Mar 10 03:59:19 EDT 2013;Committer;kosaki;2;9;4;13;0
5cebbe8f9b61edac849d8131e32d4d20105d1164;Sun Mar 10 03:59:07 EDT 2013;Committer;kosaki;2;26;14;40;0
e2e374e45a17056dcddce0827040b4219d3b7c75;Sun Mar 10 00:18:59 EST 2013;Committer;svn;1;2;2;4;0
ec9eabc6c2df764c2c51e72e23bb7512bb77d965;Sun Mar 10 00:18:52 EST 2013;Committer;tadf;3;35;0;35;0
b3265c0ed6d7a2db76c172aef128445902c36c63;Sat Mar 09 02:58:45 EST 2013;Committer;nobu;3;17;2;19;0
b0c40fca240dec15e8d709f14115d94ef6766c1b;Sat Mar 09 01:01:25 EST 2013;Committer;marcandre;1;1;1;2;0
0230ff702061a4001e671c67bda1648af4eaf0d5;Sat Mar 09 00:17:51 EST 2013;Committer;nobu;1;2;0;2;0
198a2eac906e20b068404e1307eb91f1170cfd05;Sat Mar 09 00:05:40 EST 2013;Committer;nobu;1;1;1;2;0
6c4ab3f43950d3f0302fea3ce890032a8dd34d44;Sat Mar 09 00:03:40 EST 2013;Committer;nobu;1;6;5;11;0
1b7143309b7570dd41a3d311f193f5d382d10996;Fri Mar 08 23:54:41 EST 2013;Committer;nobu;1;36;34;70;0
8237581a2eb4ea5bfd38a2f0ebfb54110704235c;Fri Mar 08 23:37:02 EST 2013;Committer;nobu;2;36;5;41;0
28d7cd1098b86b4a35bbb5bedf4eeda0b11b8201;Fri Mar 08 15:26:09 EST 2013;Committer;svn;1;2;2;4;0
0316cf2e523d9f77e610477697d5a93842b4d4bd;Fri Mar 08 15:26:08 EST 2013;Committer;nobu;3;49;13;62;0
e14095fff2aed4599a69d8c53ee5ca017a6e8826;Fri Mar 08 15:26:05 EST 2013;Committer;nobu;1;2;2;4;0
6f59a8b4a23b5e106b2e14981a2b9cc2628f851e;Fri Mar 08 11:16:00 EST 2013;Committer;knu;3;12;5;17;0
1a633537f8ca8210cb851ef34103c8befecb6c03;Fri Mar 08 07:09:14 EST 2013;Committer;nobu;1;3;1;4;0
3d881966322458abe94cfb409b1606ceaaad49d7;Fri Mar 08 07:02:37 EST 2013;Committer;nobu;2;9;8;17;0
4a3970c2118e2c4a4558431886dde02cd7ad5b7e;Fri Mar 08 05:47:52 EST 2013;Committer;nobu;1;7;4;11;0
d415f2abac2537cb9acb09def3646490d3d8518f;Fri Mar 08 05:24:26 EST 2013;Committer;nobu;1;14;0;14;0
5ebffacf17077de98fc99ee63daa617627e249cf;Fri Mar 08 05:24:23 EST 2013;Committer;nobu;1;6;1;7;0
7d183dab15665d34ad982348c3205c85b28017b5;Fri Mar 08 04:21:43 EST 2013;Committer;zzak;2;18;1;19;0
df9d847e0b6532e12ccc78e2d78d767b68364f66;Fri Mar 08 03:01:47 EST 2013;Committer;zzak;2;39;0;39;0
9c1fbec8737071580935bdeffb2c53d1a9a0c984;Fri Mar 08 01:46:59 EST 2013;Committer;zzak;2;9;4;13;0
0003ac99cccf0a91df49f9a1141b175e0f80051c;Fri Mar 08 01:21:41 EST 2013;Committer;marcandre;2;1;38;39;0
7afb2eadddee5c606bd6c30bbb3ad401cd331b3d;Thu Mar 07 18:17:56 EST 2013;Committer;marcandre;1;11;0;11;0
131fa91fce28dfd759bc229f0c7819e302c9e55f;Thu Mar 07 17:54:55 EST 2013;Committer;svn;1;2;2;4;0
dfde34cb3c968f3238afcfd05298bc6b88585bcb;Thu Mar 07 17:54:49 EST 2013;Committer;marcandre;4;39;34;73;0
221f2a1d8a7c42165b3144fbf22b9585e3026e18;Thu Mar 07 05:21:40 EST 2013;Committer;nobu;3;42;0;42;0
8a6898394c7cc04ffed49c92063d3fd2ab901497;Thu Mar 07 05:17:04 EST 2013;Committer;nobu;1;407;404;811;0
fedf4c2250fd543db2287b96d7b7cfa596749241;Thu Mar 07 05:17:00 EST 2013;Committer;nobu;1;8;7;15;0
3016b65abff3dbeb26417d70a6aecda3dbe7c843;Thu Mar 07 04:38:50 EST 2013;Committer;nobu;1;6;0;6;0
94daa860e5b263f0511478ea5783935d1e16278c;Thu Mar 07 04:38:45 EST 2013;Committer;nobu;1;1;1;2;0
9926b16d358f218776b8ae573ea775011fd367cd;Thu Mar 07 04:06:30 EST 2013;Committer;drbrain;6;77;7;84;0
105361d9d4bb4ee642d367a3652251cd516325bc;Thu Mar 07 04:01:28 EST 2013;Committer;drbrain;1;14;0;14;0
3d4d93770923cbc04fbc1b6815081d0357eb26ce;Thu Mar 07 01:39:15 EST 2013;Committer;svn;1;2;2;4;0
1a71b8718adc0d46f307f4e14d4e4baec89b645e;Thu Mar 07 01:39:13 EST 2013;Committer;nobu;2;6;2;8;0
e4e82e50abc795876b8eba99517c8209fdf1f2d7;Thu Mar 07 01:39:10 EST 2013;Committer;nobu;2;11;0;11;0
5f5d915512361c395b2b462443a68ac21ab9eeac;Wed Mar 06 13:24:06 EST 2013;Committer;nobu;1;2;1;3;0
5c1af05ef521eeb7a718aefbacf9b78a0a48e5df;Wed Mar 06 11:59:23 EST 2013;Committer;nobu;2;18;0;18;0
0af37bf0c5146a827993a4aeb0807387b6b33d1e;Wed Mar 06 10:22:29 EST 2013;Committer;nobu;1;1;1;2;0
6332415800e6ecc9cd8b87934bd47995406fb6fb;Wed Mar 06 06:30:08 EST 2013;Committer;nobu;2;7;4;11;0
6f4d00e565df9f8c46bfca069550f941dbf4c740;Wed Mar 06 06:30:06 EST 2013;Committer;nobu;1;1;1;2;0
2d1c94a18de4f278e49d918d4ba03bc1dce44706;Wed Mar 06 06:30:03 EST 2013;Committer;nobu;9;34;34;68;0
4f59a115fd9b000ce1cb0feb7272c2795ea934bb;Wed Mar 06 06:29:57 EST 2013;Committer;nobu;1;1;0;1;0
d1e3c6324551a2deb5de3faccc6973b96db86f68;Wed Mar 06 04:14:38 EST 2013;Committer;drbrain;2;4;1;5;0
48d5694f7e97dae1fc043ed781d4a8705758ac00;Tue Mar 05 23:11:43 EST 2013;Committer;drbrain;2;24;8;32;0
6e48ce9c116a799ac94b63ae486427606e40fbaf;Tue Mar 05 23:02:00 EST 2013;Committer;drbrain;3;29;3;32;0
7a88ad0a42dffdbbcaf0192635ab64c636294cf6;Tue Mar 05 22:40:53 EST 2013;Committer;drbrain;15;126;23;149;0
32fa37f53c386bf8b6d9031a7c587772ee12430d;Tue Mar 05 16:31:24 EST 2013;Committer;svn;1;2;2;4;0
dbec401c115d12190143cf062515ad358d3a710f;Tue Mar 05 16:31:19 EST 2013;Committer;kazu;7;25;10;35;0
6520da6245b70169363e33aa929775a4f958d84e;Tue Mar 05 13:48:20 EST 2013;Committer;nagachika;1;1;1;2;0
1d82ffd8d40ae5334aa40340354bb922f56fc59d;Tue Mar 05 12:50:58 EST 2013;Committer;kazu;1;5;5;10;0
f113ab552c7f83bd12f4136bce7fb8ee89819adb;Tue Mar 05 12:36:45 EST 2013;Committer;nobu;4;62;11;73;0
00a8203b0b31ba2063f4344418331af2dbed7db3;Tue Mar 05 12:30:27 EST 2013;Committer;nobu;1;1;1;2;0
2ff56cc9b4dd3566277d2201774f80fef9aefdde;Tue Mar 05 11:29:27 EST 2013;Committer;nobu;3;6;2;8;0
708df44e59915557aca1c5962d0dd196177b7e63;Tue Mar 05 11:23:55 EST 2013;Committer;nobu;2;12;4;16;0
85164e551a41d6b71224a364497af76acd147d03;Tue Mar 05 03:31:28 EST 2013;Committer;drbrain;6;56;31;87;0
6c77ae07a5f90f625346ac4193ad8c63c62ba5a1;Tue Mar 05 03:25:55 EST 2013;Committer;drbrain;2;7;0;7;0
b4a117f8d3be2aff93521c388587eff8c8601199;Tue Mar 05 01:40:52 EST 2013;Committer;nobu;3;13;2;15;0
4a429c11e1319b0e13368851454f109217ab5de5;Tue Mar 05 01:20:20 EST 2013;Committer;nobu;5;25;10;35;0
ce357ef152869d3c5bfd2e088a31d879daa4ecb6;Tue Mar 05 01:18:55 EST 2013;Committer;nobu;2;11;0;11;0
66867b0a63b62c80c8596efe34ad1ba43598e709;Tue Mar 05 01:06:08 EST 2013;Committer;nobu;1;4;0;4;0
001e06ed364b7afbba710f4408aa370f7719c0c7;Tue Mar 05 01:02:36 EST 2013;Committer;svn;1;2;2;4;0
f2d3cd1cc439122e0177cb4a38394ff7a2f1da98;Tue Mar 05 01:02:32 EST 2013;Committer;nobu;1;6;0;6;0
dbb6526e290d462f43f2b5501cbf1a692bf3cd06;Mon Mar 04 08:05:13 EST 2013;Committer;nobu;1;2;2;4;0
a95a87c0bc0ee694e880b680865072babe168802;Mon Mar 04 06:33:48 EST 2013;Committer;nobu;3;30;18;48;0
a5a4963018590c80019c361c5fe2701fc8606dae;Mon Mar 04 05:13:48 EST 2013;Committer;nobu;2;8;2;10;0
14cc02fb64959e67490abd9f23657a18ba4f1360;Mon Mar 04 01:27:02 EST 2013;Committer;nobu;1;0;5;5;0
56348e18e3a3ede7d8bbca1a36ec1d5661fbe34e;Mon Mar 04 01:24:45 EST 2013;Committer;svn;1;2;2;4;0
d4d14c198801b3965da32d1b88cf6594dfc7e0a2;Mon Mar 04 01:24:40 EST 2013;Committer;zzak;2;5;1;6;0
d71177feab63780c4d069decc96f775361afb9c5;Sun Mar 03 04:15:02 EST 2013;Committer;nobu;1;2;1;3;0
bb2551b41cacd2dfdcf3311625ec9e7eb1677072;Sun Mar 03 03:35:11 EST 2013;Committer;nobu;2;23;3;26;0
a7a0b3ad52e264d08e1b26a6bad9b9bba2a99c1b;Sun Mar 03 03:17:50 EST 2013;Committer;nobu;3;42;3;45;0
2a5b45ddc5e533ed69e656a4d384c1d4dd0dbac6;Sat Mar 02 22:34:29 EST 2013;Committer;zzak;2;6;2;8;0
da56b059bc5aa7ca665eeea7419964d106051e48;Sat Mar 02 16:33:24 EST 2013;Committer;kazu;2;3;3;6;0
59e66b101f88734863043f97f36c90a2effc55ab;Sat Mar 02 16:33:21 EST 2013;Committer;kazu;1;1;1;2;0
32458a01eba62f1468e6fc4ad858b228a5425966;Sat Mar 02 16:17:22 EST 2013;Committer;nobu;3;23;1;24;0
9b79ed12928174fa1b36d5aaa198f3de7edfd02f;Sat Mar 02 16:16:19 EST 2013;Committer;nobu;4;12;6;18;0
c0c72c9ba1e2492999664d6b0335dd7d3ae43bb6;Sat Mar 02 16:14:32 EST 2013;Committer;nobu;2;23;23;46;0
ee01561bf16105a614adf00acd4afea4832e2367;Sat Mar 02 15:31:24 EST 2013;Committer;nagachika;1;1;1;2;0
773248551b8cb46f281d5b6bb4f61477ce17d55d;Sat Mar 02 15:04:23 EST 2013;Committer;nobu;4;11;0;11;0
248aa54c274f72801da04c86f4c6653733e2c1e7;Sat Mar 02 15:01:48 EST 2013;Committer;svn;1;2;2;4;0
fa0630558f181ef744e933abb857f06f32cc3ad0;Sat Mar 02 15:01:44 EST 2013;Committer;akr;1;7;0;7;0
d613f283be274e8e50a0d62fab51c52dae8a6228;Sat Mar 02 13:50:08 EST 2013;Committer;nobu;1;1;0;1;0
2250b195a9fcbbfe752dd6d46a702674ec144272;Sat Mar 02 13:49:49 EST 2013;Committer;nobu;2;13;0;13;0
b1f493dcd1092fe17cccec998e175516ed5c6e47;Sat Mar 02 08:36:16 EST 2013;Committer;akr;2;11;19;30;0
e563e6bf1066a78d555dceba052bf9f2166271a1;Fri Mar 01 17:46:40 EST 2013;Committer;zzak;2;5;1;6;0
6751ba4c7ae392b34dc25429854cef3b658c96ee;Fri Mar 01 16:37:31 EST 2013;Committer;naruse;1;1;1;2;0
51a747c5f8fae8798dafb7125949d6433dd80d59;Fri Mar 01 16:36:44 EST 2013;Committer;svn;1;2;2;4;0
78dbaa16481c6ccda491d40695abe3d1c1d8c9b1;Fri Mar 01 16:36:37 EST 2013;Committer;naruse;8;80;56;136;0
528e02fcf660b7584e64322083e1a681533cecc2;Fri Mar 01 02:10:41 EST 2013;Committer;drbrain;1;1;1;2;0
874f8c0494b186406dba339a81b6dcce7fb7c429;Fri Mar 01 02:09:42 EST 2013;Committer;drbrain;6;249;224;473;0
6213b8370c54bed04b6f9901cd89e9a6fa08557a;Fri Mar 01 00:18:50 EST 2013;Committer;zzak;2;9;4;13;0
a5dfaca00a94bc3d135aae52b4458f5a355bf0ed;Thu Feb 28 22:25:55 EST 2013;Committer;drbrain;19;299;41;340;0
3fc7731297d8de1f52cec9382a4f1f0a08bea949;Thu Feb 28 18:27:04 EST 2013;Committer;svn;1;3;3;6;0
9460a750e181f02f57bb8ce8b0a28f57404b2778;Thu Feb 28 18:27:00 EST 2013;Committer;zzak;2;152;26;178;0
4cf0918e8e3d8b06d84c3cd3e875c82edb8b87e6;Thu Feb 28 14:04:53 EST 2013;Committer;ko1;3;52;3;55;0
338ec3cee73f58091927d9282070efd0da0cca36;Thu Feb 28 13:29:55 EST 2013;Committer;akr;2;6;3;9;0
9a1d5b04cd8aab74c4a915476d533181058ab21c;Thu Feb 28 12:35:56 EST 2013;Committer;eban;2;8;1;9;0
b0690af9a4f09fc2cd6d15e7544cc40a4371228d;Thu Feb 28 11:26:23 EST 2013;Committer;ko1;3;21;1;22;0
731acc0950e24262ca657d684ecb6de864ba9b4c;Thu Feb 28 04:30:50 EST 2013;Committer;nobu;1;3;3;6;0
8ac0f28399e51322aae86dfbd3bb8c9ed3de4e63;Thu Feb 28 04:30:26 EST 2013;Committer;nobu;1;1;1;2;0
a6c92a85e418dd9b748e37d0f4445784ad1e9c71;Wed Feb 27 23:20:57 EST 2013;Committer;drbrain;11;243;88;331;0
4e040aa6ac4cc4f3b00007b8635a990ef36526c4;Wed Feb 27 20:36:59 EST 2013;Committer;zzak;2;132;101;233;0
0315ced9a5581dafa3a1aa1b898aca457f18988e;Wed Feb 27 17:43:30 EST 2013;Committer;svn;1;2;2;4;0
b8e24f19b5874ad7e6f8cbe88e4ff6c602b00f8d;Wed Feb 27 17:43:25 EST 2013;Committer;zzak;2;6;1;7;0
bf96ea63623856a61d978da45a0f9b27560fe499;Wed Feb 27 13:55:19 EST 2013;Committer;akr;2;6;0;6;0
3b6d093451565c80d36c791ff6ac9cbc5918d287;Wed Feb 27 12:24:31 EST 2013;Committer;kou;6;54;40;94;0
20514a08936861205e21c80973b532d6af26c139;Wed Feb 27 10:54:11 EST 2013;Committer;eregon;2;8;4;12;0
7505436d62a39abbfb6b0df46adde3260f96d711;Wed Feb 27 08:08:10 EST 2013;Committer;nobu;1;8;4;12;0
2e3fc1f06427c46aff50ba8eebe2f3fcb76dc96b;Wed Feb 27 05:24:01 EST 2013;Committer;nobu;1;1;1;2;0
46e0ce84d53dbb565d6a3460b2bd37a8250ad8d7;Wed Feb 27 04:47:12 EST 2013;Committer;nobu;1;2;2;4;0
e881056fd63dfa72f31424c67fa0eb35c1f92e0f;Wed Feb 27 04:47:10 EST 2013;Committer;nobu;1;2;8;10;0
6c9fdc616a89a2a99fad1a408d2d5a2fdecef75a;Wed Feb 27 04:22:08 EST 2013;Committer;zzak;2;5;1;6;0
ab0d28c1bdf3b25080cdf7cbe3801a8deb6f617f;Wed Feb 27 04:02:06 EST 2013;Committer;zzak;2;151;1;152;0
f7a7138d5b9321d944d89625c250376074befa04;Wed Feb 27 03:58:36 EST 2013;Committer;zzak;2;9;3;12;0
e016ec17078c0c0e008b37caf78d03399a6853fd;Wed Feb 27 03:53:13 EST 2013;Committer;zzak;2;6;2;8;0
dda10afc65c4b65507c4d41ad27ad0f60bcb3117;Wed Feb 27 03:36:02 EST 2013;Committer;zzak;2;7;2;9;0
4cc2a6b1b1d54617f8582a524101b669a2366b47;Wed Feb 27 03:22:50 EST 2013;Committer;naruse;2;21;1;22;0
7c4084f9fb85073ec08450abdf70b24f7b598033;Wed Feb 27 01:24:08 EST 2013;Committer;zzak;2;7;3;10;0
530b1308c6d8199ebd7d080ec17b21eabed84342;Wed Feb 27 01:16:13 EST 2013;Committer;svn;1;2;2;4;0
54c9163f25b30d0d5d3e0e602919a4060d70f8a0;Wed Feb 27 01:16:08 EST 2013;Committer;nobu;1;0;1;1;0
790bfbf55cfa276bec8fb3465440dc4b26004026;Tue Feb 26 14:35:05 EST 2013;Committer;kou;1;4;4;8;0
b972878978ec8fa860eab3af5ac466b6b85c628d;Tue Feb 26 14:34:01 EST 2013;Committer;kou;3;28;5;33;0
ea2e083a1d67e31b8699aa849f0e1477e6ca4131;Tue Feb 26 14:30:40 EST 2013;Committer;kou;4;33;5;38;0
684ce8403c0738bbada6d84cfe60a6e16824421b;Tue Feb 26 06:39:25 EST 2013;Committer;nobu;1;2;2;4;0
b3d2b56d2b92af712501ebb1bd5a1b7c06dbe1d3;Tue Feb 26 06:12:17 EST 2013;Committer;nobu;2;12;1;13;0
a4ccd46d31ea9d67756e60a105fb9c3c3c3d063a;Tue Feb 26 06:04:22 EST 2013;Committer;nobu;2;9;4;13;0
6f8feb2276a21c4ff2a916d934e10ef6554cc6d3;Tue Feb 26 01:31:42 EST 2013;Committer;nobu;1;1;1;2;0
c07d78eb0e8e9d3a8f9e8c860b362964157ff43a;Tue Feb 26 01:24:52 EST 2013;Committer;nobu;3;23;1;24;0
47809f09346a7a026b56635bf7a2b84069fbbe39;Mon Feb 25 19:52:11 EST 2013;Committer;zzak;2;6;2;8;0
ffbd120efdbcc65937413102086f28b4090e9ce5;Mon Feb 25 18:43:41 EST 2013;Committer;kosaki;2;7;0;7;0
1b7cb091493aaeeb5963b4612509a27b9d09d31d;Mon Feb 25 15:54:04 EST 2013;Committer;svn;1;2;2;4;0
e05392ea7764659686c20e7f5fd9ac3c2475a39b;Mon Feb 25 15:54:00 EST 2013;Committer;nobu;1;1;1;2;0
b85978b1c8a639c1371e79412e45ca37db8eeb10;Mon Feb 25 14:59:24 EST 2013;Committer;nobu;1;85;85;170;0
9d6798932f213cd1031e160c23f81188e9ce2bbb;Mon Feb 25 14:59:21 EST 2013;Committer;nobu;1;3;3;6;0
c75f360bdf10f1c8847cbb8d0c7d0a68e35cf7d5;Mon Feb 25 14:51:12 EST 2013;Committer;nobu;2;5;1;6;0
2d3808eeac6ea951797fa53cb857919aa0d7d4cf;Mon Feb 25 12:18:48 EST 2013;Committer;naruse;3;30;2;32;0
9156a04d9186114f570a1ee8fe5059ec23e0b192;Mon Feb 25 08:10:44 EST 2013;Committer;nobu;1;1;1;2;0
246c3a0b7cba62ea55aead9c3040ee2c2c1dd55c;Mon Feb 25 08:10:40 EST 2013;Committer;nobu;1;5;4;9;0
6ff10e76d7669925c623167ed01962c5b57dd43f;Mon Feb 25 07:47:21 EST 2013;Committer;nobu;2;7;2;9;0
e276482efc1c274ba9cfe17f5e6fbe02819a15bb;Mon Feb 25 07:30:41 EST 2013;Committer;drbrain;4;75;31;106;0
be26224be568166b5db530cd377bf71d78e985d8;Mon Feb 25 06:59:10 EST 2013;Committer;nobu;1;2;2;4;0
72aee03262254a78736de4dba6adba2ff25efd8c;Mon Feb 25 06:47:23 EST 2013;Committer;nobu;3;13;2;15;0
593ffbcf717bde5aa9b695aeb7808ddd74bb4ccf;Mon Feb 25 05:41:16 EST 2013;Committer;nobu;3;8;2;10;0
2c183f552034ac32a026daeed2c95839fefa34b5;Mon Feb 25 04:54:27 EST 2013;Committer;nobu;1;6;4;10;0
5919370363cd39a04bb3e848b1e15f9c2f1b3ce3;Mon Feb 25 04:12:45 EST 2013;Committer;nobu;4;26;15;41;0
eed06bb0434c6c1f94513e22b4ad4f89bcec0d8b;Mon Feb 25 04:10:54 EST 2013;Committer;nobu;1;0;3;3;0
84e8862c56d90000d0ad8eb166e8fb81b5bba943;Mon Feb 25 03:50:20 EST 2013;Committer;zzak;2;31;4;35;0
1580dd29dddc02c210f96e6250d2f20df3241ab1;Mon Feb 25 03:40:16 EST 2013;Committer;akr;2;6;9;15;0
c5a7cf00660c8e1797772a357b2b0913c1fe4263;Mon Feb 25 02:38:49 EST 2013;Committer;matz;1;1;1;2;0
6487abea6ca358d72dccc4645eab06e878f212df;Mon Feb 25 02:09:07 EST 2013;Committer;knu;2;6;1;7;0
1a76bf3911669fea4919867fca6452f6e4b93776;Mon Feb 25 00:44:08 EST 2013;Committer;kazu;1;2;1;3;0
beafa477f1b48204202dfcf5f13b2b0cc216f732;Mon Feb 25 00:41:07 EST 2013;Committer;kazu;4;24550;24514;49064;0
2b847f8187069b1b2840ce664f66c3d73c8bf972;Sun Feb 24 17:51:23 EST 2013;Committer;svn;1;2;2;4;0
c89844dbc50c1422774c39b03e0757c91531e586;Sun Feb 24 17:51:17 EST 2013;Committer;akr;9;129;75;204;0
ef339580947c7df1281263ccfb99718887e5378d;Sun Feb 24 13:10:46 EST 2013;Committer;naruse;56;61;60;121;0
66f913572682f54eda3b0d4b78c5e9cef08043dd;Sun Feb 24 12:16:07 EST 2013;Committer;tadf;2;5;1;6;0
9e0683523ac1a995b9c30c94115d2cb66f2d76bb;Sun Feb 24 07:48:31 EST 2013;Committer;nobu;1;2;2;4;0
d64c926eba3a317f4756e048d2ef7522c463636d;Sun Feb 24 06:33:49 EST 2013;Committer;nobu;3;34;1;35;0
023561f704f51804d0803ff2c1839901d609a83d;Sun Feb 24 06:15:05 EST 2013;Committer;drbrain;3;8;7;15;0
1f9fa7c62fe9ea241e5f20a84e749808b1875dd4;Sun Feb 24 05:29:06 EST 2013;Committer;zzak;2;10;0;10;0
5feede6f3b0deaafed9e1f12bac330f90b68ffc3;Sun Feb 24 05:23:51 EST 2013;Committer;zzak;2;7;3;10;0
ac94eb1a9116858396998b4b93122bef942f5378;Sun Feb 24 04:36:00 EST 2013;Committer;nobu;3;56;4;60;0
bd88e6c0b5f01ebdd2d758bd86845eb44605d4f0;Sun Feb 24 04:24:52 EST 2013;Committer;zzak;4;77;5;82;0
6aaf5c5ca0f2322ba1d9001bdd1b9db649cb5419;Sun Feb 24 02:59:17 EST 2013;Committer;nobu;1;1;1;2;0
62174177991217a97d3f8576059dbab95e672c51;Sun Feb 24 01:16:46 EST 2013;Committer;nobu;1;1;1;2;0
2474a1ac007ab4c7f8b9ad202a4ff61a1cb52005;Sun Feb 24 00:18:32 EST 2013;Committer;kosaki;1;0;5;5;0
bc5a5989c044768e7a70c251d7a3f91a8f1ca0e8;Sun Feb 24 00:17:29 EST 2013;Committer;kosaki;2;8;1;9;0
45dea57588b9485b916ebdddd7eaec58199a00ac;Sat Feb 23 22:51:45 EST 2013;Committer;nobu;3;13;1;14;0
a6d08b450c440a03ebb63010048e1211df7abd0f;Sat Feb 23 20:17:20 EST 2013;Committer;marcandre;2;3;3;6;0
a0f3e24f95fbb37560cfc27943b9b070f2422ad6;Sat Feb 23 17:38:16 EST 2013;Committer;svn;1;2;2;4;0
673e1b927681b2f530bee95315fb112cce48f7ba;Sat Feb 23 17:38:12 EST 2013;Committer;marcandre;1;1;1;2;0
87e0df89d220581b09ca24256c529b77785bfa44;Sat Feb 23 14:23:39 EST 2013;Committer;marcandre;1;300;294;594;0
315c72e23486c90c552d4eec1ea498f855130628;Sat Feb 23 13:57:30 EST 2013;Committer;marcandre;1;1;1;2;0
5a34caab4f045b0808eb439fc51f5331328e054c;Sat Feb 23 08:08:24 EST 2013;Committer;zzak;1;17;0;17;0
a153ce31a13e090b780e8d95e52f3ddae3a412de;Sat Feb 23 07:52:46 EST 2013;Committer;zzak;2;18;2;20;0
a14f02f0e08c2bced7ae5a1f77aab3bac4969661;Sat Feb 23 07:06:10 EST 2013;Committer;zzak;2;5;1;6;0
5f2e43381383fd29fc3435297964281510bfc9dc;Sat Feb 23 07:00:51 EST 2013;Committer;zzak;2;73;38;111;0
4abd941e780f4dd7d672dd5d2a229682b5c20276;Sat Feb 23 06:20:19 EST 2013;Committer;nobu;1;1;0;1;0
de697194c22409cbc44d850ee7c208fb81dcf9b3;Sat Feb 23 04:51:12 EST 2013;Committer;nobu;1;4;1;5;0
0ac71e725c312c56daced0864f38217cae1d180d;Sat Feb 23 04:49:16 EST 2013;Committer;nobu;1;9;9;18;0
5b7d2440ca33f68c7b4b6c68553e75137b085666;Sat Feb 23 03:55:39 EST 2013;Committer;knu;2;59;32;91;0
c2204ca328817f3d87232471a4e1de0334425752;Sat Feb 23 03:35:38 EST 2013;Committer;zzak;9;73;40;113;0
827e71bda54ffab6e2b2e0434b235c6190055cdb;Sat Feb 23 03:34:04 EST 2013;Committer;nobu;1;16;6;22;0
933ff1d6d73eb43c1c57dc1ce8b25b172d7064bc;Sat Feb 23 02:50:34 EST 2013;Committer;zzak;2;10;3;13;0
c135883d37d061dd52e15ea7d2c4d38361cf04fb;Sat Feb 23 02:11:53 EST 2013;Committer;zzak;2;16;0;16;0
3331d6774f355e261644d7042cdeee0f03db3bc8;Sat Feb 23 00:48:44 EST 2013;Committer;nobu;3;41;2;43;0
143a2f7ef1a16e22709af87a227e9a6323aefd84;Fri Feb 22 23:57:58 EST 2013;Committer;marcandre;5;114;41;155;0
d52f95dc7ab85a9dbd0c56f034f383ed87201c8a;Fri Feb 22 23:18:47 EST 2013;Committer;marcandre;2;8;0;8;0
eff6180e5389e15f559cd8867fa0093bd05a4a37;Fri Feb 22 23:18:33 EST 2013;Committer;marcandre;1;20;0;20;0
8222a78e28d3882c7e4f62bfe838c3befbd4dd90;Fri Feb 22 23:18:18 EST 2013;Committer;marcandre;1;3;0;3;0
a3d592b47a874c35b99436eb4932b3b2172c1d01;Fri Feb 22 23:18:04 EST 2013;Committer;marcandre;1;6;0;6;0
1727511e852a4d5a351850165a0b97647b2320c0;Fri Feb 22 23:17:49 EST 2013;Committer;marcandre;1;4;1;5;0
ed045985e7e0d25e158cbd4e4bdd9170d4f4ef59;Fri Feb 22 23:17:35 EST 2013;Committer;marcandre;1;2;0;2;0
15fcd78ff7c2193d5b5a2b5e7c8cea72fdc997bd;Fri Feb 22 23:17:21 EST 2013;Committer;marcandre;1;1;0;1;0
11354e242a849b0400434724f52a7ed1ecaf1899;Fri Feb 22 23:17:06 EST 2013;Committer;marcandre;1;5;0;5;0
1ac0694c588a454c50a0388b6b55e35d8c6e25b1;Fri Feb 22 23:16:52 EST 2013;Committer;marcandre;1;3;0;3;0
ca28854eef6dff663430fc435fc25baec8375ca7;Fri Feb 22 23:16:38 EST 2013;Committer;marcandre;1;3;2;5;0
3f8d180092c4a5bf69ef90c8509cb6eab74400c7;Fri Feb 22 23:16:24 EST 2013;Committer;marcandre;1;2;2;4;0
e0003e074f57873832f64cb10235a230acb11213;Fri Feb 22 23:16:10 EST 2013;Committer;marcandre;1;3;1;4;0
bc11b883a0cc3121038e6de45c80eaacb78403aa;Fri Feb 22 23:15:55 EST 2013;Committer;marcandre;1;2;1;3;0
10f953417bf2d4cf505da9867508ea58bb61cba4;Fri Feb 22 23:15:40 EST 2013;Committer;marcandre;1;5;0;5;0
9dc30d2bc2bc2d5dd9f6ff23161d4af1e720eb9b;Fri Feb 22 22:53:20 EST 2013;Committer;svn;1;2;2;4;0
724d7f03700f9a2fa5e640bcd3ee1bc26887164b;Fri Feb 22 22:53:14 EST 2013;Committer;nobu;2;14;9;23;0
a0afa57ea41ed46ee3d0e4e45f8da4c3d0fe4e3c;Fri Feb 22 14:50:03 EST 2013;Committer;nagachika;2;6;1;7;0
1ad9075734a7fd9d58920c714953ec851efcae6b;Fri Feb 22 09:35:46 EST 2013;Committer;usa;4;63;15;78;0
7dd6e08b93a750d962fee51eeaec726caf8dc82e;Fri Feb 22 08:37:16 EST 2013;Committer;naruse;2;6;1;7;0
c84a9acb28f6e566d4047d6601db711d0689e26c;Fri Feb 22 06:02:54 EST 2013;Committer;ngoto;2;5;1;6;0
3f2ce6373f7902e02c559876fb7255b5e36aaa64;Fri Feb 22 03:46:47 EST 2013;Committer;nobu;5;31;0;31;0
e51a9b49f1ded288ee00732f0d7d4af01764a793;Fri Feb 22 02:58:53 EST 2013;Committer;nobu;1;3;3;6;0
2027a05247456879928fdc2f47e9a8aa0079becd;Fri Feb 22 02:53:54 EST 2013;Committer;nobu;1;0;2;2;0
839ae05e0cc3cfe9ecc7d1bcb6b4bb5b48a7231b;Fri Feb 22 02:37:51 EST 2013;Committer;nobu;1;55;36;91;0
20fa73249505ef1c8ecc2892be75daa2f5b2368a;Fri Feb 22 02:36:48 EST 2013;Committer;nobu;2;17;0;17;0
b9ef804fb8616ae6b7d1fe2ec0fd9eb7a2026055;Fri Feb 22 02:33:44 EST 2013;Committer;nobu;2;6;1;7;0
d2c218d559d7137f440933f29ca77d1ae65485b8;Fri Feb 22 02:11:26 EST 2013;Committer;zzak;2;32;29;61;0
8d4a11c919abf90c0283b56c758d993a79ea4753;Fri Feb 22 02:01:28 EST 2013;Committer;zzak;2;23;9;32;0
d0a4131709edc8d3fda4ab6d0212b26856213c8b;Fri Feb 22 00:05:55 EST 2013;Committer;nobu;1;4;2;6;0
cc367fb32689bf94a20c136519d537660084ae56;Fri Feb 22 00:05:51 EST 2013;Committer;nobu;1;1;1;2;0
ac4da20aa3e991a68ad4f49f6816c7652c3422fd;Thu Feb 21 22:05:09 EST 2013;Committer;drbrain;3;11;0;11;0
6b88b523f4f7e35ca685a838b751c1a70608948f;Thu Feb 21 21:31:09 EST 2013;Committer;drbrain;2;12;2;14;0
9c49b69d3eac7b19c60b3aacd00c687781c6c797;Thu Feb 21 21:27:25 EST 2013;Committer;drbrain;2;13;3;16;0
374001735559d2061bbb251b48d47ca160a60f78;Thu Feb 21 17:39:00 EST 2013;Committer;zzak;1;1;1;2;0
7ceb188443d1ff9cf7df916cba42f29025273698;Thu Feb 21 17:35:32 EST 2013;Committer;zzak;2;7;2;9;0
254dc20a470ed6516838741afa876557f0f5a9f2;Thu Feb 21 15:18:15 EST 2013;Committer;svn;1;2;2;4;0
14ffaac408f740efc91d064ea5c4dbd755d8d2af;Thu Feb 21 15:18:10 EST 2013;Committer;nagachika;1;1;1;2;0
e525bcd1b3723e91311d67262b1aa726cc9b0104;Thu Feb 21 08:31:47 EST 2013;Committer;naruse;2;14;2;16;0
45dcceaa71a64af9cf5209ed6989511bdd753ca1;Thu Feb 21 08:31:45 EST 2013;Committer;naruse;2;9;0;9;0
087e888a1535d814670e4299d04482bae6e8caf1;Thu Feb 21 07:34:53 EST 2013;Committer;nobu;2;25;15;40;0
7355c6d9c99d7636c9acbd262149f72d1f900d9f;Thu Feb 21 05:18:38 EST 2013;Committer;kosaki;2;31;10;41;0
8a9dc061f5737543eaca17ceafa6ebe4886cb26e;Thu Feb 21 04:52:38 EST 2013;Committer;kosaki;2;8;1;9;0
e93a68abfa10a7eba1fd769b6cbc55da7796f8e8;Thu Feb 21 04:41:39 EST 2013;Committer;kosaki;4;10;5;15;0
1cda6e3968b7245b302b20898ac02db3a6289309;Thu Feb 21 04:41:23 EST 2013;Committer;kosaki;2;11;9;20;0
ba37db04533cec102212605488989c5d02bea67f;Thu Feb 21 04:41:11 EST 2013;Committer;kosaki;2;11;2;13;0
7c465090fd976fe6892a8ec64b036fa0696e3723;Thu Feb 21 04:40:58 EST 2013;Committer;kosaki;3;43;23;66;0
74016f1842e1c741faf14a5c07988112dc4978fa;Thu Feb 21 03:45:07 EST 2013;Committer;nobu;3;27;6;33;0
739c8ffcee36f8e6df4a55fbfaf8a4e015e6c44a;Thu Feb 21 03:42:25 EST 2013;Committer;nobu;3;19;19;38;0
cb71fee8d95d106d3be3c924b1fdac877d14c607;Thu Feb 21 00:51:18 EST 2013;Committer;svn;1;2;2;4;0
22b51faf7edad433d7528eef5c0f4bb55dedeb84;Thu Feb 21 00:51:11 EST 2013;Committer;nobu;3;12;2;14;0
e908adc12a522d8e9ded0bf9b552f1335ac92c29;Wed Feb 20 12:49:43 EST 2013;Committer;nobu;2;54;0;54;0
fc50b60cb7a7df79a2a8267c0cac5ca6f7fa0b58;Wed Feb 20 12:34:20 EST 2013;Committer;nobu;1;1;1;2;0
9041f262e006b3b0c80c47991023bdf68fbab43d;Wed Feb 20 12:06:13 EST 2013;Committer;nobu;1;15;15;30;0
ffdb70a696725aa89df70d7bffb72d59b943bc78;Wed Feb 20 12:06:10 EST 2013;Committer;nobu;1;7;6;13;0
57bccfa900147723b0888baf5f388d927087819d;Wed Feb 20 10:27:04 EST 2013;Committer;nobu;2;8;0;8;0
52911974f8f1a9d975d63ad606f5a7ebc5b19c01;Wed Feb 20 09:02:28 EST 2013;Committer;nobu;2;5;1;6;0
67ab6e3d9bea6f8279bf50fab3a3174f23eeaca6;Wed Feb 20 09:01:17 EST 2013;Committer;nobu;3;9;1;10;0
206d1c890720dc73ac236495b821c6585e7e1228;Wed Feb 20 04:37:35 EST 2013;Committer;zzak;2;78;61;139;0
c7bb7974100c27cfbb9da2d126ec02a29851c127;Wed Feb 20 03:19:01 EST 2013;Committer;zzak;2;11;0;11;0
4b81b403eb606adbdc1c0126a46d0ed269076fa5;Wed Feb 20 03:15:32 EST 2013;Committer;nobu;2;14;5;19;0
2d112d2c78d510641d66ec22a12eca90d350a689;Wed Feb 20 02:51:51 EST 2013;Committer;zzak;2;41;21;62;0
75eb6cc98ed3c6862769e839941c27591da2d700;Wed Feb 20 00:34:58 EST 2013;Committer;drbrain;3;30;1;31;0
cd8ef79d22f7e21bdae622634657aef5a8845640;Tue Feb 19 22:51:38 EST 2013;Committer;drbrain;2;8;1;9;0
b6cdc43976f4dfbd0650f3c5d0414e0ffae72d9e;Tue Feb 19 16:19:18 EST 2013;Committer;svn;1;2;2;4;0
92abfccaa37ca9359f043078246a51261181b415;Tue Feb 19 16:19:13 EST 2013;Committer;eregon;1;1;1;2;0
c42cf83f26309b0cba46917f79d20d680e667054;Tue Feb 19 11:50:48 EST 2013;Committer;mrkn;2;7;2;9;0
7ffd5405bd5a11e0e11c95742f238d7686fdefeb;Tue Feb 19 04:40:40 EST 2013;Committer;kazu;1;2;2;4;0
e38972354acc3b3195b0bb639cce305cd2f97b0c;Tue Feb 19 04:13:57 EST 2013;Committer;knu;2;6;1;7;0
1955ac9e820f4f42debe889643104cce8cc3cacc;Tue Feb 19 03:49:37 EST 2013;Committer;nobu;1;1;0;1;0
a168db1cb28311cd5d4d38964ae778116285c3c6;Tue Feb 19 03:49:35 EST 2013;Committer;nobu;1;1;0;1;0
bbd9223f6047a44badab1dbab6c1ef1aecb2280a;Tue Feb 19 03:49:32 EST 2013;Committer;nobu;1;0;5;5;0
281e6e1b3be1a5415a51cfd80757f004d4e12e78;Tue Feb 19 03:32:11 EST 2013;Committer;zzak;3;13;2;15;0
2163738ffb01c5891f8e1d441811b8b3b50261bb;Tue Feb 19 01:36:30 EST 2013;Committer;drbrain;2;30;18;48;0
b043b0592bf284dc53555b7e6d0238a3796da45e;Tue Feb 19 01:27:33 EST 2013;Committer;drbrain;2;26;11;37;0
cc16b2139b50ae00e44c672bdf6c932da630d007;Mon Feb 18 23:53:41 EST 2013;Committer;ko1;2;26;8;34;0
aec0735f6dd816174fde5a33a6e2eb48c9c6abe4;Mon Feb 18 23:15:49 EST 2013;Committer;drbrain;3;25;0;25;0
10103e8cc7ce82027b5e96b7a5793ed4c27567b9;Mon Feb 18 21:46:00 EST 2013;Committer;naruse;1;10;10;20;0
52b01813066b68ec826e96c6db02a91df8f7f1fd;Mon Feb 18 21:21:05 EST 2013;Committer;svn;1;2;2;4;0
0b261c379bddc9772321e1ca2a79e5073b6ee4b5;Mon Feb 18 21:21:02 EST 2013;Committer;naruse;3;16;13;29;0
e233ca15e02aeae3d6db60421bec5509d65991c6;Mon Feb 18 21:20:59 EST 2013;Committer;naruse;3;68;0;68;0
a16c76f7c5dbab7d630f87d0327be79b91725d6b;Mon Feb 18 07:31:17 EST 2013;Committer;knu;2;6;1;7;0
7d63004fce9e05af0f1c91f991888e6bc7814ee2;Mon Feb 18 03:45:21 EST 2013;Committer;knu;2;13;1;14;0
e8c57cd850860d0b24e328761669166b8a6212d1;Mon Feb 18 01:49:14 EST 2013;Committer;nobu;1;1;0;1;0
3f1a33450441b00f026c287857a1e547e0a48ea7;Mon Feb 18 01:49:11 EST 2013;Committer;nobu;1;2;1;3;0
46cdc66f84b933cce2495f31e1210829d2cddceb;Mon Feb 18 01:11:58 EST 2013;Committer;nobu;3;7;3;10;0
97ef7189dd257fa81280b206ca482f4a08bac331;Mon Feb 18 01:10:02 EST 2013;Committer;svn;1;2;2;4;0
f8530342f4faca241b305fb2da3e6dd094e385c6;Mon Feb 18 01:09:56 EST 2013;Committer;nobu;2;30;0;30;0
c4d41074868afbf18c5a1750eb06617027140598;Sun Feb 17 12:46:45 EST 2013;Committer;naruse;2;0;26;26;0
44c5c2a3120439af7560f9694dcb117953ee3119;Sun Feb 17 11:55:50 EST 2013;Committer;nobu;6;40;12;52;0
c9283b5c5dd1253bbfa340b34e40dcd57da377db;Sun Feb 17 09:41:31 EST 2013;Committer;nobu;1;0;2;2;0
1264600d5ce3ef597ad56308ff760a5948161c00;Sun Feb 17 08:23:25 EST 2013;Committer;nobu;2;7;1;8;0
17b898e182de3f40ed6fba7dacb44711f7f63f8e;Sun Feb 17 07:57:43 EST 2013;Committer;nobu;2;26;0;26;0
e2bd72d524e363219e110c7f55e29f9e3114cc98;Sun Feb 17 07:56:57 EST 2013;Committer;nobu;1;1;1;2;0
91696db42d631c8feae71cc763dcb5abd2a8074e;Sat Feb 16 16:25:59 EST 2013;Committer;zzak;1;1;1;2;0
e39caa7550adf888e2e1a1ab7c75fd17c96df1d6;Sat Feb 16 16:19:46 EST 2013;Committer;zzak;2;7;0;7;0
25575b7cd716b0ee04a6f0f253884b913a49d6c8;Sat Feb 16 16:11:00 EST 2013;Committer;svn;1;2;2;4;0
16d775d94e172a8cf869b1fe84f10e90d8d324dc;Sat Feb 16 16:10:55 EST 2013;Committer;naruse;2;8;1;9;0
11498d9b1e7913dbbca27336ba22f88c52a5cfe2;Sat Feb 16 12:11:37 EST 2013;Committer;ktsj;1;1;1;2;0
16aedfe0a04432e9912dd4c8c662c5e416c67af9;Sat Feb 16 11:58:33 EST 2013;Committer;ktsj;2;5;1;6;0
b38334e2ec11ffdd8b2d37bb77167bcc7fedbfe9;Sat Feb 16 11:52:12 EST 2013;Committer;knu;2;12;4;16;0
75a5be3717d15c468beccab2ba618b01f44d56ec;Sat Feb 16 11:44:42 EST 2013;Committer;akr;3;27;3;30;0
1061371f29baabd89c60d2d364947015b928d794;Sat Feb 16 11:14:23 EST 2013;Committer;ayumin;2;7;2;9;0
b4add2ac2be49677b05402bf236c7e547949e0a8;Sat Feb 16 07:41:55 EST 2013;Committer;ko1;3;34;1;35;0
7cbeff908fb75f82b08b2e7eeaed937167eef2d6;Sat Feb 16 06:51:17 EST 2013;Committer;ko1;3;57;2;59;0
3d490d209aaa9b6ae57748dba2a5782be4aeeaf8;Sat Feb 16 05:46:06 EST 2013;Committer;nobu;1;108;93;201;0
bb7e19c8e9ca34991dedbe2da84db5605cc80834;Sat Feb 16 04:40:17 EST 2013;Committer;nobu;2;7;1;8;0
78b50f26dc14fddeeafae5121b6cd97be735680d;Sat Feb 16 04:13:07 EST 2013;Committer;nobu;2;6;2;8;0
923b8c4eda557c4ccad9d3e5859afcd4705c1fc0;Sat Feb 16 04:00:33 EST 2013;Committer;nobu;1;3;0;3;0
2a62ca666c97d5e1dd1e841b70eeee0ac7798ca3;Sat Feb 16 03:58:04 EST 2013;Committer;nobu;1;1;1;2;0
6ba2001d72c05c59bb973d7934c324263552b5c9;Sat Feb 16 03:47:21 EST 2013;Committer;nobu;3;11;1;12;0
44c24d4416a9c3f36010dcf0593e5dce21183d19;Sat Feb 16 03:46:34 EST 2013;Committer;nobu;3;46;3;49;0
62711da25352ac195013e0b81cd6343f8f39b9b5;Sat Feb 16 03:45:53 EST 2013;Committer;nobu;2;20;3;23;0
53f97f1c278d2ea22a614682cd47c3ac61e57ef5;Sat Feb 16 03:16:05 EST 2013;Committer;tenderlove;3;22;0;22;0
733d65df5e0ca8e415dd87caeb881e074d64f8ee;Sat Feb 16 00:59:24 EST 2013;Committer;akr;2;6;1;7;0
4b5b88ec7985ea043a0552e4bf43f5c6c61b2028;Sat Feb 16 00:25:54 EST 2013;Committer;akr;2;10;5;15;0
d6d0e853206535c76443b0cc03989885c964aa6e;Fri Feb 15 23:46:44 EST 2013;Committer;akr;3;10;1;11;0
899ba99b9061850c2f0c40a2bcf76a0c17eae2a9;Fri Feb 15 22:59:40 EST 2013;Committer;akr;3;10;1;11;0
35f8072e5c9a17d364f88df72f0751f894689931;Fri Feb 15 22:53:59 EST 2013;Committer;akr;1;74;70;144;0
cb31e783798438420e33a84a8bfe66acafaa7c4a;Fri Feb 15 22:19:05 EST 2013;Committer;akr;6;43;13;56;0
84a525bc4e47c33c07cc135e6e77df1369375042;Fri Feb 15 22:08:25 EST 2013;Committer;akr;3;13;4;17;0
cd63b84ce9199874816833e8023c9b21c3465869;Fri Feb 15 19:23:50 EST 2013;Committer;usa;2;6;1;7;0
49a009bbce0941067f9bdaf01a1391fb3cef7c4e;Fri Feb 15 15:20:38 EST 2013;Committer;svn;1;2;2;4;0
41b2a6f01bcf97c33ebae6ef7c524e76808752b9;Fri Feb 15 15:20:34 EST 2013;Committer;akr;2;50;49;99;0
aeac90e6c5e9e3e30fafdb7cdc9c5c569fc6516b;Fri Feb 15 13:25:28 EST 2013;Committer;knu;2;19;2;21;0
e41b789c9980e2ae4bdb9d320a498e8529524dec;Fri Feb 15 11:30:19 EST 2013;Committer;akr;3;27;2;29;0
140934c6611e77d7c1e0ce9f30e8861a20cc32ca;Fri Feb 15 09:31:16 EST 2013;Committer;nobu;1;2;1;3;0
b0488c5bb1a251be6163fda15f00c97ff7028b0d;Fri Feb 15 09:24:50 EST 2013;Committer;nobu;2;6;0;6;0
66c1e7960ccd1320e2121ed356538a674493e083;Fri Feb 15 07:54:38 EST 2013;Committer;nobu;4;11;11;22;0
a60e2e58206c779929a29fe0dd6d73cab4031487;Fri Feb 15 03:36:05 EST 2013;Committer;akr;3;9;1;10;0
0cc9cea3b4606cbb8c51118c447067245b79c68c;Fri Feb 15 03:27:05 EST 2013;Committer;akr;2;6;1;7;0
1ff7108306f63b1f5cc9b0ed2d376f5a1f99bdf4;Thu Feb 14 23:14:22 EST 2013;Committer;akr;5;27;19;46;0
dfbb5b677c1b293e0177bc99b2d7dcf24e87453d;Thu Feb 14 22:49:48 EST 2013;Committer;drbrain;3;8;2;10;0
4faef960f2e198fd3158bcaf7e37b015c9a6e7a2;Thu Feb 14 22:08:28 EST 2013;Committer;akr;2;6;24;30;0
e4b775882d8eb458342a827c9decc68db63c10eb;Thu Feb 14 20:01:37 EST 2013;Committer;kosaki;2;8;0;8;0
09faab67fb80a4c3e8fab354bf545d70370e4b23;Thu Feb 14 15:17:54 EST 2013;Committer;svn;1;2;2;4;0
792cfa3fd0251f3b9fd8993a16b5948bd852e6da;Thu Feb 14 15:17:49 EST 2013;Committer;akr;4;20;3;23;0
93c819aa716c96f4963155af7ca9bc02e93f087f;Thu Feb 14 14:46:43 EST 2013;Committer;kazu;1;3;3;6;0
1cc445fbbfaede329c0b656075201c684cbd66da;Thu Feb 14 13:27:46 EST 2013;Committer;akr;2;52;33;85;0
18a8046d1c76209449f11207ba1140d4a6c28a1b;Thu Feb 14 11:28:49 EST 2013;Committer;akr;7;66;29;95;0
64db9dcbd5451f5f3ad4ef69662311a7cbb44a95;Thu Feb 14 05:32:58 EST 2013;Committer;drbrain;4;13;4;17;0
632ab19c4ddfdd7bf73adf0215e488382f02bb1a;Thu Feb 14 02:08:31 EST 2013;Committer;nobu;3;19;3;22;0
bd255c46866f4599ab787d4748f768bbfa5842b0;Thu Feb 14 01:38:07 EST 2013;Committer;nobu;2;2;2;4;0
01e43fb0e23c2c0c89454945a71db733fbf77409;Thu Feb 14 01:30:47 EST 2013;Committer;nobu;3;24;3;27;0
8c5a6fb6843b865f2b1fb622037f312daa7be6a7;Thu Feb 14 01:09:37 EST 2013;Committer;drbrain;1;1;0;1;0
f58d39807541d8f50ba682183ab9097ddcb52698;Thu Feb 14 01:08:19 EST 2013;Committer;drbrain;7;104;0;104;0
d266423f8709cb121630cb6e3f403736dbf8ff25;Wed Feb 13 23:20:31 EST 2013;Committer;svn;1;2;2;4;0
ed193c50f52635923840991b8847211846a018f9;Wed Feb 13 23:20:27 EST 2013;Committer;akr;5;14;12;26;0
eb4ae6bc542cdec0ade408c2f5ddfebba227d30f;Wed Feb 13 14:41:28 EST 2013;Committer;akr;1;2;2;4;0
22a04e572036276261121d1e80da5ec1a96e4e17;Wed Feb 13 12:01:24 EST 2013;Committer;akr;3;11;3;14;0
4b7514527870f3e7268846ee9fb275301f57b30a;Wed Feb 13 09:38:49 EST 2013;Committer;nobu;3;33;0;33;0
aae1d28b6f33d1237e576317497d22158114f103;Wed Feb 13 09:12:04 EST 2013;Committer;nobu;3;24;1;25;0
d40ef8a85c271c3570e778fb74f53d6401281a9d;Wed Feb 13 09:10:12 EST 2013;Committer;nobu;3;21;1;22;0
4e5d0cee76dc263549958e2f08ea010a5cbd79b4;Wed Feb 13 08:56:42 EST 2013;Committer;nobu;2;15;1;16;0
391d69112374bb3635175f6b0031e3c59e39c54c;Wed Feb 13 08:51:27 EST 2013;Committer;nobu;1;10;12;22;0
dfd0cbece066cd992981607524426b36050cfb2c;Wed Feb 13 08:51:25 EST 2013;Committer;nobu;1;6;15;21;0
9f2e85a33c47493b2c58a98ab890ae1ee86b453a;Wed Feb 13 01:34:35 EST 2013;Committer;nobu;1;2;4;6;0
7266d24aa0e1289fe45de79d87bda0051bb75b85;Tue Feb 12 21:06:36 EST 2013;Committer;drbrain;3;39;1;40;0
d1691db91ee27148445189e173ab1f1f500e533d;Tue Feb 12 20:51:24 EST 2013;Committer;svn;1;2;2;4;0
d7923c82791b4c0274f6d194c6c0e711eed75a46;Tue Feb 12 20:51:19 EST 2013;Committer;akr;2;143;134;277;0
caa0e40f4dcd7d113eda3f2a24d62685510f0a16;Tue Feb 12 03:22:33 EST 2013;Committer;naruse;1;43;35;78;0
edacc7d236b87ab3a53a5812967a8fd75d61cd09;Tue Feb 12 03:18:04 EST 2013;Committer;naruse;1;2;1;3;0
062d2ee6f798205c3046730d0d348cfd0d0bc09d;Tue Feb 12 03:05:45 EST 2013;Committer;naruse;20;269;99;368;0
f1194eb9b08b7c7be39e168c1f9620e377bee472;Mon Feb 11 16:40:52 EST 2013;Committer;svn;1;2;2;4;0
17df736379b7279c2df49bb35251526b40363715;Mon Feb 11 16:40:47 EST 2013;Committer;akr;1;1;0;1;0
cbacc5d5018f752128d9b2e2566aac27784e7cde;Mon Feb 11 14:26:01 EST 2013;Committer;akr;2;8;1;9;0
c586d820c83e64966733f994299083f067dac73f;Mon Feb 11 11:07:32 EST 2013;Committer;akr;2;5;1;6;0
a378fa0d10a8de3b8a25a0633345de2241283730;Mon Feb 11 07:08:41 EST 2013;Committer;akr;2;5;1;6;0
0d467210333b666eb04eb40d9aa50d8a7b82387e;Mon Feb 11 04:17:22 EST 2013;Committer;nobu;4;23;9;32;0
507477af54fe3d0a088cc63fa85a02dd72ea9812;Mon Feb 11 04:15:14 EST 2013;Committer;nobu;3;48;2;50;0
f882c4c5e09fb5a6f78a8c04ce2dc2a69573db93;Mon Feb 11 03:33:11 EST 2013;Committer;akr;2;190;184;374;0
798e32a198a664064f22b2e98e14233035731bfd;Mon Feb 11 02:06:52 EST 2013;Committer;svn;1;2;2;4;0
0a8fc937ca838ad63511eddff6893b047e40d14a;Mon Feb 11 02:06:47 EST 2013;Committer;akr;2;28;23;51;0
c799b11273f5c82b750b98612ae0e07bfff1ce7e;Sun Feb 10 14:43:00 EST 2013;Committer;akr;2;26;21;47;0
5b057eeff2c42178ecae22173c8e931cad9622b1;Sun Feb 10 11:58:53 EST 2013;Committer;akr;2;26;21;47;0
6f278350b383681d0675c9b3a8f3fba6e74cf573;Sun Feb 10 07:10:56 EST 2013;Committer;zzak;1;7;1;8;0
d5077115dedc383ac39b92b591cdacb3166b2084;Sun Feb 10 07:02:13 EST 2013;Committer;zzak;3;23;1;24;0
5d1d6543102de8841b232063d07b1df313c92f00;Sun Feb 10 06:51:53 EST 2013;Committer;kosaki;1;2;2;4;0
bbc9fd5720a0512f861308e47a5c49a891d1b282;Sun Feb 10 06:39:30 EST 2013;Committer;nobu;1;1;1;2;0
ab42c8f739c8bbe5c853a1b23e7e3bfbbd4ac5fe;Sun Feb 10 06:27:23 EST 2013;Committer;zzak;5;194;216;410;0
dd7a64d1000f39622e63fa11254879a1841decd2;Sun Feb 10 06:13:46 EST 2013;Committer;kosaki;1;1;1;2;0
0531a076603eb9fd031d7c28574238866dfe8082;Sun Feb 10 05:41:12 EST 2013;Committer;kosaki;2;6;1;7;0
08c11c23cb809b49d443486ea677f3cb7f1db857;Sun Feb 10 05:41:01 EST 2013;Committer;kosaki;2;6;2;8;0
2bfa96ec848f9c8e27006776be17e2f818e58761;Sun Feb 10 05:26:34 EST 2013;Committer;zzak;11;1128;1124;2252;0
a00c92f7fc5bb4b3f50e600da1280f0ed456bb22;Sun Feb 10 04:14:51 EST 2013;Committer;akr;1;8;0;8;0
474e3cd2a72ab359b6a55a64539333ca65d51022;Sun Feb 10 03:29:37 EST 2013;Committer;akr;1;3;3;6;0
1ab6dccf4bfb4b8e3c05dbac4180c2d44d653d25;Sun Feb 10 03:11:00 EST 2013;Committer;akr;2;24;16;40;0
20c05cdef09b834dfa1373966a00e0afdf4dfa41;Sun Feb 10 03:00:36 EST 2013;Committer;zzak;18;4;2030;2034;0
3952de50bf8e410a5a1ce929b98dbe42a9ab40f3;Sun Feb 10 00:10:11 EST 2013;Committer;zzak;3;256;45;301;0
cf2da37701897a31951f1b83667ab5575606c297;Sat Feb 09 16:44:56 EST 2013;Committer;naruse;1;1;1;2;0
649820fdb4453b82fabf48c4a4e4c3e3ba4f469d;Sat Feb 09 15:16:19 EST 2013;Committer;svn;1;2;2;4;0
41dbe74b94d1794cb6896daee5348e2d7b266da0;Sat Feb 09 15:16:15 EST 2013;Committer;nobu;3;7;3;10;0
817dff033f14d2e96f9841847f300e3af3ebba2d;Sat Feb 09 14:50:03 EST 2013;Committer;nobu;1;1;2;3;0
e8bc7180bafe0971e86b503f88357be0ac51e4cd;Sat Feb 09 13:39:22 EST 2013;Committer;nobu;1;2;2;4;0
c38f3cd906a40dd6dff9576525621e72c6890e30;Sat Feb 09 13:13:01 EST 2013;Committer;akr;2;32;15;47;0
c4544321cbab43afe53fb65c1f7e41f02309e64a;Sat Feb 09 08:46:02 EST 2013;Committer;nobu;3;9;0;9;0
8a91512692dea480c3486ce8cf138bd831f1fb57;Sat Feb 09 08:38:46 EST 2013;Committer;nobu;2;9;5;14;0
0b24985d49d0dd737d42fc26f9ac80d7c2d77d61;Sat Feb 09 07:27:19 EST 2013;Committer;kazu;1;2;2;4;0
810516ed20967a69b801b518ef2b2c0dc4184824;Sat Feb 09 04:14:09 EST 2013;Committer;zzak;2;37;19;56;0
d48f539cfbc174e92546eb790856e03ab2194f61;Sat Feb 09 01:12:30 EST 2013;Committer;ktsj;2;5;1;6;0
7f046c653c63e455d208c77b6611c7027ec8447b;Sat Feb 09 00:24:55 EST 2013;Committer;drbrain;4;31;6;37;0
35a5e37649ab76db7d42104fc0c709dce2f7f35a;Fri Feb 08 16:27:23 EST 2013;Committer;svn;1;2;2;4;0
b7d8d0321c8d8eeb69cb6f1027e29e04c4726db8;Fri Feb 08 16:27:17 EST 2013;Committer;akr;3;12;0;12;0
01e7ec0137dce8d9269b26b9ae63c8679a7b5de9;Fri Feb 08 14:30:10 EST 2013;Committer;akr;1;0;1;1;0
513bfb29eae0aee2a7c0eed8527a19405dfdeed8;Fri Feb 08 14:26:13 EST 2013;Committer;akr;2;11;2;13;0
89ae338e97ab64a6c9af6726369e6cdc1b7db211;Fri Feb 08 12:20:27 EST 2013;Committer;akr;2;13;0;13;0
123a3a486cb03275566115530d3f0289cf67924b;Fri Feb 08 11:28:03 EST 2013;Committer;akr;1;1;1;2;0
450a515e959d2a35d6e1a59bad0a83db2a7698da;Fri Feb 08 10:58:35 EST 2013;Committer;usa;3;6;9;15;0
98932f5150c2e6e26976c9e20b34d79c645e6593;Fri Feb 08 07:09:48 EST 2013;Committer;nobu;4;66;0;66;0
49c5a3da6f7d17cb7864eebc564533754725c31d;Fri Feb 08 07:08:32 EST 2013;Committer;nobu;2;10;2;12;0
70fc27b7facb8c73580428450989b66425c08177;Fri Feb 08 04:12:56 EST 2013;Committer;drbrain;4;31;13;44;0
d2be12ef6171f75a074aca8caaeaf834e1f2aac8;Fri Feb 08 02:58:19 EST 2013;Committer;drbrain;3;101;6;107;0
16f6500cb2f81a66e831dd9d878ff56e81f1ab43;Fri Feb 08 02:09:32 EST 2013;Committer;nobu;1;2;2;4;0
cc9a5a40898cf1ef8b9c22ba932bdb5f6b2cf006;Fri Feb 08 02:09:30 EST 2013;Committer;nobu;1;1;1;2;0
b3cd19971b5ffd729af3ac27c7dc31fccd4d705e;Fri Feb 08 02:09:27 EST 2013;Committer;nobu;1;1;0;1;0
c5d1d12977c17895cb5fbbbd3cb7a51367b90eac;Fri Feb 08 01:58:59 EST 2013;Committer;drbrain;2;12;2;14;0
8bb45796c87603fe2a70885dfea3a3622f4104a5;Fri Feb 08 01:15:54 EST 2013;Committer;drbrain;3;15;7;22;0
978c0f0f0408dbdb5f0d3707157a304187161236;Fri Feb 08 00:35:20 EST 2013;Committer;nobu;2;10;3;13;0
7fd6f82fe1ccc7dbaf839ccc19560eea3109a35a;Fri Feb 08 00:26:53 EST 2013;Committer;nobu;1;1;1;2;0
f79876e194bb44a302a205ef5a91ad951a56e376;Thu Feb 07 23:58:42 EST 2013;Committer;drbrain;2;19;3;22;0
1c836f811c7f7e2cd29e2bab68f0780e10bb0767;Thu Feb 07 23:54:29 EST 2013;Committer;tenderlove;4;28;11;39;0
7a68f53dc6f710b8aeb4ebe91961c29d1ad85e5f;Thu Feb 07 23:52:01 EST 2013;Committer;tenderlove;2;34;5;39;0
a75922010fe38f48c08c744456dd92cb755e1119;Thu Feb 07 22:48:35 EST 2013;Committer;drbrain;3;68;0;68;0
45bcf5d46f19a8b5c26a89eef91e875eb6d05062;Thu Feb 07 22:35:25 EST 2013;Committer;zzak;2;7;2;9;0
e798251a8a3697e7da9b0b0a26ffa06111fedf45;Thu Feb 07 22:33:32 EST 2013;Committer;zzak;2;8;0;8;0
bab42629ebff81cf5d8117f91bd536b3b2ac4a48;Thu Feb 07 22:17:08 EST 2013;Committer;drbrain;3;34;1;35;0
972041696f8fd9506e4e0355ed1df04f78591035;Thu Feb 07 16:03:13 EST 2013;Committer;nagachika;1;1;1;2;0
876b0d27d3fd7bc413c71204e17be1f320887a1f;Thu Feb 07 15:07:42 EST 2013;Committer;svn;1;2;2;4;0
9b0a7f493e216e45a3408bdd4612e9045561385f;Thu Feb 07 15:07:35 EST 2013;Committer;akr;2;27;10;37;0
8f5f89452d6301db24b1bb2ff7f0f09e245f4596;Thu Feb 07 13:02:31 EST 2013;Committer;akr;2;5;1;6;0
ba7a0b46434162b80932fef71279b5c16fdf1306;Thu Feb 07 12:20:56 EST 2013;Committer;nobu;1;2;1;3;0
7d2725493e577c28cea7080d3e514d0ac111df10;Thu Feb 07 12:11:19 EST 2013;Committer;usa;2;8;0;8;0
2314a8fc4f033e6b5def315ddb9b30256df6f2e0;Thu Feb 07 11:55:14 EST 2013;Committer;usa;2;16;0;16;0
67e07672042118f4c206c0f4d17e1e1a5ec5d1b7;Thu Feb 07 08:02:31 EST 2013;Committer;nobu;1;1;1;2;0
c206b802db10cb4dc55fa460e959bb15c04f2272;Thu Feb 07 07:21:33 EST 2013;Committer;nobu;1;2;0;2;0
26aae7740f27722c9860201850580d3b105e48c6;Thu Feb 07 07:21:30 EST 2013;Committer;nobu;1;2;1;3;0
13b11810e289bc7b946e9c6eac7d1348107f0eda;Thu Feb 07 06:33:22 EST 2013;Committer;nobu;3;29;8;37;0
fd0c338df7348b7a482f0fc135505aade7908933;Thu Feb 07 06:32:12 EST 2013;Committer;nobu;1;69;0;69;0
c27fd3331989b33b9721444c98e77ba367a65270;Thu Feb 07 05:56:53 EST 2013;Committer;drbrain;6;165;43;208;0
38f04d823150ac6e454d66a39fcfef00e3ad7239;Thu Feb 07 01:20:39 EST 2013;Committer;nobu;1;1;1;2;0
46761cdb9858e4f9cd93bdfe8e82670b21d5ef17;Thu Feb 07 01:07:22 EST 2013;Committer;nobu;1;2;0;2;0
cbb86ec6fe234f2d6188980ff1854026822cea10;Thu Feb 07 01:05:50 EST 2013;Committer;nobu;1;1;1;2;0
90eb265f8686a5ea14cf6c745600361300b84e4f;Wed Feb 06 20:51:56 EST 2013;Committer;zzak;3;18;84;102;0
6851ad4756b676fa114e17bc805bc92bb6656caa;Wed Feb 06 17:31:22 EST 2013;Committer;marcandre;3;23;6;29;0
4f74d59be995694a271b1a1a8e7bb45573db2c6d;Wed Feb 06 17:16:39 EST 2013;Committer;zzak;1;1;1;2;0
efcc536b1dfb8c1b96c994b9f1c2f43ef7a57788;Wed Feb 06 16:35:19 EST 2013;Committer;svn;1;2;2;4;0
a99dc84165d21963800aa5a48cd1c05ee7b6d5cc;Wed Feb 06 16:35:15 EST 2013;Committer;zzak;2;6;0;6;0
a493ec0388b07052d315b86bc794f5bac946a6d3;Wed Feb 06 14:31:32 EST 2013;Committer;zzak;3;26;23;49;0
e45e06410dd36e313ea3456ba406e31f66034a2e;Wed Feb 06 13:46:26 EST 2013;Committer;charliesome;2;7;0;7;0
834fd50ae2953505c454c56342a42da441ccb22f;Wed Feb 06 08:33:03 EST 2013;Committer;nobu;3;34;8;42;0
67db06ba972a1fc99d5942e0d96ee6f0662a0e55;Wed Feb 06 08:32:58 EST 2013;Committer;nobu;4;28;4;32;0
29c214e4a058fc4017ab0c0bf5c36b5bad203b5b;Wed Feb 06 08:32:53 EST 2013;Committer;nobu;5;69;26;95;0
d32b122996778828f5d5f2ea58b0d2a8c0da7ede;Wed Feb 06 08:32:48 EST 2013;Committer;nobu;3;8;2;10;0
85aae4c658cd515a02fcc646fa1d1d67aed2c2c6;Wed Feb 06 08:32:43 EST 2013;Committer;nobu;3;28;19;47;0
a8795e35272b12ba2251baafe862e757497d3106;Wed Feb 06 08:32:38 EST 2013;Committer;nobu;2;53;47;100;0
6d0647c3508b381e3dec2616faca75d2fd338088;Wed Feb 06 08:05:44 EST 2013;Committer;drbrain;3;14;8;22;0
b99c3e74a186858f545bc9973821769f168546a8;Wed Feb 06 07:47:45 EST 2013;Committer;nobu;1;1;1;2;0
6cd1e11d01036df2856aff996984d276a602a7cf;Wed Feb 06 06:37:28 EST 2013;Committer;kosaki;2;14;7;21;0
88903e23dd4ec7e58fe3ffb0070ec7fdcd0d6b8f;Wed Feb 06 06:37:18 EST 2013;Committer;kosaki;2;13;0;13;0
42b1337551b7f9692457ee52f57f5c873e854b55;Wed Feb 06 05:25:40 EST 2013;Committer;marcandre;1;1;1;2;0
6eb76ba664a7ea1dc2b6804a0f2280e1f7531c53;Wed Feb 06 04:35:23 EST 2013;Committer;nobu;4;54;7;61;0
fe072cef25054cce460c92408f3f8fe9cb2b5c0d;Wed Feb 06 04:03:39 EST 2013;Committer;zzak;2;7;0;7;0
a77af99a66dc05fc7f3baacb27e4d997cc1cd036;Wed Feb 06 03:49:59 EST 2013;Committer;zzak;2;8;0;8;0
4ce8ede2032b40e7b6479be2ab9cd30cab085429;Wed Feb 06 03:39:59 EST 2013;Committer;marcandre;1;13;4;17;0
5e9648be88dfbbb22f00f7c0ad2686c835bb467f;Wed Feb 06 02:17:23 EST 2013;Committer;nobu;1;7;1;8;0
585af39c5b8d2c4a86b6594d0cf596e3da4dfbef;Wed Feb 06 00:33:15 EST 2013;Committer;nobu;1;18;18;36;0
50cdfe2d51a43dc826fca357787336f89d9ae971;Wed Feb 06 00:30:19 EST 2013;Committer;nobu;1;1;1;2;0
ee074d4b6c9dd8615963e06b905610e7eba3d23f;Tue Feb 05 21:06:14 EST 2013;Committer;zzak;1;1;1;2;0
dfb30ef5357d7518a7badd7b67984f1287f094e3;Tue Feb 05 20:58:01 EST 2013;Committer;zzak;2;6;2;8;0
afea6f4706e5ea681fe6a6bc347abbe698427ac1;Tue Feb 05 20:52:28 EST 2013;Committer;zzak;9;82;6652;6734;0
55f11348c3ba5129f9d4c6cd266e8fd9a02fd912;Tue Feb 05 18:44:46 EST 2013;Committer;zzak;2;5;20;25;0
b614d7823c4d3dcb263577127db5e7e333573a4e;Tue Feb 05 18:28:26 EST 2013;Committer;jeg2;4;20;302;322;0
3221e7d29ca5911437f6d2bd733d5022c7050a72;Tue Feb 05 16:50:54 EST 2013;Committer;zzak;1;1;0;1;0
5b15e5a38fb3963cffb3c795883d6fc141031251;Tue Feb 05 15:57:19 EST 2013;Committer;zzak;2;4;10;14;0
1e32d0fc1f0a86d9aafaa003e2dd28cda66d56c1;Tue Feb 05 15:55:47 EST 2013;Committer;svn;1;2;2;4;0
ca016c705fbe58d254daaaacc123a70c78caadcb;Tue Feb 05 15:55:41 EST 2013;Committer;ktsj;3;24;4;28;0
81f9052c11ea4ae1aa0323c1727a1aa91e7d9161;Tue Feb 05 09:49:09 EST 2013;Committer;charliesome;2;63;5;68;0
bd5efa7ff6e790a07c8eaa6221e9f063d5e3e3b0;Tue Feb 05 08:24:20 EST 2013;Committer;drbrain;3;26;16;42;0
627a08251c2b2dab312307c0e9c51774c34ef016;Tue Feb 05 07:37:16 EST 2013;Committer;drbrain;2;7;0;7;0
a106b310e5bbe678022b127b9d32bb0a55708002;Tue Feb 05 07:25:27 EST 2013;Committer;nobu;3;35;1;36;0
8efeb603fee5ad417d1fad69be41228458a78b75;Tue Feb 05 06:24:16 EST 2013;Committer;nobu;1;1;1;2;0
88101695ab516ce30f930513150c1247ebc6c36d;Tue Feb 05 06:04:59 EST 2013;Committer;ko1;6;59;5;64;0
757bbe8737305c13ff8885f7acb81b2ec588de4e;Tue Feb 05 05:52:39 EST 2013;Committer;marcandre;1;0;57;57;0
9a912c66d4f720e90c3522d40ac29c04dbd86a9b;Tue Feb 05 05:43:36 EST 2013;Committer;marcandre;2;10;6;16;0
d22ce4a522141c2f6e847846944ddc1ec3a949f2;Tue Feb 05 05:39:49 EST 2013;Committer;marcandre;3;36;12;48;0
8797ebd662954c96a25bac1648279431a3a378a8;Tue Feb 05 05:39:33 EST 2013;Committer;marcandre;2;66;0;66;0
075ae2955cc34980005a3bd3327049d28d1c1a25;Tue Feb 05 05:39:16 EST 2013;Committer;marcandre;1;1;1;2;0
55f0fa5a7a97fea1a41f5e56c8cd50dea0cb73f9;Tue Feb 05 04:45:23 EST 2013;Committer;nobu;1;8;1;9;0
490f1fc00979b6fb2cd45bf01544e79e9d9ea66c;Tue Feb 05 04:27:57 EST 2013;Committer;nobu;3;24;8;32;0
e29e4b55ab79bd18550b11ce7d9cf94deca365be;Tue Feb 05 03:51:09 EST 2013;Committer;marcandre;3;14;2;16;0
1677cbce9d7c72cca83d1b7d48cb85a17e74abcc;Tue Feb 05 03:49:59 EST 2013;Committer;marcandre;5;43;13;56;0
44cd5f21e9d06ccc09ba8e12fb53d64f0df059a3;Tue Feb 05 03:49:41 EST 2013;Committer;marcandre;3;140;90;230;0
5af821c6e93256cbc66d5d31c6ccb2e9aaae3dfa;Tue Feb 05 03:49:22 EST 2013;Committer;marcandre;1;36;14;50;0
1633e543db2cc5c1f690840e5e7ea1f2a9af0b55;Tue Feb 05 02:37:35 EST 2013;Committer;drbrain;15;274;92;366;0
6dfd56696fb49310149dc5ed7af52c8d7f43e536;Tue Feb 05 01:18:22 EST 2013;Committer;zzak;2;66;20;86;0
47da37b0a0e57bbf3574f2dc8e27c435437b6e4e;Tue Feb 05 01:14:52 EST 2013;Committer;zzak;2;6;1;7;0
c50b328829bad17c83bd3d74a2766999b1c93e70;Tue Feb 05 01:01:14 EST 2013;Committer;zzak;2;27;14;41;0
941ea3713f5b20bc18dcb62037bbffa35d781588;Tue Feb 05 00:56:11 EST 2013;Committer;zzak;3;420;13;433;0
f11ff34d8f89b5cd10099554c20ee53ac02f30f6;Mon Feb 04 23:04:09 EST 2013;Committer;zzak;3;24;0;24;0
e195e181e6f2bfd3c0386300688cd1270780f37c;Mon Feb 04 22:36:22 EST 2013;Committer;zzak;3;37;6;43;0
9cfc40ab96a17304dc836fdc9a807ab85dde2917;Mon Feb 04 20:20:23 EST 2013;Committer;zzak;3;132;93;225;0
53bc349069de17584e20aeef601b407d5ef74794;Mon Feb 04 19:39:15 EST 2013;Committer;zzak;2;6;2;8;0
f691d4a55468485b848120ff3edbd127791783ca;Mon Feb 04 17:59:58 EST 2013;Committer;svn;1;2;2;4;0
2a97015041f7276a84eba777da301c926bd9630d;Mon Feb 04 17:59:52 EST 2013;Committer;zzak;2;21;21;42;0
d06141cde7402ee6003a59a7a47650d3f642f4b0;Mon Feb 04 12:23:51 EST 2013;Committer;nobu;1;1;1;2;0
1a15c3770e7979e70cc6ca1a82f1e3458a90c3b4;Mon Feb 04 12:15:32 EST 2013;Committer;nobu;1;1;1;2;0
36ed400fe3b2eb2a8755e25e7ea8f93e60fd6b37;Mon Feb 04 12:09:16 EST 2013;Committer;nobu;1;3;1;4;0
a9cbe8c7219759aace315c7671bbb1681d0ae4b0;Mon Feb 04 06:19:40 EST 2013;Committer;nobu;1;7;9;16;0
523292d61294d4496c593ad530eb520b469c0f02;Mon Feb 04 06:10:12 EST 2013;Committer;nobu;2;7;0;7;0
4cb4c929df1ed1b86f3aec90ff7cb954db9a9021;Mon Feb 04 03:46:12 EST 2013;Committer;ko1;2;6;1;7;0
9e5167c3518b8a3aef7a69305bb79ef4d7892d41;Mon Feb 04 02:50:20 EST 2013;Committer;nobu;1;1;2;3;0
e7d6a0481bcac20f5466f9d8fbdb5098bd2ab40a;Mon Feb 04 00:16:40 EST 2013;Committer;kazu;1;1;1;2;0
6d32920e418db2016cb0870d171271e36168aece;Sun Feb 03 19:21:37 EST 2013;Committer;zzak;2;38;1;39;0
63bedf5d654527ee18517a3260594b556a2b7809;Sun Feb 03 17:40:35 EST 2013;Committer;svn;1;2;2;4;0
110a545d3f9161162eb358bd9323accb8b0b135b;Sun Feb 03 17:40:30 EST 2013;Committer;zzak;2;22;3;25;0
80455c0d97ccf7dddaaeb871a118e3637760f91f;Sun Feb 03 08:22:43 EST 2013;Committer;nobu;1;2;2;4;0
b3d12956b49c2d085eccb90ada1eb3d98e836ac7;Sun Feb 03 07:54:29 EST 2013;Committer;nobu;3;11;2;13;0
b381a662fec9ebfede4807277cb149063efd5dbe;Sun Feb 03 07:54:24 EST 2013;Committer;nobu;2;13;4;17;0
f050b2232711c162ee380ba61ddb8554cb4f7719;Sun Feb 03 07:54:18 EST 2013;Committer;nobu;3;38;2;40;0
cac38cd0a6984ae97a93de335c4388418e12437f;Sun Feb 03 07:14:44 EST 2013;Committer;charliesome;2;68;0;68;0
ec720303179b9ddf0c4762d17ed34d22e9ad170e;Sun Feb 03 01:25:57 EST 2013;Committer;zzak;2;10;3;13;0
a954def1fbc9630ebd6f9f31e6cb9cf4b3c36ba8;Sun Feb 03 00:59:51 EST 2013;Committer;zzak;2;79;0;79;0
9ed4d1ab8ca3bcf10cd57144768176235a06dbf4;Sun Feb 03 00:38:46 EST 2013;Committer;nobu;2;6;3;9;0
0d7a19717506a017ed2a17bb5917e335b5499e0d;Sun Feb 03 00:37:30 EST 2013;Committer;svn;1;2;2;4;0
f87614d7a8a637f673c93f9621374d3faeb936f3;Sun Feb 03 00:37:26 EST 2013;Committer;nobu;2;26;21;47;0
f5b8e90a930df3161b0dca06fdb4c9fcad6cd50c;Sat Feb 02 05:32:46 EST 2013;Committer;zzak;3;6;2;8;0
32e754c8d46afab4090b5971dda6b4e491d04bd2;Sat Feb 02 05:04:54 EST 2013;Committer;zzak;2;17;0;17;0
e91fb5eb6f5ccef0e4903b78e76626366b8a7ffa;Sat Feb 02 04:37:45 EST 2013;Committer;zzak;2;5;3;8;0
94839d4a80e62fdc8a60ddd4d4648228a9541fe5;Sat Feb 02 04:32:25 EST 2013;Committer;zzak;2;7;5;12;0
1d23123c46caafa039343a1da0b5e8fb25f49f93;Sat Feb 02 04:13:33 EST 2013;Committer;mame;2;7;1;8;0
7dc77be29960a965363a55d33feb537bf55aee7e;Sat Feb 02 03:54:00 EST 2013;Committer;mame;3;38;2;40;0
87d3c2d6d47e36223d7a6cccf1991b72dc307865;Sat Feb 02 03:31:56 EST 2013;Committer;zzak;2;5;1;6;0
a60a562ca782b9ceb81f6ef2297521d9479cac2b;Sat Feb 02 03:18:40 EST 2013;Committer;mame;2;8;8;16;0
8b54e050f92311017bc42508636237fecde5cf84;Sat Feb 02 03:09:01 EST 2013;Committer;mame;1;6;1;7;0
4077b9b89dc1f139775774e59705677e54712cba;Sat Feb 02 03:07:17 EST 2013;Committer;mame;3;35;3;38;0
2ae0c4c44bda180ec75ce8e571840e8b9667a7e5;Sat Feb 02 02:47:33 EST 2013;Committer;mame;2;9;5;14;0
d127e92b8595618a2df2c3c28efc346624e42193;Sat Feb 02 01:21:09 EST 2013;Committer;ktsj;2;6;0;6;0
f810d1804a7e1c2dbdb2d4d6c0406674a1912ea3;Fri Feb 01 22:46:32 EST 2013;Committer;marcandre;3;18;10;28;0
83610815d4ec34b3d5528aa8dbc6c4a475c7ed92;Fri Feb 01 22:46:07 EST 2013;Committer;marcandre;3;83;34;117;0
4b4d889fe00e31ca3107648c6f9c3cad3b74e2a9;Fri Feb 01 15:46:15 EST 2013;Committer;svn;1;2;2;4;0
ba5ff937c39b4f295316bb1a75dc2de516180f3c;Fri Feb 01 15:46:10 EST 2013;Committer;charliesome;2;22;4;26;0
86aa98fed4de1be2e868877fd786d3616d6c6ad5;Fri Feb 01 14:05:49 EST 2013;Committer;charliesome;3;15;1;16;0
3fe939564fc5f4dde52a6b9bc385e558e3423256;Fri Feb 01 07:35:37 EST 2013;Committer;nobu;3;28;1;29;0
46ea3f65551e2467bdd4d6c8bd0c78644c955326;Fri Feb 01 05:37:29 EST 2013;Committer;shugo;3;7;7;14;0
8df20dd70b39f01ddd8521ceebbacf7488e3e056;Fri Feb 01 00:47:54 EST 2013;Committer;svn;1;3;3;6;0
c58d8c30cef8f2d7fa35b26cf5f97fedb5d48fee;Fri Feb 01 00:47:49 EST 2013;Committer;kazu;1;1;1;2;0
f8823475d9fea9f03273ad307a5d20014b1f2cc6;Thu Jan 31 12:55:37 EST 2013;Committer;charliesome;2;10;0;10;0
20af032e82226d672d7d0f158a42e6118e8ee3fa;Thu Jan 31 07:33:30 EST 2013;Committer;nobu;3;8;1;9;0
b10e6b69a5e0a66a8406587fa03321131b5e6612;Thu Jan 31 07:08:23 EST 2013;Committer;kosaki;2;6;1;7;0
e56c7878cfa6e0d68cfaf931ec6d106b6468f88d;Thu Jan 31 06:38:43 EST 2013;Committer;zzak;2;7;1;8;0
625119a348df10aeed28b203a873a27f23fbac75;Thu Jan 31 04:59:36 EST 2013;Committer;svn;1;2;2;4;0
4ccfb2743f38d54eeecc5a229b3a8edf2eb84f3c;Thu Jan 31 04:59:31 EST 2013;Committer;shugo;4;46;4;50;0
1ff38a5bbf2baa5fa6646fffdc81ed3611be805b;Wed Jan 30 12:01:51 EST 2013;Committer;akr;4;32;0;32;0
111b86142280d3257021d142fce1317b44c1b850;Wed Jan 30 08:08:23 EST 2013;Committer;nobu;2;6;1;7;0
e16b8482c724f89bbf599185d2592f134bac8b45;Wed Jan 30 06:30:12 EST 2013;Committer;shugo;3;16;1;17;0
5efb130d3900dfb7fc577050eb5a6ef1c22eb78c;Wed Jan 30 06:21:33 EST 2013;Committer;nobu;3;20;10;30;0
e449d06f15a7b65b8f8bb1441dcad7c35f707b1f;Wed Jan 30 06:20:26 EST 2013;Committer;nobu;2;11;7;18;0
69adf990e1d05603b43c6da660870ea5b9ecef49;Wed Jan 30 06:07:29 EST 2013;Committer;marcandre;2;2;2;4;0
a7938af19c540c0f3bbd631889d936c2b0d5707b;Wed Jan 30 06:01:40 EST 2013;Committer;marcandre;2;2;2;4;0
20c0fb69d65f20d42caf980de042396370dd0ba4;Wed Jan 30 06:00:24 EST 2013;Committer;marcandre;5;30;7;37;0
00d6bb5108209329996c8062ce3e947489c38ea7;Wed Jan 30 05:46:48 EST 2013;Committer;marcandre;3;27;5;32;0
39048aca7592a4096380f45f421bad578b61efb8;Wed Jan 30 05:11:03 EST 2013;Committer;marcandre;5;25;0;25;0
ddea0c823239d2eb9b699dc00adf6b0963913d27;Wed Jan 30 04:53:58 EST 2013;Committer;marcandre;2;6;1;7;0
71eddb1dea82226a31540de2982ddfc0288cbbf4;Wed Jan 30 04:22:12 EST 2013;Committer;nobu;3;9;1;10;0
29707c1d73f35c15d118ea5ca2330e85ac475dd6;Wed Jan 30 04:17:59 EST 2013;Committer;nobu;3;31;0;31;0
3df94d7b5d7129d50443b77f869835b958423fd5;Tue Jan 29 22:15:23 EST 2013;Committer;marcandre;3;14;6;20;0
c34e9f23aa2b6909e92623710e91cd99eaff2dc3;Tue Jan 29 22:00:58 EST 2013;Committer;marcandre;4;21;2;23;0
115a51f8ec4972d6a1b4000b50536b1a64a1888e;Tue Jan 29 22:00:36 EST 2013;Committer;marcandre;2;147;159;306;0
996ff1324246012490add29ee4e56ad66fac04d2;Tue Jan 29 18:58:41 EST 2013;Committer;svn;1;2;2;4;0
bca544340ba26fcfd6a70cfd53917929b349218e;Tue Jan 29 18:58:37 EST 2013;Committer;marcandre;1;1;1;2;0
64dbc10b5fea27c9b0ac35a0b06c0b04be617fab;Tue Jan 29 12:41:56 EST 2013;Committer;akr;2;6;0;6;0
d5b7fc432f0c07dbebb070ef6af17b7d5db6c066;Tue Jan 29 10:32:27 EST 2013;Committer;eregon;2;13;3;16;0
18a8812e365f493d9de13d28ae0c1ad85c1ab838;Tue Jan 29 09:30:37 EST 2013;Committer;nobu;3;3;3;6;0
e3f88ac44d5068049e6dce1aa21ddb1ad30b24a4;Tue Jan 29 08:58:04 EST 2013;Committer;nobu;1;19;11;30;0
18e01f63816ec36d10b8d958b8298b73950dd89f;Tue Jan 29 08:25:32 EST 2013;Committer;ko1;10;204;17;221;0
499ca89e24c47cfada7e493a7dfd81cdb9323a45;Tue Jan 29 07:51:00 EST 2013;Committer;nobu;3;26;3;29;0
e26c2bc21baac04ab52bff4eeedd9f41e4cb1f31;Tue Jan 29 07:50:27 EST 2013;Committer;nobu;3;43;0;43;0
b0c4ac77799fdf60a489f9e735158647c630865a;Tue Jan 29 07:49:22 EST 2013;Committer;nobu;6;98;1;99;0
2d55537dce5fde5e3581351bd274ecabf1e284d7;Tue Jan 29 03:06:40 EST 2013;Committer;akr;4;13;1;14;0
1d15bbdae507d8631a58ff32f5fb43986c8fa86e;Tue Jan 29 00:58:55 EST 2013;Committer;nobu;1;0;5;5;0
ae0478355905890fa096971f3f612956eaae68da;Tue Jan 29 00:32:10 EST 2013;Committer;svn;1;2;2;4;0
a1ed445b812d8aa335700c0bda5e3bd70cc33d20;Tue Jan 29 00:32:05 EST 2013;Committer;shugo;3;14;5;19;0
616f2c43c6e3693957cbecfbfbf9134163c88ef8;Mon Jan 28 09:02:19 EST 2013;Committer;nobu;3;19;9;28;0
43ce5ce1b46707bdd0e5a8a3a7b536530da6d7fa;Mon Jan 28 08:51:41 EST 2013;Committer;nobu;2;14;5;19;0
ea632a6daabfc9acb01186a860ac9e66d6206bab;Mon Jan 28 03:34:50 EST 2013;Committer;svn;1;2;2;4;0
8477d3131c1dadc79e5646533baa471278be7ee2;Mon Jan 28 03:34:43 EST 2013;Committer;akr;2;16;5;21;0
b2ca2c58f15948629f16ccd763e70fcd5f85a124;Sun Jan 27 13:13:12 EST 2013;Committer;nobu;1;1;1;2;0
d10cea5010ee88cd4039908a3d02b10b79f01ea1;Sun Jan 27 04:04:26 EST 2013;Committer;nobu;1;15;15;30;0
ad1715f0b9802ddf23e83232661c7b67d2a0a7d6;Sun Jan 27 04:04:23 EST 2013;Committer;nobu;1;25;5;30;0
dbf8e164cea4dd8e8c99c223620f75af2ac627ce;Sat Jan 26 19:18:23 EST 2013;Committer;svn;1;2;2;4;0
888ccebbb0ea989347379791fd7cc56dc4e47427;Sat Jan 26 19:18:13 EST 2013;Committer;marcandre;1;2;2;4;0
a8d4b22c58ca7a2bb375f7689743bb342605c784;Sat Jan 26 13:48:15 EST 2013;Committer;kazu;1;1;1;2;0
3d0786a3a80932e99a63497597770fbb94401653;Sat Jan 26 13:39:15 EST 2013;Committer;nobu;5;32;2;34;0
68d131d6a50898dc605a739caa76b494b65c6393;Sat Jan 26 09:51:34 EST 2013;Committer;nari;1;2;2;4;0
2eae39e05bdf313cc0317f5073982777d32809b4;Sat Jan 26 07:12:15 EST 2013;Committer;suke;1;1;1;2;0
623f6d667336f864ba0870640b8406f4a16dc57a;Sat Jan 26 04:36:14 EST 2013;Committer;drbrain;2;123;65;188;0
0051369ba3eff58cb734795543d7ca894b621d05;Sat Jan 26 03:58:33 EST 2013;Committer;drbrain;5;100;11;111;0
6048f9a6cf5bc650da33124a5889a3160422f58d;Sat Jan 26 02:31:43 EST 2013;Committer;nobu;1;1;1;2;0
a110d1782ef8a1f42654906248d5a0ba960dd0b7;Sat Jan 26 02:31:40 EST 2013;Committer;nobu;1;24;0;24;0
28afe277a8e543da0e6353bdacbcad0b69739e06;Sat Jan 26 01:12:54 EST 2013;Committer;drbrain;23;837;83;920;0
89232d1dd97251b6fc626d4338c49e9e8c4f6535;Fri Jan 25 23:36:42 EST 2013;Committer;tenderlove;1;1;2;3;0
07e9f122a96c59e97020e077baf382f98582d872;Fri Jan 25 23:33:50 EST 2013;Committer;shugo;4;10;4;14;0
6b36e95851a230fd73665ca75d68b126f7b2d6e5;Fri Jan 25 17:15:10 EST 2013;Committer;svn;1;2;2;4;0
0dddb4b32895e46c31bbad363bafc5a5bfcd7c45;Fri Jan 25 17:15:05 EST 2013;Committer;kosaki;2;11;1;12;0
57408cb1d1c56a85ff72e6cc192e72d37cfbbe7e;Fri Jan 25 10:17:59 EST 2013;Committer;suke;2;7;1;8;0
ad55d141ebd0922be310b66c8e4c0e81e94521d1;Fri Jan 25 08:15:26 EST 2013;Committer;shugo;6;92;10;102;0
76ade818ae8bc3bc72979e5fa880add04b165636;Fri Jan 25 04:02:46 EST 2013;Committer;drbrain;3;200;19;219;0
90e69dfdaf0b603f3adef052274a4a73bde6e901;Fri Jan 25 03:25:39 EST 2013;Committer;drbrain;11;124;17;141;0
d50bd4939a79bb53aeaf8c607e3d6612d3167022;Fri Jan 25 03:03:50 EST 2013;Committer;ko1;2;6;1;7;0
8a77b4780ebdcf1ecbcf0b46bf007055d6d74b55;Fri Jan 25 01:39:39 EST 2013;Committer;nobu;1;2;2;4;0
8cc69387e0ad01de1bdf685413364799c61ff18b;Fri Jan 25 01:37:34 EST 2013;Committer;nobu;1;18;8;26;0
c8a4d4b071d8689678711c0711daf64ba1c8015e;Fri Jan 25 01:37:06 EST 2013;Committer;drbrain;2;68;2;70;0
5e3ebde7c8dc9f6fff12a8f69e73aa0ff5ba0556;Fri Jan 25 01:04:18 EST 2013;Committer;drbrain;4;17;0;17;0
e2d341d9e529fbf6e63264c851d7a9a4a89c3406;Fri Jan 25 00:15:14 EST 2013;Committer;svn;1;2;2;4;0
2d579c00745e342db294a4a4afb547c85ceac05c;Fri Jan 25 00:15:08 EST 2013;Committer;drbrain;4;59;9;68;0
f1ef3d600d5b0a8253dc5d6585f0607f2f23f515;Thu Jan 24 10:56:47 EST 2013;Committer;sorah;2;6;0;6;0
dbcf20069a559142ee7c96aa0e8288b4e8b001fa;Thu Jan 24 07:54:45 EST 2013;Committer;drbrain;3;32;1;33;0
96af5360a4089daf90743ad4722e77eff2261145;Thu Jan 24 07:51:05 EST 2013;Committer;marcandre;3;12;2;14;0
aab2f788d784ef73dd088f7cc6e258672da0ae59;Thu Jan 24 07:50:33 EST 2013;Committer;marcandre;3;16;0;16;0
1af390b1ea11acd00558e8d86d23d17d328e580d;Thu Jan 24 07:05:42 EST 2013;Committer;marcandre;3;54;3;57;0
cc6e6de22f08a857174813cc90e8e378c71fbef9;Thu Jan 24 06:55:24 EST 2013;Committer;nobu;2;3;2;5;0
41d6ba8765f0d856ce5cca293531f717b068ee3f;Thu Jan 24 06:24:22 EST 2013;Committer;marcandre;3;28;9;37;0
9d94a1a5a18f80974e017cb81790a08dad84faef;Thu Jan 24 06:23:42 EST 2013;Committer;marcandre;2;15;7;22;0
bcbeb5d008c1e91454b7f2c2d0e1d7b4735006e2;Thu Jan 24 06:23:07 EST 2013;Committer;marcandre;2;12;9;21;0
de0e88763561e4a5ee6be87dd6eee524ccf9c391;Thu Jan 24 06:22:34 EST 2013;Committer;marcandre;2;27;7;34;0
892e8efd47343925b76cd12da965109f084a1817;Thu Jan 24 05:35:05 EST 2013;Committer;nari;2;2;3;5;0
ded754f33d89a0ae2f5fdbc567ea18639e28eb33;Thu Jan 24 04:20:33 EST 2013;Committer;naruse;1;3;3;6;0
b5c0c4ee08196e5f6d7767e49012a13d66965f57;Thu Jan 24 03:08:00 EST 2013;Committer;nari;1;2;1;3;0
2ad0113746def243f84283bc4b7a4a24443a3946;Thu Jan 24 03:03:49 EST 2013;Committer;naruse;1;3;2;5;0
8ad15646889383f5546922bc5bb6f3f5a7391dfa;Thu Jan 24 02:50:23 EST 2013;Committer;nari;2;6;0;6;0
cef8eae85dac5e32735a43302aa02964da3651c2;Thu Jan 24 01:28:47 EST 2013;Committer;drbrain;2;17;4;21;0
30a9931bbc96a3ccda672a2cfb0ed0cd883d7c18;Thu Jan 24 00:40:49 EST 2013;Committer;drbrain;3;249;0;249;0
f031aec4233d7a6d4622c048abed3e86eb5dd6c2;Wed Jan 23 20:05:42 EST 2013;Committer;marcandre;1;10;0;10;0
ce0ed2e04e822510e9de5ecc0308d145fd32b65d;Wed Jan 23 20:05:26 EST 2013;Committer;svn;1;2;2;4;0
884a6552b79e8f50e0a41cf1047068354f87cc6d;Wed Jan 23 20:05:21 EST 2013;Committer;marcandre;1;1;1;2;0
2d9c37a895c11d921eb1527559059727895d9fc1;Wed Jan 23 07:29:15 EST 2013;Committer;nobu;2;8;2;10;0
894f6ba7f1237965ae02719140c8710e56b83784;Wed Jan 23 07:18:06 EST 2013;Committer;nobu;3;13;7;20;0
5d223fabb78ea5718eb3931f0d84a6d3df6fa014;Wed Jan 23 07:18:01 EST 2013;Committer;nobu;3;29;3;32;0
e8c229510eefb3ba2a195493119cee859f1b7634;Wed Jan 23 07:16:16 EST 2013;Committer;nobu;2;23;0;23;0
e5481ccd8e6470b05d0c8a202103dc307c4aa25f;Wed Jan 23 04:39:02 EST 2013;Committer;ko1;2;28;0;28;0
fa30ebc3c7536e0e766abbe52c24b732f83ad3b4;Wed Jan 23 03:28:25 EST 2013;Committer;nobu;2;21;8;29;0
596ed9c781ca9e9e6b381cd19b7616513e756ff5;Wed Jan 23 01:41:37 EST 2013;Committer;drbrain;2;12;4;16;0
27841296538ece9c149d85da72c9234ad08556d2;Wed Jan 23 01:35:16 EST 2013;Committer;drbrain;2;12;1;13;0
98b82acf6f18176b932b6145bb2bf3a21022a67d;Wed Jan 23 01:20:44 EST 2013;Committer;drbrain;2;6;1;7;0
5864dbc9f16ea388f0038669c86ac79f2a0ac432;Wed Jan 23 01:02:24 EST 2013;Committer;drbrain;13;110;12;122;0
95548d9dc32238fc2134ceefb7efd8450fe793d7;Tue Jan 22 21:43:50 EST 2013;Committer;svn;1;2;2;4;0
4cdb64316cc89c6a4b2be2ddafda46aaf87fc36b;Tue Jan 22 21:43:44 EST 2013;Committer;drbrain;2;18;2;20;0
ddb9c34d16093723b961bf33eb2b62f20655a38e;Tue Jan 22 14:12:42 EST 2013;Committer;knu;1;2;1;3;0
9545483ad3b5fcc414dcdd681aca5cbb778ff858;Tue Jan 22 14:05:40 EST 2013;Committer;knu;2;10;8;18;0
7d6f22f4cd287aa89a4fe714f05abed7d91eb6a6;Tue Jan 22 02:35:52 EST 2013;Committer;svn;1;2;2;4;0
b536e31faac5121f44ab0b53a901a6e7784bce59;Tue Jan 22 02:35:48 EST 2013;Committer;naruse;1;8;8;16;0
385ef8e5c24b0e28ef88346725380c7e26bf427a;Mon Jan 21 06:41:38 EST 2013;Committer;nobu;3;7;3;10;0
c7d3039187c03fc3378aa7fd983bd629eac794e9;Mon Jan 21 04:53:43 EST 2013;Committer;nobu;1;2;2;4;0
5e031bbc74afb4665961fbae187a9540f963aad7;Mon Jan 21 04:51:30 EST 2013;Committer;svn;1;2;2;4;0
d78a00cc0ccc69f8e27f8e415506837d0c9f5592;Mon Jan 21 04:51:24 EST 2013;Committer;nobu;2;13;3;16;0
433999fd5c82a8925baf312155351252320a44ce;Sun Jan 20 14:55:42 EST 2013;Committer;nobu;2;28;67;95;0
51e5863aa883ed2d5d5ee12d107e29d4154d89d1;Sun Jan 20 13:25:58 EST 2013;Committer;nobu;1;7;3;10;0
c6699319417c244ad6dce99b608ddd4635f5bdbc;Sun Jan 20 13:24:31 EST 2013;Committer;nobu;5;12;4;16;0
8d83736f0c7ae9fed8ae4e19768fa035bb734cac;Sun Jan 20 01:19:49 EST 2013;Committer;svn;1;2;2;4;0
8208e9872a20cc6a0da9bd199fe1187c38b7c0d3;Sun Jan 20 01:19:44 EST 2013;Committer;nobu;1;6;4;10;0
eed593eba6a18a71d876ac49178aeeb0aad6b7c0;Sat Jan 19 02:37:01 EST 2013;Committer;zzak;2;19;3;22;0
b7ae472b58f0bb47754b0db975fe74359c2d4b0f;Sat Jan 19 00:52:57 EST 2013;Committer;drbrain;2;34;0;34;0
1ecaf599ff22d6102dde5b76699d78ec13758d88;Sat Jan 19 00:27:45 EST 2013;Committer;drbrain;2;17;1;18;0
6ff1653cf6dc03d9ca5698c2247c8bb50e8bfd95;Sat Jan 19 00:16:08 EST 2013;Committer;drbrain;4;16;5;21;0
672da11abfae089bee49ec7f286f2d540edad721;Fri Jan 18 23:47:56 EST 2013;Committer;svn;1;2;2;4;0
d9d981b94011fdf6c311b963916528545e5245da;Fri Jan 18 23:47:51 EST 2013;Committer;drbrain;2;443;0;443;0
6f9bbca2dfabace0c641ed1e7a9647d34a9794a5;Fri Jan 18 09:14:11 EST 2013;Committer;nobu;1;1;1;2;0
1d5a5c235fe2af8cda21ca8224a139391dc4c211;Fri Jan 18 05:15:44 EST 2013;Committer;drbrain;2;65;0;65;0
7a9bbf31fd6fd88a7d2b83046808101eede7831b;Fri Jan 18 05:02:07 EST 2013;Committer;nobu;1;0;1;1;0
3b5ba5df173f04fde0bacde7dd196d57528bda80;Fri Jan 18 03:54:24 EST 2013;Committer;nobu;2;8;1;9;0
090d20fc16dbb91a816ee9a94c426da56dd1fbc2;Fri Jan 18 02:29:59 EST 2013;Committer;nobu;1;0;7;7;0
27ed294c7134c0de582007af3c915a635a6506cd;Fri Jan 18 02:24:35 EST 2013;Committer;nobu;2;17;1;18;0
588504b20f5cc880ad51827b93e571e32446e5db;Fri Jan 18 02:23:37 EST 2013;Committer;nobu;3;29;29;58;0
6a052813d013679a75469762d290e63d2efbc61c;Fri Jan 18 02:18:35 EST 2013;Committer;svn;1;2;2;4;0
750a5d38a6d8f4d22606a693bc807605869e9a79;Fri Jan 18 02:18:31 EST 2013;Committer;nobu;1;7;0;7;0
aaff971e017e0cf6edf37c4ec265ede3d04c686f;Thu Jan 17 13:20:12 EST 2013;Committer;kou;3;38;0;38;0
53ec135d45e298b296c58cd39d7782781cf4e525;Thu Jan 17 12:09:44 EST 2013;Committer;kou;2;5;1;6;0
3a50fb15d00aed9debc95bfb2db40553b4570174;Thu Jan 17 11:28:52 EST 2013;Committer;eregon;2;6;1;7;0
03d19637f61873cb86caf7311d2b3bf2757c9a8d;Thu Jan 17 08:50:12 EST 2013;Committer;nobu;1;2;1;3;0
a23469f4b6d3395c3d8feeef5f34b082751676df;Thu Jan 17 08:50:09 EST 2013;Committer;nobu;1;0;6;6;0
70c647b8c50106f15687b3e665f3d907ea8d61dd;Thu Jan 17 05:06:28 EST 2013;Committer;nobu;1;17;15;32;0
679a646e377340177666688c2d6baa3e0bbb140b;Thu Jan 17 01:49:55 EST 2013;Committer;tenderlove;2;8;3;11;0
66013dc6d071f432fc6a1902f8e0d16abb08aa5a;Thu Jan 17 01:21:28 EST 2013;Committer;drbrain;2;21;0;21;0
219e1566876c2a6996b88728eb558691d5c77459;Thu Jan 17 00:37:28 EST 2013;Committer;drbrain;5;40;1;41;0
1be8ac57abca95de2525c9b56fb51e9c8a802660;Thu Jan 17 00:08:53 EST 2013;Committer;drbrain;2;25;0;25;0
1eb9f71c3ae41182a08cd965340854f116354827;Wed Jan 16 23:36:46 EST 2013;Committer;drbrain;4;83;2;85;0
038c535e18549740c34d63efc3326c8e12379317;Wed Jan 16 22:50:54 EST 2013;Committer;drbrain;2;64;0;64;0
9ceb50972fb43acd0f714243fda3761dc2f6ab6e;Wed Jan 16 22:00:02 EST 2013;Committer;drbrain;2;6;1;7;0
93b115346fbdef42aeebe35ef7e9243e4c29eaec;Wed Jan 16 21:54:45 EST 2013;Committer;svn;1;2;2;4;0
d86ee14c5a25a32d5705740b0154d6b6e415cebc;Wed Jan 16 21:54:31 EST 2013;Committer;drbrain;2;6;1;7;0
0c61c3b67b548ab73b54e795efc4bb1b7d8e19b9;Wed Jan 16 09:45:48 EST 2013;Committer;nobu;3;27;23;50;0
2d59c39978481cc5ae5a90eaa6c585488eb7a306;Wed Jan 16 09:43:11 EST 2013;Committer;nobu;1;18;18;36;0
063cdaeddc8f3ff65a6e112b3b60482fb4e04d31;Wed Jan 16 05:30:20 EST 2013;Committer;naruse;1;1;4;5;0
247d51a44fc21bd2298b0c01fde6080e5de7cb33;Wed Jan 16 00:36:07 EST 2013;Committer;drbrain;7;19;3;22;0
a06f22f915a20ef3c35bae9addd4f718d8c4c8c2;Tue Jan 15 18:54:54 EST 2013;Committer;drbrain;2;44;22;66;0
4cf9fa309d0f561f9dacaeebffa7dee9d6f40f01;Tue Jan 15 18:29:05 EST 2013;Committer;drbrain;3;12;1;13;0
8113321482debca4d4bfd77af8941a106a3350fd;Tue Jan 15 18:15:12 EST 2013;Committer;drbrain;4;23;5;28;0
4b8bb0f95fe3fb9205b1d995470797fe87975915;Tue Jan 15 18:06:35 EST 2013;Committer;svn;1;2;2;4;0
d902101b32c4efb487559ab91a48cb1fe28f1ae9;Tue Jan 15 18:06:24 EST 2013;Committer;drbrain;3;28;0;28;0
eaab306b59c4a1905b67ff989339938d8ab67fe9;Tue Jan 15 14:12:36 EST 2013;Committer;nobu;2;7;1;8;0
d2a176028f2975f305ff06ca6984e68f7cd022fe;Tue Jan 15 14:07:24 EST 2013;Committer;nobu;1;10;20;30;0
e4ebf6d946ad4dcf21a4db1c2dc75dde28f58b92;Tue Jan 15 14:07:22 EST 2013;Committer;nobu;1;1;2;3;0
a16c576fac23463da89d56025c4aca73f705ee33;Tue Jan 15 14:07:20 EST 2013;Committer;nobu;1;2;0;2;0
330e39d5684d0b4f5b2565eaf6d991185be2ebf0;Tue Jan 15 14:07:17 EST 2013;Committer;nobu;1;4;0;4;0
e70e46a1be711b1bacee43b1922601cb2aa377e5;Tue Jan 15 13:42:09 EST 2013;Committer;keiju;2;7;1;8;0
e071e13068a92c367a87f529926997657c309ce3;Tue Jan 15 06:55:43 EST 2013;Committer;drbrain;2;404;0;404;0
68b072bfbabdcd78b4d7980c15ab83163ecbacd3;Tue Jan 15 04:33:28 EST 2013;Committer;drbrain;3;150;1;151;0
108f3acbe41ec2de5164109ee80377fe31951e08;Tue Jan 15 02:49:54 EST 2013;Committer;drbrain;2;37;0;37;0
ec2bdfc7635e98a7f694cc8f67d5b4a0d8fc83bc;Tue Jan 15 02:48:49 EST 2013;Committer;drbrain;2;197;13;210;0
8892cc5a8fbdc91c375f9b3b81051e153aefc268;Tue Jan 15 01:40:29 EST 2013;Committer;marcandre;2;5;1;6;0
bd407329df45d84b57fd74329882823d224aecc1;Tue Jan 15 00:59:19 EST 2013;Committer;nobu;3;18;2;20;0
cccd464e4d8f84dda8d8c65e825232cd52b8b5b4;Tue Jan 15 00:59:16 EST 2013;Committer;nobu;1;2;2;4;0
e32ce1868f62070663a13813b132a2bb0cf5f147;Tue Jan 15 00:32:23 EST 2013;Committer;kosaki;2;7;0;7;0
17bc951fc53e51469f39ff78fd40cad50daea278;Tue Jan 15 00:29:56 EST 2013;Committer;drbrain;2;12;2;14;0
eeee1908824cd0ebaf8ea6c4a2019be887b280ed;Tue Jan 15 00:11:46 EST 2013;Committer;drbrain;2;38;17;55;0
c3319d991ae708b1c209b7089f0c29fe404e47d0;Mon Jan 14 23:56:47 EST 2013;Committer;drbrain;2;153;0;153;0
7cd5800f1263d467fc220f2770ce190f10165f07;Mon Jan 14 22:43:28 EST 2013;Committer;svn;1;2;2;4;0
c8633294c63ce3dcc9f80ec3b8afb30982338772;Mon Jan 14 22:43:21 EST 2013;Committer;drbrain;3;22;2;24;0
9deb82b1d9457997c34ebca25f2f985778c6c8fd;Mon Jan 14 14:17:18 EST 2013;Committer;keiju;2;18;1;19;0
7dd52f895f8271be242ff549668d825295f12ccf;Mon Jan 14 08:36:15 EST 2013;Committer;shugo;3;51;15;66;0
8ca504214d8a20bdda05b65016812fa7234faad4;Mon Jan 14 07:42:43 EST 2013;Committer;marcandre;3;16;0;16;0
a4665e30f72bc42a9b12b8751ce73ad282ccc5f6;Mon Jan 14 05:42:51 EST 2013;Committer;mrkn;2;45;30;75;0
512b9875444fef706597d2447b9e52d8ae1c09f7;Mon Jan 14 05:42:48 EST 2013;Committer;mrkn;2;26;21;47;0
62e67609b694000cfdb5b80152d3c48a90cfb79b;Mon Jan 14 01:19:12 EST 2013;Committer;marcandre;3;7;3;10;0
1f4c792072b0f53d084abe7601ef5e371b4a1019;Sun Jan 13 22:13:12 EST 2013;Committer;marcandre;2;9;4;13;0
d5b62c3aa152c2303458bee99666d3858c0792c9;Sun Jan 13 22:02:31 EST 2013;Committer;naruse;1;4;3;7;0
b44ac42335a9c135cd67a9881341fbf74b4b13fe;Sun Jan 13 21:51:37 EST 2013;Committer;naruse;3;11;1;12;0
2437d06890aa0d10ba05d2cad0137dfa5fab0224;Sun Jan 13 21:09:52 EST 2013;Committer;svn;1;2;2;4;0
93f023feae1463b1f88d1d2f599c5b5ad34bf329;Sun Jan 13 21:06:39 EST 2013;Committer;marcandre;2;9;8;17;0
c12d66f0d11aa79dc937e41b6fd5e481d9973d36;Sun Jan 13 07:47:10 EST 2013;Committer;zzak;2;22;17;39;0
dc2182aab8c319697b0f4c7f22cb99e5266c43c6;Sun Jan 13 06:15:37 EST 2013;Committer;mrkn;3;107;5;112;0
cc64c2144abbbaf1b0b5fef3bcc4a8ab162cc397;Sun Jan 13 05:50:52 EST 2013;Committer;marcandre;1;3;0;3;0
ad162055c41cbcb279705480c8405219688e34f2;Sun Jan 13 05:50:34 EST 2013;Committer;marcandre;2;8;2;10;0
790e7f797b94d5bcbe79448a17189f845aca1498;Sun Jan 13 05:07:08 EST 2013;Committer;zzak;3;7;2;9;0
075e4cba6603d23107eddc7914f10813c9244333;Sun Jan 13 04:46:25 EST 2013;Committer;marcandre;1;1;1;2;0
51ebd17afbef736da26e3731d15cccdedc394972;Sun Jan 13 04:40:42 EST 2013;Committer;zzak;1;3;3;6;0
59edab809e6b2ba1eb7e77c9a9162a4957fcce66;Sun Jan 13 04:40:15 EST 2013;Committer;zzak;2;6;1;7;0
949092060cf43d761e0e355094d945a1240696ea;Sun Jan 13 00:19:14 EST 2013;Committer;svn;1;2;2;4;0
19c530d8c17bb5f123bb12b4f993654b6dba8729;Sun Jan 13 00:19:10 EST 2013;Committer;marcandre;1;1;1;2;0
350c448da83c61cebbe0c679678af18cd1c1a858;Sat Jan 12 08:47:18 EST 2013;Committer;mrkn;2;32;8;40;0
8d816aef2e8eecd805193398ad00b604ce424d6c;Sat Jan 12 07:12:49 EST 2013;Committer;nobu;3;29;63;92;0
9f7717e836e9e26a70df886e4fea13bc6be5d434;Sat Jan 12 07:06:49 EST 2013;Committer;nobu;1;1;1;2;0
c2f9fcad7145bf8a3a78f2d33ae3d394bf61ce31;Sat Jan 12 01:41:43 EST 2013;Committer;nobu;2;3;3;6;0
0a60805af583612439750e3ae2e168bf183f6e84;Sat Jan 12 00:00:12 EST 2013;Committer;tenderlove;3;78;6;84;0
92a7da1900323139bb678dcde62a8c821cf301f9;Fri Jan 11 22:59:51 EST 2013;Committer;suke;3;31;22;53;0
ecd8abbda494187e547fe3b8c0e6d0217f50934a;Fri Jan 11 17:44:22 EST 2013;Committer;svn;1;2;2;4;0
b239611b06c7ecc79fb92c05e7ecd9bc563d98e3;Fri Jan 11 17:44:16 EST 2013;Committer;zzak;2;8;0;8;0
09f564b15fbbd9ae18bf945d15736b093e00cf1e;Fri Jan 11 14:38:57 EST 2013;Committer;kazu;2;6;2;8;0
51914fcce6ed0fdb8ae63e51c6ae53d72e4cd755;Fri Jan 11 10:21:52 EST 2013;Committer;nobu;1;11;8;19;0
101d458fdf1336b72030b38a1aec6231902f7ac5;Fri Jan 11 10:21:49 EST 2013;Committer;nobu;1;1;1;2;0
86bd6920353185975dc623cbefc211a17783fa90;Fri Jan 11 07:59:07 EST 2013;Committer;nobu;1;14;3;17;0
fc81730154a90b6460368194139eca05ecee757c;Fri Jan 11 07:56:32 EST 2013;Committer;nobu;2;10;1;11;0
ffe2c179e4efb1316436e2f05edaf305ef636333;Fri Jan 11 07:11:54 EST 2013;Committer;usa;1;3;3;6;0
2bcff78b424a637cf2a057ac901da34fc298094a;Fri Jan 11 03:00:23 EST 2013;Committer;naruse;2;7;3;10;0
2b131e1eb6d915f077f6b258a1f9ea4ef8bae98f;Fri Jan 11 02:02:18 EST 2013;Committer;nobu;1;1;1;2;0
bb54d0ae4cafaecfecb2299d7acacaa642afce5c;Fri Jan 11 00:58:08 EST 2013;Committer;shugo;3;28;1;29;0
c0c381e4d55dc42319e24b5a569b6fe8d6fdf84f;Fri Jan 11 00:41:49 EST 2013;Committer;kazu;1;2;2;4;0
6d84fade7b36a5281a75eb972276246cef506959;Thu Jan 10 17:13:14 EST 2013;Committer;svn;1;2;2;4;0
a29c648d9c4da94b95434957db417acc3f23a11a;Thu Jan 10 17:13:09 EST 2013;Committer;shugo;2;6;1;7;0
5849920066ad295cd416c5b4782e795329a666fd;Thu Jan 10 13:03:39 EST 2013;Committer;ko1;2;8;1;9;0
da6ddf240e8c500182f3c9b745db0a265e23e205;Thu Jan 10 12:29:48 EST 2013;Committer;nagachika;1;1;1;2;0
8cada3837f32941a74a7e20e16247982a27cc212;Thu Jan 10 12:05:40 EST 2013;Committer;takano32;2;5;1;6;0
bd0be3c4fda2320ad65475b793b9503a9cbb9d89;Thu Jan 10 10:45:05 EST 2013;Committer;takano32;2;5;1;6;0
1a920c7f9b05c57070add324899dae5b4562b963;Thu Jan 10 08:45:42 EST 2013;Committer;nobu;3;10;3;13;0
b7b183f682672de2e4e468e84fa865e7c1520ef8;Thu Jan 10 08:44:19 EST 2013;Committer;nobu;1;1;1;2;0
8307cb90a0d20976707a25203ff3c249c9c86411;Thu Jan 10 08:12:58 EST 2013;Committer;eregon;1;2;2;4;0
4707fdea0171aab43a1178d4344725d8ca145ada;Thu Jan 10 07:51:35 EST 2013;Committer;shugo;3;16;4;20;0
a5ddc2e1966a6a3af5653b1af45ccb379e346414;Thu Jan 10 07:47:20 EST 2013;Committer;nobu;2;39;12;51;0
42eadff3a113de824dee177ac242c6a7d8f8f2d6;Thu Jan 10 06:57:17 EST 2013;Committer;shugo;2;4;3;7;0
72f980510962c55dedda97a36208994afe732533;Thu Jan 10 06:49:25 EST 2013;Committer;kazu;1;1;1;2;0
2cdd17b458eb2be8dce033217d6debb46b716090;Thu Jan 10 06:39:55 EST 2013;Committer;shugo;2;8;0;8;0
9aa75d08ceb497645940f06bf690f3bdb764031e;Thu Jan 10 06:30:23 EST 2013;Committer;mrkn;2;20;20;40;0
9ef6eefbd30c54931a1fb06712f370e1853188e7;Thu Jan 10 02:16:00 EST 2013;Committer;tenderlove;3;182;4;186;0
b104e2524ddd8f8c34918a31dbfca54169dd0535;Wed Jan 09 19:26:45 EST 2013;Committer;tenderlove;4;18;1;19;0
ac8b1869c0b80fd948a6a50d2a737123b5fa5bd2;Wed Jan 09 19:26:36 EST 2013;Committer;tenderlove;3;31;4;35;0
113c81219de64c9e7d40b113b6a6d98d882e4d9f;Wed Jan 09 18:38:45 EST 2013;Committer;svn;1;2;2;4;0
a5e2f3221a96ee54dd8f5abdfc4439328f34e386;Wed Jan 09 18:38:41 EST 2013;Committer;ko1;3;21;0;21;0
62efc6f305045d83eab8493bc3b58e9bd3504159;Wed Jan 09 13:14:09 EST 2013;Committer;glass;2;7;1;8;0
94b4e7c78311679859d5bd6505382885cc7cb169;Wed Jan 09 13:14:05 EST 2013;Committer;glass;2;8;0;8;0
4e323c0a9d4f333ca6405c97893570df578dfbf8;Wed Jan 09 06:40:30 EST 2013;Committer;nobu;2;7;0;7;0
f608b1b8dc3fd1ff9578e88c4ec3b55bf620f469;Wed Jan 09 05:32:33 EST 2013;Committer;nobu;1;21;0;21;0
193e1fc81055e99626f08a43a4fc7ccb96933091;Wed Jan 09 04:56:34 EST 2013;Committer;naruse;1;1;3;4;0
1ff3e23fe844f780e88f971c759cfc2184f508a3;Wed Jan 09 04:26:15 EST 2013;Committer;glass;2;14;4;18;0
bc0577c6c8607d57a13282a34c80f64fe9bf1eef;Wed Jan 09 00:59:30 EST 2013;Committer;glass;3;29;3;32;0
4ddf057b9aace467b707347209bb572ea2643c32;Tue Jan 08 18:47:05 EST 2013;Committer;nobu;1;1;1;2;0
cbd1f2571af6bf93d5c4d4c25bbb692aad90b864;Tue Jan 08 17:13:33 EST 2013;Committer;svn;1;2;2;4;0
8ad71433279fe8caa1e06038674c0559edfa1468;Tue Jan 08 17:13:26 EST 2013;Committer;nobu;2;10;1;11;0
a00b29a67f669c53f7940fa7814a209f7ea47f7e;Tue Jan 08 05:57:42 EST 2013;Committer;nobu;1;3;4;7;0
69b716111f04a5a692578638a16fc55a75a9dd1d;Tue Jan 08 05:41:44 EST 2013;Committer;nobu;5;17;4;21;0
bdb18e5ffad55f326c0fc3ea659fbe254f15b909;Tue Jan 08 03:40:21 EST 2013;Committer;mrkn;1;1;1;2;0
dbdaf98cb8a422c79751333697480376375c1684;Tue Jan 08 02:18:46 EST 2013;Committer;nobu;1;4;0;4;0
91c6d576b676a6b311ba1d74e0d967d88eac7933;Mon Jan 07 22:26:55 EST 2013;Committer;svn;1;2;2;4;0
8253cb26da4008f3e153fb392f06e6a1172d7420;Mon Jan 07 22:26:00 EST 2013;Committer;kazu;1;1;1;2;0
1be6a498ba8d1c113d4e0e7547d01c86c188e5c4;Mon Jan 07 14:42:52 EST 2013;Committer;mrkn;3;17;0;17;0
19768b6cacb1319f34944a0dc5e0bbe099d2d18e;Mon Jan 07 12:42:48 EST 2013;Committer;shugo;4;29;17;46;0
4722c20661093f5071701941bc2f7b519f2a7283;Mon Jan 07 11:55:17 EST 2013;Committer;shugo;3;29;1;30;0
04fd9aceab50c0ca97e96a8e183a948a903ed56e;Mon Jan 07 11:30:43 EST 2013;Committer;shugo;2;6;3;9;0
9cadf0c03906f49f41e4222248c6a48e72bdb82f;Mon Jan 07 11:22:31 EST 2013;Committer;shugo;5;35;35;70;0
06f2a86f1a57ded8177f0611bb107f0c4bcc2e70;Mon Jan 07 08:38:25 EST 2013;Committer;ko1;3;17;3;20;0
80ad3e2a4332fb4997d30a9e836a7d5f0d9b8dae;Mon Jan 07 07:50:27 EST 2013;Committer;nobu;1;1;1;2;0
e489dc1ff42ad3027319d7d01f4885164fdb410a;Mon Jan 07 06:42:13 EST 2013;Committer;nobu;3;17;0;17;0
38da1a5398f146a36910fde34b72dc9b3aa7918f;Mon Jan 07 06:32:01 EST 2013;Committer;nobu;3;57;0;57;0
86c0eae56e496584105f550b0d123b666885a99f;Mon Jan 07 06:29:48 EST 2013;Committer;nobu;1;24;0;24;0
5551307dd3a016d79b0df50e22cbc4db6a975cee;Mon Jan 07 06:29:44 EST 2013;Committer;nobu;2;12;4;16;0
b8e6fd6ffe9f24921c7138f656596ae3bbdd7ad7;Mon Jan 07 06:24:46 EST 2013;Committer;ko1;3;32;1;33;0
6e4b187bfe582614a491008a68292e8e67a6cfb0;Mon Jan 07 06:23:15 EST 2013;Committer;usa;4;18;10;28;0
8f1be270179f771b517d551fe1ce3d12234f0324;Mon Jan 07 03:09:28 EST 2013;Committer;nobu;3;36;7;43;0
04d244642d0a42aa0bfe3f8ed4afa0e0d8744254;Mon Jan 07 01:44:42 EST 2013;Committer;nobu;1;12;12;24;0
ff696da3b02caedd0a04f7564d7d9ff13dcae743;Mon Jan 07 00:38:11 EST 2013;Committer;svn;1;2;2;4;0
bb70ca493f4547cbb86c54d216b5559b68f2d860;Mon Jan 07 00:38:06 EST 2013;Committer;ko1;2;18;1;19;0
dfb868758526ac639b580b80ed859b3142c65062;Sun Jan 06 12:52:49 EST 2013;Committer;kazu;1;2;2;4;0
f849917a7084e288871e2864a41ae07cb2b7a830;Sun Jan 06 10:08:22 EST 2013;Committer;yugui;2;6;1;7;0
c9f5a8f3f2a18b1a2e283d29e906471dade5f3be;Sun Jan 06 09:48:00 EST 2013;Committer;yugui;4;30;5;35;0
015997ecde57588a5ae850b0c27751162cbc0cf4;Sun Jan 06 02:11:40 EST 2013;Committer;drbrain;2;5;1;6;0
d0f56ab582c1d94a238bc218688ce5ebbb68ebeb;Sat Jan 05 23:04:00 EST 2013;Committer;kazu;1;1;1;2;0
ac67a2b6d45d2ab443517110674d240bd1ee8ed6;Sat Jan 05 20:35:30 EST 2013;Committer;drbrain;2;50;0;50;0
902a36c1f6157385fc8cd914f3c8824017efbfeb;Sat Jan 05 17:24:40 EST 2013;Committer;zzak;2;6;1;7;0
0573d5ea685e5a04b10b94ce7329d29eab2d3ea9;Sat Jan 05 15:04:50 EST 2013;Committer;svn;1;2;2;4;0
a1de1fa575786655f5c9960d4b8dcb8db695ccf4;Sat Jan 05 15:04:48 EST 2013;Committer;naruse;2;15;1;16;0
bd7184b8661f9d517be007b083f4fb874e6ff186;Sat Jan 05 15:04:46 EST 2013;Committer;naruse;1;11;5;16;0
4061f5b6fcfe6ad76d7ba7cd4fd6b0274c2d910f;Sat Jan 05 05:00:33 EST 2013;Committer;drbrain;2;12;2;14;0
3b983407ef254cf1908f844fecb4d8b3a02f9a67;Sat Jan 05 04:45:32 EST 2013;Committer;glass;3;17;3;20;0
3caea6b6a2e4c2e152bf8799acd21127bb88a607;Sat Jan 05 03:25:44 EST 2013;Committer;nobu;2;19;10;29;0
a13aee62d243105ffd3b5178a4d4d6b99c2b2755;Sat Jan 05 01:23:49 EST 2013;Committer;drbrain;3;297;30;327;0
1da85070b0be2aa81ab68adf96ec10c99ba2baf1;Fri Jan 04 23:39:48 EST 2013;Committer;drbrain;2;119;13;132;0
753f68cf20e1492cf980106027dd1f0969d546f2;Fri Jan 04 23:23:40 EST 2013;Committer;kosaki;2;8;3;11;0
da9fe1c4528ef8b25f099345428a30b99bdf76ee;Fri Jan 04 22:58:15 EST 2013;Committer;drbrain;3;120;50;170;0
1b82e0776c26136d5dd121e969d8d73d261cb42e;Fri Jan 04 20:05:47 EST 2013;Committer;svn;1;2;2;4;0
03f7f9ea40d6da40d847d6a422c66ff229bd2aa9;Fri Jan 04 20:05:42 EST 2013;Committer;kosaki;2;11;0;11;0
db58af6051886ba44e6e741210dc4c242c62dd0f;Fri Jan 04 14:51:08 EST 2013;Committer;kazu;1;1;1;2;0
275a9dcb8caa389ec7cbdfcfb860f56f5ddbc4d0;Fri Jan 04 11:19:19 EST 2013;Committer;yugui;4;9;1;10;0
f9d7df33a1e34e3b468ce3bf468615adcfe8c382;Fri Jan 04 10:47:06 EST 2013;Committer;yugui;2;9;4;13;0
ea9301bd2bf814438e31c6d5d9e78354b75752c1;Fri Jan 04 09:04:58 EST 2013;Committer;yugui;4;18;3;21;0
2d08d23e9cdd13616d8819aa7a582d3a5838636f;Fri Jan 04 07:31:57 EST 2013;Committer;drbrain;8;36;22;58;0
f3b24b5b7f88ecfdefcd898f01ea1cfb2ee418f3;Fri Jan 04 06:16:13 EST 2013;Committer;drbrain;16;266;52;318;0
5a7c4d2a78f78804a0508c56fbdf26738251bb5b;Fri Jan 04 02:52:54 EST 2013;Committer;zzak;2;9;3;12;0
6856d86dc177c40a7264ae3b9c9895a312e886e7;Fri Jan 04 02:49:53 EST 2013;Committer;zzak;1;1;1;2;0
aa1b87a5021c499e05ac18c6fe9e7a101a092039;Thu Jan 03 15:42:14 EST 2013;Committer;yugui;1;0;10;10;0
05483e020c7b56e0b74c7c2bcde2cfbd55f4c610;Thu Jan 03 15:40:12 EST 2013;Committer;yugui;1;10;0;10;0
089c0dcc067d9e163d4b14f6ccb1c020faa55266;Thu Jan 03 15:39:16 EST 2013;Committer;svn;1;2;2;4;0
6efba755da0c9d1ff6fc53767d4770d6ca507d19;Thu Jan 03 15:39:15 EST 2013;Committer;yugui;6;29;6;35;0
0626021e13c6aaf9db1bf34a10e8186867e30901;Thu Jan 03 15:39:10 EST 2013;Committer;yugui;2;10;2;12;0
1fe680e812e44a760b2e9bc58402c08774d5d1a0;Thu Jan 03 08:48:22 EST 2013;Committer;kou;2;6;1;7;0
ece67a0a12aaffc083963b606a5bd09feb5cf68a;Thu Jan 03 08:44:09 EST 2013;Committer;kou;2;10;4;14;0
3e028faf7c0a5bf2ac491b4368edc75b6980489b;Thu Jan 03 06:13:56 EST 2013;Committer;zzak;2;9;3;12;0
e25d55ae08230ba7ed597f00ecac20a546aae719;Thu Jan 03 05:59:27 EST 2013;Committer;zzak;2;18;9;27;0
c4653fb344823712feee254097ea7fad153976e9;Thu Jan 03 05:46:34 EST 2013;Committer;svn;1;2;2;4;0
6837b808cd248a0a85b0953a30e945541769d3df;Thu Jan 03 05:46:29 EST 2013;Committer;yugui;3;10;2;12;0
73bd4c3ff6220250219e10eb44ef1c4742991e5d;Tue Jan 01 21:06:11 EST 2013;Committer;zzak;1;1;1;2;0
762aa293ca80cd4a6e92f73477610944801675a9;Tue Jan 01 18:10:34 EST 2013;Committer;zzak;2;6;1;7;0
663613a993cc51d5c5e89e9d31b587d1f5688be8;Tue Jan 01 17:28:47 EST 2013;Committer;zzak;2;5;13;18;0
98b1b387f293df232d4cb70857a46d3cb71854e9;Tue Jan 01 17:17:33 EST 2013;Committer;svn;1;2;2;4;0
1290747cfbaee88fa330b46613a4a8e498733436;Tue Jan 01 17:17:28 EST 2013;Committer;zzak;2;23;5;28;0
10c8aa81fb64bad42ac89a0a91f5f8b1b78810af;Tue Jan 01 14:42:52 EST 2013;Committer;nobu;1;1;1;2;0
4136f8ce890350c8899fb853397de15b68453445;Tue Jan 01 14:42:50 EST 2013;Committer;nobu;1;10;10;20;0
5c7027d227f6c1517d6fd2767ad08b6c7e9fc3bf;Tue Jan 01 14:35:04 EST 2013;Committer;nobu;1;1;0;1;0
56554d12a5f2ae7189980649832a301bd97304fd;Tue Jan 01 09:24:20 EST 2013;Committer;svn;1;4;4;8;0
78ac68e8aa6d6613260959e8d72cfe82f87f984b;Tue Jan 01 09:24:15 EST 2013;Committer;kazu;1;2;2;4;0
7e62b6cccffbefeb2ac4d7a54548ac6fd6ffb73d;Mon Dec 31 06:09:57 EST 2012;Committer;zzak;2;131;7;138;0
534d99ec31e50d1588742ef26aec2eed7fd52dee;Mon Dec 31 04:03:59 EST 2012;Committer;svn;1;2;2;4;0
e4be7f97727f2d33af41be9d8d6a8879a088d886;Mon Dec 31 04:03:55 EST 2012;Committer;zzak;2;11;0;11;0
77df5bb1b5ab3e4d6ed32d0b43acb69b3167f5dd;Sun Dec 30 14:33:38 EST 2012;Committer;nobu;3;12;0;12;0
a6c637f013b7a4031df13a56fdb00560369d2aa8;Sun Dec 30 14:01:37 EST 2012;Committer;nobu;1;5;6;11;0
afa4770aa63d6d08d4e3873861698feae142e3ed;Sun Dec 30 12:57:25 EST 2012;Committer;nobu;1;1;0;1;0
c56eee05c6426733b66b4aa04a32bc7d6b474d65;Sun Dec 30 03:11:17 EST 2012;Committer;charliesome;2;8;1;9;0
64e36b0efc5647fa47385a1a2c628d24bff174d2;Sun Dec 30 02:06:35 EST 2012;Committer;svn;1;2;2;4;0
2a4e4d86733b40a017d9465e6328d63fa1fbb411;Sun Dec 30 02:06:32 EST 2012;Committer;ktsj;2;6;0;6;0
371c07f2a2ce59ff9a045181b997826b3da3ef8a;Sun Dec 30 02:06:28 EST 2012;Committer;ktsj;3;161;23;184;0
b0767cf8c03ad9a656dec63712a8b3f8cf00394f;Sat Dec 29 12:59:06 EST 2012;Committer;keiju;2;7;2;9;0
cdabc58f8e9a8a24f1bd3513fdb0e33c0c94aa12;Sat Dec 29 12:54:41 EST 2012;Committer;shugo;2;10;10;20;0
be7bf5aa0cd9a8e90dbaf268d53b8590fc23393d;Sat Dec 29 12:22:04 EST 2012;Committer;nobu;12;18;18;36;0
e878df745ca89ecdb07090ad2bb99fd433dfc3a3;Sat Dec 29 12:22:01 EST 2012;Committer;nobu;6;11;11;22;0
eb56c1084d57e59b9daab78b22812660d890a354;Sat Dec 29 12:21:58 EST 2012;Committer;nobu;1;1;1;2;0
fd636ef99bc532a15181ecd8f41f01629e92300d;Sat Dec 29 07:44:54 EST 2012;Committer;zzak;2;96;63;159;0
1ddf1833534eea3d88f82c340400ca505550ebb9;Sat Dec 29 06:29:47 EST 2012;Committer;zzak;2;127;1;128;0
4706171d27f63b0687de586d84c028e4f68b6bc1;Sat Dec 29 05:09:18 EST 2012;Committer;zzak;2;22;0;22;0
ad6f06aed8bf9b753622809441c4db0d523cd41f;Sat Dec 29 02:37:47 EST 2012;Committer;nobu;5;32;1;33;0
11803022002e188eb94868335d79ea2b16bd7934;Sat Dec 29 01:13:53 EST 2012;Committer;nobu;1;12;12;24;0
df158322cf05830b0d78f17c66c0699f71b7bcb3;Sat Dec 29 01:10:47 EST 2012;Committer;svn;1;2;2;4;0
2eb92b143aba045fc6a867c9cea8ed66a4df1e5e;Sat Dec 29 01:10:41 EST 2012;Committer;nobu;2;5;6;11;0
af35f2a61d8027df2e70012ae736f91ee0e41b85;Fri Dec 28 14:23:25 EST 2012;Committer;charliesome;6;42;5;47;0
80b0c6ca3b15a621dbbe129f4770c7a2f404eebe;Fri Dec 28 12:49:19 EST 2012;Committer;keiju;2;7;1;8;0
7bc4cfe47950afd6660be17b1b3d48a490291d81;Fri Dec 28 08:10:01 EST 2012;Committer;knu;2;11;2;13;0
7c7a3c4d96de3b28fc7987750f7f681dab22f073;Fri Dec 28 03:34:12 EST 2012;Committer;kazu;1;2;2;4;0
d00b1a76874bafd9d27b6da0ba599e8fcb238c8d;Fri Dec 28 03:03:19 EST 2012;Committer;nobu;1;3;0;3;0
0ea1e43174a5b75682fc19789ea8dbeeb5b10ec6;Fri Dec 28 02:50:57 EST 2012;Committer;nobu;3;23;1;24;0
d5a39c0aa85a705fcf360a535a278aed9116f644;Fri Dec 28 02:23:11 EST 2012;Committer;shugo;3;25;1;26;0
bab92f0fea521263964115339b7f395c38400ab0;Fri Dec 28 00:19:03 EST 2012;Committer;nobu;1;23;23;46;0
8654730aa8449ccd5b470c88cb5c0a22e36eabbd;Thu Dec 27 22:08:41 EST 2012;Committer;naruse;2;6;1;7;0
109d71ac71cab09d415a489deb39191735d9d00c;Thu Dec 27 16:45:36 EST 2012;Committer;naruse;3;10;1;11;0
3e81553a1e6d71a1f8c528581c317e34f245f200;Thu Dec 27 16:15:59 EST 2012;Committer;svn;1;2;2;4;0
93030d0e4d93683346648b25bd69a3f33a5f0486;Thu Dec 27 16:15:53 EST 2012;Committer;jeg2;3;84;17;101;0
7b34c2f81aa300aa943479077c7c19c472b0c71c;Thu Dec 27 14:48:42 EST 2012;Committer;keiju;2;11;1;12;0
8f4d0c4526d38eac768c5d8517feb3a003b3d45c;Thu Dec 27 12:35:28 EST 2012;Committer;keiju;2;24;4;28;0
89182621d9949b24e67d48b751a1997e9eeb06ec;Thu Dec 27 12:21:17 EST 2012;Committer;glass;3;10;2;12;0
22691e7f6b88a58f9d874b07ce09e2f82bfd112f;Thu Dec 27 12:09:33 EST 2012;Committer;charliesome;2;6;1;7;0
cd453f16b42ea9b68993631b27773165b24ee9b2;Thu Dec 27 11:43:02 EST 2012;Committer;glass;3;20;0;20;0
90833dd452c0c7276b1dd5a88ab1dd99fbb2d6a5;Wed Dec 26 15:43:31 EST 2012;Committer;svn;1;2;2;4;0
8f54e81dbbbe68b54f38c9fa2bee40398d27d358;Wed Dec 26 15:43:26 EST 2012;Committer;zzak;1;1;1;2;0
8494484dc0b1901d9ba49a31c6a6b3771b8942a2;Wed Dec 26 14:56:57 EST 2012;Committer;keiju;2;5;1;6;0
d565cf7b43bf2d70444e003760ca1afa4544044d;Wed Dec 26 14:37:24 EST 2012;Committer;shugo;1;1;1;2;0
5983e1be1057c534355c82f7eb8e962e0a68f319;Wed Dec 26 14:29:01 EST 2012;Committer;keiju;2;9;10;19;0
a03c07584577f279183946bf238994b345c95ffd;Wed Dec 26 12:42:09 EST 2012;Committer;keiju;2;6;1;7;0
35caefa5f1a6c20c1c9bc9bb92a681d7969b0f14;Wed Dec 26 12:29:28 EST 2012;Committer;keiju;2;6;1;7;0
32bb0eeb36fa811044e2fccd1b6addc92c3320f8;Wed Dec 26 03:55:22 EST 2012;Committer;keiju;2;6;1;7;0
495f72ed3885970c40689186d0031c0f457f7e49;Wed Dec 26 03:00:13 EST 2012;Committer;kosaki;2;14;1;15;0
e4b760128b523007ab31c5e8eb7ca22c2ce43df2;Wed Dec 26 00:50:55 EST 2012;Committer;naruse;1;2;1;3;0
6da33430de3d4ff36799925c7425921a21bb56ff;Tue Dec 25 22:31:26 EST 2012;Committer;nobu;2;11;7;18;0
73982fa7217038249bf2e538003cc524146f79c6;Tue Dec 25 22:31:21 EST 2012;Committer;nobu;2;10;15;25;0
c8484fb3228eeac72497cd1003c2e601b767f785;Tue Dec 25 22:31:16 EST 2012;Committer;nobu;2;12;4;16;0
5a7347a7bd6a7ee31f3a6d8b90e38e8bf3ac8421;Tue Dec 25 22:29:42 EST 2012;Committer;nobu;1;1;1;2;0
c3992aa40cdd74d91f18f8633ee96ec48bb5ee64;Tue Dec 25 21:45:36 EST 2012;Committer;naruse;1;1;1;2;0
4d9480cbbb52c19af714578b4801a325cf6bce8a;Tue Dec 25 18:10:46 EST 2012;Committer;nobu;3;4;4;8;0
b7d11c6942c40464280af331aa15e2361a55d6d3;Tue Dec 25 16:35:04 EST 2012;Committer;keiju;3;7;3;10;0
7eb75edd4e65494a9500492f44409f10709322ef;Tue Dec 25 16:04:57 EST 2012;Committer;svn;1;2;2;4;0
d43e3321b512008f7077cdc14e84cca82020fdec;Tue Dec 25 16:04:52 EST 2012;Committer;keiju;2;9;4;13;0
23c93b500743c784ae9f6b5d766afd1787e752a6;Tue Dec 25 13:34:34 EST 2012;Committer;keiju;2;9;2;11;0
c2693f8bd61757e32d2f92010c041a79b21d074a;Tue Dec 25 13:24:17 EST 2012;Committer;ko1;5;69;9;78;0
0f63b60f23aea76e52a6f6fc0d073eb2defe58d8;Tue Dec 25 12:16:10 EST 2012;Committer;keiju;4;13;1;14;0
6dab48b20eaafe8482d2f34096c5f28779115ca9;Tue Dec 25 11:21:19 EST 2012;Committer;keiju;2;7;2;9;0
2f345f9de680b23843c7067b7fa22fd47b1e3ea0;Tue Dec 25 10:45:20 EST 2012;Committer;usa;1;1;1;2;0
a3d9672407b77c2a26af7e15a82d1f91e762b602;Tue Dec 25 10:14:12 EST 2012;Committer;usa;4;23;6;29;0
270fbd9c058fc2a36dc7c44243f4a20c91143481;Tue Dec 25 09:57:07 EST 2012;Committer;ko1;7;40;20;60;0
febab308c87f721d9b7491d37e345d0130a4bca2;Tue Dec 25 08:00:50 EST 2012;Committer;naruse;1;10;4;14;0
59e1e822a189f8b4c89c3216dd1d82b827969c46;Tue Dec 25 07:29:36 EST 2012;Committer;ko1;2;9;1;10;0
48f320194a267bcf6858cbaa77a688cce0759d8d;Tue Dec 25 07:17:55 EST 2012;Committer;ko1;1;1;0;1;0
320b49473ee64f37787c514e18577106e8231588;Tue Dec 25 04:38:18 EST 2012;Committer;nobu;6;37;3;40;0
5688e811bdbec002c491a96baeec4745235c19ab;Tue Dec 25 01:20:17 EST 2012;Committer;naruse;1;2;2;4;0
94b57518b19d0f8322e664e4ec7374199d037e48;Tue Dec 25 00:30:47 EST 2012;Committer;nobu;1;4;1;5;0
73fb923cb3489e8f6505493282f025c751f5fcd4;Mon Dec 24 23:50:49 EST 2012;Committer;nobu;1;4;4;8;0
7ea675732ac1dac72f07756498706678d8725719;Mon Dec 24 15:59:31 EST 2012;Committer;nobu;6;173;10;183;0
d2fa4d7118b4b064cd84a7b1dbf37ae0ff6c1883;Mon Dec 24 15:58:15 EST 2012;Committer;nobu;1;8;1;9;0
4d33d02778cab46615f799e77db179a12c95613e;Mon Dec 24 15:57:57 EST 2012;Committer;svn;1;2;2;4;0
427bcc40ac818e5f3525a117c0848c89bca6db45;Mon Dec 24 15:57:51 EST 2012;Committer;nobu;1;2;3;5;0
8a3d7236cd0faf0581172ba975c6455bcbb6728f;Mon Dec 24 00:45:26 EST 2012;Committer;nobu;1;0;10;10;0
e9381c0559cc7c8b241db3eab46fd01b062acbad;Sun Dec 23 22:23:52 EST 2012;Committer;nobu;1;1;1;2;0
e1682d34749a2b7c51561d76741343cf367c30ed;Sun Dec 23 19:58:51 EST 2012;Committer;svn;1;2;2;4;0
02253a796181cf958f858ec3a767de333e0fcab5;Sun Dec 23 19:58:44 EST 2012;Committer;naruse;3;19;0;19;0
0f9b33c793f225c1b817d73e5c915050c429edc4;Sun Dec 23 10:18:58 EST 2012;Committer;ko1;10;208;170;378;0
80b55686f0cce9c8fb2aaec6e5f957555e18f60c;Sun Dec 23 08:57:32 EST 2012;Committer;nobu;2;30;9;39;0
c81a5012f1401b382cbc641e306a2cfcaa3e1610;Sun Dec 23 08:57:27 EST 2012;Committer;nobu;2;23;24;47;0
ef6abd10c725bdf85d8b35a723cd0eca454bfcd7;Sun Dec 23 08:57:22 EST 2012;Committer;nobu;2;11;7;18;0
cd6139cacdef549b6eda975d55be80a9cf37fb4e;Sun Dec 23 07:13:07 EST 2012;Committer;zzak;2;10;6;16;0
4fa9e3307dd3b2cf3afea278a833a5d05ddb45de;Sun Dec 23 07:07:18 EST 2012;Committer;zzak;2;6;0;6;0
1f3bf4ce550e7c5208bf214884830daff876587b;Sun Dec 23 06:34:56 EST 2012;Committer;nobu;1;1;1;2;0
4943b46ae7ce04ec8faae014040cc487a35bf149;Sun Dec 23 06:25:22 EST 2012;Committer;zzak;2;7;0;7;0
20a550534959929978258fb79ff1ff1fa6cfb1ea;Sun Dec 23 06:21:49 EST 2012;Committer;nobu;1;1;1;2;0
0fe46ceae30eedb2d87f9e62992bf8803c9a4fa5;Sun Dec 23 06:05:50 EST 2012;Committer;nobu;4;136;45;181;0
450b9bb6cb46bcc64b3d593e060c4d69df8d95d9;Sun Dec 23 05:52:50 EST 2012;Committer;zzak;2;11;3;14;0
3193599d853dcedd9a1302a50d217e5512f959ee;Sun Dec 23 05:43:04 EST 2012;Committer;nobu;1;1;1;2;0
482bf47d1f54ade2052a5e8feb039134b510f1c6;Sun Dec 23 05:35:15 EST 2012;Committer;nobu;2;14;1;15;0
6fe32d72667945605ef710395706e04491bfd86a;Sun Dec 23 00:35:09 EST 2012;Committer;drbrain;14;739;153;892;0
c47c095b9740e7c19d6fdca29ab661c1089221d4;Sat Dec 22 17:22:04 EST 2012;Committer;knu;7;299;55;354;0
2742b6bc432e82a502a7fe7234090592a31dc432;Sat Dec 22 16:53:12 EST 2012;Committer;nobu;1;7;1;8;0
78c56ae5840c4d41a6d6c7a38c023982c2ab3637;Sat Dec 22 16:36:30 EST 2012;Committer;zzak;2;13;2;15;0
a756488c6d3a9a0d0fab76cd4c67e655f00c399b;Sat Dec 22 15:06:22 EST 2012;Committer;mrkn;6;164;35;199;0
0f16820fc0484697c0535961162d5f53b9ee0a42;Sat Dec 22 15:05:01 EST 2012;Committer;svn;1;2;2;4;0
6f02547d83ec4651999b55f606672084cb0fe22b;Sat Dec 22 15:04:57 EST 2012;Committer;nobu;9;168;96;264;0
1df33a4a5f4bb1b2393cf5597e7d1156983c7741;Sat Dec 22 14:59:21 EST 2012;Committer;nobu;2;53;71;124;0
920736460b687bfd513e83011d9d0e8617335d0a;Sat Dec 22 13:08:24 EST 2012;Committer;nagachika;2;5;4;9;0
398581564d155cab50beeb28fbb61fcbb5f4da16;Sat Dec 22 13:02:12 EST 2012;Committer;kosaki;2;21;0;21;0
c0a50272354ee03a4dbc7c518d5719a4f95b00d3;Sat Dec 22 12:52:31 EST 2012;Committer;nagachika;1;1;1;2;0
f3b132faac3a6a777fb624b1a4c7bcb95c3eb625;Sat Dec 22 11:31:13 EST 2012;Committer;nobu;3;11;2;13;0
7815cbd7d0699ab0b9e50998882b7981acca8e07;Sat Dec 22 10:40:03 EST 2012;Committer;nobu;1;26;43;69;0
af1ca4cb132dba91dd88471170d3106d304f0e24;Sat Dec 22 10:26:40 EST 2012;Committer;nobu;3;11;5;16;0
6a35c26b2dfbd2a516e450e916eb8d13c3ff5ddf;Sat Dec 22 06:45:28 EST 2012;Committer;nagachika;5;23;8;31;0
a44e41e8316820b51e183939d64b15ef68b321b2;Sat Dec 22 05:00:00 EST 2012;Committer;kazu;1;1;1;2;0
ca2fce0cf286cc505aa8f134275616a5d903fa8d;Sat Dec 22 04:25:18 EST 2012;Committer;shirosaki;2;14;2;16;0
f9e621372df2551fa269f3c814246eca1e34e4fb;Sat Dec 22 02:52:48 EST 2012;Committer;glass;3;20;8;28;0
570b766901c1a80f5a317012eb81ee9d1f301073;Fri Dec 21 20:36:07 EST 2012;Committer;drbrain;7;149;12;161;0
34a3668c30753dcd2632aaf84d3ee5d29599eac1;Fri Dec 21 17:36:14 EST 2012;Committer;zzak;2;6;1;7;0
e8a7607ed0e089c12e9e2df7bdd6c2efd2e58dd9;Fri Dec 21 17:29:18 EST 2012;Committer;zzak;3;10;4;14;0
585afbbc6a833e91cd2e51b8faeece2248c0cc16;Fri Dec 21 17:21:12 EST 2012;Committer;kosaki;3;20;6;26;0
4da6fa28f884329e04b3916565b6ba674705345a;Fri Dec 21 17:08:24 EST 2012;Committer;zzak;3;72;67;139;0
75584a1d8672d99ec658744330a13fafeb13a806;Fri Dec 21 15:30:53 EST 2012;Committer;svn;1;2;2;4;0
e31b67700b8c71061bd0ee33a7235d423ca6f6f0;Fri Dec 21 15:30:44 EST 2012;Committer;usa;2;14;1;15;0
8346f7b2ad3138bdc30c8b39c8de13f3b392c059;Fri Dec 21 14:16:02 EST 2012;Committer;kou;3;18;1;19;0
e852838cee777cfc9c6e3f8f16142d4809422179;Fri Dec 21 14:12:57 EST 2012;Committer;kou;3;20;1;21;0
3fed8bc9a5c924c43aef32098ebd201d0ab6af76;Fri Dec 21 13:44:44 EST 2012;Committer;kou;3;9;1;10;0
914611adbcaec6a2711d30fcc1ff136e02efecf8;Fri Dec 21 13:36:17 EST 2012;Committer;ko1;2;6;1;7;0
9848f0d0ca3b086383a0df3a5baed973b6bafa26;Fri Dec 21 13:06:17 EST 2012;Committer;usa;4;18;18;36;0
315bf4b6d726c7a26fe1ae75889056cba90cb472;Fri Dec 21 12:17:03 EST 2012;Committer;tarui;2;11;4;15;0
17ac7835415cab22649422704a17c7b7f1c43419;Fri Dec 21 11:44:09 EST 2012;Committer;ko1;2;16;1;17;0
a6c5431156d3fde6364724e7bd061b1ae79334db;Fri Dec 21 11:22:54 EST 2012;Committer;ko1;2;11;3;14;0
1ed4ed43f7c49cd690464a60c7e1ec1c0150688b;Fri Dec 21 10:53:57 EST 2012;Committer;naruse;1;13;0;13;0
f4ef96e6a292b70947adbeca4e12fb7943718e8e;Fri Dec 21 10:39:59 EST 2012;Committer;ko1;2;13;5;18;0
a598fcc8c1412f82453f709433275f52d29f0501;Fri Dec 21 09:51:03 EST 2012;Committer;ko1;1;2;3;5;0
8578cc337bf270545217db6827c6c5ccbc0ef64b;Fri Dec 21 09:48:15 EST 2012;Committer;ko1;3;22;16;38;0
979479270ca802c0d10dc1bd60c7ff445886eb51;Fri Dec 21 09:37:31 EST 2012;Committer;ko1;1;1;0;1;0
87d48d14a0839316f051bddd4d794bdd64e49181;Fri Dec 21 09:33:44 EST 2012;Committer;ko1;5;108;87;195;0
94a4bc0ef4165e42ec36c9562ce7a7bcf01ba1cf;Fri Dec 21 07:38:11 EST 2012;Committer;nobu;3;8;1;9;0
2edcf87c1c30c29562fc52075896935ebf398367;Fri Dec 21 07:38:07 EST 2012;Committer;nobu;4;18;3;21;0
298694a2fdf4451163299d61a49a15fe49ab598a;Fri Dec 21 07:38:03 EST 2012;Committer;nobu;4;47;16;63;0
e8794bf2151bf2427e9a69f86cd818c9ed24d0fa;Fri Dec 21 07:35:49 EST 2012;Committer;nobu;1;18;14;32;0
2ed9c6fe0b38e28bdceb73e37fe3e7aaeab4ab06;Fri Dec 21 07:35:47 EST 2012;Committer;nobu;1;3;2;5;0
3763c760fd3d4643b8e0e9f9ceef6ca976fb4149;Fri Dec 21 07:35:42 EST 2012;Committer;nobu;1;2;2;4;0
7e9eb32669348b7e0a5775c8e0fc9566be11fc31;Fri Dec 21 05:45:50 EST 2012;Committer;zzak;21;611;60;671;0
4f7a6aafa57bf57ce4b0b5e323548f0a6385d527;Fri Dec 21 02:34:37 EST 2012;Committer;drbrain;20;917;91;1008;0
7764dd935737aed303b3d61928ad36f4b67ae8ed;Thu Dec 20 23:58:16 EST 2012;Committer;tarui;2;4;1;5;0
349b20cc9132c0b22a210dce8d6ff36699f0a3ce;Thu Dec 20 16:02:43 EST 2012;Committer;tarui;2;8;2;10;0
d73872f3bc6230a0a24644aaa0cc7a5a0ed960c4;Thu Dec 20 15:32:44 EST 2012;Committer;svn;1;2;2;4;0
5e85f086925c9c0afd0b1d9312c796956fcd5f50;Thu Dec 20 15:32:39 EST 2012;Committer;kazu;1;4;4;8;0
fbbb06f803611735c9792678f005f9f6953b73af;Thu Dec 20 12:02:37 EST 2012;Committer;tarui;2;10;2;12;0
8497a7b9187a05210a4f6b842d06d1268d704d35;Thu Dec 20 09:29:57 EST 2012;Committer;nobu;2;7;2;9;0
ee26f5ec253b17ed7e7d63ed818b060e70b345a7;Thu Dec 20 09:28:35 EST 2012;Committer;nobu;1;4;4;8;0
026518c8e58c726668c875a0fabc42747ede17d8;Thu Dec 20 09:28:33 EST 2012;Committer;nobu;1;2;2;4;0
f1f05e75cdae18a022aea39a4011c18d9f513c97;Thu Dec 20 08:29:41 EST 2012;Committer;shugo;2;8;7;15;0
ea01ffa56951724708858b982d7aa64504cc412c;Thu Dec 20 08:13:53 EST 2012;Committer;shugo;5;96;13;109;0
a1580347899f1fb6fd85d82828db3f372e5ec86d;Thu Dec 20 07:54:13 EST 2012;Committer;emboss;2;7;0;7;0
94f42d6d79717c19f20e33ca4a29ce206d79f74e;Thu Dec 20 07:43:54 EST 2012;Committer;usa;2;14;1;15;0
b9bd8eaf3b973268b898df22ee4cdadca7d15730;Thu Dec 20 07:42:56 EST 2012;Committer;emboss;3;16;0;16;0
4fce754f9b603664501ac4ee982988fb264d20f2;Thu Dec 20 07:00:11 EST 2012;Committer;emboss;4;23;47;70;0
a6ed298df738b21b21ed2073bd89bb65565848f7;Thu Dec 20 06:23:28 EST 2012;Committer;drbrain;3;53;4;57;0
d3d00ab8fe750551219655ab5cce0aee77efbe44;Thu Dec 20 06:18:26 EST 2012;Committer;nobu;2;2;2;4;0
215b54806b035509272779fefd57b432a1a0f9e5;Thu Dec 20 06:03:03 EST 2012;Committer;emboss;3;361;8;369;0
ec6cacf00ad0dcf8a37cdfe2f31e6a06cd2a7262;Thu Dec 20 03:57:08 EST 2012;Committer;drbrain;6;92;12;104;0
440714529477663f19a683f2ccee8f568a5481c6;Thu Dec 20 03:43:53 EST 2012;Committer;nobu;1;8;0;8;0
0de805f62bda2cbfac2a0c6392bdf7cae014cde4;Thu Dec 20 02:05:37 EST 2012;Committer;nobu;3;25;15;40;0
3ec171510eafbf682d67b1997460f2c5c27a3636;Thu Dec 20 01:52:50 EST 2012;Committer;nobu;1;1;1;2;0
30fbc5591da5922f359987bbbb41de7ac6173ae8;Thu Dec 20 01:52:47 EST 2012;Committer;nobu;5;6;6;12;0
b28ac4039df7f04d8bb743cc1741a4a31c52e270;Thu Dec 20 00:32:09 EST 2012;Committer;emboss;2;7;2;9;0
a3b753b28214ad321e7335afada7f1b06d036836;Thu Dec 20 00:29:07 EST 2012;Committer;emboss;5;107;8;115;0
e3e4e9dfe77c103ac8a46e5ad15ef6b36e6f0653;Wed Dec 19 22:33:43 EST 2012;Committer;ko1;1;1;0;1;0
87e1616048edca270c86ab7e5d8b8599e1df79de;Wed Dec 19 22:29:18 EST 2012;Committer;ko1;7;261;40;301;0
5d92f6ec05be5df5f89f81fb926ad08faf22ee03;Wed Dec 19 21:28:44 EST 2012;Committer;ko1;2;6;1;7;0
7cb7d8ad1da6ee575c69307e863efa6f19ff0456;Wed Dec 19 16:04:16 EST 2012;Committer;svn;1;2;2;4;0
bfa7a49d3152eeaa1969fceec4f210bb2581999b;Wed Dec 19 16:04:11 EST 2012;Committer;zzak;2;12;0;12;0
e446378ad044b7f7464d040eb5cc8f3784732c44;Wed Dec 19 14:54:50 EST 2012;Committer;usa;2;10;2;12;0
e90ccd3beb0b9bf1125461ef68943578739bebbe;Wed Dec 19 14:47:26 EST 2012;Committer;ngoto;2;9;2;11;0
b8422636967a53f598968fbbc49326dd4ab027c6;Wed Dec 19 11:19:37 EST 2012;Committer;kosaki;1;0;2;2;0
c3026b723c4af4be56e3297a29d5a21b5d64eecc;Wed Dec 19 10:34:13 EST 2012;Committer;nobu;3;17;3;20;0
542a12d673ee5da8a7b8d40d66415f3e72bb0077;Wed Dec 19 09:05:44 EST 2012;Committer;marcandre;1;2;2;4;0
e9e4ea981ed45edd35f177992ca2002a82283c8f;Wed Dec 19 08:54:57 EST 2012;Committer;tarui;2;7;2;9;0
8255e83912f908a6ea50f7989ac27b8587fca2b6;Wed Dec 19 07:30:58 EST 2012;Committer;drbrain;2;9;1;10;0
d8cda044883c587ba75140b72200b94051a28349;Wed Dec 19 07:19:59 EST 2012;Committer;drbrain;2;5;1;6;0
eddc0685f224a6de2f5a6bdaab7f87562192ba7f;Wed Dec 19 07:19:10 EST 2012;Committer;drbrain;8;236;119;355;0
1b2be1f8ca5286a75d9401f96eaec89317353e3e;Wed Dec 19 06:31:02 EST 2012;Committer;naruse;1;1;1;2;0
2c0d2db5cb8f63e9b1e2c2ff776a8d26d510e49f;Wed Dec 19 06:24:02 EST 2012;Committer;drbrain;2;6;1;7;0
67ae926c5e68b656c3661aaa747d7720488c32ba;Wed Dec 19 05:29:04 EST 2012;Committer;naruse;1;1;1;2;0
30635a9429930a7b31a1acd0b9aab4abe6b47529;Wed Dec 19 02:46:41 EST 2012;Committer;kazu;1;1;1;2;0
a83df3dc8261d16d333387a0c47a887e36c8b15c;Wed Dec 19 02:25:42 EST 2012;Committer;naruse;1;2;2;4;0
056bdfd2e5a208e691cffc405d775ee5939ca3d3;Wed Dec 19 02:25:40 EST 2012;Committer;naruse;2;1;11;12;0
526d7af1a7da85cf40bfdb43c2e19d010685d4fc;Wed Dec 19 02:25:37 EST 2012;Committer;naruse;1;11;11;22;0
b32f9edda74af06866e2fded9d7abcf6e556a111;Tue Dec 18 17:06:09 EST 2012;Committer;nagachika;1;1;1;2;0
26221584a98681b6f2f48970ccdf7f93d741e00b;Tue Dec 18 17:04:05 EST 2012;Committer;nagachika;4;14;7;21;0
ba6a2e7f7456d6f25e9bd84ff6531b98ba85abcb;Tue Dec 18 15:29:09 EST 2012;Committer;svn;1;2;2;4;0
157bfdcf916abb57e61ecd7f682f6d9dcfc07f1b;Tue Dec 18 15:29:01 EST 2012;Committer;kazu;1;4;5;9;0
c2834e3ce4df149fbecce450772c1f045de3119f;Tue Dec 18 14:02:18 EST 2012;Committer;nagachika;1;2;1;3;0
06dcf7840fd6a9f7f6ad48ff9ce9d0bbe180c1eb;Tue Dec 18 10:07:15 EST 2012;Committer;kosaki;2;13;8;21;0
005db82d368d9e030b3b370ceba8b46e739b2b2b;Tue Dec 18 10:07:05 EST 2012;Committer;kosaki;2;8;5;13;0
dff59f6c5df7d995d02e8173a8ce42ff9c552e88;Tue Dec 18 08:24:57 EST 2012;Committer;drbrain;5;37;4;41;0
aa233d3f3331c266baabfefc68d9bc2cc2f4fd0b;Tue Dec 18 07:46:33 EST 2012;Committer;drbrain;2;13;4;17;0
69dfd5e034188e20bc12c8a5dcb62694f52295a7;Tue Dec 18 07:39:15 EST 2012;Committer;drbrain;3;21;0;21;0
2e881bd59e12cb33e868be93af34cb1e2d5475d1;Tue Dec 18 07:31:36 EST 2012;Committer;drbrain;4;80;9;89;0
606b66db7dd142884acfdab7a40a29938ea729f1;Tue Dec 18 04:30:44 EST 2012;Committer;nagachika;5;43;0;43;0
ec3226d826e9ec7381cdb53a0c45c153065bfdad;Tue Dec 18 04:18:06 EST 2012;Committer;zzak;2;33;26;59;0
dbc8565fa3b3afb227fc0e41acbcc1e395837bb7;Tue Dec 18 04:16:00 EST 2012;Committer;zzak;1;2;2;4;0
b06dfe594e0e4709d41f101ee7e9ecbb85728728;Tue Dec 18 03:16:27 EST 2012;Committer;drbrain;3;30;14;44;0
87f099d0699f77162007217611c4568b6926092c;Tue Dec 18 02:48:35 EST 2012;Committer;drbrain;2;10;2;12;0
831af844ef2d4d716da07eda331c50d1e73005e3;Tue Dec 18 02:32:28 EST 2012;Committer;emboss;2;9;1;10;0
c2606d23c5cb25bdddf8e32a811da773b82b2d60;Tue Dec 18 02:06:39 EST 2012;Committer;naruse;1;2;2;4;0
e814e2ff3a6a970e88843cc6ff1e161075931e8e;Tue Dec 18 02:04:52 EST 2012;Committer;emboss;1;2;3;5;0
84f1dae9d637a2038d1b395bcc2f22404770d2d7;Tue Dec 18 02:02:43 EST 2012;Committer;emboss;4;30;4;34;0
f5a32acb97dec5c798001f2eb6d31bb78fda0113;Mon Dec 17 22:08:00 EST 2012;Committer;ko1;1;2;1;3;0
256c5f257743401d4ee7e2ba756ef2ffd22e4d7a;Mon Dec 17 22:04:12 EST 2012;Committer;ko1;6;44;38;82;0
6247099f4c85a43c0405d1f4536cea99b37a652a;Mon Dec 17 20:28:51 EST 2012;Committer;ko1;3;65;5;70;0
4654d75ea31041d5ab90a4ead43b53743f20f391;Mon Dec 17 18:04:50 EST 2012;Committer;tenderlove;2;42;35;77;0
c60e45f100f06131a6a8bd9d7d42c554c9777b1b;Mon Dec 17 17:44:34 EST 2012;Committer;zzak;2;8;0;8;0
08d599670ad5250efcd1b73a5d93222e0b1ce3a5;Mon Dec 17 17:37:28 EST 2012;Committer;zzak;1;1;1;2;0
b02141ad78e629a2b334333042967957d8a4caa1;Mon Dec 17 17:37:02 EST 2012;Committer;svn;1;2;2;4;0
f2a997d858225463edc693a70098f29e6951999f;Mon Dec 17 17:36:56 EST 2012;Committer;zzak;2;5;1;6;0
8dcc5ec888b5cdf7634fb717823db6e8ad8cef86;Mon Dec 17 12:48:12 EST 2012;Committer;naruse;1;2;1;3;0
a70bb8889b3130d72ec5a1f0ce92f386000a60da;Mon Dec 17 09:49:00 EST 2012;Committer;charliesome;3;39;0;39;0
6d8ad6c489f41dfb5553d0933793eb5c84e0cc29;Mon Dec 17 05:04:04 EST 2012;Committer;kosaki;2;22;8;30;0
73b244d0ded191337ed6b30eb7ead658b614ae8b;Mon Dec 17 03:05:45 EST 2012;Committer;drbrain;2;25;0;25;0
85d3d572fad648cd4f7ae2f57bb62ea0ab6cc384;Mon Dec 17 02:36:30 EST 2012;Committer;drbrain;2;5;0;5;0
29fd59347576ed1ef8fa18534b595b320a939db1;Mon Dec 17 02:26:15 EST 2012;Committer;drbrain;5;512;0;512;0
810008293fd8ce3a9d3d62dcf2f2229b98c2bd49;Sun Dec 16 23:07:49 EST 2012;Committer;drbrain;13;422;208;630;0
10295ab2ff87b1189dcbe129a07a692417db53f6;Sun Dec 16 23:00:08 EST 2012;Committer;svn;1;2;2;4;0
92443fccbfeb910447c1db2a1fad750415525040;Sun Dec 16 23:00:04 EST 2012;Committer;drbrain;4;22;3;25;0
44b4b9060d7f02b10768c09bf8f59fa96aeda1b9;Sat Dec 15 17:10:50 EST 2012;Committer;kosaki;2;6;1;7;0
54619f8d1e1c582b989bb910c2f5dadfde2d530b;Sat Dec 15 15:46:07 EST 2012;Committer;nagachika;3;17;1;18;0
48bcb55c41135ed72805ebc7847ad3570867c099;Sat Dec 15 15:04:25 EST 2012;Committer;ngoto;2;6;1;7;0
438cca5720d93a3286b71a1c42fc67db492378d3;Sat Dec 15 15:00:05 EST 2012;Committer;svn;1;2;2;4;0
9d960e38c8880c747efbf2499ac9a1dcd6e9fc7e;Sat Dec 15 15:00:00 EST 2012;Committer;kazu;1;1;1;2;0
0e19d2b434776e580ebafeafa553bc335d5e5e38;Sat Dec 15 14:20:24 EST 2012;Committer;kosaki;2;5;3;8;0
aff9dff46d79181d143697d7b9e76735788e45cc;Sat Dec 15 14:20:12 EST 2012;Committer;kosaki;6;39;9;48;0
cbe5f8820b71e0e9a214ae86e9264712e5580413;Sat Dec 15 09:25:13 EST 2012;Committer;tadf;2;10;0;10;0
81af1bd9e8b8d84860cade1b5918b1c801b57845;Sat Dec 15 09:01:22 EST 2012;Committer;tadf;2;22;10;32;0
985fe77356ca24e78548ca5bce61f2328c49575b;Sat Dec 15 07:29:43 EST 2012;Committer;nobu;1;5;17;22;0
43f791624a80b8f7b84acdd37e41ec9ae8c1a994;Sat Dec 15 07:18:07 EST 2012;Committer;kazu;1;1;1;2;0
691ee91c1a8873777bc0dfa544630f30f7d9379a;Sat Dec 15 06:10:04 EST 2012;Committer;nobu;1;2;1;3;0
2ca5e8eeababba0469aef7421572e29d81b9bd34;Sat Dec 15 06:10:01 EST 2012;Committer;nobu;2;10;10;20;0
771f692792227e77dd9e9df74a2fda7bb6f33622;Sat Dec 15 05:40:41 EST 2012;Committer;kosaki;1;1;1;2;0
7fbaa0bedf29d6c44a3e038ec6dd9d153e4c7479;Sat Dec 15 05:40:29 EST 2012;Committer;kosaki;2;9;1;10;0
e78d4e69fe15b84358ce8fb30edf5c6610a6bad9;Sat Dec 15 05:40:18 EST 2012;Committer;kosaki;4;14;2;16;0
9bd33790b7f992520f003954df743dd6e8502622;Sat Dec 15 05:40:07 EST 2012;Committer;kosaki;2;34;1;35;0
2a4d86f385c4d4fd3f4195e8dbb0aa61ae4f8eea;Sat Dec 15 05:39:57 EST 2012;Committer;kosaki;2;28;1;29;0
96350867e1a003ecc40e987ea4bf55c069e519fd;Sat Dec 15 05:39:46 EST 2012;Committer;kosaki;2;6;0;6;0
70df4dec03fe9e557c55162ed6fc2201c3960c48;Sat Dec 15 05:39:36 EST 2012;Committer;kosaki;2;6;1;7;0
47fa79203d04ac0de21539a5843197bbb299abab;Sat Dec 15 05:39:25 EST 2012;Committer;kosaki;2;5;1;6;0
2ed40d3b57f61c67962cf0fb5049021b02fddacf;Sat Dec 15 01:39:49 EST 2012;Committer;nobu;1;9;11;20;0
67c599a5d222380549c1ca87294b06fbed36cc3b;Sat Dec 15 01:39:47 EST 2012;Committer;nobu;1;3;1;4;0
c99425101d76a9c9c812bb895c78fcd385ee48d3;Sat Dec 15 01:39:43 EST 2012;Committer;nobu;1;2;2;4;0
ce6a2c7fac7123e76f457dfca77964b38875ff46;Sat Dec 15 01:22:44 EST 2012;Committer;nobu;3;26;5;31;0
cb6917d9138d33d1206d9f47d419aa24e212e24e;Fri Dec 14 23:40:02 EST 2012;Committer;tarui;2;6;1;7;0
4bcfc171823f85111be7374e95318901b8298f9a;Fri Dec 14 23:11:36 EST 2012;Committer;kosaki;3;83;60;143;0
3074406bbeaefbc7f90fe5dfd705d0d5249befc5;Fri Dec 14 23:11:26 EST 2012;Committer;kosaki;2;6;1;7;0
40f89c17e688d5b25e5dea93d8f4cc6ac61f744f;Fri Dec 14 21:18:00 EST 2012;Committer;drbrain;2;7;1;8;0
2d5fc17f140dfc99221e1eb2ccc5751df12ece5b;Fri Dec 14 19:25:29 EST 2012;Committer;kosaki;1;4;0;4;0
688f3ec67db55e8b7e063175672e8ac64b011ed7;Fri Dec 14 18:59:12 EST 2012;Committer;nobu;1;2;1;3;0
13b20230f9c01c94f6878f0aebfb86d659960234;Fri Dec 14 18:47:02 EST 2012;Committer;ngoto;2;8;0;8;0
a24f2d99155e20833f26d9bbc1d97bb0ae31a9c4;Fri Dec 14 18:08:40 EST 2012;Committer;kosaki;3;12;20;32;0
2d2cac4b05e6bc24e1d1a40b9d1a972732fe4fc9;Fri Dec 14 15:12:03 EST 2012;Committer;svn;1;2;2;4;0
cb92817e7cb41f31abf371dc162996554ab50f6a;Fri Dec 14 15:11:59 EST 2012;Committer;kosaki;2;11;1;12;0
c492bc127bb5e54cb7c00ed757dc309cf634def1;Fri Dec 14 08:11:03 EST 2012;Committer;nobu;1;1;1;2;0
5a565d5c4df425c9c591099cf750f123d432ba7a;Fri Dec 14 08:11:00 EST 2012;Committer;nobu;3;73;20;93;0
1d7f737553b2d7071fc4e28e4bfaf40778acf9a6;Fri Dec 14 08:04:55 EST 2012;Committer;shugo;2;23;7;30;0
72360463598453e7a79eb81a3974cbd2d20de016;Fri Dec 14 06:09:04 EST 2012;Committer;nobu;1;1;1;2;0
c97dc42bb0c7e4843639895c62ef3d5012632b9b;Fri Dec 14 05:59:17 EST 2012;Committer;nobu;2;10;3;13;0
2bd5113c8c91977c231dc5f806d0396c4ea0b3f8;Fri Dec 14 05:58:41 EST 2012;Committer;nobu;2;7;1;8;0
8adec52962b261ade1ec1d538d93ebeea69db5b2;Fri Dec 14 05:16:56 EST 2012;Committer;drbrain;5;77;30;107;0
1dfe3d93fa5d9ddabae8db067c5705ea6e551442;Fri Dec 14 05:09:37 EST 2012;Committer;drbrain;6;139;89;228;0
497f8904cb3f90a3abf5340a129811aceb96ee33;Fri Dec 14 01:38:14 EST 2012;Committer;naruse;2;10;1;11;0
1e7ef5882e18b318f68804aada885eee47045593;Fri Dec 14 01:38:12 EST 2012;Committer;naruse;2;6;2;8;0
bc2195e4fbf7281af3a0bd055d4263690d7aad9f;Fri Dec 14 01:38:07 EST 2012;Committer;naruse;2;23;0;23;0
2f0095e1abf1cdfe1d0cdabc0d24260f602810b2;Thu Dec 13 22:45:21 EST 2012;Committer;svn;1;2;2;4;0
8a4cc4e02a2dc161008f9df99dfe6fb9698de649;Thu Dec 13 22:45:16 EST 2012;Committer;tenderlove;3;15;0;15;0
3738ebe15aaedcf4cf38021ade61909c84707b93;Thu Dec 13 14:32:40 EST 2012;Committer;nobu;3;2;2;4;0
a4629a2ec5c0d975947fb7b18e67776639974e66;Thu Dec 13 14:18:20 EST 2012;Committer;shugo;2;11;0;11;0
c01f06089f233e74b9e4c0d41b395264da87062f;Thu Dec 13 14:11:01 EST 2012;Committer;charliesome;4;41;17;58;0
6b4687e6057bfcdb82e3530386a7011014fb2111;Thu Dec 13 09:41:17 EST 2012;Committer;shugo;1;1;1;2;0
d8c7695fbb2944aba9a69dce75f41b6881d1fc12;Thu Dec 13 07:58:47 EST 2012;Committer;drbrain;8;467;75;542;0
a0046fe94972ba4873244a1b985cb69f1685b5f3;Thu Dec 13 06:16:14 EST 2012;Committer;naruse;1;1;1;2;0
536ecb34773e31e9366e909243107f4a7140562a;Thu Dec 13 05:25:15 EST 2012;Committer;zzak;1;0;391;391;0
89833152381b759482d5e0ae9dcbdd9ed29a2b6a;Thu Dec 13 05:22:30 EST 2012;Committer;zzak;29;432;23;455;0
0ac361f54060a26f771d8751f06bbd1013db2016;Thu Dec 13 05:12:55 EST 2012;Committer;shugo;3;28;1;29;0
bfb08c1ece75101e36caef2a87ca74a3e07e92d4;Thu Dec 13 05:11:02 EST 2012;Committer;usa;2;6;1;7;0
3432474c906343d4a739a860c32371124def0349;Thu Dec 13 05:02:55 EST 2012;Committer;usa;2;10;0;10;0
06675418948d45f5448c7b722f1e7c990f5c89bc;Thu Dec 13 04:06:40 EST 2012;Committer;nobu;3;11;1;12;0
cd9d004e7ff8ec567bc10f067260ee4da33d028d;Thu Dec 13 03:50:19 EST 2012;Committer;nobu;1;11;1;12;0
2b73ea15f57dcc570e9e087c7b33b6a0ec5245b8;Thu Dec 13 03:38:00 EST 2012;Committer;nobu;1;2;2;4;0
3a6dec0c5daf568f4846f10fed9c115bc164871b;Thu Dec 13 03:09:22 EST 2012;Committer;shugo;3;15;1;16;0
14d72e66858fac7297e193d116ae7363b222b398;Thu Dec 13 02:28:02 EST 2012;Committer;svn;1;2;2;4;0
33fedef5a5e3b846c06cccefd9fef23485c7f8ba;Thu Dec 13 02:27:58 EST 2012;Committer;ko1;5;12;9;21;0
6f8bce9eff15b527c87e1b13312db2fbf0b504f4;Wed Dec 12 12:40:51 EST 2012;Committer;nobu;3;18;1;19;0
43f6fdfb42d3f4c9025c290bdf5aeffe5959f1bf;Wed Dec 12 10:51:49 EST 2012;Committer;naruse;12;84;32;116;0
395d7bb34624d69bf54e121a4f385ef84537e996;Wed Dec 12 10:06:29 EST 2012;Committer;naruse;1;3;1;4;0
75bed271f0719642f1866bdbbfa3c9940aad9abb;Wed Dec 12 09:35:50 EST 2012;Committer;shugo;3;82;0;82;0
a773539d3af48a8e95960fa1c98d0be790a6e529;Wed Dec 12 09:27:12 EST 2012;Committer;nobu;2;20;10;30;0
486795d95124c8d2bdaf4ae84a282e3879cb367c;Wed Dec 12 07:36:32 EST 2012;Committer;naruse;3;14;3;17;0
b3f491d3cb55b06029edf790ccf26cb6be50e28a;Wed Dec 12 07:08:06 EST 2012;Committer;nobu;2;11;5;16;0
3c4f8ce0921a5b64b77c5d6be69737f9dbf48d70;Wed Dec 12 07:07:25 EST 2012;Committer;nobu;5;28;4;32;0
9354b05e5cd4ee0fb0a6ed823145657eb4e68d55;Wed Dec 12 07:06:14 EST 2012;Committer;nobu;1;1;1;2;0
182ce60f7552ec62b1d97fbc3e701f9405b12291;Wed Dec 12 05:16:53 EST 2012;Committer;drbrain;6;54;4;58;0
f92db3dd73328b9743a91654453e51cdef19ea4c;Wed Dec 12 04:40:55 EST 2012;Committer;nobu;3;70;0;70;0
dcb6e7330699e2b4b476ab5caff8e3d0508c500c;Wed Dec 12 04:39:48 EST 2012;Committer;nobu;1;2;8;10;0
34fb7d783045dd4bb7b6dd49e6a1e922b7b947ff;Wed Dec 12 03:12:37 EST 2012;Committer;naruse;2;11;10;21;0
a52c63e420c6e30688f00790d39bb1f720b7be80;Wed Dec 12 00:42:26 EST 2012;Committer;naruse;1;7;6;13;0
0314f93ef402083ea5fd7cb2015f7a98cd0a3358;Tue Dec 11 21:44:49 EST 2012;Committer;eregon;4;46;14;60;0
64bbd55c85a3f3d7c88ba898d81e55f068e9eb7e;Tue Dec 11 21:17:37 EST 2012;Committer;naruse;1;3;3;6;0
63d0ea4c03616e1f6f7e4be41c5de4cbb0a3a68e;Tue Dec 11 18:45:43 EST 2012;Committer;nobu;4;15;3;18;0
8dafe8c88df357cc1a26a6b565bf9efa625da204;Tue Dec 11 18:09:10 EST 2012;Committer;nobu;3;12;3;15;0
a6455f2994994a44212eeb3693940065c5acbe7f;Tue Dec 11 17:13:18 EST 2012;Committer;naruse;3;27;2;29;0
b5e9c6cb903aa550713f5f5764964560f98e180f;Tue Dec 11 16:48:21 EST 2012;Committer;shugo;3;74;0;74;0
9f69bef99bdaf542e3cc93215bcf5e1dbba1b91b;Tue Dec 11 16:18:01 EST 2012;Committer;naruse;2;11;3;14;0
a1a5c879f74720d729f1c6f5db994ad0d2905345;Tue Dec 11 15:44:22 EST 2012;Committer;ngoto;2;38;19;57;0
ef12c29f3c3b9717606ff44c95f318a520e0c86e;Tue Dec 11 15:24:35 EST 2012;Committer;svn;1;2;2;4;0
1fcde7c2e2bd780fc3bf4bf98fad7054177de5aa;Tue Dec 11 15:24:31 EST 2012;Committer;ngoto;3;71;0;71;0
80e1f46ff07436b3c95624046f50667dde6b7da6;Tue Dec 11 12:38:42 EST 2012;Committer;kazu;1;1;1;2;0
3e6a624a8346ca0c26a292676adb4d0595090f09;Tue Dec 11 10:41:00 EST 2012;Committer;ngoto;4;33;8;41;0
16af9a107e8307567e2e1154328e9d24d9886803;Tue Dec 11 09:31:26 EST 2012;Committer;kazu;2;8;8;16;0
52d4a465a8cafe5b2a09647ff117ad4d425840ce;Tue Dec 11 07:57:56 EST 2012;Committer;drbrain;4;12;5;17;0
b65b75bf2ce955dc8f5fb589732927acc8b72c29;Tue Dec 11 07:44:56 EST 2012;Committer;drbrain;5;107;1;108;0
d5ba73e0d9fd2fb9d1c787247c8755fa8ccc8404;Tue Dec 11 06:25:56 EST 2012;Committer;drbrain;2;13;9;22;0
10c014b06d293314da37ec2171b3b20e64cbd670;Tue Dec 11 06:13:43 EST 2012;Committer;naruse;2;10;0;10;0
55058e3583a177ad86deef7c0128f777e4be0f24;Tue Dec 11 06:13:41 EST 2012;Committer;naruse;2;1;6;7;0
b949447a495ee1438e6a483a20631ab855c7e68f;Tue Dec 11 03:37:19 EST 2012;Committer;nobu;2;3;1;4;0
4a0cda64b2fb743b1cdcd00d2b57e452835d99e4;Tue Dec 11 03:37:16 EST 2012;Committer;nobu;1;1;0;1;0
addefaa6a3ee7308b031e843ce222d99d218d1c4;Tue Dec 11 03:02:04 EST 2012;Committer;naruse;2;7;1;8;0
0ab057280cee1b67b83bd4e9b1e9a8f5806c7bf1;Tue Dec 11 02:58:54 EST 2012;Committer;naruse;3;2;27;29;0
381b72da1202557b5670f39241c783658915a3da;Tue Dec 11 02:38:20 EST 2012;Committer;naruse;2;6;1;7;0
20d68c92ca089156e7b216ce823b699fce3410ea;Tue Dec 11 02:32:35 EST 2012;Committer;naruse;1;0;5;5;0
4eb272e83c3872504bce29daa967778e1e4a8419;Mon Dec 10 16:57:23 EST 2012;Committer;naruse;1;2;0;2;0
8aac5f48fc96c4aa76d4758d8c873f3e2cb6de90;Mon Dec 10 16:53:57 EST 2012;Committer;marcandre;4;124;116;240;0
4c02cff191df87992a1c18d39f85693ec0de6597;Mon Dec 10 16:05:50 EST 2012;Committer;svn;1;2;2;4;0
7ef16d224a80a6e1e8c01b5b45ac7e2315a04e4c;Mon Dec 10 16:05:45 EST 2012;Committer;shugo;6;132;7;139;0
fa7c4ab4084ac6d5ad615d133ab0dcaca2c817fb;Mon Dec 10 13:02:54 EST 2012;Committer;shugo;3;29;1;30;0
a263a8567a3c0ea3bdd3b3fc10f0880aa23d85b3;Mon Dec 10 09:27:28 EST 2012;Committer;naruse;1;3;0;3;0
0e7fd84774441a2dadbaa6d58b324685567a67f5;Mon Dec 10 09:03:17 EST 2012;Committer;nobu;1;3;3;6;0
f9aa334b5be35ebf5f6dea4f995b7f2a78d1b192;Mon Dec 10 09:01:27 EST 2012;Committer;usa;5;1236;1;1237;0
13e83d055ffba19d4db9ed56a80b8bfd849354fe;Mon Dec 10 06:23:44 EST 2012;Committer;nobu;4;22;9;31;0
c9b4b78085ee07fa6cae4a267fa5dff80d6351a4;Mon Dec 10 06:11:16 EST 2012;Committer;nobu;7;50;22;72;0
2ffc29e8644f2aff66f373573299b33618b145f7;Mon Dec 10 05:05:32 EST 2012;Committer;nobu;1;1;0;1;0
fa8c97438fcb124dd4ffd27e3631ca0ac54197a6;Mon Dec 10 04:32:11 EST 2012;Committer;nobu;1;1;1;2;0
2b8485bc89d8f79dc33e635a006d5230414b3506;Mon Dec 10 04:18:13 EST 2012;Committer;nobu;2;7;4;11;0
08b98cc317801f7ec836472524b8150ac4dbd3b4;Mon Dec 10 04:18:11 EST 2012;Committer;nobu;1;1;0;1;0
f9e4651039f2095f9c9aec00edcabfcd9b3d01db;Mon Dec 10 02:50:57 EST 2012;Committer;nobu;1;2;0;2;0
bb87365711b20d23f7a5622242f5dbee4d2a4200;Mon Dec 10 02:50:12 EST 2012;Committer;nobu;1;10;8;18;0
f04dd0f08b20ce48cc10fa88bab08b1941b3c558;Mon Dec 10 02:06:51 EST 2012;Committer;nari;2;8;1;9;0
f58ff1ba12a0bbd52ff59e2e8b780004c5edfe9e;Mon Dec 10 00:40:39 EST 2012;Committer;drbrain;5;108;0;108;0
a16cf580b0e330e746f287b6d75160b8e6bd9a55;Mon Dec 10 00:13:46 EST 2012;Committer;svn;1;2;2;4;0
91998d694c41a93d2b545f7e1f1ec80b6a7d9de9;Mon Dec 10 00:13:42 EST 2012;Committer;drbrain;3;11;2;13;0
0c0496ebd2a61f1d9b115209b0aa314a9dee60a8;Sun Dec 09 14:34:33 EST 2012;Committer;nobu;1;4;1;5;0
29756c5e94c6f273c6b1a1103d9c0b12570566ea;Sun Dec 09 08:48:34 EST 2012;Committer;shugo;6;44;12;56;0
1cf13e078593c31aec06e4749287aceab989baf6;Sat Dec 08 21:19:26 EST 2012;Committer;svn;1;2;2;4;0
4eaf05c847bd32d246968b68c8d6c88381ce5c01;Sat Dec 08 21:19:22 EST 2012;Committer;drbrain;5;28;6;34;0
54fce8119a4697638ec1c37104f6b9d5d7cfe0c2;Sat Dec 08 13:41:16 EST 2012;Committer;shugo;2;6;32;38;0
4363d0765b802e0f8322fceeb282aa1c0d3f3e8b;Sat Dec 08 13:35:15 EST 2012;Committer;shugo;3;8;93;101;0
bdb8607cb7549f8555fed781392231ead86d984b;Sat Dec 08 13:35:12 EST 2012;Committer;shugo;3;38;0;38;0
537030e19b98cb99d161eff292a33fbdeea19a93;Sat Dec 08 07:06:24 EST 2012;Committer;marcandre;1;5;1;6;0
75894547f50888b86f15c118b6e047d8b9a94a74;Sat Dec 08 06:01:49 EST 2012;Committer;drbrain;37;593;202;795;0
ee68f78c2462908882e3394f8a91631ec4a45beb;Sat Dec 08 03:36:58 EST 2012;Committer;shugo;3;19;4;23;0
d928280cb6644d2d899aadf7bfc8cf4e1b5e2997;Sat Dec 08 03:06:13 EST 2012;Committer;shugo;4;24;3;27;0
db051011d68950cd1261f91e724513282d419d9e;Sat Dec 08 02:37:16 EST 2012;Committer;shugo;6;159;96;255;0
3adc9834d18ee6ff67dfca060eee170025ce3fef;Sat Dec 08 00:26:56 EST 2012;Committer;drbrain;2;102;7;109;0
1c9e3155959ff0841c57b89a40fa47f2099c4732;Sat Dec 08 00:24:35 EST 2012;Committer;nobu;1;16;16;32;0
1c5b309211c8d41b2624766fdeb60cc5fa3faf94;Sat Dec 08 00:18:42 EST 2012;Committer;ko1;3;25;1;26;0
5b1065f3fee2a3cb0095a28a5bedaa3f74f09a5b;Fri Dec 07 17:42:16 EST 2012;Committer;jeg2;3;27;18;45;0
0dc6b83935ce6b35d8443f51b787ac2300197c12;Fri Dec 07 16:27:32 EST 2012;Committer;nobu;2;6;1;7;0
8978ec05dc2b88cc6ca3593798a2ff65e8c677a6;Fri Dec 07 15:49:26 EST 2012;Committer;svn;1;2;2;4;0
537297d1cbcd2ed97488774e67c4fc001282a658;Fri Dec 07 15:49:21 EST 2012;Committer;shugo;6;96;502;598;0
c36d15f206f83100ef1fc8f2bd3b23116c0ee6a1;Fri Dec 07 14:44:02 EST 2012;Committer;shugo;2;7;7;14;0
3bbffbc7dd024179777192950ac07b9ef6ca2968;Fri Dec 07 10:36:59 EST 2012;Committer;kosaki;4;18;106;124;0
65129f3a5dfbfd820f9ad96268f6992f667efe8d;Fri Dec 07 07:10:10 EST 2012;Committer;zzak;1;0;347;347;0
a756aa75ea9a8cd21264864d3cb81b7f13e43a8c;Fri Dec 07 07:08:06 EST 2012;Committer;zzak;3;183;158;341;0
8b2a4e68c38c50b0a5d658ea101d9933dfd3de53;Fri Dec 07 07:03:45 EST 2012;Committer;usa;2;9;3;12;0
85e3560a3bfb1652128d3336400f852b863f6c07;Fri Dec 07 05:22:50 EST 2012;Committer;drbrain;9;381;25;406;0
08f0db2c68a9e306f3a637e9d32d9e7b8b1f2e92;Fri Dec 07 05:04:02 EST 2012;Committer;nobu;3;21;14;35;0
9dd64b6053685a4db7d4e60d16b0fc090384dae0;Fri Dec 07 05:02:21 EST 2012;Committer;nobu;1;1;1;2;0
13d3f023c6db44ffafeb5845516086b6b3f44d39;Fri Dec 07 05:02:18 EST 2012;Committer;nobu;6;23;23;46;0
97de2b36e92cc4efec081c51aea62ff40e8c1b56;Fri Dec 07 04:39:39 EST 2012;Committer;ngoto;1;1;1;2;0
a297576c375d1543748f228805619d4d02fc952e;Fri Dec 07 04:35:43 EST 2012;Committer;ngoto;1;1;1;2;0
2db4ac6e2bdae58574438fc3081d5f1fda7fa430;Fri Dec 07 04:21:20 EST 2012;Committer;zzak;1;5;0;5;0
5452c2d625a7ce337a81c2c88e7fdf6c453c5b42;Fri Dec 07 04:08:29 EST 2012;Committer;zzak;2;62;158;220;0
3c0f66570cec6ce2eb7e60d2dfef80ad0cff2878;Fri Dec 07 02:58:55 EST 2012;Committer;naruse;1;1;1;2;0
1bb1d096fbd5d5b79539aa5ff9bf53bca87fe686;Fri Dec 07 02:55:35 EST 2012;Committer;naruse;3;33;2;35;0
68300e95545d9b7d9c2c7a922cc6377a42c1f8a1;Fri Dec 07 02:55:33 EST 2012;Committer;naruse;1;1;1;2;0
b03c751e9494df2a7735a7907320c74705b0b4b0;Fri Dec 07 02:55:30 EST 2012;Committer;naruse;1;5;5;10;0
811efc8276e9ffd6adf95d8e954d8cac40ed49ef;Fri Dec 07 02:55:28 EST 2012;Committer;naruse;1;7;0;7;0
0bc733d9e3cf49c67b79a120ba08f1433ce82c7b;Thu Dec 06 16:21:43 EST 2012;Committer;ngoto;3;17;2;19;0
5f912e7e2fe9e952f07abdd850e24f61afaa9c56;Thu Dec 06 15:12:41 EST 2012;Committer;svn;1;2;2;4;0
d87b56c411304260b269e475a0c4b40dd30d1962;Thu Dec 06 15:12:36 EST 2012;Committer;shugo;2;90;75;165;0
328e0ff5ad47c4d88aeeb6341fe66b33b4bb8b37;Thu Dec 06 14:31:43 EST 2012;Committer;shugo;5;44;6;50;0
34592fb5b6798b15a3fbc1dd62ad5e0250411f52;Thu Dec 06 14:30:24 EST 2012;Committer;ngoto;1;5;3;8;0
382217c8b6633fc6a6c8dbf1173ff491ab86da25;Thu Dec 06 14:27:38 EST 2012;Committer;ngoto;1;2;0;2;0
60d6038ddaa6678ddcd7ce96ca6c947494b227a6;Thu Dec 06 13:08:41 EST 2012;Committer;shugo;14;445;181;626;0
bd0c636211bb3063d9633d955f8807a1d9490048;Thu Dec 06 08:29:16 EST 2012;Committer;nobu;3;33;11;44;0
68a44cd169e5c9c1d2150e1f3932da8c4cb2c013;Thu Dec 06 08:25:50 EST 2012;Committer;nobu;1;39;39;78;0
d3a2aa40042e5c7fce409866a65e815c23ad2f70;Thu Dec 06 08:25:45 EST 2012;Committer;nobu;1;2;2;4;0
9b76b5057cb3f8344332f1dad0bf739c24d4381f;Thu Dec 06 07:35:45 EST 2012;Committer;drbrain;4;13;6;19;0
854758c464e6cdba06eed5d05b7fe10c33788c89;Thu Dec 06 06:20:50 EST 2012;Committer;drbrain;3;37;5;42;0
80ba379c242ce1d92005403423717cf0f74a74db;Thu Dec 06 05:26:46 EST 2012;Committer;drbrain;12;48;35;83;0
afae107a4c969845c58985159a0ce51f80e920ca;Thu Dec 06 05:13:08 EST 2012;Committer;drbrain;10;76;16;92;0
5ffc1a3aaa5f63465fb210d08070e380c67916dc;Thu Dec 06 04:57:20 EST 2012;Committer;zzak;1;1;1;2;0
c2f5a574034cacd938d5af888646585c850f2747;Thu Dec 06 03:13:50 EST 2012;Committer;ko1;3;57;26;83;0
54c40f3db59d6875de0c2c0f47ab7edce0bd3f43;Wed Dec 05 22:20:15 EST 2012;Committer;drbrain;9;136;14;150;0
fe6b2e20e9f17ed2c2900aa72994e075ffdc7124;Wed Dec 05 19:37:49 EST 2012;Committer;kosaki;5;78;15;93;0
def63c3466939161f2459f6489815b444bbde8a3;Wed Dec 05 19:37:37 EST 2012;Committer;kosaki;3;29;0;29;0
84cfe8f8d669c3b8bdadc8a819d6482b890c5e24;Wed Dec 05 16:10:41 EST 2012;Committer;nobu;3;28;10;38;0
cfc2103108bdc8c5b9ad2bc859bfd2699c921131;Wed Dec 05 16:07:27 EST 2012;Committer;nobu;1;26;0;26;0
ce48e9a9301c517f99b85e225dd73b72a0833956;Wed Dec 05 15:53:27 EST 2012;Committer;tarui;2;7;2;9;0
61f46bafa47df9d5aa9bd79b565a3d8bf44b946c;Wed Dec 05 15:48:11 EST 2012;Committer;kazu;2;4;3;7;0
1b648d04673813185cd92653813905ebcf3bd9aa;Wed Dec 05 15:34:11 EST 2012;Committer;naruse;1;36;32;68;0
05db61c25daa2192b625ad04771c82ee4b12867d;Wed Dec 05 15:12:58 EST 2012;Committer;naruse;1;2;2;4;0
7424e9e8dd6a08fadc1abcf3e7cf3476a9a724b8;Wed Dec 05 15:04:16 EST 2012;Committer;svn;1;2;2;4;0
a400c94d7272d29f09b16c059bb9ca3b34bd398f;Wed Dec 05 15:04:09 EST 2012;Committer;kosaki;4;111;30;141;0
4a572d5bb46451f171c30e09f88a2dcf67478006;Wed Dec 05 14:56:58 EST 2012;Committer;nari;1;1;0;1;0
ab012bda4a0bdfb720fdf4debbf401f6923f401f;Wed Dec 05 14:53:16 EST 2012;Committer;nari;2;14;1;15;0
31e6f72c8ea0990ca7acdfc7b99b89abd4566f0b;Wed Dec 05 13:46:11 EST 2012;Committer;nobu;3;22;1;23;0
1bddcc72f6e6f7cd5708d9ae34aa3b4a6bbde6c1;Wed Dec 05 13:35:05 EST 2012;Committer;kazu;2;3;3;6;0
9920da55936adc025fb65bc00d2973cf0d952d87;Wed Dec 05 13:24:19 EST 2012;Committer;ngoto;3;18;0;18;0
17a11774ca9bc79609128187e3b6c814bd590ce5;Wed Dec 05 09:54:58 EST 2012;Committer;tarui;3;39;2;41;0
592e87e1f8cbe257f8f11d703c1315b033537b6c;Wed Dec 05 07:56:07 EST 2012;Committer;ko1;2;13;2;15;0
16c34f9df081765042a37e02bfbc949329fb78f8;Wed Dec 05 07:07:28 EST 2012;Committer;drbrain;3;113;34;147;0
8d7e3c6abac0227a6bdc4990893a3e740f9df795;Wed Dec 05 06:30:39 EST 2012;Committer;nobu;1;14;0;14;0
34dc263af894ece623b99f1138eccf4f5b806724;Wed Dec 05 06:30:36 EST 2012;Committer;nobu;1;14;6;20;0
228d36fb359650d010433ea6db6f7b76e9d8a3a7;Wed Dec 05 06:30:34 EST 2012;Committer;nobu;1;1;1;2;0
94cb1c9b4bef8736212e78aae6dbe8304a69e4ae;Wed Dec 05 04:08:17 EST 2012;Committer;nobu;11;25;25;50;0
1dd7e5690cf8dd9e3aadee2152f8af387009f6f8;Wed Dec 05 03:59:39 EST 2012;Committer;nobu;1;45;0;45;0
f1841f43eb9d7ec45bcbee7f70abae77d999f76d;Wed Dec 05 03:20:05 EST 2012;Committer;ngoto;4;63;10;73;0
342d2f2aa6037bd126c2247c6c6b9bf97f8c42bd;Wed Dec 05 02:55:07 EST 2012;Committer;zzak;5;324;116;440;0
895bb667b294ab2b762c83373c320a5bbf94dd3f;Wed Dec 05 02:43:31 EST 2012;Committer;ko1;2;9;0;9;0
1692d4933845fad2f35fd949e9473688029da00b;Wed Dec 05 02:37:41 EST 2012;Committer;nobu;3;41;1;42;0
1d50afc2a201dbac64caed4df35b6ff44c1fc38e;Wed Dec 05 02:00:01 EST 2012;Committer;kazu;1;5;5;10;0
df8d84bb73c4476c25831e1456e1a08f7c700f4f;Wed Dec 05 01:23:03 EST 2012;Committer;nobu;1;0;1;1;0
32a75432b6436bf6d39424535556c751470ba9c1;Tue Dec 04 19:24:37 EST 2012;Committer;zzak;2;98;91;189;0
9f9380edf0ea13328281dec7a36598cf8282729d;Tue Dec 04 19:11:42 EST 2012;Committer;tarui;1;2;2;4;0
afa3ce2518feafcb412a2f007be8e08900ef26ef;Tue Dec 04 19:06:46 EST 2012;Committer;tarui;2;7;1;8;0
64f634f1de8581e398843b2f178827dbcaa90a30;Tue Dec 04 18:38:21 EST 2012;Committer;tarui;4;53;9;62;0
28ee4c296680e9131c6d7869d0fd523738af2b89;Tue Dec 04 17:36:19 EST 2012;Committer;nobu;7;94;95;189;0
01380620bdbe1afe848e91fc953dc345a39a1188;Tue Dec 04 16:08:05 EST 2012;Committer;usa;1;2;2;4;0
70d603a41274c873183abcfb83dabfcaa3caf95c;Tue Dec 04 16:06:43 EST 2012;Committer;kosaki;1;2;2;4;0
3765f668c616c1ef2b8d4feb9195fb2c62e96c3d;Tue Dec 04 16:05:40 EST 2012;Committer;kosaki;1;1;1;2;0
bbfbf662cceb6e7d8dc769ca365c563b9c073592;Tue Dec 04 16:02:07 EST 2012;Committer;kosaki;4;63;0;63;0
1bdf339516c9886db6f950da6f5506c4f94baa65;Tue Dec 04 15:10:23 EST 2012;Committer;svn;1;2;2;4;0
d8164d50c907b1908b578965af1a1ecf5a19d852;Tue Dec 04 15:10:17 EST 2012;Committer;seki;2;25;16;41;0
784019f7400b5c1af123a9af1ab113906effffc6;Tue Dec 04 14:54:21 EST 2012;Committer;nobu;1;0;2;2;0
34422887c2e42866680d289a7207ea4b8cff48fe;Tue Dec 04 09:55:07 EST 2012;Committer;ngoto;2;19;4;23;0
b6b8960018dd87fca321be2b701be7cc934f312d;Tue Dec 04 09:08:12 EST 2012;Committer;ngoto;2;76;0;76;0
7b103012dc9fa53f138ea7aa6db9133a3f02081b;Tue Dec 04 09:00:23 EST 2012;Committer;ngoto;2;18;3;21;0
b2e6a26a37b3a97b725c69087a6384c0e6fc0bde;Tue Dec 04 08:39:59 EST 2012;Committer;kazu;1;4;4;8;0
95ae31b70bc73282f65ff37534f012c48d6c02c2;Tue Dec 04 07:54:13 EST 2012;Committer;drbrain;2;8;4;12;0
38b9667310d7d0cc0184c199fd870bfc8990eab4;Tue Dec 04 07:50:48 EST 2012;Committer;drbrain;4;329;0;329;0
086fce313553e31a22b95719eef34dbc7b775332;Tue Dec 04 07:24:21 EST 2012;Committer;nobu;1;1;1;2;0
cfa4a59da811ba9c0cfdf53e525dd234d2c4446d;Tue Dec 04 07:23:34 EST 2012;Committer;nobu;2;5;5;10;0
dd2eb69457e48c6c4ffaffac6afe66e5dab19937;Tue Dec 04 07:23:25 EST 2012;Committer;nobu;2;13;14;27;0
2974b00f1713156528db1d482cf247c1c37c7ceb;Tue Dec 04 07:23:20 EST 2012;Committer;nobu;3;21;9;30;0
d3842de5c9baa2962e01d02b2499eac49d9065a6;Tue Dec 04 04:57:50 EST 2012;Committer;ko1;4;27;50;77;0
51ee08fd7128639ecb82997612b028ba94ba8c3d;Tue Dec 04 01:01:37 EST 2012;Committer;naruse;1;1;1;2;0
f68ab200449715adbe11d78cd028592410dd4b4c;Tue Dec 04 01:01:34 EST 2012;Committer;naruse;2;27;22;49;0
56fca7f141c2a911ad96df56fed0b9bdf657930e;Mon Dec 03 23:34:17 EST 2012;Committer;drbrain;3;1038;994;2032;0
ec05ade5312881296891949e05afa3ace8754207;Mon Dec 03 23:32:39 EST 2012;Committer;drbrain;3;38;1;39;0
f8f5a9eb4e628814803f98bceb9e4437241a7746;Mon Dec 03 19:12:03 EST 2012;Committer;drbrain;7;33;10;43;0
943da6d279f38b59f014e2954ddccbd5896182c3;Mon Dec 03 15:08:07 EST 2012;Committer;svn;1;2;2;4;0
2c5c076009b7508ba2165327f98405553e59b801;Mon Dec 03 15:08:00 EST 2012;Committer;kazu;1;1;1;2;0
ef0003a448b32a17f068db35eeef20f4e8201f89;Mon Dec 03 14:55:13 EST 2012;Committer;nagachika;1;1;1;2;0
9975712793a8289e229d7f9fe23c8df77e1005ae;Mon Dec 03 11:38:43 EST 2012;Committer;ko1;2;6;0;6;0
5c582807731b675012647e0f7d9ad8bae937053b;Mon Dec 03 11:33:09 EST 2012;Committer;ko1;2;8;0;8;0
41d77571ff4cb3e6ccf238cf63bfdc3c50fc1564;Mon Dec 03 11:06:21 EST 2012;Committer;ko1;2;11;1;12;0
010b6e6a38540f5e2e98c9f6053ae0f550d09af6;Mon Dec 03 11:02:47 EST 2012;Committer;ko1;1;1;1;2;0
fcc557a8f48de33fb686025624aad0cedc0c7183;Mon Dec 03 11:00:37 EST 2012;Committer;ko1;2;5;1;6;0
fcbd6db87d003ff14c4bc968b81fa99bd8260e64;Mon Dec 03 10:22:15 EST 2012;Committer;nobu;1;3;2;5;0
d4736bcf4d329d556f8646585abd00c9370f1300;Mon Dec 03 10:21:46 EST 2012;Committer;nobu;1;2;1;3;0
4d73f950682736914ae1a1935b0d224ffeb5ba9c;Mon Dec 03 10:10:14 EST 2012;Committer;nobu;4;14;9;23;0
c4f9dd26263da640a2c9a02c478df245685e2b69;Mon Dec 03 10:03:25 EST 2012;Committer;ko1;3;27;6;33;0
17a2be29b91b971d28f4d0f2381973ee65fc13c4;Mon Dec 03 09:25:19 EST 2012;Committer;nobu;2;8;4;12;0
1d193d9251fb5cc58f1b4ac3346ac63529d63097;Mon Dec 03 07:23:57 EST 2012;Committer;ko1;2;8;1;9;0
9def7828895b4a119bb1504019ea5c7501255272;Mon Dec 03 06:58:29 EST 2012;Committer;knu;1;6;6;12;0
ca4a5bd9d723e3e78465de008d41d35e4cc12ce8;Mon Dec 03 06:52:47 EST 2012;Committer;knu;2;8;3;11;0
38766319e181e6cdbd3f7bb14f8cc9736f4d6c9e;Mon Dec 03 05:14:50 EST 2012;Committer;ko1;4;17;10;27;0
983c2e874f2c5e12fa29d3c66d077aa232092834;Mon Dec 03 03:43:40 EST 2012;Committer;nobu;3;34;9;43;0
488fb86a1eb3307030c8d4c0946ea080205b78f3;Sun Dec 02 22:52:57 EST 2012;Committer;drbrain;3;30;2;32;0
28f6b32e7e31017a9ca2bd5497e142a0f5ee7b7c;Sun Dec 02 15:09:54 EST 2012;Committer;svn;1;2;2;4;0
1fec21fe601c60c347d03dbd8f9ad83b0db677a4;Sun Dec 02 15:09:49 EST 2012;Committer;mrkn;3;20;2;22;0
c1e6052bfec1e621c3d2eda598b7f69270e176b8;Sun Dec 02 10:28:27 EST 2012;Committer;tarui;3;19;15;34;0
f6f388a5bdbd3d3a68bf18f3352ba2be12688639;Sun Dec 02 09:57:47 EST 2012;Committer;ko1;10;38;24;62;0
d64a73e1ddba8706617205dab4e640f5ce7191b0;Sun Dec 02 08:56:27 EST 2012;Committer;tarui;2;5;7;12;0
1e88b393e07f76e548eb7377d81e8834abdfaa33;Sun Dec 02 08:45:14 EST 2012;Committer;tarui;2;7;5;12;0
c5824f38adf2707ca2c64fdc6f2eaa42826ac8ab;Sun Dec 02 07:57:45 EST 2012;Committer;zzak;1;1;1;2;0
98eaac15ffbe51836ce13d6c8bd5bb85e6d2219b;Sun Dec 02 07:48:42 EST 2012;Committer;zzak;2;62;6;68;0
5c4e025f6fae3e51f3c69f1992152d91b5f2a3d3;Sun Dec 02 07:45:17 EST 2012;Committer;zzak;2;8;1;9;0
9b711fc731426beb01e98cb39611a4bfbde0036f;Sun Dec 02 03:30:02 EST 2012;Committer;kazu;1;1;1;2;0
8f7a275c6750b233164e742c013f26969777ac87;Sun Dec 02 02:47:19 EST 2012;Committer;tarui;1;1;1;2;0
f242cefc68e8755493a50aaf2a30943e85994d6d;Sat Dec 01 22:24:53 EST 2012;Committer;drbrain;3;67;1;68;0
2ba9cdcee6b0b97999c74c6fb19cdae08edd0e25;Sat Dec 01 21:15:01 EST 2012;Committer;kosaki;2;7;2;9;0
5bdd03936c2a7fb5c835587535466ec76bf0ca9e;Sat Dec 01 20:07:58 EST 2012;Committer;ko1;3;31;9;40;0
921385a6443338d6150e71acf0806108294c1c9a;Sat Dec 01 17:47:37 EST 2012;Committer;ko1;3;87;0;87;0
e78cf44a99b37c8f0f53844b0c0acbd073067bae;Sat Dec 01 15:26:52 EST 2012;Committer;nobu;1;1;1;2;0
d9254071eaef8dece23938edf92e9e4004cc5e85;Sat Dec 01 15:25:34 EST 2012;Committer;svn;1;2;2;4;0
17b19ca0f8c61c2e955a3a040965dcbab70a03b3;Sat Dec 01 15:25:31 EST 2012;Committer;nobu;1;1;0;1;0
66fd9d44d87240164588b42c887b6e3d6ee99308;Sat Dec 01 15:25:28 EST 2012;Committer;nobu;14;44;47;91;0
82b1bfe417120de96737de88f406e1b877cef5f7;Sat Dec 01 14:22:11 EST 2012;Committer;nobu;1;5;2;7;0
0efa7abc40cb8008c030ca65c6ad404a81cf19e9;Sat Dec 01 13:54:57 EST 2012;Committer;nobu;1;1;3;4;0
3faee6520e582a866a2c306fe8725ba31e56cbda;Sat Dec 01 13:54:54 EST 2012;Committer;nobu;2;6;22;28;0
ccebd9b016c31d3c5f7ed55eb60066fa9425a439;Sat Dec 01 13:35:32 EST 2012;Committer;nobu;1;4;1;5;0
095022cbe91ff03af27c19bbe47a819e1323f004;Sat Dec 01 12:19:52 EST 2012;Committer;ko1;2;15;0;15;0
c906e879d8e83263752a25faf34cc102a7b2e60e;Sat Dec 01 12:09:17 EST 2012;Committer;ko1;2;13;0;13;0
01eb117b01576e5b8386af5b6b425655f314888c;Sat Dec 01 10:24:12 EST 2012;Committer;nobu;3;22;5;27;0
af4ceeff105003cbb124c420898121742ed66bd7;Sat Dec 01 10:06:59 EST 2012;Committer;nobu;1;1;0;1;0
4f0c9b2bc65a715b44d18bda5ffb44605977bba0;Sat Dec 01 10:01:40 EST 2012;Committer;nobu;2;20;12;32;0
4090ec1017d3b41a6589858f2f2be484a1d6d041;Sat Dec 01 09:52:39 EST 2012;Committer;drbrain;4;30;12;42;0
018d8261ce66724c16a9b91c70d71ce60ca6c6cf;Sat Dec 01 09:30:24 EST 2012;Committer;nobu;1;5;5;10;0
9c1b3161f20162dc1682d758c0e4d2fc3a74745e;Sat Dec 01 09:17:02 EST 2012;Committer;nobu;4;12;9;21;0
82ec3de020fb765d3d1ad8422744e39bba0f4106;Sat Dec 01 09:16:57 EST 2012;Committer;nobu;3;8;4;12;0
cf9d17a3d3cad278f4eeb7aeebc8faaa7c1b845a;Sat Dec 01 09:16:52 EST 2012;Committer;nobu;5;28;1;29;0
89ff44e22e737b1138954e482602c5f2ef9d08f1;Sat Dec 01 08:29:09 EST 2012;Committer;kosaki;3;196;168;364;0
afbbcd133ce38bf6749d8a431d08cf1c4bf732c7;Sat Dec 01 08:28:56 EST 2012;Committer;kosaki;2;23;12;35;0
1f1db611b9860291454f38459f2aed33e0877d84;Sat Dec 01 08:28:44 EST 2012;Committer;kosaki;3;15;25;40;0
f9aef18497c42d704657566ab2f99b089dea01ae;Sat Dec 01 08:17:05 EST 2012;Committer;nobu;2;6;1;7;0
5852d901b5dc8c128a53285297f094f925f29c1b;Sat Dec 01 08:13:04 EST 2012;Committer;nobu;2;8;1;9;0
214938f1033713adcef145758a8128748ab63e4d;Sat Dec 01 08:08:19 EST 2012;Committer;nagachika;1;1;1;2;0
0f37c95134cf66b03fa81de743884e301d871685;Sat Dec 01 06:05:33 EST 2012;Committer;nobu;2;18;12;30;0
6e46c0485022917576837a3daafa3e05a9d1166f;Sat Dec 01 04:48:36 EST 2012;Committer;drbrain;2;7;0;7;0
f593911dbe7dc70d53c7626db75cb63ee7421803;Sat Dec 01 03:58:39 EST 2012;Committer;nobu;1;4;4;8;0
946ab45d6531a5427c8c62ba74c0b25d3cc62f3d;Sat Dec 01 03:57:43 EST 2012;Committer;nobu;1;2;2;4;0
bfd5921e5d83b4ba473fe44b48b8bfea3ee22269;Sat Dec 01 03:35:36 EST 2012;Committer;kou;3;110;12;122;0
3f50943b0378e32aef13a93f14dfacebdf5b0a1c;Sat Dec 01 03:30:55 EST 2012;Committer;nobu;1;4;0;4;0
afb02bbe92e55f877d50ed8705c95a41d541458d;Sat Dec 01 02:13:06 EST 2012;Committer;tenderlove;9;178;69;247;0
d3c6187a4d968549b689757bb360e482bd881e07;Sat Dec 01 00:49:20 EST 2012;Committer;drbrain;2;6;1;7;0
5db8f999431b22b31c4feecbabb498047bc3e6d2;Sat Dec 01 00:42:36 EST 2012;Committer;drbrain;3;61;2;63;0
18a3774438469b6da3f44635e38c8b00f36c4cd7;Sat Dec 01 00:34:01 EST 2012;Committer;drbrain;2;7;9;16;0
7c407e2a338c75005e510afe28ef96916b8afa59;Fri Nov 30 22:29:13 EST 2012;Committer;shirosaki;2;8;1;9;0
1b6c1cb61ef259fba05510f6ec3a4db3ef23286a;Fri Nov 30 20:13:40 EST 2012;Committer;drbrain;1;1;1;2;0
b1920c034b3bdd7421d2629c57a963d1878d0e1b;Fri Nov 30 19:10:17 EST 2012;Committer;naruse;2;10;5;15;0
b1b7c389fbea8da2989a241f4f067f73f2bb8e7d;Fri Nov 30 19:10:14 EST 2012;Committer;naruse;1;7;1;8;0
9207474f04b9aa6e60f1d0799a4afbd908e9dac7;Fri Nov 30 19:10:12 EST 2012;Committer;naruse;2;3;3;6;0
8539a917ddf13e48237bf9a10eb8b660dbba4628;Fri Nov 30 19:10:05 EST 2012;Committer;naruse;1;1;1;2;0
c62ec3ae1aa5ac3b3f7f2756763a41c5703c06ca;Fri Nov 30 18:55:28 EST 2012;Committer;kosaki;2;29;20;49;0
028ca79f986448221361bf2e9c16ec9c3e3b734b;Fri Nov 30 18:55:18 EST 2012;Committer;kosaki;2;7;2;9;0
3357d88ada8ad44ecf267f5f2a1fb1df4e5cb8f4;Fri Nov 30 18:55:09 EST 2012;Committer;kosaki;3;58;58;116;0
e742a446c8864e3988537d06022312c708f9e176;Fri Nov 30 18:47:00 EST 2012;Committer;ko1;2;11;6;17;0
5697f69baa942ae117c66322bca0088cbb38557f;Fri Nov 30 18:02:43 EST 2012;Committer;ko1;3;105;18;123;0
57a83c4c9ac1de6da5184972cc10e33f44f6f747;Fri Nov 30 17:59:06 EST 2012;Committer;drbrain;2;6;1;7;0
646eeab1130f4b78b6673452e87b824b9bf5a5e2;Fri Nov 30 17:54:00 EST 2012;Committer;drbrain;2;9;3;12;0
a113ab64b23c430a944e639d0535529707540790;Fri Nov 30 17:39:59 EST 2012;Committer;kosaki;2;38;44;82;0
279cd29b1b544cba09f5839d4abce81ab322d2c6;Fri Nov 30 17:39:48 EST 2012;Committer;kosaki;3;35;0;35;0
6ca32179e6d04cc6b22c4c2bbb55d3cc34127b3b;Fri Nov 30 17:39:36 EST 2012;Committer;kosaki;2;37;24;61;0
a1d837ccc1ff4b41f385fe0a167ae67cee1bcdd8;Fri Nov 30 17:14:27 EST 2012;Committer;kazu;2;7;0;7;0
8f9b451dd8260417fa57f88c6df09e41535d3c2b;Fri Nov 30 17:14:24 EST 2012;Committer;kazu;1;2;2;4;0
ad01ea426ceb9939e01c564eff0365a2a5cad196;Fri Nov 30 17:11:11 EST 2012;Committer;usa;2;21;9;30;0
12f2f7371f2dcf9c8da2a96fa251d1af2a7e977e;Fri Nov 30 17:00:30 EST 2012;Committer;ko1;6;154;0;154;0
60317fa81df069a7a2a7bdcb0aaaaebc9b77bed9;Fri Nov 30 16:51:11 EST 2012;Committer;usa;2;9;3;12;0
952beb5ff4a866a012fb646bf598ae112acdfb82;Fri Nov 30 16:27:52 EST 2012;Committer;usa;4;22;3;25;0
4bb1bfa0ed10a3a1e2ca04ada24d72e0227ebce7;Fri Nov 30 15:57:21 EST 2012;Committer;ngoto;3;9;1;10;0
7c1a19b641fadd5eef3d21d327935adbb1aef853;Fri Nov 30 15:16:03 EST 2012;Committer;kazu;1;2;2;4;0
a847bedb1df3e0af9e1f0cc53ff831f4316dd46f;Fri Nov 30 15:11:30 EST 2012;Committer;usa;2;10;1;11;0
b688029ae85afe8d816f34bd74cca5602e7a0e7f;Fri Nov 30 15:07:30 EST 2012;Committer;nagachika;1;0;8;8;0
ed13a84ace529dc0d901e310a6cf1bd6407c76ba;Fri Nov 30 15:05:19 EST 2012;Committer;svn;1;3;3;6;0
b20e7eb95442340155b2a471de31361afc164f8d;Fri Nov 30 15:05:18 EST 2012;Committer;nagachika;1;1;1;2;0
f125ec9ac5cab7f5b063e90ebf53a6b7088f3ba8;Fri Nov 30 15:05:15 EST 2012;Committer;nagachika;1;1;1;2;0
ec7d935ce7292e88949d23fabdbc04a4b578a5d3;Fri Nov 30 14:43:10 EST 2012;Committer;usa;2;8;1;9;0
053ca25f2d3876262e5830438a50816c4b66b944;Fri Nov 30 14:29:03 EST 2012;Committer;usa;2;7;0;7;0
bcef71590ccc9e4a76d6ab2187d16b07ef9fd3a6;Fri Nov 30 14:15:35 EST 2012;Committer;usa;2;13;4;17;0
15b25acd2541ae37f4f874b50128d34d8b079457;Fri Nov 30 13:52:34 EST 2012;Committer;kosaki;3;32;2;34;0
2e72d1c3236c8ec1c0cb8f35c1dd6b64fde02fce;Fri Nov 30 13:52:24 EST 2012;Committer;kosaki;3;1;22;23;0
5d33dad16cc34c39e75f6e61fd469c69c86f8741;Fri Nov 30 13:00:23 EST 2012;Committer;usa;3;18;95;113;0
759619ca864077a8508afcd04a514eb2ff629d3a;Fri Nov 30 12:50:05 EST 2012;Committer;kazu;1;5;5;10;0
d07346a1021039cc239bffd9286f03f13f5098d0;Fri Nov 30 12:09:19 EST 2012;Committer;usa;2;6;1;7;0
bb4410a2890fab69271145a09f895c91a8ee8863;Fri Nov 30 11:50:26 EST 2012;Committer;ko1;3;22;6;28;0
d0a4fecffcf3c74f14ba392f5785ea8f48d19683;Fri Nov 30 11:22:49 EST 2012;Committer;usa;1;5;2;7;0
88201504aea9d0d62310c3cc931d6ed2127e58f4;Fri Nov 30 11:15:36 EST 2012;Committer;usa;1;6;1;7;0
7ca1927af1d36c9388fc5eee86597ab94f54f311;Fri Nov 30 10:59:38 EST 2012;Committer;usa;1;1;1;2;0
77df72a64aa7a7f223bff8050cc43224694a680f;Fri Nov 30 10:57:06 EST 2012;Committer;usa;2;10;4;14;0
f807e1b80d4fd503f342d64a4343025e56247997;Fri Nov 30 10:45:58 EST 2012;Committer;kou;3;105;12;117;0
57540a49325b449e4e315b951914e31285a2cce1;Fri Nov 30 10:29:49 EST 2012;Committer;zzak;2;47;5;52;0
5a82fca5f9c7df65a8e04951e8378830d697d151;Fri Nov 30 10:08:02 EST 2012;Committer;zzak;1;1;1;2;0
6df1b3a9de0076e1f51a58ffc23b1d42cf2e8366;Fri Nov 30 09:55:32 EST 2012;Committer;ko1;2;9;2;11;0
fcd4ecd576ac1c3af047eb9491ae8c45c22d8e64;Fri Nov 30 09:50:34 EST 2012;Committer;nobu;1;1;1;2;0
ed0aa14fcc1b2629cb385bc34e9a69c9a43a9fc5;Fri Nov 30 09:50:32 EST 2012;Committer;nobu;1;1;1;2;0
578deb65b090f0c1486f901ea2d00bb456f7f4c5;Fri Nov 30 09:50:30 EST 2012;Committer;nobu;1;3;3;6;0
719e0cd530dd7187c716c103876fb3a112cbd30c;Fri Nov 30 09:28:35 EST 2012;Committer;ko1;3;104;63;167;0
f2fee8446648c12b80f2d7d7a16fe6d527971838;Fri Nov 30 09:25:24 EST 2012;Committer;zzak;2;161;1;162;0
020cc0ad5c5b4b2b2aac9e0a7fc9d35cfc76dfdc;Fri Nov 30 08:43:52 EST 2012;Committer;nobu;3;9;5;14;0
c08785a36278ad10aa977168813e1cfcb531cc7b;Fri Nov 30 08:43:47 EST 2012;Committer;nobu;2;7;4;11;0
1dbc720c0d91bfdb39dbef75606d5cd4ef4d9884;Fri Nov 30 08:43:42 EST 2012;Committer;nobu;3;16;7;23;0
981f9c52c6b0d7197e098ae9a0375485cf0c9c0c;Fri Nov 30 07:19:16 EST 2012;Committer;nobu;3;27;2;29;0
b5d8a0b339321c1ba1453d9549d074148079707b;Fri Nov 30 07:06:01 EST 2012;Committer;drbrain;2;21;0;21;0
8e2839ba2f6c648d7cd3ed3b6e820a043df7f9b7;Fri Nov 30 06:24:40 EST 2012;Committer;nobu;3;8;1;9;0
6969043477575df3525725a9488be7b6a04ad8f3;Fri Nov 30 06:20:34 EST 2012;Committer;drbrain;3;13;6;19;0
0d672c18cfbe960a6368cf61256ff6096f9589b3;Fri Nov 30 06:15:59 EST 2012;Committer;zzak;2;29;11;40;0
421d4f628bcaad61f101a9e7ad491b300dd5cb13;Fri Nov 30 05:45:23 EST 2012;Committer;zzak;2;6;0;6;0
25b0a58bf5f79ca49f3e7074aacd0f57df8fd227;Fri Nov 30 05:42:01 EST 2012;Committer;nobu;1;1;1;2;0
7e42e55e089363f8f4e14d732256d5e22ac74bf0;Fri Nov 30 05:41:57 EST 2012;Committer;nobu;1;7;5;12;0
90d43225ebb70db5aeb221b7d7191764058520d9;Fri Nov 30 05:06:45 EST 2012;Committer;zzak;2;23;14;37;0
088b04e8a4164f62e43437300246886af3be84a8;Fri Nov 30 04:53:09 EST 2012;Committer;zzak;2;162;149;311;0
24c0d0764b9ae8ebabbac7bd89335763ade06fa9;Fri Nov 30 04:48:50 EST 2012;Committer;drbrain;3;7;2;9;0
42968fe65af25c6348719272c3e81f721e4a5a35;Fri Nov 30 04:30:12 EST 2012;Committer;drbrain;3;78;2;80;0
3c4633a3a1ace272566618c9e002489d3c03b569;Fri Nov 30 04:01:07 EST 2012;Committer;knu;2;7;4;11;0
4078d42b72339cd80a88a1d2aa163b5499e2f5f7;Fri Nov 30 03:56:28 EST 2012;Committer;knu;3;15;2;17;0
aac52e2b87389aa41013e6fd7f26d119de10c209;Fri Nov 30 03:56:25 EST 2012;Committer;knu;1;2;4;6;0
06c3b413f07bfcc93621fb644a4865e8f48cf851;Fri Nov 30 03:35:01 EST 2012;Committer;knu;2;53;0;53;0
aee295fc747c7e117f4b550ab806057b4c4738a4;Fri Nov 30 03:28:04 EST 2012;Committer;drbrain;3;33;3;36;0
8137152e01dbeaf8504f3d7e2117e22dfdf6801f;Fri Nov 30 03:21:06 EST 2012;Committer;drbrain;3;16;1;17;0
9e449748744cbb28ede16ecb3064e3fcb0899022;Fri Nov 30 02:11:59 EST 2012;Committer;shugo;12;170;372;542;0
696ebcd8cafece7c0ed6407af9679699a16a5c5a;Fri Nov 30 01:39:03 EST 2012;Committer;drbrain;3;44;2;46;0
e553663cbda58188d085a0e6e5a71d52d3d95c5a;Fri Nov 30 01:35:13 EST 2012;Committer;nobu;1;52;52;104;0
1459cabe703832a8eeb6eda934537334347f3a7b;Fri Nov 30 01:35:08 EST 2012;Committer;nobu;1;0;2;2;0
d8da36dd227122126db565f056cbb3c3493d7c33;Fri Nov 30 01:29:57 EST 2012;Committer;naruse;1;2;2;4;0
9674860077c266094c545d61d4899abcee71df44;Fri Nov 30 01:01:26 EST 2012;Committer;drbrain;2;39;71;110;0
b479ca0c98007840b4d67c9539a2455eef7fead2;Fri Nov 30 00:54:04 EST 2012;Committer;naruse;1;1;1;2;0
4f451dddeb81941a25a9ccd9dadc1a0247274e0d;Fri Nov 30 00:38:24 EST 2012;Committer;nobu;3;14;3;17;0
82e6c75d145224eae63aab862c213b0ed8f0daf0;Fri Nov 30 00:23:15 EST 2012;Committer;drbrain;5;20;4;24;0
09af9d7f7ffe1bde891040e0232038130266ccbc;Thu Nov 29 23:34:29 EST 2012;Committer;drbrain;11;71;17;88;0
a22bb18e3e1f48f1155819351bd40c681f971fe0;Thu Nov 29 23:10:36 EST 2012;Committer;nari;2;4;16;20;0
6b627e6cd6dca18c5decff895af7bcdc623d05a9;Thu Nov 29 23:02:03 EST 2012;Committer;nari;1;1;1;2;0
59770bf960aba2ef14cb5306606bbb6a64d38188;Thu Nov 29 22:56:02 EST 2012;Committer;nari;3;19;10;29;0
c86379402c8dfeab9504c39c2de435601d408e57;Thu Nov 29 22:44:51 EST 2012;Committer;ko1;2;9;2;11;0
0c3f23ae7c60798e1c40421eb2924bcd1e063f25;Thu Nov 29 22:35:09 EST 2012;Committer;ko1;2;20;4;24;0
4db83403982100df21c3c6c18b1cef29dd379e6a;Thu Nov 29 22:28:16 EST 2012;Committer;ko1;9;138;31;169;0
2dc5e62545eb18feb85b1fa321f19904704cc76f;Thu Nov 29 22:02:36 EST 2012;Committer;ryan;2;27;20;47;0
213ba52407aa96d51e983579d61367991fc78d67;Thu Nov 29 20:48:52 EST 2012;Committer;naruse;1;1;1;2;0
e818b24c44572dda8d430bfc8d9d755602de1249;Thu Nov 29 20:34:29 EST 2012;Committer;naruse;1;1;1;2;0
d1d4490a57413ff5cb7e8bd0274bb34c7da68d29;Thu Nov 29 19:16:46 EST 2012;Committer;drbrain;18;181;41;222;0
40bae2f67c1160e1e59018c1003d014c60d1ee47;Thu Nov 29 18:22:52 EST 2012;Committer;naruse;1;6;3;9;0
970944847455dae54072ade11b4f4247e4707681;Thu Nov 29 17:55:54 EST 2012;Committer;tenderlove;7;64;12;76;0
4556a9ec654406c1be43a0b0b3bff99e4d0ed3c1;Thu Nov 29 17:35:29 EST 2012;Committer;naruse;4;157;1;158;0
0e0a8244c3c931129c81b8ff658073c0742b10cb;Thu Nov 29 17:05:17 EST 2012;Committer;kazu;1;1;1;2;0
6a631b7b17269d25c48aa0ed5d5598f516e050cc;Thu Nov 29 16:55:28 EST 2012;Committer;svn;1;2;2;4;0
584e05261b767860a212036e65afe3591bc76529;Thu Nov 29 16:55:23 EST 2012;Committer;kazu;1;6;6;12;0
36c40166aca9dd59dc867ac2e46f102cc443c4b2;Thu Nov 29 13:54:02 EST 2012;Committer;ngoto;2;8;1;9;0
40a442541cfe836cdff88dbc385bb87110d71ae9;Thu Nov 29 13:25:47 EST 2012;Committer;nahi;1;1;1;2;0
361f6b250312b56fc4ec76a4efe90160109cb459;Thu Nov 29 13:24:42 EST 2012;Committer;nahi;2;20;0;20;0
421314cf4e532cd4b840924b73f73fe33f25647b;Thu Nov 29 12:50:10 EST 2012;Committer;shugo;12;410;166;576;0
bda0aca2afa263022876432c5a91259193192a25;Thu Nov 29 11:09:34 EST 2012;Committer;naruse;3;1;146;147;0
399a32dfca7bbf2cb770cb7cd422b30ac220f01c;Thu Nov 29 10:15:16 EST 2012;Committer;nobu;3;146;1;147;0
f77c97a8ca966ba2a0303b838fa7e04ebc311ecb;Thu Nov 29 08:45:13 EST 2012;Committer;nobu;3;12;2;14;0
5cab66cbcfd2c1d1b1da916b7e7b2be8b41cc06a;Thu Nov 29 08:34:52 EST 2012;Committer;naruse;2;9;1;10;0
88f5a4ff2d2201a455a4b056acccefd42eb18ac4;Thu Nov 29 08:22:04 EST 2012;Committer;drbrain;3;10;3;13;0
8baab38ad20024d1f5d248a1c97bf144bc9e39e0;Thu Nov 29 08:15:53 EST 2012;Committer;zzak;2;121;76;197;0
8818a574a1ed9a322f8d2374db6276a9e8d279b8;Thu Nov 29 08:13:16 EST 2012;Committer;nobu;1;11;2;13;0
d22ac50ad493256c707b7b39eadf3ac46d989224;Thu Nov 29 08:12:29 EST 2012;Committer;nobu;6;108;91;199;0
2f80fddadc25d13c2c9862b03d16c0445265c027;Thu Nov 29 08:11:10 EST 2012;Committer;nobu;2;7;1;8;0
cf1d6730c1a850d885632477fb9f5463cc46035d;Thu Nov 29 08:10:23 EST 2012;Committer;nobu;10;13;14;27;0
0a7d24cc5aa8d0066e123a9b0594ac6fba9ad60a;Thu Nov 29 08:04:04 EST 2012;Committer;drbrain;3;14;10;24;0
d9422d8721d003d81ba00b8843e7c39c1359880e;Thu Nov 29 07:18:26 EST 2012;Committer;drbrain;2;18;3;21;0
e8af0046b72bb5a1da549a90888b445525d6cfff;Thu Nov 29 07:15:30 EST 2012;Committer;ko1;2;6;1;7;0
585ac7f1a2a1e96460cc78e050d2700d2e2680e5;Thu Nov 29 07:05:27 EST 2012;Committer;ko1;8;180;16;196;0
07b10cd59f372498e43d7bb10ce019e782c7a548;Thu Nov 29 07:01:46 EST 2012;Committer;naruse;10;37;15;52;0
a985c5898cb2efd83e817dd476999f28af73f763;Thu Nov 29 06:54:53 EST 2012;Committer;usa;2;6;1;7;0
9694bb8cac12969300692dac5a1cf7aa4e3a46cd;Thu Nov 29 06:52:18 EST 2012;Committer;drbrain;214;13969;7005;20974;0
3f606b7063fc7a8b191556365ad343a314719a8d;Thu Nov 29 06:43:31 EST 2012;Committer;ko1;3;153;79;232;0
d81b5a4ffb9f549cfefdc41581fe9fa7dbb91130;Thu Nov 29 06:19:05 EST 2012;Committer;naruse;2;7;1;8;0
479e39619240d7723f0573add301d71125df6933;Thu Nov 29 05:57:35 EST 2012;Committer;ko1;4;16;7;23;0
89c889d4e72eb39bb70734d2360b9607c1099bdb;Thu Nov 29 05:52:27 EST 2012;Committer;ko1;4;15;5;20;0
502ab126ac8d4b87edebb786e69042f13463e525;Thu Nov 29 05:29:22 EST 2012;Committer;ko1;2;30;10;40;0
c512d6acf98a6d550d1dd03c7642fee82dc46cea;Thu Nov 29 05:05:19 EST 2012;Committer;ko1;2;45;52;97;0
5bb12509a2db64cb92fd52222fc2022c9181d54e;Thu Nov 29 04:39:09 EST 2012;Committer;nobu;11;12;15;27;0
81eb635f8cf9e2c25703cb9735dce012daa70ccc;Thu Nov 29 03:23:11 EST 2012;Committer;ryan;13;760;240;1000;0
304885cdffeba202de0e51425f76d92945a3b2a5;Thu Nov 29 02:58:34 EST 2012;Committer;nobu;3;5;2;7;0
ecaba0f21ffd4d3ef5511ec117865af634554dea;Thu Nov 29 02:58:31 EST 2012;Committer;nobu;8;117;118;235;0
c058d821f84287dd8812b6cac3edf6cd6f1bc364;Thu Nov 29 02:50:11 EST 2012;Committer;kosaki;1;10;9;19;0
989c529c8999a03faf8c17c5b3068e73e632be6d;Thu Nov 29 02:09:36 EST 2012;Committer;kosaki;2;13;8;21;0
f22f1fbb54f7a2d3088205bf951d255f41f8f034;Thu Nov 29 01:30:42 EST 2012;Committer;ko1;2;11;7;18;0
d7ab6820b589571f9a82246f6f4c96688d9fd824;Thu Nov 29 01:26:38 EST 2012;Committer;ko1;2;5;1;6;0
d1dfebc05a0af85d6dac21038662a794464ff0e8;Thu Nov 29 01:11:47 EST 2012;Committer;naruse;2;10;7;17;0
e2779a53ef78eddfe464fc5c9821e7c43f061597;Thu Nov 29 00:52:51 EST 2012;Committer;naruse;2;7;1;8;0
98ed344ae9c97d2b273c57f35c6bde9761b1906a;Thu Nov 29 00:48:16 EST 2012;Committer;ko1;2;8;3;11;0
3d47e7b2854a47878fd6346586d12cb6c312df82;Thu Nov 29 00:12:49 EST 2012;Committer;ko1;2;50;16;66;0
b76b6b5c98133da0e3d23318ab1dcc86c3f0074f;Wed Nov 28 21:55:26 EST 2012;Committer;kosaki;2;13;10;23;0
5e606aee2ff1b54c174cb716762c3e4f59007699;Wed Nov 28 21:55:14 EST 2012;Committer;kosaki;2;18;19;37;0
fdda95ed8c17ea179c1778d3ad475fcbaff9030a;Wed Nov 28 21:55:03 EST 2012;Committer;kosaki;2;6;1;7;0
1d207fcff0e50ecdffb35b77bd10d2a3873cc8c3;Wed Nov 28 21:54:52 EST 2012;Committer;kosaki;2;7;10;17;0
2fa079b62ac3611ee7c52c605bd2da8209129895;Wed Nov 28 20:30:01 EST 2012;Committer;ko1;2;27;21;48;0
4bdd9095183666d515635946085becc66a418b16;Wed Nov 28 20:20:50 EST 2012;Committer;tenderlove;9;39;28;67;0
0fe2051c93197d7617ccc4f07a2dfc697cde9df7;Wed Nov 28 19:46:44 EST 2012;Committer;ko1;2;7;1;8;0
c5c1d8c23632c7ce40587788c5ee2d3591285232;Wed Nov 28 18:09:34 EST 2012;Committer;nagachika;1;1;1;2;0
c788b5f52b9d3dde4dde951b903811d9f235330e;Wed Nov 28 17:56:50 EST 2012;Committer;svn;1;2;2;4;0
af6decf85e18e8c6be0332d78f7ce3e14032384d;Wed Nov 28 17:56:39 EST 2012;Committer;nagachika;1;1;1;2;0
7b6e26ae143721b631be8247a7f02c8f11c111df;Wed Nov 28 14:55:41 EST 2012;Committer;nagachika;1;1;1;2;0
5c32aff16eb82679dc31849b733936b3e276d296;Wed Nov 28 14:53:47 EST 2012;Committer;tarui;2;11;4;15;0
36b21ada61220c0675fa3c00aa091538a2063739;Wed Nov 28 14:41:13 EST 2012;Committer;ko1;1;1;0;1;0
09f9aa43858de25a16db90fb55dc28a9d7be0e32;Wed Nov 28 14:40:00 EST 2012;Committer;ko1;3;13;3;16;0
e59c7307dabab8dea3dfaea80c02c3155ae10389;Wed Nov 28 14:37:47 EST 2012;Committer;tarui;2;4;9;13;0
bf442ed2b3385016b81472da981aaff51ad89ab7;Wed Nov 28 13:57:52 EST 2012;Committer;ko1;2;6;2;8;0
ff2ca81bb387ceae24d70a139ec48f227a83be39;Wed Nov 28 13:56:29 EST 2012;Committer;ko1;2;8;2;10;0
c6557c6fabfac078bda4ce19f1d1cda425998e48;Wed Nov 28 13:24:36 EST 2012;Committer;tarui;2;16;11;27;0
9d0de48e662046d870e38a21771cbe939031051a;Wed Nov 28 13:01:25 EST 2012;Committer;ko1;3;114;89;203;0
f5dc27aa77f77e68086d9300c7dfe1a3280c7714;Wed Nov 28 12:34:15 EST 2012;Committer;tarui;3;59;37;96;0
ac93d931fa8c089a4fa6cbafb5727829161ea22e;Wed Nov 28 12:23:20 EST 2012;Committer;nobu;2;9;4;13;0
082a2716cc0e95f37ac9b64c26f9d55d2b0cb499;Wed Nov 28 12:22:47 EST 2012;Committer;nobu;2;7;3;10;0
d8da0faf236052d7e16c08bcb31c2d32d661a266;Wed Nov 28 12:21:19 EST 2012;Committer;nobu;2;8;12;20;0
a0f7f36a5a47098c30125d3ad5c19db71fc34960;Wed Nov 28 12:19:49 EST 2012;Committer;nobu;3;23;5;28;0
3baef1fc22f01634b908b598beee280b7788cc36;Wed Nov 28 12:17:30 EST 2012;Committer;nobu;1;0;4;4;0
9cbf473287b6e0fca089c30db1cd276b3c2d477c;Wed Nov 28 08:31:03 EST 2012;Committer;kosaki;5;93;35;128;0
b8a1e36201d3965b3f7b87fe1fa1cf55e00ce045;Wed Nov 28 08:30:51 EST 2012;Committer;kosaki;5;41;10;51;0
fc57f2bfdbc6c34289bd3143a7cd5e948ddded9b;Wed Nov 28 08:01:43 EST 2012;Committer;ko1;1;1;0;1;0
49ed2a756bb41e4e3d3b520d0f84a60851504fe2;Wed Nov 28 08:00:53 EST 2012;Committer;ko1;3;7;39;46;0
45011d08e13878ba7593cc4aa3d112d689b9b95e;Wed Nov 28 07:41:19 EST 2012;Committer;drbrain;4;38;12;50;0
013521e55742a07fbc5a4b264862b2da21168b89;Wed Nov 28 06:45:25 EST 2012;Committer;naruse;2;16;0;16;0
e6ef313a498e5bff7a54944722abff33ef966166;Wed Nov 28 06:36:28 EST 2012;Committer;kosaki;2;4;2;6;0
58b8573081fb6dbc542f5b5313bc844e8b162e25;Wed Nov 28 06:29:05 EST 2012;Committer;ngoto;2;6;11;17;0
1ff0a3d0c66e89f4c920e67813d604a6bb933fac;Wed Nov 28 05:52:11 EST 2012;Committer;ko1;2;12;2;14;0
835d24f637e7616787e369ae4bf7edd0f8302a3d;Wed Nov 28 05:40:54 EST 2012;Committer;kosaki;2;14;6;20;0
8111b32d685278de68e9eefe273524cf1266cff0;Wed Nov 28 04:43:15 EST 2012;Committer;kosaki;3;8;4;12;0
14099149f403f4cfbaa4cd673f04bf20cc3c5ac5;Wed Nov 28 04:34:41 EST 2012;Committer;tenderlove;35;14034;1227;15261;0
694c77633c80a106a1e526870ad5076bfac30640;Wed Nov 28 04:09:38 EST 2012;Committer;kosaki;4;30;11;41;0
4ed6a88b74be65894b580dba81e7b8e3e8b0c3ce;Wed Nov 28 02:08:39 EST 2012;Committer;zzak;8;139;40;179;0
0700a9113f94a82d786271bc44140691d47f6bac;Wed Nov 28 00:17:33 EST 2012;Committer;ryan;3;48;1;49;0
0713f89944ecfff3aeefda1edcf44c0ea3e98de0;Wed Nov 28 00:02:49 EST 2012;Committer;tenderlove;16;1316;61;1377;0
118d9f43c8f2e1665fb6ebac751299a852072133;Tue Nov 27 23:57:20 EST 2012;Committer;zzak;2;66;0;66;0
d07c73be40e44cbd8e6a11245bda57be28015270;Tue Nov 27 23:55:31 EST 2012;Committer;zzak;2;9;0;9;0
13dc0e14fec6715b148de3586f4481175801ba82;Tue Nov 27 23:30:33 EST 2012;Committer;naruse;2;15;4;19;0
4ba88161ee01c804db85a7fd3ecd562eb251d765;Tue Nov 27 23:27:36 EST 2012;Committer;zzak;2;6;0;6;0
9c831edbf4f30fdcf90d8c991ded624c27898874;Tue Nov 27 23:26:07 EST 2012;Committer;zzak;7;127;55;182;0
c1fb6a82dcfbd308390d380d62c7127635fc66db;Tue Nov 27 19:54:50 EST 2012;Committer;tenderlove;17;1949;33;1982;0
c8d3536852a0a8db04ec214eb0a723876438b961;Tue Nov 27 18:12:53 EST 2012;Committer;naruse;2;2;2;4;0
bb2e9e9e9871eab71aac3f316339c67e8bb4a1a5;Tue Nov 27 18:04:55 EST 2012;Committer;naruse;2;5;1;6;0
c41e749c4d6102bc3db543c272f7e344896f70dc;Tue Nov 27 18:02:31 EST 2012;Committer;naruse;2;9;3;12;0
e6be878413de8744a3476f55fa80c24a1da599a6;Tue Nov 27 16:20:26 EST 2012;Committer;svn;1;2;2;4;0
bd43e67e25e8eaacf92dbc91794625e9f1865a06;Tue Nov 27 16:20:21 EST 2012;Committer;nagachika;1;4;4;8;0
06d6edcaccbe3d8082fd2ec5681b4113cf7f4441;Tue Nov 27 13:34:40 EST 2012;Committer;knu;2;6;3;9;0
8c4992f1f58bf868d9c0e674227af3496900ba4f;Tue Nov 27 12:53:32 EST 2012;Committer;eregon;1;8;7;15;0
1dce5edf993a15c66c61965fcab4c2f5a07f6312;Tue Nov 27 12:46:32 EST 2012;Committer;mrkn;3;56;15;71;0
956cc2934d9848fa4c5cc7bcf79edd76f1171053;Tue Nov 27 11:58:10 EST 2012;Committer;ko1;3;46;11;57;0
5faf4cc77b6a223dc86fddc69e0f377d27f5585a;Tue Nov 27 10:21:59 EST 2012;Committer;ngoto;3;27;2;29;0
6d1266a879a94a6f76106e1bbdfa3576b6612a69;Tue Nov 27 08:54:03 EST 2012;Committer;drbrain;20;169;35;204;0
7de9e2dfdeefeefe6c3d4ff9ebafa8c947eca33f;Tue Nov 27 07:29:00 EST 2012;Committer;drbrain;2;6;1;7;0
ef8e0908af4a1784d8e06b0110168e2df0f95f1e;Tue Nov 27 07:09:21 EST 2012;Committer;drbrain;7;25;4;29;0
585de40a6955434c93910295f452308c5f9d548f;Tue Nov 27 06:19:06 EST 2012;Committer;drbrain;2;5;1;6;0
cb581e205910f5a6a6a35c8774a055d1cc049d98;Tue Nov 27 06:01:41 EST 2012;Committer;drbrain;3;54;38;92;0
1eac1cb21ebb095886393ee71acd0ed8f6dedab8;Tue Nov 27 05:59:34 EST 2012;Committer;tenderlove;17;33;1951;1984;0
1d8d7a3eec54a5440a1942c0b589c228138834ae;Tue Nov 27 05:00:57 EST 2012;Committer;nari;2;10;0;10;0
1c279a7d2753949c725754e1302f791b76358114;Tue Nov 27 04:28:14 EST 2012;Committer;drbrain;235;45426;5507;50933;0
c72f0daa877808e4fa5018b3191ca09d4b97c03d;Tue Nov 27 03:18:29 EST 2012;Committer;ko1;2;13;2;15;0
2f9ee7af47124113bc0aa0966816720c907a9c91;Tue Nov 27 03:04:36 EST 2012;Committer;ko1;2;10;14;24;0
9ace5c122e9ad5203e98590adfc3896464b67ec1;Tue Nov 27 02:00:40 EST 2012;Committer;kosaki;3;22;0;22;0
863e08732624822bac9fe546dc13ef2b6d23e542;Tue Nov 27 02:00:29 EST 2012;Committer;kosaki;2;5;0;5;0
b1a18cf49bc475e6c563f55b23fa36594d70f4bc;Tue Nov 27 02:00:19 EST 2012;Committer;kosaki;4;20;1;21;0
8079f8a6f25bd1e6ef9fa0bff569a850c31c6fb3;Tue Nov 27 02:00:09 EST 2012;Committer;kosaki;4;18;2;20;0
ab2a7a9346038c4d47dcac030611834cde06a62d;Tue Nov 27 01:38:41 EST 2012;Committer;tenderlove;17;1951;33;1984;0
357d42569fc99c9eb6482484dab8a72cd35c57da;Tue Nov 27 01:35:13 EST 2012;Committer;naruse;1;1;1;2;0
3677a68d81593493a3d19ea5bec6d3ba9faa98c1;Tue Nov 27 00:59:19 EST 2012;Committer;nobu;2;6;0;6;0
f0a229b69b40e27a1f0e542a1d4099bd832d8cda;Tue Nov 27 00:58:52 EST 2012;Committer;nobu;6;16;5;21;0
4df479f50b66ebbde130668a39714e9b6f8b0aaa;Tue Nov 27 00:18:52 EST 2012;Committer;ko1;2;8;0;8;0
d187f4bc215119469c3da6828ef78f216dfe20f2;Mon Nov 26 23:25:21 EST 2012;Committer;ko1;5;34;22;56;0
a916278900dcd0db090db11d50e082e941968b9f;Mon Nov 26 23:08:36 EST 2012;Committer;kosaki;2;17;5;22;0
8c138db3d28828365f86f276ec753a248d2e0a19;Mon Nov 26 23:01:45 EST 2012;Committer;ko1;3;57;39;96;0
253938067a37d7ba9751ec1afbbd6033f886cab4;Mon Nov 26 22:49:36 EST 2012;Committer;kosaki;2;7;0;7;0
5768a4a7e051963db769b5aafe8aadc6bc97f867;Mon Nov 26 20:14:49 EST 2012;Committer;marcandre;2;11;3;14;0
cd246ff2545cd5399e98ff93eda29ba57e44cc85;Mon Nov 26 19:19:51 EST 2012;Committer;nobu;1;1;1;2;0
943b664eeace274f3235e6dbd3bb2757374a85c0;Mon Nov 26 19:12:55 EST 2012;Committer;nobu;2;14;3;17;0
79d42a8831cc85dd8f956b54cee78990d184b34a;Mon Nov 26 16:01:51 EST 2012;Committer;usa;2;10;5;15;0
4491b98c651afbb2f9b3e88fbb8eb4a96bf23e6e;Mon Nov 26 15:17:06 EST 2012;Committer;svn;1;2;2;4;0
5b238e8dc7fd55622c4e0a382b9783648ba412f5;Mon Nov 26 15:17:01 EST 2012;Committer;kosaki;3;31;0;31;0
23d5c282b4df78b5f6b8684c0d9f5aece7dd3f70;Mon Nov 26 14:55:56 EST 2012;Committer;kosaki;2;11;0;11;0
39d38ff82f3a6158d2adc5883b86691a424ed1c0;Mon Nov 26 13:47:23 EST 2012;Committer;kosaki;2;11;1;12;0
66e2e6ee697a322bb7521d7ecaff6be3fb69f4dd;Mon Nov 26 12:17:10 EST 2012;Committer;kosaki;4;27;11;38;0
58543f00b6386b5631ffc6d8f029be149d632457;Mon Nov 26 11:45:39 EST 2012;Committer;kosaki;4;11;9;20;0
12d48f4ef242eaa48844e9dbbbd5ae22b87870c3;Mon Nov 26 11:25:45 EST 2012;Committer;usa;2;7;2;9;0
6190bb4d8ad7a07ddb1da8fc687b20612743a34a;Mon Nov 26 10:57:39 EST 2012;Committer;kosaki;5;60;14;74;0
8c6ad2b0ae9a0d5c2205f4648e5fa0c86fa6077f;Mon Nov 26 10:46:01 EST 2012;Committer;ko1;2;7;0;7;0
42e9fc4110dc6607332fe05c2e2f4e565fd1b5fd;Mon Nov 26 10:14:01 EST 2012;Committer;ko1;2;10;1;11;0
7b918be3d43a043abfa47772da90e856cdd7a355;Mon Nov 26 09:30:32 EST 2012;Committer;ko1;3;10;4;14;0
521af835583fba7793650c2a9203c43f31800642;Mon Nov 26 09:28:35 EST 2012;Committer;kosaki;2;6;1;7;0
458796d4f1dfef954f570c9b8355088b88d8f895;Mon Nov 26 09:25:47 EST 2012;Committer;kosaki;2;6;1;7;0
7087153156a32373960b8edbe938f3095be55389;Mon Nov 26 09:22:01 EST 2012;Committer;kosaki;2;24;7;31;0
2e87867a8f07e93141156933e8d648c57c0b57d4;Mon Nov 26 09:19:00 EST 2012;Committer;ko1;2;19;10;29;0
6746eecaf132cd2b4f4fed85e9bb66c4f655eb2e;Mon Nov 26 08:13:19 EST 2012;Committer;kosaki;2;9;3;12;0
f150ed1532e727c409cc018a98e1362a8c71242c;Mon Nov 26 08:05:49 EST 2012;Committer;kosaki;5;56;1;57;0
3e0becb42d73be66cd60a0694554eb014b1b6552;Mon Nov 26 07:37:25 EST 2012;Committer;naruse;3;60;0;60;0
cb0a4c0f6231639dab11d50b21614cbea019e5d4;Mon Nov 26 07:00:04 EST 2012;Committer;kosaki;2;19;2;21;0
6f3ad9bd3d1c0fd53539d55743b445d67360e911;Mon Nov 26 06:49:48 EST 2012;Committer;kosaki;2;11;4;15;0
e4b54208d0e98677db83b92a458be6847258e54c;Mon Nov 26 03:12:25 EST 2012;Committer;nobu;1;3;0;3;0
6a858bc109bf879b9a51c8efe17f51553b38735f;Mon Nov 26 03:11:12 EST 2012;Committer;nobu;2;5;0;5;0
769781a0990a9d44f45f235086d8474a80fcc27d;Mon Nov 26 01:57:41 EST 2012;Committer;kosaki;2;9;8;17;0
251dbc1241ef2721abaceeebdc70428668f978f4;Sun Nov 25 16:59:13 EST 2012;Committer;svn;1;2;2;4;0
997518c677a708b86f9ec8b26b6fe6df60a01485;Sun Nov 25 16:59:07 EST 2012;Committer;nagachika;2;10;2;12;0
56132b13465c2c766fc15b8c04a7fb116315cd45;Sun Nov 25 13:39:26 EST 2012;Committer;shirosaki;4;34;25;59;0
0012b0abd775c2b9f2f79e21e8668528b0af6091;Sun Nov 25 13:28:59 EST 2012;Committer;eregon;2;20;14;34;0
d91b1dd448f17f471ce20af2d1d62e92531e9dfc;Sun Nov 25 10:45:46 EST 2012;Committer;ktsj;2;7;0;7;0
1ab73afbf9a6d6ae72b02674fa1b253469f1bf36;Sun Nov 25 07:39:59 EST 2012;Committer;naruse;1;2;2;4;0
e58d0bd393ccd114c54bc7857feff281c4643a65;Sat Nov 24 18:51:45 EST 2012;Committer;knu;3;644;647;1291;0
3f9b0936aa846bdf6984019ca40bc629fe05d929;Sat Nov 24 18:46:15 EST 2012;Committer;knu;4;446;105;551;0
7f0dd3a5a23d0009862e0f1213e536fff1a94727;Sat Nov 24 17:14:13 EST 2012;Committer;svn;1;2;2;4;0
6c1bfbe478c5b7698ba9c96e61a2a597b44d4d16;Sat Nov 24 17:14:06 EST 2012;Committer;knu;6;35;27;62;0
7b298723b08e30d336f6172a6d4f6d9dea3a5a8e;Sat Nov 24 12:26:57 EST 2012;Committer;shirosaki;2;25;14;39;0
1cdeab5cdd4b84cc0d97ee1a148beeb11bdd2d44;Sat Nov 24 12:26:54 EST 2012;Committer;shirosaki;5;104;10;114;0
e6c2ffa981f00c249a9a6a1595ecab18d0a6f741;Sat Nov 24 12:09:39 EST 2012;Committer;naruse;2;7;2;9;0
0114fde85a09b69ad424c9bb239836f4896b016d;Sat Nov 24 10:31:10 EST 2012;Committer;tadf;2;8;6;14;0
757413f6bb6879a3bf92cf26fa4d0c9467cd84ff;Sat Nov 24 07:43:13 EST 2012;Committer;naruse;3;15;66;81;0
9d803dfd5f1a57a6d07c27b0d95917165ba259dc;Sat Nov 24 04:12:30 EST 2012;Committer;ko1;3;59;6;65;0
76cffcdbf2554afbaf8018b8a6c5993bf09577c1;Sat Nov 24 04:01:43 EST 2012;Committer;shirosaki;2;6;1;7;0
005986bd445f44a1a6500f8dbc9841d644ceb7a2;Sat Nov 24 04:01:40 EST 2012;Committer;shirosaki;2;8;1;9;0
3fac4abc7b6d562905e59f16042a657dff9c8987;Sat Nov 24 04:01:37 EST 2012;Committer;shirosaki;2;25;14;39;0
82cac33ecb45abf68a98e5f30849502e50579242;Sat Nov 24 04:01:33 EST 2012;Committer;shirosaki;3;49;9;58;0
5611df706e5685fbe03412588d23ee31f13c671d;Sat Nov 24 02:51:24 EST 2012;Committer;kosaki;5;65;1;66;0
82b33551a4ead2fa13120751242c493e2084cada;Sat Nov 24 02:00:10 EST 2012;Committer;kosaki;2;6;2;8;0
b9163cc1fdb109f214cda44b07f2b960338015f4;Fri Nov 23 15:00:55 EST 2012;Committer;nobu;2;10;3;13;0
a20d306f8a11c94a1da4940b0e10de0af3bf8698;Fri Nov 23 15:00:20 EST 2012;Committer;svn;1;2;2;4;0
f6761088a4eb4d51765d9ea032e15dc5a581958f;Fri Nov 23 15:00:12 EST 2012;Committer;nobu;4;12;1;13;0
e54cd2bd97b4da5e9a02ab35cdb3f75f4b645b06;Fri Nov 23 14:44:45 EST 2012;Committer;nobu;2;10;3;13;0
400d2d9d0394dda6f201eb0c92c056adfe5ca4db;Fri Nov 23 13:49:14 EST 2012;Committer;nobu;1;5;3;8;0
48df345894b80d20a51c7761a26b2d7bf83e9755;Fri Nov 23 08:31:57 EST 2012;Committer;nobu;3;22;8;30;0
38a1bcb056f90552f564fffbfcac421c30ea2266;Fri Nov 23 08:31:52 EST 2012;Committer;nobu;3;76;46;122;0
10cceae9e374a3430383c85f1770bb478989769e;Fri Nov 23 03:35:27 EST 2012;Committer;tadf;2;36;73;109;0
d53204f910ba374a8141c92a2344362e129baff5;Fri Nov 23 02:41:47 EST 2012;Committer;tadf;2;10;3;13;0
0d280f3d638e472aef0c388b6227f4739fd2e27d;Fri Nov 23 02:13:48 EST 2012;Committer;nobu;2;6;2;8;0
d03ed07e60f34715298ace6d8b8a3619eb71407c;Fri Nov 23 02:12:09 EST 2012;Committer;nobu;2;6;4;10;0
d2ddd30a3fbdaae3eb8e1356c6c411703645d0b6;Fri Nov 23 01:46:51 EST 2012;Committer;zzak;2;6;1;7;0
ed7d776317e35976daf9537d2609ca1c65366525;Thu Nov 22 17:42:06 EST 2012;Committer;zzak;2;13;0;13;0
7bfb6b2bc763d85f571aa18e162116917453ab11;Thu Nov 22 15:04:09 EST 2012;Committer;svn;1;2;2;4;0
66db637a9fc0e03b4b25e213e2e96ddf5b53597f;Thu Nov 22 15:03:46 EST 2012;Committer;nari;2;69;4;73;0
97ecab7b34aaf58f472254356afcd3d529e57401;Thu Nov 22 14:55:32 EST 2012;Committer;shirosaki;3;50;4;54;0
ff6c50709c7f8ee6ce81963864598223fc07f40d;Thu Nov 22 13:00:03 EST 2012;Committer;kazu;1;3;3;6;0
f317a1562e1b8c871227559c64a6839070af663d;Thu Nov 22 12:49:59 EST 2012;Committer;usa;3;15;5;20;0
b4f25e30dfbf4c8346a9c99e359bd9f240d5c72f;Thu Nov 22 12:36:22 EST 2012;Committer;tadf;2;15;0;15;0
d6ec400148f58061118917fb5ed3977425244f0d;Thu Nov 22 11:32:52 EST 2012;Committer;tadf;3;47;6;53;0
84a57715e1b20e4d06f90139687d8131705ffc18;Thu Nov 22 11:25:01 EST 2012;Committer;kosaki;2;6;1;7;0
8e8d7bb7fcbc0f26ba8c2af36a7abc0e18979ffb;Thu Nov 22 09:16:48 EST 2012;Committer;usa;4;15;4;19;0
1dec7384d1629eb1b45252294c7e1a7009f148bc;Thu Nov 22 09:03:43 EST 2012;Committer;naruse;5;14;6;20;0
59c41661a7de1c4eab03023fa463792f7be0e944;Thu Nov 22 08:47:30 EST 2012;Committer;naruse;5;6538;188;6726;0
86541e02c18e6ccdd0c0c632da06120a04a9ef11;Thu Nov 22 08:41:19 EST 2012;Committer;kosaki;2;8;2;10;0
4d7e8b7305c392646f68a785df8f4019ec1e69c9;Thu Nov 22 08:01:49 EST 2012;Committer;kosaki;5;15;5;20;0
82e7d00344a185ea46a72ed1352d25d99056add8;Thu Nov 22 07:23:40 EST 2012;Committer;kosaki;2;8;3;11;0
4ba69a41d8373bfdc17f54a1d5f16886ad3f6371;Thu Nov 22 06:28:17 EST 2012;Committer;naruse;2;10;1;11;0
d5d2440e0fcb7f8f24b24702c75171eb662ca0b2;Thu Nov 22 05:54:13 EST 2012;Committer;knu;0;0;0;0;0
81632542d8b91f75db3b1062bdff9423ecf73212;Thu Nov 22 05:32:31 EST 2012;Committer;knu;0;0;0;0;0
61e21e82adadc1795de115a9ebe0019245de007d;Thu Nov 22 05:23:12 EST 2012;Committer;knu;3;16;0;16;0
9cbaeed6eda4c26a488878aeb0d47b976cc02472;Thu Nov 22 05:02:30 EST 2012;Committer;knu;2;13;0;13;0
cda3a0c75e25b36169c3fa56068803cca9229242;Wed Nov 21 23:09:46 EST 2012;Committer;nari;2;7;2;9;0
4c6a41145956c1d635b7255cba1df15501a43fa9;Wed Nov 21 17:26:11 EST 2012;Committer;svn;1;2;2;4;0
9c8a54c56097798fb86e51f543dbfb52227b6e91;Wed Nov 21 17:25:59 EST 2012;Committer;tadf;2;66;62;128;0
79fab011d419d0daf315cbbde8e7e3ecea4c2dd8;Wed Nov 21 14:37:22 EST 2012;Committer;kazu;1;2;2;4;0
29d626109bf83f193b5b8cf64d36d61084bcb968;Wed Nov 21 13:54:36 EST 2012;Committer;nobu;1;75;75;150;0
45faa57b49cbb0c8a3cbdc8f44b8dd619ecea15b;Wed Nov 21 13:53:02 EST 2012;Committer;nobu;3;13;4;17;0
e786aa711da8e64734d20acfd9c6b8df0b4515c5;Wed Nov 21 13:40:00 EST 2012;Committer;nobu;3;81;0;81;0
7d0cabb8f881798da1332becf60096a09fbb6c01;Wed Nov 21 13:31:06 EST 2012;Committer;nari;2;4;3;7;0
fe9fc6df018402de830f42b63ea25d927c8726a8;Wed Nov 21 13:15:10 EST 2012;Committer;nari;3;31;1;32;0
4d03af3d9cdedacadc1e967490c9201fec13fc53;Wed Nov 21 12:54:06 EST 2012;Committer;tadf;2;20;0;20;0
c07d295204de26a8926b5c58c2b849022e5db02b;Wed Nov 21 12:42:11 EST 2012;Committer;tadf;7;17;7;24;0
1ac4e6d2746144598404487b67630b31288db8ae;Wed Nov 21 09:48:51 EST 2012;Committer;tadf;2;10;2;12;0
15648bfda8c7ee29006dc8871985ce6e3d042237;Wed Nov 21 07:36:24 EST 2012;Committer;ko1;1;1;1;2;0
9d8c6adce1b4dc3c9adf37e0d3dbc1b6ed964c1f;Wed Nov 21 07:16:19 EST 2012;Committer;ko1;1;3;1;4;0
c13f83471ae115bea4f52c2860a5b5f63e17571d;Wed Nov 21 07:15:03 EST 2012;Committer;ko1;2;5;0;5;0
5821c7514836104b44892c046590b09d42d444b9;Wed Nov 21 05:09:19 EST 2012;Committer;shyouhei;3;2;8;10;0
165da0da2f185cab12ba68214de3b4f4ab81a46a;Wed Nov 21 04:23:56 EST 2012;Committer;marcandre;1;4;4;8;0
b317bf06a4d8200b43d46685e251e993241e0765;Tue Nov 20 16:00:04 EST 2012;Committer;kosaki;2;7;5;12;0
9d71f70da9f30528675f07228687106a69f05b3b;Tue Nov 20 15:29:59 EST 2012;Committer;naruse;2;6;1;7;0
132eb25a79fee6c24d6a68da2f0de74ee3229517;Tue Nov 20 15:17:15 EST 2012;Committer;glass;2;141;16;157;0
2fff359537705ee4c2b1c98a2f95e8b7ffa306f1;Tue Nov 20 15:03:56 EST 2012;Committer;svn;1;2;2;4;0
aa58a684b7caea9ef3666b6df10bf13c1e11f6c8;Tue Nov 20 15:03:52 EST 2012;Committer;marcandre;1;4;4;8;0
68de2e580089e6894f37755d227db99ce1c8e32a;Tue Nov 20 14:53:54 EST 2012;Committer;marcandre;1;6;0;6;0
1196b798d63f2834b2db6ed09794c1f1ea517b9b;Tue Nov 20 13:48:04 EST 2012;Committer;naruse;2;6;1;7;0
3ee0326bf90dfd4d88543ae9d8ca3c8b1ad49235;Tue Nov 20 13:17:30 EST 2012;Committer;kazu;1;1;1;2;0
bf445c240a189ef973d22052d2099efc0f1c0602;Tue Nov 20 13:09:15 EST 2012;Committer;naruse;1;2;2;4;0
cea7600b524cfc5023a15436f1263a5c872f99d9;Tue Nov 20 12:57:49 EST 2012;Committer;ko1;9;252;161;413;0
f495c968c901b3db0f67310ffe815a360b9587a3;Tue Nov 20 12:49:36 EST 2012;Committer;naruse;2;32;28;60;0
8459af3f5c67d4dcc4fcf0fcb91b7258b33bf1ab;Tue Nov 20 12:41:38 EST 2012;Committer;kazu;1;3;3;6;0
5191b2ae3b5a99e34e34b531a6d754b34d256c13;Tue Nov 20 12:39:57 EST 2012;Committer;kazu;1;5;5;10;0
2562560c87c38c5f3f055b2011b4dc6404638f89;Tue Nov 20 12:39:54 EST 2012;Committer;kazu;1;2;2;4;0
eabe74e0341ce1144d2a7521f88dcaf940a02380;Tue Nov 20 12:34:45 EST 2012;Committer;nobu;1;3;2;5;0
c3da426d10a686dc24f86d000178a2d1eb852e17;Tue Nov 20 12:34:37 EST 2012;Committer;nobu;3;6;6;12;0
a00a9a28fbbb1268fc6c3c50a695adadbf5be4f4;Tue Nov 20 12:34:21 EST 2012;Committer;suke;2;7;1;8;0
21453dc7381d09e6926c02c0143812680c1cfa8a;Tue Nov 20 12:10:08 EST 2012;Committer;tadf;3;69;25;94;0
3b3d2006c2251c1a007fd362729c36b0a26149c0;Tue Nov 20 12:01:21 EST 2012;Committer;nobu;2;6;1;7;0
4c37c520e2443097268356d784a1179589d3bad4;Tue Nov 20 11:13:45 EST 2012;Committer;mame;3;9;2;11;0
f1aee6327a8afa5ed048b270772ae0bf054a4d87;Tue Nov 20 11:13:13 EST 2012;Committer;ko1;1;2;0;2;0
1da641a16b6fdccad639ac46cec658436029af16;Tue Nov 20 11:05:20 EST 2012;Committer;ko1;3;135;35;170;0
553931962a8a6c73ecef770831165070479c8763;Tue Nov 20 09:48:24 EST 2012;Committer;ko1;10;183;90;273;0
b1fa559039d9a2130975a364260fe77a086e6e8b;Tue Nov 20 08:47:43 EST 2012;Committer;naruse;1;1;0;1;0
da56cb6bf2bc71cd1b8cbb272f8bc4acd2a4d6be;Tue Nov 20 08:35:57 EST 2012;Committer;naruse;2;30;32;62;0
b6161a3bad879003b85aca13b637fb1fda5070e3;Tue Nov 20 06:37:53 EST 2012;Committer;zzak;2;15;2;17;0
134d33b0613093d338870a53328f156bcbf50f06;Tue Nov 20 05:39:33 EST 2012;Committer;kosaki;1;1;1;2;0
4d3f768b41b0c7f2e8ef166b9c363e63e92e59ed;Tue Nov 20 05:39:14 EST 2012;Committer;kosaki;2;9;3;12;0
c8a3b2ba8bb18752c4d0aee6483f516e827f4bc9;Tue Nov 20 05:00:45 EST 2012;Committer;kosaki;3;84;56;140;0
7e96fb252a79fbdd9c34924edddbf781937d50b8;Tue Nov 20 03:37:27 EST 2012;Committer;zzak;2;5;1;6;0
ca8f327522fa9672ef4f569c71063112308099fa;Tue Nov 20 03:34:15 EST 2012;Committer;zzak;2;9;0;9;0
0c3d96756ab470c71f3da579513a767f27fc08be;Tue Nov 20 03:07:23 EST 2012;Committer;usa;2;7;1;8;0
bd0931f7b9a39dd48af48ebef5c2a13d7c3e3e56;Tue Nov 20 02:21:17 EST 2012;Committer;naruse;2;20;9;29;0
b65dda51bd8731a30a94e394c31198427b90a368;Tue Nov 20 02:05:21 EST 2012;Committer;zzak;2;6;1;7;0
b74e1b21dbb15d67945e36153368bb4aa78dcd68;Tue Nov 20 01:21:19 EST 2012;Committer;kosaki;3;138;144;282;0
49c0c51056377819d6289d04baa69e38d9871d24;Tue Nov 20 01:18:18 EST 2012;Committer;naruse;2;6;9;15;0
f86396e40d63834aad6843c9c28c0555718d4cd5;Tue Nov 20 00:51:02 EST 2012;Committer;svn;1;2;2;4;0
a7e13d65f4cb6e0f61cee67a85417aa572f3bd22;Tue Nov 20 00:51:00 EST 2012;Committer;naruse;1;1;0;1;0
29996bb313088f448cc323e16f4e2a91d2008914;Tue Nov 20 00:50:58 EST 2012;Committer;naruse;1;13;11;24;0
029b59ba53d0cc42630d623b52d94cae0df62734;Mon Nov 19 14:12:48 EST 2012;Committer;ngoto;2;9;6;15;0
82b2436422231701d666a6d7a06f8a7b1fa293aa;Mon Nov 19 13:31:26 EST 2012;Committer;nagachika;1;2;2;4;0
f17aa9b361f3d7eb2eac2d1403d1818e9522a315;Mon Nov 19 12:37:43 EST 2012;Committer;ngoto;3;7;2;9;0
57ee8128514f9e904325436099088703ee5938e5;Mon Nov 19 11:15:07 EST 2012;Committer;kosaki;2;8;3;11;0
4b25e0ceca487725f4579d21271546e2bd0d3563;Mon Nov 19 11:13:40 EST 2012;Committer;kosaki;2;16;3;19;0
212150c2e148278b1a300bd823f0a3d4753cd37d;Mon Nov 19 11:10:24 EST 2012;Committer;kosaki;3;144;138;282;0
0a2da327f46ec0e129de52f668d00f04f2529b7e;Mon Nov 19 11:07:53 EST 2012;Committer;kosaki;2;6;1;7;0
7643e4604bc5a661d10c7940b948ae6c66694f09;Mon Nov 19 11:04:39 EST 2012;Committer;kosaki;2;12;12;24;0
6d9f7672dd0560478c0031953a3cc8bd5cd05dd9;Mon Nov 19 10:54:55 EST 2012;Committer;kosaki;2;8;6;14;0
562cb0ae5997006441221710d531ac166546319d;Mon Nov 19 10:38:02 EST 2012;Committer;kosaki;2;7;0;7;0
75df3aae0f8fdb09ed377102952e78e3dc282516;Mon Nov 19 10:35:34 EST 2012;Committer;kosaki;2;33;57;90;0
6c56dae4b23c5c50e351758538141ca26b9aba40;Mon Nov 19 10:22:53 EST 2012;Committer;kosaki;3;23;16;39;0
58282ed667d720816366c9e45c3560904196d078;Mon Nov 19 09:43:53 EST 2012;Committer;kosaki;4;49;0;49;0
92cef134b54fadb79e5d338a3aea1b51ff500386;Mon Nov 19 07:54:53 EST 2012;Committer;nobu;1;1;1;2;0
7588c674d52791a15fa7631ba2628d6547ad1185;Mon Nov 19 07:31:05 EST 2012;Committer;nobu;3;14;1;15;0
2370556d3d8ec4138c4326208a6da7c1c485e908;Mon Nov 19 07:17:56 EST 2012;Committer;nobu;2;7;3;10;0
a824a6187d202ba57bcdf874c53606c103c357e4;Mon Nov 19 07:08:13 EST 2012;Committer;nobu;4;10;1;11;0
b999f95e707f57e3732b873113c35fa688e5d6ea;Mon Nov 19 06:41:43 EST 2012;Committer;shyouhei;2;5;1;6;0
24512ba1b4be9698f127795d8e9ccfe96640983c;Mon Nov 19 06:11:36 EST 2012;Committer;naruse;3;16;7;23;0
15d940b8b0361925e15f412913f346fca4bf3400;Mon Nov 19 06:07:06 EST 2012;Committer;ko1;6;124;58;182;0
3918bbfac493d7c83371e0491570ea11d53d249a;Mon Nov 19 05:56:38 EST 2012;Committer;usa;4;13;4;17;0
70927cb204f0dd6dc9d82e45d75fec50c437269c;Mon Nov 19 02:06:39 EST 2012;Committer;naruse;2;3;1;4;0
f567a1a4d9b90ff2e20f4a1238d39dfbf5db6995;Mon Nov 19 01:04:53 EST 2012;Committer;naruse;4;18;4;22;0
e1ffb8766802e7d2887d90f124747f4a8991cc20;Sun Nov 18 16:30:14 EST 2012;Committer;svn;1;2;2;4;0
979dff3ee48c2bc26ca9ac817425e2b073e12d73;Sun Nov 18 16:30:10 EST 2012;Committer;ngoto;6;49;32;81;0
2630ad09bd6f959b0379adfba84a6c7b4e4958ff;Sun Nov 18 11:55:34 EST 2012;Committer;tadf;3;8;2;10;0
1f225be2e51f0ff7376846d5631fd6287eb03d14;Sun Nov 18 08:24:24 EST 2012;Committer;ngoto;4;176;21;197;0
42d38decda9249ba77b365f2b242a76e7e109945;Sun Nov 18 00:35:06 EST 2012;Committer;tadf;3;16;11;27;0
7a1985a96970f7e759b945be74e7a8f41a797cd8;Sun Nov 18 00:26:15 EST 2012;Committer;tadf;2;22;18;40;0
55915036a6d1edebe739737bb7d910a8851e21e5;Sat Nov 17 17:53:21 EST 2012;Committer;luislavena;2;7;1;8;0
62f7e108e2e91bfb2c806f1badcdea59f7c8fbfe;Sat Nov 17 17:03:52 EST 2012;Committer;tadf;2;8;5;13;0
8d05671d63b506f8e3db75db4db5631bc61d0fd2;Sat Nov 17 15:51:55 EST 2012;Committer;tadf;2;15;3;18;0
8f3882d0f8342f4fe91713ce5ba5c00adab299ac;Sat Nov 17 15:20:00 EST 2012;Committer;svn;1;2;2;4;0
47fe9b79a3039f3fdd74847feb3570e368a7ac35;Sat Nov 17 15:19:55 EST 2012;Committer;tadf;3;402;256;658;0
20039668ddf425ab3430e06b1021bc86f2f30b4f;Sat Nov 17 14:57:22 EST 2012;Committer;tadf;3;6;1;7;0
628559765352624df9aff2ff7d73927e0df858de;Sat Nov 17 12:46:17 EST 2012;Committer;luislavena;3;13;3;16;0
ee6cfa9cca54082d0e98751b6208a6b3626f3f44;Sat Nov 17 11:07:05 EST 2012;Committer;eregon;1;3;3;6;0
653b0bcbafcbddc9811c06e984f1bbeee2330ddf;Sat Nov 17 03:15:54 EST 2012;Committer;tenderlove;3;17;2;19;0
24c6a7c3680b7a4b40526e28391fabe5e5c36ce3;Sat Nov 17 03:11:22 EST 2012;Committer;tenderlove;3;43;13;56;0
262cb379d6d2fa6500faa90cfdfa54ae044d2296;Sat Nov 17 02:46:13 EST 2012;Committer;shirosaki;3;23;0;23;0
4e57f4e1826ff6f1f3b3c3ffb78132b448b732f9;Sat Nov 17 02:28:48 EST 2012;Committer;tenderlove;3;15;8;23;0
5bab43401841264a2651652f69e1f76d78dce0d4;Fri Nov 16 23:14:38 EST 2012;Committer;eregon;2;15;11;26;0
25058a58a290728e1bb0643145c19b283fba6db6;Fri Nov 16 22:43:22 EST 2012;Committer;luislavena;3;17;0;17;0
7bd638b7a4062d774da7c96d3e926733b6a103ad;Fri Nov 16 17:02:39 EST 2012;Committer;nobu;2;4;1;5;0
ed86cd0536fd1e77a17d69bf30fe5ef531e182ca;Fri Nov 16 17:02:37 EST 2012;Committer;nobu;1;1;0;1;0
b29b2962d2b58587fb1a70a3e97b109757e7586e;Fri Nov 16 17:02:35 EST 2012;Committer;nobu;2;5;5;10;0
6f64d9eb56ef58b73df7f653ece55742129ddbe4;Fri Nov 16 16:55:29 EST 2012;Committer;marcandre;8;22;22;44;0
f45f668fa14104dab9c0e7712b6f3a3ab3d26558;Fri Nov 16 15:55:59 EST 2012;Committer;nagachika;3;15;0;15;0
6379b316bbd74e299d0f9c5d9e6fc0f2d8fffecb;Fri Nov 16 15:40:30 EST 2012;Committer;nobu;2;7;3;10;0
2934f3b96d240f97a1631e5d710d46d2ab5972d3;Fri Nov 16 15:22:43 EST 2012;Committer;svn;1;2;2;4;0
eb40d20e30a7eaf23da16e32c63101ec05d346f6;Fri Nov 16 15:22:37 EST 2012;Committer;nobu;6;31;22;53;0
e4479a1c1bad695070fd435f958dfc98c4e63f0d;Fri Nov 16 12:51:08 EST 2012;Committer;kazu;1;1;1;2;0
1d9d1a8f56df81a6670401d3160f601995bf2cc9;Fri Nov 16 12:32:48 EST 2012;Committer;nobu;1;1;1;2;0
9ee34b15e415446093039f620a5986dd3426f552;Fri Nov 16 10:34:54 EST 2012;Committer;ko1;3;21;10;31;0
6e0375e3e220350b20bbba8125b8243e11e8c810;Fri Nov 16 10:03:07 EST 2012;Committer;naruse;3;8;2;10;0
df4e0dd52d15028fc13dababa2d95d77a33bdb7e;Fri Nov 16 08:57:17 EST 2012;Committer;nobu;3;21;9;30;0
e516438581a6ff13b994aaed48963b4e0720fbd0;Fri Nov 16 08:56:49 EST 2012;Committer;nobu;3;9;4;13;0
1c7f72dac2b864ceeccc6b6b871c6207340c8876;Fri Nov 16 08:30:56 EST 2012;Committer;nobu;2;12;9;21;0
c9b6a01435ef814f790f770520400e7f6ccc5e20;Fri Nov 16 07:28:30 EST 2012;Committer;nobu;1;3;5;8;0
288da355e3575a7331f75ae2a8593e59d4433d78;Fri Nov 16 07:24:45 EST 2012;Committer;nobu;2;8;2;10;0
620a2b6c65ef497529bca89abae5ea7d16e0d191;Fri Nov 16 06:42:38 EST 2012;Committer;nobu;3;8;2;10;0
6fd1ef7719b7296dfd3b672c6b44c2fc74b02322;Fri Nov 16 06:41:51 EST 2012;Committer;nobu;1;1;0;1;0
1e6ced13be0646ea1d16f0791072441673d100d0;Fri Nov 16 06:41:05 EST 2012;Committer;nobu;2;3;3;6;0
df03463ff22cf54dc71713e2d92b99b7168430db;Fri Nov 16 06:37:06 EST 2012;Committer;glass;2;7;1;8;0
a632fe43d837f3cb05ed35012327aa60c37919b7;Fri Nov 16 03:49:09 EST 2012;Committer;naruse;7;17;9;26;0
48aab9e032f7deca5ccc994356428c86f75ef2f7;Fri Nov 16 01:25:46 EST 2012;Committer;naruse;2;6;1;7;0
4b96ecc89f2ca222d0a94f880ee7ca25985a2d96;Fri Nov 16 00:43:00 EST 2012;Committer;naruse;2;12;2;14;0
1b023030a88a35118875b068a1fd725c58a32083;Thu Nov 15 22:32:34 EST 2012;Committer;drbrain;13;90;28;118;0
84da520d8398a213d18f79af1ac17bf488b0a96d;Thu Nov 15 21:59:43 EST 2012;Committer;svn;1;2;2;4;0
9c66bad9f3d522d50d4a45ef8a3a92abbf93229f;Thu Nov 15 21:59:37 EST 2012;Committer;drbrain;45;1408;230;1638;0
412b023742171585b123cf20fcbb9b94476582ac;Thu Nov 15 13:50:55 EST 2012;Committer;mame;4;23;9;32;0
768801b020d2ec28af2bb719cadf5bc3c126c3d6;Thu Nov 15 13:42:27 EST 2012;Committer;ko1;2;6;1;7;0
5457b86aaf6dfa3191cd53eed7e32e4b5cc867e0;Thu Nov 15 04:22:44 EST 2012;Committer;zzak;7;33;21;54;0
81d71fee9ba3be04209c2f157b16f06ec5054028;Thu Nov 15 02:37:05 EST 2012;Committer;zzak;2;15;10;25;0
5c30ce373f071750a0346091595caae840e64994;Wed Nov 14 16:03:04 EST 2012;Committer;svn;1;2;2;4;0
de07850e47ac41149304c58e9ebdbed47af23a70;Wed Nov 14 15:53:50 EST 2012;Committer;mame;6;511;0;511;0
c8b0b5362c1bf354d1b4141a11b3192d1668e1f5;Wed Nov 14 04:26:20 EST 2012;Committer;zzak;2;19;12;31;0
a4b0291fcb4bbb53c57fbaeaeb5b16d8aa63d5a7;Wed Nov 14 02:53:02 EST 2012;Committer;zzak;2;10;0;10;0
5de3acdcd8943c10617c842d81f4c0cc27d6bf47;Tue Nov 13 15:56:30 EST 2012;Committer;svn;1;2;2;4;0
3dd13a1c07077dd491c4916ffdf37b61f395ad78;Tue Nov 13 15:56:23 EST 2012;Committer;mrkn;2;7;3;10;0
0c1682b3045a04f753f81d0a5d18c303dd9496ba;Tue Nov 13 09:48:08 EST 2012;Committer;ko1;5;77;57;134;0
684aa1f98590ca97eab22ceecfea04c5cb5134bf;Tue Nov 13 09:05:18 EST 2012;Committer;shugo;3;50;0;50;0
e7659bd2fd61b13800f2e5841659ab85a8aff525;Tue Nov 13 08:52:34 EST 2012;Committer;naruse;10;10;10;20;0
bd5b2cb6171d7985fd9fade8f3deaf59cd176d71;Tue Nov 13 08:41:11 EST 2012;Committer;naruse;2;5;1;6;0
1619c02dd34dcc811b7d18437e8fc3f019906d1c;Tue Nov 13 08:36:42 EST 2012;Committer;ko1;2;4;3;7;0
0d6c9accd7f64c19ff9162e42890aba87b4f9d4e;Tue Nov 13 08:35:22 EST 2012;Committer;ko1;1;1;1;2;0
ffd3cbdc759841c984ec35bfecfb9f7ed28d4faa;Tue Nov 13 08:34:43 EST 2012;Committer;ko1;3;79;2;81;0
db31b3dad519f755358f0a96baad5c378e7c7972;Tue Nov 13 07:49:09 EST 2012;Committer;naruse;4;16;7;23;0
d8aaa430747121474ae88edc5807a9b970a15e75;Tue Nov 13 06:38:08 EST 2012;Committer;naruse;2;6;2;8;0
aec93c22832ef302d102fe45cafa506b4edc1436;Tue Nov 13 06:35:30 EST 2012;Committer;usa;4;17;10;27;0
f82d652f35b594c63358cf06bdd242f3cb30b534;Tue Nov 13 06:13:39 EST 2012;Committer;naruse;6;58;40;98;0
8e72bb717ab8613e25ac0c2e68cdff23fd905f04;Tue Nov 13 03:32:06 EST 2012;Committer;usa;2;10;0;10;0
c5b19cf01cd15e0d9d8e2847ba746a5f361841df;Tue Nov 13 02:12:40 EST 2012;Committer;glass;3;56;0;56;0
d24e2d746f417a041499e66cc54bafdf221f00ad;Tue Nov 13 00:44:12 EST 2012;Committer;kazu;1;1;1;2;0
4c740bae97f31e16cc6d15753868b6bd49e330d0;Mon Nov 12 21:52:12 EST 2012;Committer;tenderlove;37;850;25;875;0
25f64fc62cfcd4ae1c1e95a5c5448102edccdf8a;Mon Nov 12 15:37:34 EST 2012;Committer;svn;1;2;2;4;0
9900da041c1b4d774098c227d996a6e667463304;Mon Nov 12 15:37:30 EST 2012;Committer;kazu;1;2;2;4;0
e34f5087756654f6c8368c1825861ab7e1b64585;Mon Nov 12 10:26:28 EST 2012;Committer;knu;2;9;0;9;0
afdfbde4e73135985a3762adc437c6e317b0904e;Mon Nov 12 07:00:12 EST 2012;Committer;shugo;5;13;16;29;0
6483a1057abdacff541641d117c364591bfb3e13;Mon Nov 12 05:30:00 EST 2012;Committer;svn;1;2;2;4;0
198b740019081ee64c6b15fe54062d4c7d279803;Mon Nov 12 05:29:52 EST 2012;Committer;usa;2;7;1;8;0
cb9beafd115d0d71033d70fe2b847668a40f175b;Sun Nov 11 10:02:32 EST 2012;Committer;tadf;3;458;454;912;0
8defbc442bde7872ed8d8c5f1081fc6765641c26;Sun Nov 11 09:45:44 EST 2012;Committer;tadf;2;83;38;121;0
64757d284aad769dc16229881822bbbb3a0d7751;Sun Nov 11 08:15:53 EST 2012;Committer;naruse;1;10;0;10;0
5051186a0b1ca74a3fbd82714f93333995ea471e;Sun Nov 11 06:39:08 EST 2012;Committer;nobu;3;16;3;19;0
5a5a86cc527946fb40f241377179b0723f2348db;Sun Nov 11 06:38:17 EST 2012;Committer;nobu;5;17;5;22;0
10ba3bdd533389fbd037be26930795d80d8f7104;Sun Nov 11 06:14:16 EST 2012;Committer;shugo;3;34;7;41;0
b0c8aeeb9caa9b796892c30f6c675cc2191e89b5;Sun Nov 11 04:45:31 EST 2012;Committer;shugo;3;78;1;79;0
fc4b6cd25f231d19851cd256b7c0ad1fe06000d9;Sun Nov 11 04:23:04 EST 2012;Committer;glass;2;18;4;22;0
ba5ea548cefd82307e96a6308e2b85425030e461;Sun Nov 11 02:42:04 EST 2012;Committer;shugo;5;51;3;54;0
35020e355cdabd2edf1d9e264cd1ff12993fe027;Sat Nov 10 23:47:45 EST 2012;Committer;duerst;2;5;1;6;0
c274c951593218379b3d73756202d6faca68c62f;Sat Nov 10 15:04:32 EST 2012;Committer;svn;1;2;2;4;0
8a9097e83cd942584af77778abb033eba56bc7eb;Sat Nov 10 15:04:27 EST 2012;Committer;nari;2;47;50;97;0
59050cbafa2c2c9c0ca8713561c872c283bfb990;Sat Nov 10 10:34:40 EST 2012;Committer;tadf;1;1;1;2;0
e864787c849bd723747d753837bc8bdce0428589;Sat Nov 10 10:29:13 EST 2012;Committer;tadf;3;22;8;30;0
b04aa4d2cfcae41f039f964fdfa99e3428fd8710;Sat Nov 10 09:21:41 EST 2012;Committer;tadf;2;111;11;122;0
52c50bf5f57d6651d2e709a8cb472b19607601d3;Sat Nov 10 04:03:30 EST 2012;Committer;marcandre;1;0;3;3;0
e91c04e2e97ced1031200477c3ca1d4144f76989;Sat Nov 10 03:15:55 EST 2012;Committer;kou;2;7;1;8;0
05a05cc62b7668dc9806b94fda6aea95116cee81;Fri Nov 09 16:05:07 EST 2012;Committer;ngoto;7;127;119;246;0
c4e1ecef13458e9ec260bad524bacb7f3e185816;Fri Nov 09 16:00:00 EST 2012;Committer;ngoto;2;4;1;5;0
e4d1a8a1579edaa56af1b3cac7b031ad59673d58;Fri Nov 09 15:42:55 EST 2012;Committer;usa;1;1;1;2;0
125ca30ca270683ff029c27e6f5fcc4f26363841;Fri Nov 09 15:34:31 EST 2012;Committer;usa;2;4;2;6;0
36ca3781bd1bed82aa898823cceb03ae99bf3d12;Fri Nov 09 15:20:01 EST 2012;Committer;svn;1;2;2;4;0
f20ea787a5974ad87888024be8f589456708225d;Fri Nov 09 15:19:56 EST 2012;Committer;usa;2;6;0;6;0
e3adacf0cb4297a5a0c1ae1b0a872d18939f2d4a;Fri Nov 09 14:44:05 EST 2012;Committer;nagachika;1;0;28;28;0
62f7424640b0aff81834d3d310193ab9e1288bfb;Fri Nov 09 14:33:11 EST 2012;Committer;nobu;3;25;3;28;0
2ce1fbeb59dd0a125d56f2500b0dba1a56380da0;Fri Nov 09 14:05:11 EST 2012;Committer;nobu;2;16;1;17;0
1d2ddae1607b32d5183a9d9cdd0ccf57127e3dc3;Fri Nov 09 14:02:34 EST 2012;Committer;nobu;1;5;0;5;0
496d7cc886ddf7b466019a65506d3b9977bca8d4;Fri Nov 09 14:02:31 EST 2012;Committer;nobu;1;5;2;7;0
bbcfac95d467a6581b75da4c29f8a5a17804cd70;Fri Nov 09 13:02:16 EST 2012;Committer;kazu;1;2;2;4;0
a91e3149c4eddd897bbfd4ddc6fcbf1b3b9086eb;Fri Nov 09 11:20:31 EST 2012;Committer;zzak;1;3;5;8;0
efeee7afa9c9dc442a4eb591cc0f6a89dc03bc01;Fri Nov 09 11:04:05 EST 2012;Committer;naruse;3;18;1;19;0
5bde05f98f97557e0d040d7a579111e5bb0f2c0e;Fri Nov 09 08:11:44 EST 2012;Committer;naruse;1;1;1;2;0
525cb66467ff22a50f2e6bf307924459d38cd592;Fri Nov 09 07:12:00 EST 2012;Committer;nobu;6;553;7;560;0
fdbd3716781817c840544796d04a7d41b856d9f4;Fri Nov 09 07:08:50 EST 2012;Committer;nobu;2;65;10;75;0
aaa9cb1ab4dd225113f027d4b725b8bb417e2cb1;Fri Nov 09 07:08:45 EST 2012;Committer;nobu;2;8;5;13;0
b11975dfe072630a0a14ab4664a688b855cbdaa6;Fri Nov 09 07:08:42 EST 2012;Committer;nobu;2;47;9;56;0
06de286c68f04b989cd7fd6e282065b3e8479d7e;Fri Nov 09 07:08:38 EST 2012;Committer;nobu;2;55;6;61;0
50c859715de864630d8c9259d6e6facc7c158bb8;Fri Nov 09 07:03:13 EST 2012;Committer;zzak;2;168;83;251;0
f030a91d3e5317f62ca6ff8c273061e46248dd08;Fri Nov 09 06:57:42 EST 2012;Committer;nobu;1;1;3;4;0
ab714c82f0f9b8c27275f9dde3b56ff171ef37dc;Fri Nov 09 06:28:00 EST 2012;Committer;knu;2;14;2;16;0
eccb95543cd9cfa26daaeacd5c4e44672286948d;Fri Nov 09 06:25:02 EST 2012;Committer;knu;2;7;3;10;0
dfb44feefeb837bae561769e5f1a30276e70b0a8;Fri Nov 09 04:06:45 EST 2012;Committer;naruse;2;11;1;12;0
1c0323adbc390c40453c4ad02150e26b55e0dbf5;Fri Nov 09 03:34:08 EST 2012;Committer;knu;5;51;49;100;0
8ebd713b7f469923749c53d3ed191123d8f0ef27;Fri Nov 09 00:30:55 EST 2012;Committer;zzak;1;3;3;6;0
de794aefa6ba7d33eea333e7ae0f266cfd4331a4;Fri Nov 09 00:28:41 EST 2012;Committer;zzak;2;8;2;10;0
bb250b002bbb0c079ead456f1bf0a47a394f29be;Thu Nov 08 22:38:03 EST 2012;Committer;mrkn;3;20;7;27;0
9071bbb8cc28c8a0fc7dd9d1d0d6c8be5f506f24;Thu Nov 08 20:38:58 EST 2012;Committer;svn;1;2;2;4;0
22767ffd13d17dd5b2dbdfcc9c8a92b23637a366;Thu Nov 08 20:38:53 EST 2012;Committer;mrkn;3;121;7;128;0
9f9ebe4ebae2769be512e46e720c3e523b7f7479;Thu Nov 08 13:40:33 EST 2012;Committer;glass;2;11;6;17;0
6ce8c33936d59716a0676d2ec8e22b22e2a1da94;Thu Nov 08 10:04:24 EST 2012;Committer;naruse;3;15;2;17;0
edb68694b8c2a36704257470631792dad498bf87;Thu Nov 08 06:56:17 EST 2012;Committer;xibbar;1;7;1;8;0
f822c523fbb639275e42fda3403e1495733f00ff;Thu Nov 08 04:52:35 EST 2012;Committer;knu;1;2;2;4;0
0a741075a362d55869f29662d528e2c97194574c;Thu Nov 08 03:09:18 EST 2012;Committer;knu;2;8;1;9;0
6ea34efab04f08c4bb772af8406e09021a403bc0;Thu Nov 08 00:34:55 EST 2012;Committer;mrkn;2;20;0;20;0
a68cc24a9e8ad3c1ce2b9ce4b13d2b5849ec1fd9;Wed Nov 07 19:46:16 EST 2012;Committer;marcandre;3;22;5;27;0
bc634493313a180c2d14e3d8c1d511b7a6044c85;Wed Nov 07 19:45:59 EST 2012;Committer;marcandre;1;2;2;4;0
0ab21f9572d5d5f76b908aaf3381cde32a64c4c8;Wed Nov 07 15:51:00 EST 2012;Committer;ayumin;1;3;0;3;0
94cd486b511f8a7705f96654fd070835bdecd683;Wed Nov 07 15:36:22 EST 2012;Committer;svn;1;2;2;4;0
316947eaa4bd0684c6b6b371f1b797aadd8ff586;Wed Nov 07 15:36:14 EST 2012;Committer;knu;2;6;1;7;0
a3286ba320deabfd60861eabaddbc0263cb429f8;Wed Nov 07 07:03:53 EST 2012;Committer;naruse;1;6;4;10;0
172d8f9b6eb3d0af7f451e505fd3a5c2e438215e;Wed Nov 07 07:03:50 EST 2012;Committer;naruse;3;19;4;23;0
043c0eaac0e63eacc5da6624432420a903e8f2d6;Wed Nov 07 06:49:57 EST 2012;Committer;ayumin;2;6;1;7;0
8549059d7677bc005012e3002515ed8a29bcb7f9;Wed Nov 07 06:36:49 EST 2012;Committer;xibbar;3;9;4;13;0
5836962f48200c71f5989315b9e2ac4db2b87541;Wed Nov 07 04:09:51 EST 2012;Committer;shugo;5;35;17;52;0
1c5104ac9c0803c476b54d751b0ec4579a1828af;Wed Nov 07 02:48:19 EST 2012;Committer;nobu;2;46;0;46;0
bd9b31e557ca557aa2ae8b5908c71e1250e450c8;Wed Nov 07 00:16:03 EST 2012;Committer;nobu;2;14;2;16;0
db54dc7215bc6838feaea452a13a8954cdad8a7b;Tue Nov 06 22:52:52 EST 2012;Committer;nobu;4;8;3;11;0
7f00f853d4b1c09c4b37eeb6c12e8386c622fa3f;Tue Nov 06 22:50:30 EST 2012;Committer;nobu;4;20;10;30;0
6678422feea0bc7e3c8e3097c47ac6ef396557db;Tue Nov 06 22:00:12 EST 2012;Committer;shirosaki;2;4;4;8;0
75c20a7902e50a05263b30b5ae1feaf54788833c;Tue Nov 06 19:40:42 EST 2012;Committer;luislavena;2;5;1;6;0
95cd5aaa48f6b39062b5c4a5950928817b9bf8d6;Tue Nov 06 18:50:53 EST 2012;Committer;luislavena;2;8;1;9;0
81bfd9a6c0960e0a20a2b93a4db8f38c1507998d;Tue Nov 06 17:17:12 EST 2012;Committer;marcandre;2;38;0;38;0
0814c4ac643fcbb2d7f2d6c077fa1626a5e59b77;Tue Nov 06 17:16:58 EST 2012;Committer;marcandre;4;19;2;21;0
7a31096255cd226d16c918fa859e3e4a654e64b9;Tue Nov 06 17:16:44 EST 2012;Committer;marcandre;2;19;1;20;0
9aafa954aa9ddb54f943c029100c03c4d4a1701b;Tue Nov 06 17:16:29 EST 2012;Committer;marcandre;2;15;1;16;0
5dbbfc3b3463d08b290e33975d815b6336069810;Tue Nov 06 17:16:13 EST 2012;Committer;marcandre;2;22;12;34;0
c8426ce840bf5329fd31e8696d4f225a207b6550;Tue Nov 06 17:15:59 EST 2012;Committer;marcandre;2;27;2;29;0
44374034268913246d517ff25365e0bccb453e02;Tue Nov 06 17:15:45 EST 2012;Committer;marcandre;2;28;3;31;0
3a4eb4dd39b4a6687068de391c8543008c3f977c;Tue Nov 06 17:15:30 EST 2012;Committer;marcandre;2;14;1;15;0
c2dc0dc1ce7ae4340966118994e04d4dd3fb0c3f;Tue Nov 06 17:15:15 EST 2012;Committer;marcandre;2;18;2;20;0
faed90d814d6739cc55e6f0103fdc06fc1c5de0a;Tue Nov 06 17:15:00 EST 2012;Committer;marcandre;2;30;1;31;0
28d8bf902d573236ee0bdfdc84de5d96deffefee;Tue Nov 06 17:14:46 EST 2012;Committer;marcandre;2;29;1;30;0
34be3a5d907a83a9b71a5916a283c0ec7151d6eb;Tue Nov 06 17:14:31 EST 2012;Committer;marcandre;3;56;2;58;0
f02c29ee4f0396735c260114fc9f93ba3dc8ca2e;Tue Nov 06 17:14:16 EST 2012;Committer;marcandre;1;28;24;52;0
ce0bf9f43d9d1828bfd1d8001dcba729d9553f38;Tue Nov 06 17:14:02 EST 2012;Committer;marcandre;2;13;3;16;0
17c0aff0d6d8a2629b535a52a93e348904e27b97;Tue Nov 06 17:13:48 EST 2012;Committer;marcandre;2;32;8;40;0
19ed71c8d035e14d6ca39af4e52fb6630cb56c23;Tue Nov 06 17:13:33 EST 2012;Committer;marcandre;2;17;8;25;0
cef054d5b2d29422b2160783aea6d0581c701483;Tue Nov 06 17:13:19 EST 2012;Committer;marcandre;2;24;1;25;0
fe9386cdcbfce8c631a333add2b2cab8366ee6dc;Tue Nov 06 17:13:04 EST 2012;Committer;marcandre;2;22;1;23;0
df8451e6062029cb23593679317be97d1c218c7b;Tue Nov 06 17:12:50 EST 2012;Committer;marcandre;2;29;1;30;0
c82ad6d20781630c9bf71fd811cade770691240e;Tue Nov 06 17:12:35 EST 2012;Committer;marcandre;2;36;14;50;0
727024fbac6ac97a3c4236583e5819d72a1513b7;Tue Nov 06 17:12:20 EST 2012;Committer;marcandre;2;10;1;11;0
b8b01ab995b963db825b9b493aa98500f0be83e0;Tue Nov 06 17:12:05 EST 2012;Committer;marcandre;2;23;1;24;0
ba59365db9283b23b1a2dd9b91dac7303c798326;Tue Nov 06 17:11:51 EST 2012;Committer;marcandre;2;17;1;18;0
68c90c4a2d0b9431ad6f12ba12c91c7e3d65360d;Tue Nov 06 17:11:36 EST 2012;Committer;marcandre;2;20;2;22;0
6bbf668d6e797a402a3e6819f4efda5315db1a11;Tue Nov 06 17:11:21 EST 2012;Committer;marcandre;2;32;2;34;0
1cb9f27c13481594469948ddbca982dd5ae4fad8;Tue Nov 06 17:11:06 EST 2012;Committer;marcandre;2;37;1;38;0
55fb13eff9dbc5c0565dfb75d6a4e919af00e696;Tue Nov 06 17:10:50 EST 2012;Committer;marcandre;2;21;12;33;0
57d596cdb4a0de82288e3f526126ddf23fff0c41;Tue Nov 06 17:10:35 EST 2012;Committer;marcandre;2;11;2;13;0
acfd34a6a9e6462ed05f74e07f204b98d93126ff;Tue Nov 06 17:10:20 EST 2012;Committer;marcandre;2;14;2;16;0
610eeffa468f43c13fd374c53b5ed5cb5dd9c1b3;Tue Nov 06 17:10:06 EST 2012;Committer;marcandre;3;74;14;88;0
2f4769a874252cecac25486170a03b1002af0c17;Tue Nov 06 17:09:49 EST 2012;Committer;svn;1;2;2;4;0
c73b6bd7ebd01133538c645566944132dbde4d13;Tue Nov 06 17:09:43 EST 2012;Committer;marcandre;2;5;1;6;0
ac7f5157ac9d35b40da74ad932e9997f3f3e38a4;Tue Nov 06 11:42:24 EST 2012;Committer;tenderlove;3;43;1;44;0
e5e5d0c55efb5f51c6825c58a95f9ad77408b1d1;Tue Nov 06 09:46:30 EST 2012;Committer;glass;1;2;0;2;0
31f72cf518c58567a4f5daac64d990654d835ef8;Tue Nov 06 08:06:21 EST 2012;Committer;glass;2;18;0;18;0
e2418e3fcada21067b98032d514c34586f078b5b;Tue Nov 06 07:30:49 EST 2012;Committer;ngoto;2;7;0;7;0
bba3ceafa5a79e2c5d90c13d630c94b66a5da797;Tue Nov 06 05:43:47 EST 2012;Committer;usa;1;2;2;4;0
f2fc82fc2a45e653f67d3a67e76dc8d4385e12e4;Tue Nov 06 05:39:36 EST 2012;Committer;usa;2;6;1;7;0
ccd7a805cc4ceb274ece6ba519fa233ed8d210c2;Tue Nov 06 05:30:17 EST 2012;Committer;naruse;3;17;1;18;0
a6ec2584527fb4d6f3a65a2dd16dc02eabdfcec6;Tue Nov 06 00:50:02 EST 2012;Committer;naruse;4;45;2;47;0
58ef0f06c6f6fcc4f6a0d31ade430d87ef9d968d;Tue Nov 06 00:49:57 EST 2012;Committer;naruse;24;32;6;38;0
c9fc6b08ae515a22293a4a44fe1f0d8452b88183;Mon Nov 05 20:55:30 EST 2012;Committer;shirosaki;2;9;2;11;0
4e73323a6007d0a554b52440f316e3c4c71eae26;Mon Nov 05 16:43:32 EST 2012;Committer;kosaki;2;7;1;8;0
d33b9a8a724f5c46308b1a76062ac5722269905b;Mon Nov 05 15:27:08 EST 2012;Committer;shirosaki;7;276;13;289;0
9823c46189d7447692ea6c33e07b4cae5fed74f2;Mon Nov 05 15:27:05 EST 2012;Committer;shirosaki;5;54;8;62;0
b56a2afc14ebdc2e5524e0a8ebcf920626d463af;Mon Nov 05 15:27:01 EST 2012;Committer;shirosaki;6;182;26;208;0
2a7d349eb4d8535dda1f615a262614d3cee4d038;Mon Nov 05 15:24:08 EST 2012;Committer;svn;1;2;2;4;0
e575070f2f513051d2937bf2f6031e400eb6a82e;Mon Nov 05 15:24:07 EST 2012;Committer;shirosaki;4;27;1;28;0
4d414c9f681a0a359df7686fef45bfd531ba634e;Mon Nov 05 15:24:03 EST 2012;Committer;shirosaki;2;53;12;65;0
9bb55f7633a1a6c88efb9bd3581cf7f71b20fc23;Mon Nov 05 14:00:41 EST 2012;Committer;shirosaki;2;9;1;10;0
868ab650eb54e723e4c91a7279b7bfbe424d23e4;Mon Nov 05 14:00:35 EST 2012;Committer;shirosaki;2;10;2;12;0
9da62b63d9377299db5240e007ccf4a1644e4233;Mon Nov 05 02:46:41 EST 2012;Committer;kosaki;2;8;4;12;0
0ba4526d06e16ee496c581d7cf5a9fee801b3109;Mon Nov 05 02:34:17 EST 2012;Committer;naruse;3;42;3;45;0
0ba78cb2f79530abf433b008a23778c7468d6af4;Mon Nov 05 01:19:09 EST 2012;Committer;zzak;2;7;1;8;0
1362d81a22ab179c1286a61b8d5a54e59784458e;Mon Nov 05 00:57:45 EST 2012;Committer;xibbar;2;27;0;27;0
d5528ec3580dba09ebbda819c7b10e25d5af5981;Mon Nov 05 00:57:41 EST 2012;Committer;xibbar;1;7;0;7;0
a8aaf1eb14fea89c0f448aa5c96555d5f4c286c4;Sun Nov 04 21:14:23 EST 2012;Committer;svn;1;2;2;4;0
b5c5b980ddd9e8ad44c099d9fa9a53c0fb7eb49d;Sun Nov 04 21:14:19 EST 2012;Committer;naruse;1;1;0;1;0
8519a2d581209e774b52ff8510b6c444971c1021;Sun Nov 04 12:37:11 EST 2012;Committer;kou;1;0;3;3;0
6837f3dc54ac4afd89c185e520c250ef2eb42c4e;Sun Nov 04 11:48:05 EST 2012;Committer;xibbar;8;73;54;127;0
2142287c8696f5c8b1ca8e68c557ff61ab921f8e;Sun Nov 04 02:56:11 EST 2012;Committer;glass;2;13;10;23;0
a28a060db41415c1c1dad3e554ff2c865a20ebca;Sun Nov 04 02:44:58 EST 2012;Committer;glass;3;25;1;26;0
e59d5667c7769ffbe77f50687cb4393ca9280b2b;Sun Nov 04 01:19:11 EST 2012;Committer;nobu;5;48;4;52;0
7ba2f1a9ddd7efc36aa3bfddbefc262b5fe6c990;Sat Nov 03 19:51:43 EDT 2012;Committer;svn;1;2;2;4;0
129dafda6facb819da0858f43730fd2bd7149676;Sat Nov 03 19:51:38 EDT 2012;Committer;nagachika;1;2;2;4;0
d4199057bc9767d05bc05e90a4ce5de642306396;Sat Nov 03 14:39:50 EDT 2012;Committer;tadf;3;103;93;196;0
64bb9749afa914d08a022ec67159ee40b24baaf1;Sat Nov 03 13:39:54 EDT 2012;Committer;tadf;2;8;153;161;0
65b746bec045ec94ec762fbb9187fbd3a8860716;Sat Nov 03 09:41:38 EDT 2012;Committer;ktsj;3;26;27;53;0
049ace5888174d5c2680a9203a8e3f24e928f2b9;Sat Nov 03 09:18:58 EDT 2012;Committer;ktsj;3;6;4;10;0
c1dbeada5bdc9ad13d811b33d1637971ae1e3658;Sat Nov 03 09:14:28 EDT 2012;Committer;ktsj;1;0;2;2;0
98d69f426fc1243de3817e602fe2da959962375e;Sat Nov 03 08:56:22 EDT 2012;Committer;kou;3;17;8;25;0
0ae90522a684de90e38b45fa8e5d027b04049861;Sat Nov 03 05:59:08 EDT 2012;Committer;tadf;2;5;1;6;0
d55aa2bf6757d494f2c2da42a0be13e34de7da0c;Sat Nov 03 05:47:32 EDT 2012;Committer;tadf;2;9;5;14;0
6bc138b0525d08a62f5d597bc75af66b2176843d;Sat Nov 03 05:44:31 EDT 2012;Committer;kou;2;6;1;7;0
04f41f019a5fda5cc63ef2aadb8acd079a5ee6ec;Sat Nov 03 05:43:28 EDT 2012;Committer;kou;2;6;1;7;0
ac9a8ac62416cfc7c6faf059651b7945cb5e3bf6;Sat Nov 03 05:42:40 EDT 2012;Committer;kou;3;30;0;30;0
15a743b3ff393092f19fb8e57bd79675dd208b02;Sat Nov 03 05:11:00 EDT 2012;Committer;kou;2;10;0;10;0
82aef2ae509361c08498c1a4ca07bf03866b5ecb;Sat Nov 03 04:58:03 EDT 2012;Committer;kou;2;9;6;15;0
c420f8449ea45dd4c45db9dea601039c47f3ecf3;Sat Nov 03 04:47:49 EDT 2012;Committer;zzak;2;13;5;18;0
bdbc8c5b74b0b17da710c9f174a920e4c8b3cb02;Sat Nov 03 04:46:06 EDT 2012;Committer;kou;4;9;32;41;0
4aca275e9c0778eafed9a54467e5446cebac48fe;Sat Nov 03 04:40:42 EDT 2012;Committer;kazu;1;3;3;6;0
c442d22160465d79b94c65e9a4398ff01ec396c5;Sat Nov 03 04:28:38 EDT 2012;Committer;zzak;1;6;0;6;0
4d42277823dc334b119d84376f5812c76691ac8a;Sat Nov 03 04:27:56 EDT 2012;Committer;zzak;1;19;18;37;0
dbfb5deab64a8b929b77361b132cd4cad4f8ce10;Sat Nov 03 04:03:55 EDT 2012;Committer;kou;2;9;2;11;0
9c606a0a4cb6d573c1331215386d35d5fdc59e55;Sat Nov 03 03:55:06 EDT 2012;Committer;kou;2;7;2;9;0
3f817764e24eb05aceef884e213d4a7043c292fa;Sat Nov 03 03:53:09 EDT 2012;Committer;kou;4;35;15;50;0
69eedf6a18d0c21b06d30ec4bc4a550d4ac125dd;Sat Nov 03 03:41:26 EDT 2012;Committer;kou;3;25;7;32;0
c032c5bc9acb015dbe2947a39d3d7ce033c934ee;Sat Nov 03 03:21:47 EDT 2012;Committer;glass;2;11;3;14;0
bd2024165c8d9380a75b88607a9c0dfe066aae5f;Sat Nov 03 03:06:50 EDT 2012;Committer;kou;2;9;3;12;0
9a2dc8f9da2b344c91dcd8c66223fa11412ec78b;Sat Nov 03 03:05:28 EDT 2012;Committer;kou;3;38;33;71;0
63e9bc50f563dd0cddbdf957e27c3159aac49249;Sat Nov 03 02:45:15 EDT 2012;Committer;zzak;2;8;2;10;0
4166390229eea57c350f964fd0abf050ce3781d8;Sat Nov 03 02:35:39 EDT 2012;Committer;nari;2;8;0;8;0
e2f951656f952d73e16a60b75767cae8e651c532;Sat Nov 03 02:35:36 EDT 2012;Committer;nari;2;5;0;5;0
805b08f2925f5ceec67bf472e76e869bbddc8c39;Sat Nov 03 01:37:50 EDT 2012;Committer;nari;4;37;0;37;0
d2fd7f32c8f4b134dc6716903be3be0f6c67760b;Sat Nov 03 00:09:26 EDT 2012;Committer;shugo;2;37;0;37;0
f7894e422a935d975f7fc4130b73fefba16a9433;Fri Nov 02 19:14:24 EDT 2012;Committer;nobu;4;60;20;80;0
0446be770e48de54a32e7f383f064e734473785a;Fri Nov 02 15:28:36 EDT 2012;Committer;svn;1;2;2;4;0
2f3068fd43a32a09dfb33b83b1e66f9214e5ec76;Fri Nov 02 15:28:31 EDT 2012;Committer;glass;1;2;1;3;0
5f06ee7ea0d50ae91f5d92c449d4cedd1de497a6;Fri Nov 02 11:11:21 EDT 2012;Committer;nobu;2;6;3;9;0
e627955d140d10f8b3575f6a5d8efd5edf220cc5;Fri Nov 02 11:02:27 EDT 2012;Committer;nobu;2;6;1;7;0
7f6d21731c627b310b6853d80fdcc09bdcb424c9;Fri Nov 02 08:56:10 EDT 2012;Committer;sorah;2;17;4;21;0
b14e2b4401db4746cc45ae9e4ce6350f7594f84f;Fri Nov 02 08:53:06 EDT 2012;Committer;shugo;4;55;1;56;0
a8b3d67e7c78d6be55e030159db5d611d8b5a247;Fri Nov 02 08:00:02 EDT 2012;Committer;sorah;2;12;6;18;0
8db54e07f9154d2cf6d4242f864e68e4d54c2b25;Fri Nov 02 07:52:56 EDT 2012;Committer;mrkn;2;9;3;12;0
584afabcc059879ee16dd9d8cca4a2b0af4ea80e;Fri Nov 02 07:16:54 EDT 2012;Committer;glass;1;1;1;2;0
da9f6cdcb774ae8ee052f9d05b0554a44dde2af4;Fri Nov 02 07:04:39 EDT 2012;Committer;glass;2;24;3;27;0
fb4e75c1fb5b36a55ac3ff6614601ca59fb2c2ac;Fri Nov 02 05:48:34 EDT 2012;Committer;svn;1;2;2;4;0
bb504213816e4598f1961b99e115f8ba59bef71f;Fri Nov 02 05:48:29 EDT 2012;Committer;shugo;5;87;24;111;0
499b5a9197f68e14873e641b737aea40a0f8bc5a;Thu Nov 01 23:24:33 EDT 2012;Committer;nobu;4;52;1;53;0
603fcafdc33ea5aed55240020e7287597b6b2e01;Thu Nov 01 23:23:23 EDT 2012;Committer;nobu;2;6;2;8;0
71dcc25fb768b0ff8fe49d0d8186d001b98ae469;Thu Nov 01 19:48:34 EDT 2012;Committer;naruse;1;1;1;2;0
1d4ec583c7a0b83c153cab34a2b6865db7ea0619;Thu Nov 01 19:41:38 EDT 2012;Committer;nobu;2;6;1;7;0
27f414916e2f65291d162a3c02407c595dd86400;Thu Nov 01 19:40:15 EDT 2012;Committer;nobu;2;6;1;7;0
082e1344ccb587fd663446a423095b58a6cc34a6;Thu Nov 01 19:24:21 EDT 2012;Committer;naruse;2;34;9;43;0
072ab753ec04dc7578abeeeea23fe2d47e2d75fc;Thu Nov 01 18:24:39 EDT 2012;Committer;naruse;2;7;3;10;0
b2bbfb3e1836db4c48bc6ebae63af96be85d380b;Thu Nov 01 18:22:31 EDT 2012;Committer;naruse;2;11;3;14;0
98c96a69c379ab377217469f2b8115ba83447a86;Thu Nov 01 13:29:28 EDT 2012;Committer;ko1;2;9;0;9;0
a3e5a86596c8a34559361055911f724a2200d287;Thu Nov 01 13:04:04 EDT 2012;Committer;mrkn;3;21;1;22;0
2e6b5ece958d6bfb389d2b0cb9fedce0e733214f;Thu Nov 01 13:03:53 EDT 2012;Committer;mrkn;3;40;15;55;0
a5fc96a5c12b347c9b78949810bca245f48a1bec;Thu Nov 01 12:46:27 EDT 2012;Committer;mame;2;6;1;7;0
de08204297f3272ad66b0ec9813caf03b17519fc;Thu Nov 01 12:33:51 EDT 2012;Committer;mame;2;7;1;8;0
0c4a27a5a207b7ab30d4b2edd16e0b75e551e1da;Thu Nov 01 12:20:00 EDT 2012;Committer;nobu;2;10;1;11;0
5aa7ff2b8a41ad688465b3d919aab62d214c74c3;Thu Nov 01 10:47:27 EDT 2012;Committer;nobu;2;13;8;21;0
ba1bd089c8445e83f99cb07563234dd8bdbf0f55;Thu Nov 01 07:48:29 EDT 2012;Committer;shugo;2;13;0;13;0
5f0b7f8c6f581e9c2bc25936756616993c26c6e5;Thu Nov 01 05:45:30 EDT 2012;Committer;shugo;1;1;1;2;0
7a58c65a8931dab792ac40ae7227ff82b1610178;Thu Nov 01 05:45:28 EDT 2012;Committer;shugo;3;95;2;97;0
94d10fbb14743acfa4ef067522d19bf7246236c5;Thu Nov 01 04:17:05 EDT 2012;Committer;svn;1;3;3;6;0
130bb41d0a71547505e4f3e071deaf397cb28e38;Thu Nov 01 04:17:01 EDT 2012;Committer;nobu;1;2;14;16;0
25a973e84b1e9879977010b3825b59faa740ff0d;Wed Oct 31 09:22:37 EDT 2012;Committer;nari;2;15;5;20;0
9fd08911c0ab12591735c133769ef1828e5bd9c0;Wed Oct 31 09:22:35 EDT 2012;Committer;nari;2;5;1;6;0
7ae466f134a457e16d88dce4a5355b4cd6596ae5;Wed Oct 31 00:29:27 EDT 2012;Committer;drbrain;2;14;4;18;0
5562411c7f1ea19788cfcc9f963ede2f46180cd5;Wed Oct 31 00:07:17 EDT 2012;Committer;drbrain;2;71;64;135;0
974c1b404b7b4c8ca340c42870de50b4cd77632f;Tue Oct 30 17:54:40 EDT 2012;Committer;svn;1;2;2;4;0
4b1df2ae45a9f76b047db58c4df45432898f59c9;Tue Oct 30 17:54:34 EDT 2012;Committer;tenderlove;5;14;4;18;0
e46471e90c656b6a4c0e6c6846040e51448c2255;Tue Oct 30 14:58:47 EDT 2012;Committer;shugo;3;20;0;20;0
05ba90697f6a717b18bb9111960e157e8e9182eb;Tue Oct 30 12:13:39 EDT 2012;Committer;kazu;1;11;11;22;0
ee2718039c143a2668e227b1c5611c41a93da2bb;Tue Oct 30 10:32:56 EDT 2012;Committer;usa;3;26;2;28;0
643f5308e683334aceb2db9656b61f577579effb;Tue Oct 30 00:40:54 EDT 2012;Committer;naruse;1;2;0;2;0
bd89d0cba5a20a2d2f76c4d98e3e70553973c7e7;Mon Oct 29 18:08:56 EDT 2012;Committer;nobu;3;44;0;44;0
e33cbc0f540560a3fe0694a5c2792a1b45499951;Mon Oct 29 17:22:45 EDT 2012;Committer;svn;1;2;2;4;0
2285319b31aa00b121c688d0bc67740ba385ab75;Mon Oct 29 17:22:36 EDT 2012;Committer;tenderlove;5;249;1;250;0
b9cba0711b2753a26b9f1155ea62e2a8d07cc76e;Mon Oct 29 09:31:50 EDT 2012;Committer;nobu;1;7;6;13;0
56f9574de8786c3364bbc8e95876abe296c845d7;Mon Oct 29 09:23:02 EDT 2012;Committer;nobu;3;63;45;108;0
897a3fce917c55ed9751b0834c63c7e6c5085bcf;Mon Oct 29 08:52:59 EDT 2012;Committer;naruse;1;12;11;23;0
78625e585207bab02c5c2b905797849996cf5436;Mon Oct 29 03:19:38 EDT 2012;Committer;nobu;1;3;3;6;0
0f9307914b08a60102d29cee2260358bd2aaac75;Mon Oct 29 01:23:54 EDT 2012;Committer;tenderlove;4;87;0;87;0
87b248dc4d4bed790fc402756993d64962ed8595;Sun Oct 28 21:20:26 EDT 2012;Committer;marcandre;1;9;2;11;0
e44e356b53828d6468114b30e5c169296896f9b1;Sun Oct 28 21:20:10 EDT 2012;Committer;marcandre;3;34;8;42;0
3785d2675abf2e4aca07e89596ea6f12b4c474a5;Sun Oct 28 21:19:50 EDT 2012;Committer;marcandre;3;14;3;17;0
22115ec87e5c805711762eac46cc5332bf2afb16;Sun Oct 28 21:19:32 EDT 2012;Committer;marcandre;1;4;6;10;0
b4300d25c941475db902ed2dc667ac23d36be992;Sun Oct 28 21:19:15 EDT 2012;Committer;marcandre;3;34;2;36;0
15d4862b913f6d555ce8a79075d69bba74b5b9bc;Sun Oct 28 21:18:53 EDT 2012;Committer;marcandre;3;22;0;22;0
2dafb0f47a7ae70362aea7649b635e97bb33dcf2;Sun Oct 28 21:18:32 EDT 2012;Committer;marcandre;1;2;1;3;0
af29f7d2a36647463b5afdc54c5fa4f7cf9e4275;Sun Oct 28 21:18:11 EDT 2012;Committer;marcandre;1;4;22;26;0
8c163b8599e4e86461c05e1bc464de1499b0ba8b;Sun Oct 28 18:21:24 EDT 2012;Committer;svn;1;2;2;4;0
23798cd67bb80a025241d8e08cbb281da08d80a9;Sun Oct 28 18:21:17 EDT 2012;Committer;marcandre;2;5;1;6;0
4e2350539807abcdeb098da8d4ac7fd5f0b4c80a;Sun Oct 28 14:54:59 EDT 2012;Committer;kou;1;3;3;6;0
5f18ce9a0277772e581c0c74a0026f26a3092e6b;Sun Oct 28 14:53:07 EDT 2012;Committer;kou;2;25;0;25;0
718813ca9b2228274b32a9119023074be116fe9b;Sun Oct 28 14:52:21 EDT 2012;Committer;kou;3;61;58;119;0
7ba54654a5f102be085bda53d4f117dfc0b06d8f;Sun Oct 28 12:52:57 EDT 2012;Committer;nagachika;1;1;0;1;0
a7322e3678d8c5be0e528a346fa42444325e5349;Sun Oct 28 12:42:37 EDT 2012;Committer;kou;3;32;0;32;0
a750424cab13cab79de7d7922f32f31be6f415f3;Sun Oct 28 12:39:37 EDT 2012;Committer;kou;2;21;14;35;0
2a42c1bd3a8fcaa59f778070bff0eac60757ced3;Sun Oct 28 12:31:20 EDT 2012;Committer;kou;3;50;14;64;0
100b3be9ae7f6ad0af53dd87d0e9706df6e813c3;Sun Oct 28 12:19:58 EDT 2012;Committer;kou;2;27;0;27;0
f774c96beb1fd61720b335b1b7b54cf9422a6f2d;Sun Oct 28 11:20:45 EDT 2012;Committer;kou;2;2;8;10;0
054ae037e656b349fa55f32aa18c1338027ed26e;Sun Oct 28 10:57:01 EDT 2012;Committer;kou;2;8;2;10;0
9f773625e5ae2d9b38ec5ccd6ecc6435fc891439;Sun Oct 28 10:16:02 EDT 2012;Committer;tadf;3;27;2;29;0
b4c6d6a3a55ffc86848c6bcb271d19186b324391;Sun Oct 28 09:53:08 EDT 2012;Committer;tadf;2;207;87;294;0
af83fcfe4de5d0497e78789efdfb7e7daf251805;Sun Oct 28 06:43:38 EDT 2012;Committer;kou;3;36;5;41;0
292c659b5ce2b8e01d59f87713450e6c66ca14a0;Sun Oct 28 06:01:06 EDT 2012;Committer;kou;2;6;1;7;0
de2e09e0bcf61fa54572feb6ed2e432ac003fe3d;Sun Oct 28 05:59:59 EDT 2012;Committer;kou;3;138;5;143;0
134ded5d7720544f28c8949743ec4d64cc9b8b9d;Sun Oct 28 05:10:07 EDT 2012;Committer;kou;2;7;2;9;0
64c4647665dadbab678da57a9ae18126482ad629;Sun Oct 28 05:05:18 EDT 2012;Committer;kou;2;7;2;9;0
f8d34b2a751207fa9d31482e7f587f8bf59b892c;Sun Oct 28 01:13:09 EDT 2012;Committer;tenderlove;3;15;0;15;0
dbe6250af2a873f7a79980a98f4fe2b4e89ef8c4;Sun Oct 28 01:06:09 EDT 2012;Committer;tenderlove;3;19;1;20;0
f3e5f2cd758f5013685d997ffd9efdcceccd449f;Sun Oct 28 00:03:20 EDT 2012;Committer;ko1;9;33;22;55;0
5dc9855a4f6a223b903fb6629aace9a5a49b064b;Sat Oct 27 23:22:10 EDT 2012;Committer;ko1;1;40;40;80;0
2731767b5dfefacf139ba4eedb25a9b550ad5454;Sat Oct 27 19:47:58 EDT 2012;Committer;ko1;2;6;8;14;0
492fcfda8bf3fd127eb0a31721ab594b2a73a6e6;Sat Oct 27 15:49:17 EDT 2012;Committer;svn;1;2;2;4;0
e672994d146eeb85fc3670cbd97b484f6101d373;Sat Oct 27 15:49:09 EDT 2012;Committer;nobu;3;54;18;72;0
1fe5783104b248be54f21d147722ca2ebc7d149a;Sat Oct 27 14:36:22 EDT 2012;Committer;eregon;2;48;47;95;0
493d2533002169132162534ee87595c1b91b920d;Sat Oct 27 11:06:46 EDT 2012;Committer;ktsj;1;1;1;2;0
180c744b3b4043b2491031a4af9c8cbe4c0ae2ab;Sat Oct 27 02:10:53 EDT 2012;Committer;ko1;8;27;36;63;0
909bc583a4f5c5c09fd47b89f44005d66b8bc674;Sat Oct 27 01:51:58 EDT 2012;Committer;tenderlove;2;9;1;10;0
d090f17f21c1b938e9aa97c14e9e2d7e079b4420;Sat Oct 27 01:16:25 EDT 2012;Committer;shyouhei;3;17;5;22;0
197e7b812c8ab14a7b61b7d0425c70768453ac65;Sat Oct 27 01:07:59 EDT 2012;Committer;nobu;2;78;102;180;0
854c5ec4704736124b6fd0dcebe2f05557dfc1b8;Sat Oct 27 01:05:06 EDT 2012;Committer;nobu;2;6;1;7;0
bc9428b73239a472f7a888f78822af221f295475;Fri Oct 26 21:31:36 EDT 2012;Committer;svn;1;2;2;4;0
82af182e740bcb2a3aa1d9b2b62412f8ab28a8b1;Fri Oct 26 21:31:23 EDT 2012;Committer;tenderlove;4;118;18;136;0
8ee4f0ad80720d38022b81b1cead87fe4c08f006;Fri Oct 26 04:24:36 EDT 2012;Committer;svn;1;2;2;4;0
e7576a777c32fdf04f6e014a225025b5e2b45553;Fri Oct 26 04:24:29 EDT 2012;Committer;nobu;2;26;1;27;0
e6c5b9f30840ae985c4bdcb91435e9c2c06fb7ef;Thu Oct 25 14:06:31 EDT 2012;Committer;nobu;16;44;35;79;0
c6629c48e61f341aa5e0b4b8f0c4816a2e9e0cc1;Thu Oct 25 11:50:20 EDT 2012;Committer;naruse;2;0;8;8;0
db1f7079b6ff3c7227f20fc9c0743f9147bba2d2;Thu Oct 25 10:07:22 EDT 2012;Committer;nobu;16;35;44;79;0
acd82f6e24494ccced2fca81681c1beb1a5e0e58;Thu Oct 25 08:50:55 EDT 2012;Committer;usa;2;8;0;8;0
9dc3a7d7a5aece71c2bad9d2ec185f2ef87245b6;Thu Oct 25 06:03:53 EDT 2012;Committer;ko1;5;10;23;33;0
8ca58751c106d8d88ed4fe41306a389f4dd53b23;Thu Oct 25 04:36:15 EDT 2012;Committer;usa;2;5;1;6;0
70e7d0732954df21bb2d7170afaf3ed43a16f87a;Thu Oct 25 04:22:25 EDT 2012;Committer;svn;1;2;2;4;0
4a309b765e23f22cb20e9d8edebe2e922d1052c6;Thu Oct 25 04:22:21 EDT 2012;Committer;usa;2;8;0;8;0
e59e5e90c09f6d67695a0c592a1940585c1cc72e;Wed Oct 24 09:49:18 EDT 2012;Committer;nobu;2;7;2;9;0
aaf346059d0b998ab4d31099d8c3043df1034bf7;Wed Oct 24 09:48:32 EDT 2012;Committer;nobu;1;3;3;6;0
9b68747be0f70908d0147b4d753e322bab5a8b5c;Wed Oct 24 08:46:01 EDT 2012;Committer;ko1;2;12;0;12;0
a4ba41a29d9d0281f7e62ef94ffbd778a34c91db;Wed Oct 24 04:29:53 EDT 2012;Committer;nari;2;4;4;8;0
bda726223f88b12e31634daecbe75cecb1885640;Wed Oct 24 04:14:22 EDT 2012;Committer;nari;2;5;5;10;0
f0a435c18725318eae1bfb3dfd15c457f511d814;Wed Oct 24 03:55:46 EDT 2012;Committer;nari;2;8;3;11;0
04c177e277cad6e3c785de00238ef48c3fbe027a;Wed Oct 24 03:00:39 EDT 2012;Committer;ko1;2;20;7;27;0
aab12ec054ed6af47bc67abd07076a64a10222b6;Wed Oct 24 01:39:45 EDT 2012;Committer;ko1;2;12;7;19;0
6cbd18d7ef28ab2eebc07dfb1badc9c02fba8a15;Wed Oct 24 01:21:13 EDT 2012;Committer;ko1;2;14;0;14;0
6c6dece7f192664986c3973ed15c994cc6af1696;Wed Oct 24 00:04:56 EDT 2012;Committer;ko1;4;174;70;244;0
e1d772c801b95a5b0c8ed898b48d7205faceb83c;Tue Oct 23 20:53:35 EDT 2012;Committer;ko1;2;7;3;10;0
378041cfbf91809fe84fe70bbc90162f065a18a0;Tue Oct 23 20:42:45 EDT 2012;Committer;ko1;4;18;12;30;0
a0873931cedcb7039b752d6e615e46e3d3d4b2a1;Tue Oct 23 20:34:25 EDT 2012;Committer;ko1;2;58;54;112;0
fe38109ffe721dda8024214c246fa8af4e6c3d78;Tue Oct 23 17:46:33 EDT 2012;Committer;tenderlove;1;9;0;9;0
a8e25c92f36cd4c03d0db16fe93f3b8cf205edb3;Tue Oct 23 16:37:47 EDT 2012;Committer;nobu;1;0;5;5;0
8642c4af6a88764e465a928ab0e88ab5a4a17f4c;Tue Oct 23 15:54:25 EDT 2012;Committer;svn;1;2;2;4;0
d8d95fcc03215f206be323af7112fb029c25b56c;Tue Oct 23 15:54:20 EDT 2012;Committer;nagachika;1;4;4;8;0
479d8ce5b5ba8ce22fdb6e92ed7e871f99d88735;Tue Oct 23 13:37:45 EDT 2012;Committer;ko1;2;16;3;19;0
357a5f5ab527e7db6f009b8fae2aebae1debfd97;Tue Oct 23 08:08:42 EDT 2012;Committer;nobu;2;78;32;110;0
ec007f72cf9b4329c5ba59fe6463e38c163637fb;Tue Oct 23 05:20:45 EDT 2012;Committer;nobu;2;8;2;10;0
024939558224abd68a0bba5cae8d2930eed5bc0c;Tue Oct 23 05:06:50 EDT 2012;Committer;nobu;2;15;1;16;0
a4f79a6ece4b02720507b0ff249c2964ee859479;Tue Oct 23 04:52:20 EDT 2012;Committer;ko1;2;0;10;10;0
d41ec2a79a53bc17dc9c7d574ae3824f5276745d;Tue Oct 23 04:33:04 EDT 2012;Committer;ko1;2;10;0;10;0
9eba45a72a63674e35d0e9dec6ddf73088ed39e8;Tue Oct 23 04:22:31 EDT 2012;Committer;ko1;7;278;84;362;0
3c73f44c7f779fe9eea823457c4f288aa21d3c32;Mon Oct 22 21:25:02 EDT 2012;Committer;tenderlove;4;35;2;37;0
6c6d4568e8b8c8667c0b57ca6e1b5ba5d7acbbe3;Mon Oct 22 21:24:50 EDT 2012;Committer;tenderlove;2;9;2;11;0
ca0cf1673409cae3f8425d6235dbcce9709fa61b;Mon Oct 22 21:24:36 EDT 2012;Committer;tenderlove;2;8;1;9;0
b3fb872d9db31d752aeefdb62b7ea928b9cadc42;Mon Oct 22 21:14:08 EDT 2012;Committer;tenderlove;2;14;3;17;0
ec3056ae227fd79d706b2c6cdcdd8725df99c178;Mon Oct 22 21:09:56 EDT 2012;Committer;tenderlove;3;25;1;26;0
c05952c6a1687cac0526b0324b3659032aa7664a;Mon Oct 22 21:06:25 EDT 2012;Committer;tenderlove;3;13;1;14;0
1c5ae4b31d364dd9af8c7e4b1499c48f08e55cf2;Mon Oct 22 21:02:20 EDT 2012;Committer;svn;1;2;2;4;0
b00362eb3e7f0c50a6cd1e46940167b7fd86f1a4;Mon Oct 22 21:02:16 EDT 2012;Committer;tenderlove;2;11;4;15;0
155291a8521b0db2bf702e265b61819fa68b4fa7;Mon Oct 22 00:47:56 EDT 2012;Committer;svn;1;2;2;4;0
900b62a2e96228d75c3552e04e81fd12f474a1d3;Mon Oct 22 00:47:50 EDT 2012;Committer;naruse;2;12;7;19;0
f1cbd700e8107f6871dfc18814f3a19b8beb225f;Sun Oct 21 10:16:27 EDT 2012;Committer;ktsj;1;1;1;2;0
811d072dcb7ef63a8953c17641801f7cce787cc7;Sun Oct 21 10:14:29 EDT 2012;Committer;ktsj;1;3;3;6;0
f21d7d98318919c730a5dbcca9f2c931ebd66898;Sun Oct 21 10:14:26 EDT 2012;Committer;ktsj;3;20;4;24;0
93184600c8dfe84f03d2c41035c5bc0fdbe4e84f;Sun Oct 21 10:14:24 EDT 2012;Committer;ktsj;2;5;1;6;0
9e3633dfadd31c254dc4d5383a54e23533086029;Sun Oct 21 09:41:31 EDT 2012;Committer;svn;1;2;2;4;0
2cbb4481bd4cee7ca69cc9fb961ec63c06f32579;Sun Oct 21 09:41:25 EDT 2012;Committer;tadf;2;479;24;503;0
0ef8222e6327e1ebf353a8153432668a7f9fa085;Sat Oct 20 11:36:46 EDT 2012;Committer;eregon;1;3;3;6;0
c3a46d6acab5ab063cc6b5808c2b344f110bef12;Sat Oct 20 06:57:51 EDT 2012;Committer;nari;20;74;42;116;0
f1e488e5241f52765550a7e5e20d1d7509da5b32;Sat Oct 20 03:51:33 EDT 2012;Committer;zzak;2;51;36;87;0
dd05478f2431dd734cfb3a1a858377497263aaa2;Sat Oct 20 02:01:23 EDT 2012;Committer;zzak;2;19;8;27;0
167c4781a077546aad0849c2d59d4265c7ff8722;Fri Oct 19 21:20:37 EDT 2012;Committer;svn;1;2;2;4;0
fb03eb91fea8de00e78bdccfd00265a9ddd27538;Fri Oct 19 21:20:33 EDT 2012;Committer;tenderlove;2;11;0;11;0
2fe13f62efe400736bb078cafcebba5f5ba7b83b;Fri Oct 19 13:22:03 EDT 2012;Committer;nobu;4;19;2;21;0
b0e40509c3b60242c6a1b0e67276849eea505977;Fri Oct 19 13:13:32 EDT 2012;Committer;eregon;4;25;4;29;0
f4dbc7a3849988ebe75d3e1031aa50441347c497;Fri Oct 19 10:38:30 EDT 2012;Committer;ko1;6;197;87;284;0
0fc7f4bb304ad07e8172f868d885112a1dcceb0f;Fri Oct 19 07:57:56 EDT 2012;Committer;ko1;3;13;9;22;0
e99989bf4fffa966b6333f43d47ce54e2384122c;Fri Oct 19 02:15:00 EDT 2012;Committer;ko1;2;5;1;6;0
3daa9b9f5aa705169f9d6fb672d7814749471493;Fri Oct 19 01:24:50 EDT 2012;Committer;ko1;2;5;3;8;0
f2a9c42c7aa666b70286045570c42b7884257550;Fri Oct 19 01:23:50 EDT 2012;Committer;ko1;2;5;5;10;0
0801dba3f6699488b12e70146f8cf3c0c28b1cb5;Fri Oct 19 01:22:12 EDT 2012;Committer;svn;1;2;2;4;0
a31d53ecf58686718128021b4d3c4f0575e0ad28;Fri Oct 19 01:22:08 EDT 2012;Committer;ko1;2;13;1;14;0
7e8f558aea05d97f7879d6ead4488cc9807c5136;Thu Oct 18 09:44:19 EDT 2012;Committer;ko1;2;21;15;36;0
d0ead20888daff68f58472ad7f5002d6b168e1d5;Thu Oct 18 09:41:55 EDT 2012;Committer;ko1;3;10;5;15;0
1486b9cf0ac549edb7e7c3f886558d3e98100746;Thu Oct 18 08:35:19 EDT 2012;Committer;ko1;3;47;20;67;0
6be52625b25ac334f182a7814c7c0590c5a0bc16;Thu Oct 18 07:44:09 EDT 2012;Committer;nobu;2;7;0;7;0
60f949e1013bf22e5392587ef725888f82834e48;Thu Oct 18 06:57:58 EDT 2012;Committer;nobu;1;4;4;8;0
fea629da834c4e33b2ad1b41a1412e8e7aebfc8b;Thu Oct 18 06:14:39 EDT 2012;Committer;ko1;2;10;5;15;0
cc012cfb193c858482adb195128a76893ac22903;Thu Oct 18 06:04:02 EDT 2012;Committer;ko1;2;6;0;6;0
c992cec4a04839410caf2da53dac7662a67129bb;Thu Oct 18 05:33:31 EDT 2012;Committer;ko1;2;11;3;14;0
588b73bca2f16f03710d531d64e3dc6a0050c2d7;Thu Oct 18 05:22:13 EDT 2012;Committer;ko1;6;29;15;44;0
676c01bb36d39cf1c0085c4853c9dcbd3b908f35;Thu Oct 18 01:30:37 EDT 2012;Committer;nobu;3;15;7;22;0
849c4eaaf3a03e98ee1f7aefbf58ec152585e4df;Thu Oct 18 01:29:54 EDT 2012;Committer;nobu;1;6;0;6;0
46a45ca613321a8fa3fdee1d358a609b1635625e;Thu Oct 18 00:24:05 EDT 2012;Committer;svn;1;2;2;4;0
a34a3c2caae4c1fbd9b4a0fa7194e0edfbad6bbe;Thu Oct 18 00:24:00 EDT 2012;Committer;tenderlove;3;19;1;20;0
bff930ccf476e1a7e01720e2fd4f6c09d226a56f;Wed Oct 17 13:36:45 EDT 2012;Committer;nagachika;1;1;1;2;0
14d59c122f3158356bc84b25829f752585480cb7;Wed Oct 17 12:20:57 EDT 2012;Committer;shirosaki;4;23;6;29;0
aef5f90281d470449fa785f8778b3223a02afd2e;Wed Oct 17 07:26:58 EDT 2012;Committer;ko1;2;17;0;17;0
000ff5b3ce9ff045a30e146aede5917d6fa4f0ff;Wed Oct 17 07:24:52 EDT 2012;Committer;ko1;2;7;2;9;0
9a82db49eb5d464d6d0adc3c7c3ebf4574d5d025;Wed Oct 17 07:12:40 EDT 2012;Committer;ko1;3;44;23;67;0
7254573c551f83a83cf3f2d6e97de8ebe72e16fa;Wed Oct 17 06:33:14 EDT 2012;Committer;nobu;2;18;6;24;0
0f1e7bcec093b2ee57bcda68a7008fb854f13134;Wed Oct 17 06:30:29 EDT 2012;Committer;shugo;1;1;0;1;0
bd6bb6c0b26168833ff9027611a3febc6eeca91b;Wed Oct 17 06:18:14 EDT 2012;Committer;shugo;3;73;0;73;0
c4e63346d241af300594804cb54351817c496a4d;Wed Oct 17 03:55:35 EDT 2012;Committer;shugo;1;1;1;2;0
38c0b5f0e3abe32d220f01deb77a45aa9100bdcb;Wed Oct 17 02:06:34 EDT 2012;Committer;usa;2;14;0;14;0
8f58f60643638add42658d51114abe36dc8257fd;Wed Oct 17 01:50:53 EDT 2012;Committer;shugo;2;6;1;7;0
5e2625eebd5ab1c1224ea35d70ad544e67a4ee41;Tue Oct 16 23:47:51 EDT 2012;Committer;ko1;2;11;0;11;0
49371b5420619c0729154939b13e02aceb471611;Tue Oct 16 23:38:58 EDT 2012;Committer;ko1;2;19;4;23;0
8addee964963725695f59184281810b7d6956713;Tue Oct 16 23:03:54 EDT 2012;Committer;ko1;2;7;0;7;0
199fc6a54f8890c1935e797d5ef09a529bb5391b;Tue Oct 16 21:49:18 EDT 2012;Committer;ko1;2;18;24;42;0
b3803cc49ad382e23291d75ce57ffb2b74bb9577;Tue Oct 16 21:33:59 EDT 2012;Committer;tenderlove;3;32;1;33;0
ddb6408f6ef338310065a87cd32b9ed3afbe9c46;Tue Oct 16 21:20:11 EDT 2012;Committer;ko1;2;59;34;93;0
db3898fe905cf19a65ba8edfe13774a3613943fc;Tue Oct 16 20:37:25 EDT 2012;Committer;ko1;3;27;0;27;0
9182dab459137533a4315bf13d3a921a24e5d76c;Tue Oct 16 20:30:17 EDT 2012;Committer;ko1;2;8;1;9;0
db1e99cdad846fd2bab426ae0cc39c7321fae427;Tue Oct 16 17:07:23 EDT 2012;Committer;ko1;4;71;28;99;0
aedc460fed41f3e77f8970b51b8027f633691337;Tue Oct 16 15:32:23 EDT 2012;Committer;svn;1;2;2;4;0
0eb6ef5b5b03b35b70c1189fce9bc09650521c54;Tue Oct 16 15:32:19 EDT 2012;Committer;nagachika;1;1;1;2;0
f8c2a968dd3628dc0a5f3b671bd41a08104ce466;Tue Oct 16 13:26:46 EDT 2012;Committer;ko1;2;51;18;69;0
64b1751194754a20173bbf48cff2035078bc225f;Tue Oct 16 13:07:44 EDT 2012;Committer;ko1;2;18;14;32;0
9af8102225d13f3f5fd49e6e12f4819e5e1a437d;Tue Oct 16 05:56:25 EDT 2012;Committer;nobu;2;8;0;8;0
66141d47d79f986951068d538b3972d14e7476d4;Tue Oct 16 04:02:04 EDT 2012;Committer;kazu;8;27;22;49;0
41e5fdb20f6bfa9fb62af2edf029a84f74ac970f;Tue Oct 16 04:02:01 EDT 2012;Committer;kazu;1;2;2;4;0
37b8f7b84fedff7937598273fb65c7fb4f8390f1;Tue Oct 16 02:30:20 EDT 2012;Committer;nobu;2;6;1;7;0
a583f4206210cfccd9228d6f1f0cef0f2fdb5b92;Tue Oct 16 02:27:07 EDT 2012;Committer;nobu;3;18;3;21;0
7b4f0c0d1d4815807b000506cb470eb925834f9d;Tue Oct 16 01:54:05 EDT 2012;Committer;nobu;3;15;1;16;0
ad54de2acac70ba2f889892df950508edbc972b7;Tue Oct 16 01:53:32 EDT 2012;Committer;nobu;2;18;12;30;0
5ed8ca14526539b31d6089a91585b9301097f380;Tue Oct 16 00:40:26 EDT 2012;Committer;usa;2;8;1;9;0
4ae5081b7b005fcef00166045fe4dd7890c74902;Tue Oct 16 00:31:20 EDT 2012;Committer;usa;2;7;6;13;0
7c1778d6387c6bf695f87fc718d878eb228b628c;Mon Oct 15 21:45:24 EDT 2012;Committer;ko1;2;5;1;6;0
3083ad7b83486e217ce7c112ed4610f3d4ba3702;Mon Oct 15 21:35:29 EDT 2012;Committer;ko1;3;33;4;37;0
90a6dce0415f7dc5accc9929d497a8044d9e6067;Mon Oct 15 21:24:08 EDT 2012;Committer;ko1;6;82;8;90;0
747487cda7b5a8c893ed8f6b0d7f7498aa434a02;Mon Oct 15 17:40:50 EDT 2012;Committer;ko1;3;32;11;43;0
a91e91c537bf77afc49c2aef4b65d91237cbd786;Mon Oct 15 17:22:57 EDT 2012;Committer;ko1;6;58;50;108;0
b188d42b2d05f1746f1a9c7de46feb0529f3dc42;Mon Oct 15 15:45:14 EDT 2012;Committer;svn;1;2;2;4;0
84cfea7008f031eb70f478eec53d39a3ee07e1f5;Mon Oct 15 15:45:07 EDT 2012;Committer;nagachika;1;1;1;2;0
32569104e121e6dc7363acf37b5aef766bd04d4d;Mon Oct 15 13:14:48 EDT 2012;Committer;nobu;9;42;23;65;0
a17cb167ea5e0f0690a94d8f39b821a43aebd456;Mon Oct 15 12:53:12 EDT 2012;Committer;kou;52;56;56;112;0
2780e752edac13439b14033b653588a511b8e111;Mon Oct 15 12:29:42 EDT 2012;Committer;kou;1;1;1;2;0
f1d3fcec91a4d82f04c1f1f5ea18e378f7c3e764;Mon Oct 15 02:04:55 EDT 2012;Committer;kazu;1;5;5;10;0
c0481015b3c7e8371fc9b75c3b0235ab19d7d22f;Mon Oct 15 00:57:37 EDT 2012;Committer;nobu;1;1;1;2;0
f9e50b05b15dacd7cdee8fc380fecb93b6ecbd97;Mon Oct 15 00:44:04 EDT 2012;Committer;ko1;2;9;4;13;0
c4457e03c665a48f1d953fbbe4499b65e7b1149b;Sun Oct 14 20:59:21 EDT 2012;Committer;ko1;3;49;18;67;0
8f08e61bad1d745dc7a10ff216ad5ca2e92b3ded;Sun Oct 14 19:58:59 EDT 2012;Committer;ko1;4;1470;1408;2878;0
fd3b0dec4a4aa0e56bf56bb058688e0dea91c090;Sun Oct 14 18:53:01 EDT 2012;Committer;ko1;4;41;0;41;0
7f052a7213e21c800fa4bd80f61e7903804bcf4f;Sun Oct 14 17:54:21 EDT 2012;Committer;ko1;2;56;39;95;0
ca968ee45eabd35e21c1f3f602ae33816ae64d23;Sun Oct 14 17:20:42 EDT 2012;Committer;nobu;2;0;2;2;0
c84bd9d7b89eca3bb563e83e864db5604626d4cd;Sun Oct 14 16:59:12 EDT 2012;Committer;svn;1;2;2;4;0
cbd597e9bc05eac7249e91dcdb4f1c1c75a53cf5;Sun Oct 14 16:59:05 EDT 2012;Committer;ko1;9;672;551;1223;0
e8c234577fa7061a22f0dc515aefdc8dbc61f3b5;Sun Oct 14 06:11:05 EDT 2012;Committer;kazu;1;1;1;2;0
204692c5ad8ecbb625742daf807e80734cfb9490;Sun Oct 14 03:31:01 EDT 2012;Committer;svn;1;2;2;4;0
9e02550b21e2fa73049284fa8f0b6c5d8a2d5394;Sun Oct 14 03:30:50 EDT 2012;Committer;nobu;3;19;4;23;0
be3a6b8c403f94715205bcb7ee60515f65c6d482;Sat Oct 13 14:23:40 EDT 2012;Committer;usa;3;27;8;35;0
872a47c1bf2ebdc1e517a6b429bbe065860b5206;Fri Oct 12 18:01:56 EDT 2012;Committer;nobu;2;8;0;8;0
5ea65366f5786f3f88837d8f9f7a2303cd813144;Fri Oct 12 16:38:52 EDT 2012;Committer;usa;2;16;0;16;0
5eb3f9cbaf3a3a77543c50b93e50063ed9bccafb;Fri Oct 12 16:03:45 EDT 2012;Committer;svn;1;2;2;4;0
78e3185a20d9307c98fecca6d3bacfb8f2c271b8;Fri Oct 12 16:03:41 EDT 2012;Committer;naruse;1;1;1;2;0
8d236bc0b150b531acc121d657428bf824a9ca35;Fri Oct 12 13:30:17 EDT 2012;Committer;shirosaki;2;26;1;27;0
25a79e9f9be11f184485d3177a7ec75516d37259;Fri Oct 12 13:30:11 EDT 2012;Committer;shirosaki;2;14;2;16;0
7206f9bc7913fc191fddd654ea9cbded9abad14f;Fri Oct 12 11:41:40 EDT 2012;Committer;akr;2;5;1;6;0
7085db45e4f15a58f9a82c8815bcc31364e0fde1;Fri Oct 12 09:18:07 EDT 2012;Committer;nobu;3;17;0;17;0
84fa14aab12ef679ead8af2da2574db9b9a05c84;Fri Oct 12 08:19:28 EDT 2012;Committer;naruse;1;2;2;4;0
727c8cdfe7d5769d403f180b539e08e0f03eae2f;Fri Oct 12 07:07:10 EDT 2012;Committer;usa;2;6;0;6;0
1b4c99c0573719871ffa6491a3873adcff920c52;Fri Oct 12 05:10:43 EDT 2012;Committer;nobu;2;9;2;11;0
1968892c0d38b8d03b7710b94cbbcc4798b76f87;Thu Oct 11 20:26:49 EDT 2012;Committer;svn;1;2;2;4;0
17821595f1757a4fa93bd200cd930026424a0c29;Thu Oct 11 20:26:45 EDT 2012;Committer;zzak;2;6;3;9;0
e808b2b18f13fba51c4e2e8b31e83228d26e3f53;Thu Oct 11 14:09:49 EDT 2012;Committer;nobu;2;10;0;10;0
104d173752b240dd9a52a4edf2f3715f540e629a;Thu Oct 11 06:50:31 EDT 2012;Committer;nobu;1;6;0;6;0
88e326eddaf90dd628d4b2ef013301ecc231b9b7;Thu Oct 11 06:50:29 EDT 2012;Committer;nobu;1;5;1;6;0
eddfa31bda3a06c857217cbc09050cda920f1c7f;Thu Oct 11 06:50:26 EDT 2012;Committer;nobu;1;2;2;4;0
34996e23efc17063c369ca0435c51d98f496f225;Thu Oct 11 00:50:29 EDT 2012;Committer;naruse;1;1;1;2;0
b5ff6f11b52ef381e4fcbe90618e75a1a5321395;Wed Oct 10 22:43:51 EDT 2012;Committer;naruse;2;6;1;7;0
fb9034e757da5ecdb79bb552233696779b54b9b7;Wed Oct 10 18:38:01 EDT 2012;Committer;ko1;2;36;0;36;0
a52af292712cd527b155962feebbc79abfeb957f;Wed Oct 10 17:55:57 EDT 2012;Committer;ko1;2;23;4;27;0
dddb92fd8f0397fadd79f7b3ae16adfe2a95a893;Wed Oct 10 17:52:29 EDT 2012;Committer;svn;1;2;2;4;0
6990c7f9cd5108be6d9a490d68ff13ded582558e;Wed Oct 10 17:52:24 EDT 2012;Committer;ko1;2;9;0;9;0
187ae6d5a7b4b8f98383f8833f4742ab66f27c22;Wed Oct 10 12:38:15 EDT 2012;Committer;naruse;1;3;4;7;0
ba7c9b1cf7681d56e25d67b54bfaee9331aab723;Wed Oct 10 08:08:22 EDT 2012;Committer;naruse;1;10;1;11;0
f784e14fcea519a707c9ec3b5716f59b491c75cd;Wed Oct 10 06:14:54 EDT 2012;Committer;svn;1;2;2;4;0
7eb1fee9a6c432ce5617359c91c02797be422ba1;Wed Oct 10 06:14:48 EDT 2012;Committer;usa;2;7;0;7;0
428ec4ec05c0f5a0c24dacee406854fff623dca4;Tue Oct 09 14:18:05 EDT 2012;Committer;nobu;8;33;18;51;0
e3efce6df1aa691e17c59f442b35b4fd129d3a13;Tue Oct 09 09:01:40 EDT 2012;Committer;nobu;5;41;22;63;0
7f8e5584649b1bba6d30d78c661a1b1eca28340e;Tue Oct 09 08:59:03 EDT 2012;Committer;nobu;3;23;0;23;0
dd83dd6bda20f701ce637031532be14a165f1de1;Tue Oct 09 08:13:29 EDT 2012;Committer;nobu;4;151;39;190;0
0bf06ff434c0e4a88616c1c7d5be2c5f76978db4;Tue Oct 09 08:05:59 EDT 2012;Committer;nobu;1;2;2;4;0
62ad069c3a8fbd785e766274e02e348b1ec2fc6f;Tue Oct 09 05:37:43 EDT 2012;Committer;ko1;2;6;0;6;0
7ea3edc409dc6d383df9bc10d0034a6ecddb84dc;Tue Oct 09 05:33:54 EDT 2012;Committer;ko1;7;107;51;158;0
4be0c562a4b3e1bc6f185cf8fbd636b9e8ebb7f4;Mon Oct 08 16:40:23 EDT 2012;Committer;svn;1;2;2;4;0
f21ac99ef95f7b5737308858bbbde9e28de26a5f;Mon Oct 08 16:40:19 EDT 2012;Committer;nagachika;2;16;0;16;0
1bb89a6dea9e2ec3730713285fba33c197578fb8;Mon Oct 08 14:56:08 EDT 2012;Committer;shugo;3;103;0;103;0
e028d3d90572a58f87f4efb6ada3ffdc857d44c7;Mon Oct 08 14:02:46 EDT 2012;Committer;shugo;11;84;71;155;0
7b6e6ede60864563c66f909ca7dba5a13f49d883;Sun Oct 07 17:14:39 EDT 2012;Committer;kazu;1;1;1;2;0
aaa8880dedbfdaab3afe0bc0843bc9f6b64b8e82;Sun Oct 07 17:10:08 EDT 2012;Committer;svn;1;2;2;4;0
98f14a91003aa70a51e4f8bdbf57f9f024197648;Sun Oct 07 17:10:03 EDT 2012;Committer;kazu;1;3;3;6;0
511703c770acd5b68eb1cbe644f431d9c2ba9564;Sat Oct 06 20:03:26 EDT 2012;Committer;zzak;2;43;9;52;0
61d460e5e18d9cebf13157e95d55f3cf1b139205;Sat Oct 06 19:51:40 EDT 2012;Committer;zzak;2;8;2;10;0
5683d8b48e4bcc6b050202381bf7a5aaf5646aff;Sat Oct 06 19:48:51 EDT 2012;Committer;zzak;1;6;0;6;0
bdbd1f847a9ab1b6e50de081e3d3469e38ffbd55;Sat Oct 06 19:38:22 EDT 2012;Committer;svn;1;2;2;4;0
1b5ce6132748f4766e167aebefd7028c0e93ea3c;Sat Oct 06 19:38:18 EDT 2012;Committer;zzak;1;4;0;4;0
974e3c9c5d15af79a7992a55fb37b07ee0a7532f;Sat Oct 06 14:26:29 EDT 2012;Committer;nobu;1;3;3;6;0
0751c5d16d983ae9541bdbfb109d4b310ee162d9;Sat Oct 06 14:22:52 EDT 2012;Committer;nobu;1;1;2;3;0
960e8a419f9bbf4b48f534c66972e833d56e8289;Sat Oct 06 09:36:35 EDT 2012;Committer;shugo;3;11;0;11;0
c29c44c4544896cf3e9d0788f52597e1f73dce02;Sat Oct 06 07:32:45 EDT 2012;Committer;shugo;2;43;10;53;0
a9497d5a842d762ad7e18a7abe9413581ea44804;Sat Oct 06 03:04:55 EDT 2012;Committer;naruse;1;2;1;3;0
b1058ef46c04e8b76139d1985dd549a53396661b;Sat Oct 06 00:50:12 EDT 2012;Committer;nobu;1;1;2;3;0
122de73a19cb5f08c56589748ebc98055fc964df;Sat Oct 06 00:48:28 EDT 2012;Committer;nobu;1;3;5;8;0
928d1a5261fc3afcfcdfb267b6b5f0323b81a669;Sat Oct 06 00:42:14 EDT 2012;Committer;nobu;5;24;3;27;0
5d316e77864376805fee44a01bfb1728e9c47f6e;Fri Oct 05 16:22:03 EDT 2012;Committer;tenderlove;1;11;0;11;0
f6848bf1c646c9bc7268d05da5c6eacdfdc5a491;Fri Oct 05 15:14:19 EDT 2012;Committer;svn;1;2;2;4;0
d5ac3f71aa662d77f987bd2700345118633c6ea5;Fri Oct 05 15:14:15 EDT 2012;Committer;nobu;1;1;2;3;0
3376ea81f95fb295bc4172a3bafb50481a166263;Fri Oct 05 09:21:41 EDT 2012;Committer;nari;1;3;3;6;0
4c0f022f45a9221c2f97b2d21a9eb476f40b1d93;Fri Oct 05 09:19:49 EDT 2012;Committer;nari;2;7;12;19;0
ae114a8ee6ad606ec682fe0af26fa86c9e563237;Fri Oct 05 08:20:34 EDT 2012;Committer;takano32;2;6;2;8;0
e03d6d9eb84764cb854dc500ce8c19d85db53656;Fri Oct 05 08:14:09 EDT 2012;Committer;ko1;5;202;31;233;0
7cc6bfa32947dcc60dab6e47250409b7962b29e7;Fri Oct 05 07:28:32 EDT 2012;Committer;nobu;2;4;2;6;0
c38ee00226517bae961fe19cc5ad4f11b91c69fc;Fri Oct 05 07:25:39 EDT 2012;Committer;nari;1;2;2;4;0
271f069c7f07391fe9626ca01f4d4a8076fb6c04;Fri Oct 05 07:20:49 EDT 2012;Committer;nari;2;12;7;19;0
42fcb804f458ae8f3db787f26574fdbddcba2823;Fri Oct 05 00:26:46 EDT 2012;Committer;svn;1;2;2;4;0
e2220d19e1267ccfdc34d9c106124a1aba30fdaa;Fri Oct 05 00:26:43 EDT 2012;Committer;nobu;1;3;2;5;0
ec62e301965c12a5e1e0f931a8b0152d374a1912;Thu Oct 04 14:48:02 EDT 2012;Committer;nari;2;8;1;9;0
08c8605de91d2f04dcb53672a2eca6bd3f77bb18;Thu Oct 04 13:52:20 EDT 2012;Committer;ko1;6;69;88;157;0
326e22e14a7625fd947f038f8c3f2235a059d522;Thu Oct 04 12:48:35 EDT 2012;Committer;ko1;2;17;7;24;0
23dc0dbc4ad3354a9df899c0105c57bf42e2d243;Thu Oct 04 12:31:05 EDT 2012;Committer;ko1;7;295;177;472;0
b1ad79774de9789a2dd60c19c907356fa823ebd9;Thu Oct 04 10:00:56 EDT 2012;Committer;ko1;2;6;53;59;0
2f9f17ac98597d54aa241a6ccea5b458c2759d7a;Thu Oct 04 08:34:20 EDT 2012;Committer;nari;2;6;3;9;0
6aa2aabd8b8c948d1f9eb2fb367ef24a24f237ce;Thu Oct 04 07:31:31 EDT 2012;Committer;nobu;2;26;6;32;0
6fa2980e53c168ccfd08fdfdcc3444cdda6b3bcc;Thu Oct 04 07:23:41 EDT 2012;Committer;nobu;1;55;53;108;0
fab7e66131a899fcb1839dbc0564cc84d1a43674;Thu Oct 04 02:43:30 EDT 2012;Committer;nobu;2;16;2;18;0
cbe3646e683e8d1112ff832cfb74ca2aec006991;Thu Oct 04 02:39:34 EDT 2012;Committer;nobu;1;21;19;40;0
6ed36284db86cf180280ee3fe1feb2509d978c4c;Thu Oct 04 02:21:00 EDT 2012;Committer;svn;1;2;2;4;0
aeca9656813575c0ffd696115a607a43eb776012;Thu Oct 04 02:20:55 EDT 2012;Committer;xibbar;3;67;2;69;0
4336caf20422cdaeb99e519e20ff9214667e594d;Wed Oct 03 13:23:30 EDT 2012;Committer;nobu;1;3;2;5;0
8d53a08ed81ae1dbaabef79fcf0b0e759de2e82f;Wed Oct 03 12:30:21 EDT 2012;Committer;nari;4;270;237;507;0
f6d0cb46f6a97018a3cb21916cb289c9e334045e;Wed Oct 03 07:58:00 EDT 2012;Committer;nobu;1;1;1;2;0
396903d3842fbae6c2bc5d2d72eb734516a88f3a;Wed Oct 03 07:33:24 EDT 2012;Committer;nobu;1;1;1;2;0
54c17dc8a979ce072991e4480e5ae3d70bad9b2a;Wed Oct 03 06:33:08 EDT 2012;Committer;nobu;2;18;1;19;0
5c677a83bab95b01a0c5d6d3eda9e26e8e43fab2;Wed Oct 03 02:43:19 EDT 2012;Committer;nobu;3;83;35;118;0
48af304cf7e74717ea95235901a48ba5904711bd;Tue Oct 02 19:36:26 EDT 2012;Committer;drbrain;2;34;0;34;0
a0ead9fca181f243e57eca8b5ba4527c69f7a3b1;Tue Oct 02 17:25:21 EDT 2012;Committer;svn;1;2;2;4;0
a1ed68b93199acab7673be6791e7bf60cce22662;Tue Oct 02 17:25:10 EDT 2012;Committer;shugo;3;56;7;63;0
a63bde6d9171006a32123a19019b701362133db8;Tue Oct 02 07:47:17 EDT 2012;Committer;svn;1;2;2;4;0
a416367b0434e52ae2eef0ea84c19a2c1e3d05ca;Tue Oct 02 07:47:11 EDT 2012;Committer;nobu;2;7;5;12;0
39ef471e2d460141fc7c71b66b7ec6c7b520faed;Mon Oct 01 14:52:53 EDT 2012;Committer;nagachika;1;2;2;4;0
e56eb1b163eed2220fdde972b196c59a7c93edb0;Mon Oct 01 13:56:37 EDT 2012;Committer;shugo;2;25;6;31;0
a0f43fad5e37dd60d5f17bbe81e0e1d84e382147;Sun Sep 30 17:36:14 EDT 2012;Committer;svn;1;3;3;6;0
1d695c36b963c49cb7b68542b0e8fd45874d51e3;Sun Sep 30 17:36:09 EDT 2012;Committer;knu;2;9;1;10;0
0d3cd4119e8c18dba326aa51ec0aee7719d30b31;Sun Sep 30 14:34:55 EDT 2012;Committer;mrkn;2;9;3;12;0
173aacf9ff5089fef416631ae9c1c0b5e88be628;Sun Sep 30 12:32:04 EDT 2012;Committer;nagachika;1;1;2;3;0
ab5545ee579d54f7cf30ce04a2e1bf3308cbddd7;Sun Sep 30 12:20:15 EDT 2012;Committer;svn;1;2;2;4;0
64989fa5a2a8022aee8e6a5b71eb1e77eba5ce82;Sun Sep 30 12:20:09 EDT 2012;Committer;naruse;3;12;1;13;0
4d4800a5a7b078f34b86654b40321e498d50714e;Sat Sep 29 11:19:11 EDT 2012;Committer;shirosaki;3;15;1;16;0
e453cc71a88e01effc9de6971acc1f446f22495f;Sat Sep 29 11:19:06 EDT 2012;Committer;shirosaki;2;23;11;34;0
d0df0547c6b50ea1ef7a2b90efc8d848b7141078;Sat Sep 29 11:19:02 EDT 2012;Committer;shirosaki;2;11;2;13;0
6d1220b0131af25e14f56b1d0b49b8e650376885;Sat Sep 29 11:18:57 EDT 2012;Committer;shirosaki;2;8;5;13;0
0954607864bcdd81ea5f3dd2ea52f638f2f32e47;Sat Sep 29 02:21:27 EDT 2012;Committer;shugo;4;81;14;95;0
039e2a35c2e410cf1679cf10b492112cc67931a9;Fri Sep 28 17:32:12 EDT 2012;Committer;svn;1;2;2;4;0
93731ef21188079b7c6fccebecec75f3551c949c;Fri Sep 28 17:32:06 EDT 2012;Committer;shirosaki;2;11;1;12;0
b5de8fcd81d715268829e1427db4194e776a6f64;Fri Sep 28 13:43:06 EDT 2012;Committer;shirosaki;2;9;1;10;0
2adb9fd4a51b054543cc40555718bd09901a324f;Fri Sep 28 08:58:22 EDT 2012;Committer;ko1;2;11;7;18;0
948169c5be76936a2e8ccffe6301bf4ee1b6d559;Fri Sep 28 08:29:21 EDT 2012;Committer;naruse;2;16;1;17;0
82491a4f73e4276dd8eef30091cff0b629ec1caf;Fri Sep 28 08:11:27 EDT 2012;Committer;nobu;1;4;4;8;0
de14055d62da51b91f9883ae1b3af2ae247565be;Fri Sep 28 06:48:20 EDT 2012;Committer;shugo;3;48;8;56;0
e3990633cb2e44f19588c16a436516a8ecae0459;Fri Sep 28 06:44:24 EDT 2012;Committer;ko1;6;10;39;49;0
64f5b6aedc25dc8b6ef086f40d7f3c6cd401ee3e;Fri Sep 28 04:16:59 EDT 2012;Committer;ko1;2;5;1;6;0
d50483df23383caf098c23c25c133f4eefca5917;Fri Sep 28 04:05:36 EDT 2012;Committer;ko1;7;98;42;140;0
8124d67988ea5aa995f1721446c229a83a8b356d;Fri Sep 28 01:41:01 EDT 2012;Committer;svn;1;2;2;4;0
4a3c049cd1a02f3a650cec165178b33d8bfb0bfd;Fri Sep 28 01:40:56 EDT 2012;Committer;nobu;3;39;2;41;0
8940e3721010e8867242ecf72d23a647304581a1;Thu Sep 27 09:53:24 EDT 2012;Committer;shugo;4;94;7;101;0
e0bff65092ddd92058994feb33e69195fb216488;Thu Sep 27 09:20:58 EDT 2012;Committer;knu;3;50;14;64;0
015af597e09a8fc938ed9562e29946da7fb0aa38;Thu Sep 27 02:36:41 EDT 2012;Committer;svn;1;2;2;4;0
454d393555887b6d517644419b1ab40e47342acb;Thu Sep 27 02:36:36 EDT 2012;Committer;nobu;1;12;4;16;0
1bebb22ce16c6129a805adad83e0f1e29f3874a0;Wed Sep 26 09:34:46 EDT 2012;Committer;ko1;8;74;0;74;0
24793ac32db538306899aed7ba588b7231f93a95;Wed Sep 26 04:03:26 EDT 2012;Committer;naruse;1;1;1;2;0
8432fda6d77c6bfbc6c33a02f88e992a71e07b73;Wed Sep 26 01:26:14 EDT 2012;Committer;svn;1;2;2;4;0
6fc41b02915eb48efd6150a139a255672450c56f;Wed Sep 26 01:26:09 EDT 2012;Committer;naruse;1;1;1;2;0
2301f983d2bd7edc5c36352e97b8028dc4c4bc24;Tue Sep 25 02:14:18 EDT 2012;Committer;nobu;1;3;2;5;0
26df05b2f80c47c080b01b2c23623d5aabba0321;Tue Sep 25 01:10:32 EDT 2012;Committer;nobu;1;10;4;14;0
1e56548995fe2b3b266ccdfecce0ef1163534dc6;Tue Sep 25 00:59:29 EDT 2012;Committer;nobu;4;28;4;32;0
80440ed07f23c2f6a53e210f84aa2d4ca7f92555;Mon Sep 24 23:18:04 EDT 2012;Committer;svn;1;2;2;4;0
2eadff346a96ccb756bd8949298a48e709edbe4f;Mon Sep 24 23:17:59 EDT 2012;Committer;naruse;3;12;2;14;0
418bbce88a77599672a5851f63245a4723a8a608;Mon Sep 24 12:10:51 EDT 2012;Committer;naruse;1;1;1;2;0
2314b80d4c5ed712308f6b32aa8bf865d8d9ffff;Mon Sep 24 08:36:53 EDT 2012;Committer;nobu;8;100;29;129;0
8ac52a95d577d00ed7b783fde8bca5b2b76cb404;Mon Sep 24 02:23:48 EDT 2012;Committer;naruse;2;10;1;11;0
a7353f69244d00a49edfb899151e2fcd82c89c2c;Mon Sep 24 01:18:22 EDT 2012;Committer;nobu;1;1;1;2;0
96e4afdb02d0e8d0f37eee986a3197c9ef54e6b8;Mon Sep 24 01:16:40 EDT 2012;Committer;svn;1;2;2;4;0
8a3856dc1ee0f0a9105592de9b29507eba1a8dda;Mon Sep 24 01:16:36 EDT 2012;Committer;nobu;1;6;4;10;0
aed254f314b9c2bdae46d34dd17300cadace3907;Sun Sep 23 12:52:01 EDT 2012;Committer;nobu;2;15;6;21;0
ba3d6005837aab1815131512ca4918f17ee12d07;Sun Sep 23 12:48:15 EDT 2012;Committer;nobu;2;7;4;11;0
9f4f1545010b42c23a7085de5db9ae6ce06f1148;Sun Sep 23 12:46:48 EDT 2012;Committer;nobu;2;7;4;11;0
255e1b05b1e3163c251eb4cc18aa116d75de601a;Sun Sep 23 12:45:21 EDT 2012;Committer;nobu;2;4;2;6;0
de9093ad2941a4c1ae64fe5a6e48166d155397e5;Sun Sep 23 12:44:30 EDT 2012;Committer;nobu;2;14;12;26;0
87fe2bfdcf16b37608b5c1b51da63f024818cc85;Sun Sep 23 12:42:29 EDT 2012;Committer;nobu;2;5;1;6;0
ca7ffa341835d947f08446d4257f34626f6fa56e;Sat Sep 22 17:36:52 EDT 2012;Committer;svn;1;2;2;4;0
63f6cda81574bdeb2d5ba9e7ba48d44c8f45f7a1;Sat Sep 22 17:36:47 EDT 2012;Committer;eregon;2;11;7;18;0
f9ff15055319568d09bd343e5c223bc9ca568ac9;Fri Sep 21 22:15:26 EDT 2012;Committer;svn;1;2;2;4;0
e4ac8fa28242b365cb81a95e7421806c350d1b65;Fri Sep 21 22:15:21 EDT 2012;Committer;zzak;2;7;1;8;0
523290ac139d44aa57e57955bc4d3cd964848dcf;Fri Sep 21 00:35:13 EDT 2012;Committer;svn;1;2;2;4;0
ecc80b3cb46e526bef64d9761b972e32e7152193;Fri Sep 21 00:35:09 EDT 2012;Committer;nobu;1;9;10;19;0
d9dfe2e514631be9ae243de8f3b6f52e35ac82e0;Thu Sep 20 14:16:02 EDT 2012;Committer;kosaki;2;7;0;7;0
187d2bc1d6e6f3f18a443614406598ed6fc0ef0f;Thu Sep 20 14:15:46 EDT 2012;Committer;kosaki;2;7;4;11;0
025a2479ae6bc2896e78594a49acd64c32415166;Thu Sep 20 08:05:08 EDT 2012;Committer;naruse;4;36;1;37;0
796700aca712dbd1155760b22cb50cfd8aab70d9;Thu Sep 20 08:05:05 EDT 2012;Committer;naruse;1;2;2;4;0
4e195e0ff3aab6994b760387c747b1f3ac1a0a3f;Thu Sep 20 07:14:54 EDT 2012;Committer;nobu;2;1;6;7;0
2b64e10feb46cf6fafc57a036e80ee497806213f;Thu Sep 20 07:06:06 EDT 2012;Committer;nobu;4;4;7;11;0
a9fefe7555a43152b21c589a2582ba212ece4d82;Thu Sep 20 01:59:52 EDT 2012;Committer;usa;2;11;1;12;0
2a50cecab888848b1303307d039f7429e23e17a3;Thu Sep 20 01:32:08 EDT 2012;Committer;zzak;2;6;1;7;0
7c4d0468df37da40cbcd178070b288dd535bc72e;Wed Sep 19 22:23:15 EDT 2012;Committer;zzak;2;23;3;26;0
cca61dafe8f2799994a57f067ea10472992c13b5;Wed Sep 19 22:17:16 EDT 2012;Committer;zzak;2;13;8;21;0
0503756fe5e56453ba1e10674615b71cd2c5a554;Wed Sep 19 22:07:44 EDT 2012;Committer;zzak;2;32;5;37;0
f205ac490e5b05e9c070a992ad6bb9cf5988104e;Wed Sep 19 15:42:32 EDT 2012;Committer;svn;1;2;2;4;0
abeedb0875f3fb8e8d1329b8dc885b159cb61841;Wed Sep 19 15:42:26 EDT 2012;Committer;nobu;7;37;3;40;0
b70f99d15f3f139523aa8f1dcb200fa8a8aaa16b;Wed Sep 19 14:49:22 EDT 2012;Committer;svn;1;2;2;4;0
181815422b02bccc24a98dd2637a6e1da8d5a43e;Wed Sep 19 14:49:19 EDT 2012;Committer;naruse;2;4;2;6;0
aab70ee3d3d9f16f7299d02536ea751ee58abf62;Tue Sep 18 08:52:46 EDT 2012;Committer;svn;1;2;2;4;0
e8854f8c62bd4241c77e5b2db82060d94193ea51;Tue Sep 18 08:52:40 EDT 2012;Committer;naruse;2;6;0;6;0
315cbef8358eb4f1fae3faba90c459054ad2a2c0;Sun Sep 16 09:24:44 EDT 2012;Committer;nobu;1;5;7;12;0
f3dd7c49630a771acafd2d4f358ff2e7a74b4d15;Sun Sep 16 09:09:10 EDT 2012;Committer;nobu;1;1;1;2;0
32d416db0db4e445d8156885aae9c6b26ce56c56;Sun Sep 16 08:47:53 EDT 2012;Committer;drbrain;2;6;1;7;0
c278c84692c17f3d83fa3acfe39f2a2564dced0d;Sun Sep 16 08:41:37 EDT 2012;Committer;nobu;1;1;0;1;0
59383b1f9cffc2815d4a213710be253d9b6114d4;Sun Sep 16 02:39:18 EDT 2012;Committer;nobu;3;69;3;72;0
4a906510a289475bb4baf662a70e07e6b01fad3b;Sat Sep 15 23:58:04 EDT 2012;Committer;nobu;3;8;3;11;0
057b1986a4bdc449c2c328fce9df1869d527be2e;Sat Sep 15 23:52:34 EDT 2012;Committer;nobu;1;1;1;2;0
310cbde45c2b54c55fff82eb86dae4f56ae4b122;Sat Sep 15 23:16:20 EDT 2012;Committer;svn;1;2;2;4;0
fdd8d5badca40c9d514c52c32c791b58165c2087;Sat Sep 15 23:16:15 EDT 2012;Committer;nobu;2;20;0;20;0
47b642bdd318d55884ef9d1143787456da63539b;Sat Sep 15 09:26:33 EDT 2012;Committer;nobu;1;33;78;111;0
2bfc48dd62e572c554529f67f57e0da8bbcb2475;Sat Sep 15 09:26:31 EDT 2012;Committer;nobu;1;50;72;122;0
66d03f5f3cae77cca211cc89ae9db87e8777c035;Sat Sep 15 09:26:28 EDT 2012;Committer;nobu;1;39;46;85;0
b520b218391b7af434c428f622797ae59b4691c4;Sat Sep 15 09:26:26 EDT 2012;Committer;nobu;1;8;14;22;0
356c085709099df61fdf177d1e7717aa65640376;Sat Sep 15 09:26:21 EDT 2012;Committer;nobu;1;58;58;116;0
bcd7b81ea60b37bc2772bccbc0354051e59e4192;Fri Sep 14 17:29:59 EDT 2012;Committer;eregon;1;1;1;2;0
429c856e9c3b8f192753eaba6ddd1ea7a19676c6;Fri Sep 14 17:29:40 EDT 2012;Committer;eregon;1;1;1;2;0
3d42b23557f135100e2b41b0a9ed4c47d58c3d45;Fri Sep 14 17:26:39 EDT 2012;Committer;naruse;2;22;6;28;0
4649f218c84803ce86c813cc0b40f1531959d1bf;Fri Sep 14 16:07:57 EDT 2012;Committer;svn;1;2;2;4;0
1aab4196fa000cf93032bcf621f202c3e4016578;Fri Sep 14 16:07:49 EDT 2012;Committer;naruse;2;18;9;27;0
00fb59f19ab801b8d7ae44c0d3582e2a31fbbcff;Thu Sep 13 19:08:45 EDT 2012;Committer;zzak;2;29;5;34;0
1ae1b85e81bcfa1742e7d6fd5d02c0b11f1170ce;Thu Sep 13 18:32:07 EDT 2012;Committer;zzak;3;27;12;39;0
7a0d7e74cbdff8946c63534d0fb666af39fa72bb;Thu Sep 13 15:24:10 EDT 2012;Committer;svn;1;2;2;4;0
b1228caeff7791116a68a400607f55fc891a4b2a;Thu Sep 13 15:24:05 EDT 2012;Committer;zzak;2;11;5;16;0
3207af4cb841872176ad0ba5cc62f868b83ee769;Thu Sep 13 13:01:23 EDT 2012;Committer;shirosaki;2;14;4;18;0
92300037ad5f8817bd364594d3d5bc55e3190ae7;Thu Sep 13 02:25:37 EDT 2012;Committer;zzak;2;6;2;8;0
1df7862b2bf2ba3ebd9d33c6be4882e727fb64f4;Thu Sep 13 02:22:10 EDT 2012;Committer;zzak;14;1015;1147;2162;0
d11ef850b21cadc92b8b2bb509c3a329dc70cd43;Thu Sep 13 01:22:13 EDT 2012;Committer;nobu;2;12;1;13;0
5d62cf1376bbe6ee14a3e9bfae5b407d6cf9a4ef;Wed Sep 12 23:22:26 EDT 2012;Committer;zzak;2;80;35;115;0
54de5e3f2d6f48522c114bdf467ddb1260ec65ac;Wed Sep 12 23:04:45 EDT 2012;Committer;svn;1;2;2;4;0
8f0d172f581351e89497ce5f9893b4be0f887b6d;Wed Sep 12 23:04:41 EDT 2012;Committer;zzak;6;109;20;129;0
857ec7118f69b140f5fd09b16fac9e28b90508f8;Wed Sep 12 14:16:16 EDT 2012;Committer;nobu;1;1;1;2;0
6f50057bda967cb2ff29d7a2459e906876a39795;Wed Sep 12 13:59:10 EDT 2012;Committer;nobu;2;19;20;39;0
bed6c49801072e54558d858d698b8036e5c81872;Wed Sep 12 13:54:13 EDT 2012;Committer;svn;1;2;2;4;0
b5c38622b191dbc0789bc613ad6042d49ec91743;Wed Sep 12 13:54:08 EDT 2012;Committer;zzak;3;320;148;468;0
4893e6abab603b68f91920bd57410d120754e5f7;Tue Sep 11 00:44:33 EDT 2012;Committer;svn;1;2;2;4;0
9445ab2d9864dd2c53fce6468e4ff15f40761914;Tue Sep 11 00:44:30 EDT 2012;Committer;nobu;1;3;1;4;0
f228a4b20949997c139cbb33434099bd71b81578;Mon Sep 10 08:21:02 EDT 2012;Committer;nobu;1;1;1;2;0
91987f6b047afba7ffe4852539a15c214bdf56ba;Mon Sep 10 01:41:59 EDT 2012;Committer;usa;3;5;1;6;0
7d59a9631405b68e7aec9dbcf5e513649b779ceb;Mon Sep 10 01:20:16 EDT 2012;Committer;usa;2;5;1;6;0
84c77c15205d57a3d50d8b29bb6d2af2ff44de77;Sun Sep 09 17:29:12 EDT 2012;Committer;kosaki;5;22;17;39;0
946f7fc7888f61da879c660b43e2c574aaf713eb;Sun Sep 09 17:11:25 EDT 2012;Committer;kosaki;2;10;4;14;0
4c10b36467ba7cbb59128dabd437ef3931c7d0e4;Sun Sep 09 17:11:03 EDT 2012;Committer;kosaki;2;9;8;17;0
252334e016e97565e4d290719ff57c8043004fad;Sun Sep 09 15:17:20 EDT 2012;Committer;svn;1;2;2;4;0
aa8dd0290b20fa9db9b545b8a1670ff3371c2e4b;Sun Sep 09 15:17:15 EDT 2012;Committer;naruse;2;9;1;10;0
7198053a49d39a5c80551fc9147b9c0ab21e75a2;Sun Sep 09 12:32:33 EDT 2012;Committer;kosaki;3;73;13;86;0
2248a8ce643509577dd29988f5ea1e662f4aaa65;Sun Sep 09 11:34:47 EDT 2012;Committer;kosaki;3;80;8;88;0
5dbbee86b616424ee9800488a381b02f9e7c65b3;Sun Sep 09 11:32:11 EDT 2012;Committer;kosaki;2;7;0;7;0
149176225ac37574530f52e61e2f1dc1b8905e24;Sun Sep 09 11:29:40 EDT 2012;Committer;kosaki;2;4;2;6;0
fde6de9fc7417e5bafc724f85d8d8b0b050430f1;Sun Sep 09 09:24:35 EDT 2012;Committer;kosaki;2;17;0;17;0
4b58f39dedfb3491aba7e39e5c2dba0876437cc4;Sun Sep 09 09:10:46 EDT 2012;Committer;kosaki;2;63;13;76;0
3df2fc2da8ee34ad0b923e42b3fcdc8daf391370;Sun Sep 09 07:20:00 EDT 2012;Committer;kosaki;2;16;3;19;0
44f9d99e3dcbd526b11dc5a693df4f9ca9292618;Sun Sep 09 06:27:07 EDT 2012;Committer;svn;1;2;2;4;0
10c14095de5dd4114d8cf536c5bd4cea63370a97;Sun Sep 09 06:27:02 EDT 2012;Committer;kosaki;2;20;1;21;0
5fbfc21b67f4bd68502e186024636f5bf4350f90;Sat Sep 08 09:52:26 EDT 2012;Committer;nobu;9;34;39;73;0
ea005c47faf3563b7fc9a3f92525a05e745df033;Sat Sep 08 09:31:18 EDT 2012;Committer;nobu;1;1;1;2;0
583ae60897452ff48d3d4a986a0604b4b519be91;Sat Sep 08 09:18:50 EDT 2012;Committer;nobu;1;1;1;2;0
dffb71060edb3160e1d89b4df6709795f1920232;Sat Sep 08 07:54:31 EDT 2012;Committer;svn;1;2;2;4;0
68e47b61226df183ae17203ae9d0b812f2ce46eb;Sat Sep 08 07:54:27 EDT 2012;Committer;nobu;1;14;0;14;0
9dd9041fcfa4335f748a0ce9424ddd1af9343cff;Fri Sep 07 14:34:40 EDT 2012;Committer;nagachika;1;0;1;1;0
aa9789bdec8c3b0543db844dd0b0acf4a62de7d1;Thu Sep 06 16:22:03 EDT 2012;Committer;svn;1;2;2;4;0
d0d68df7d00f58c8ebb9a74f577dca389876d882;Thu Sep 06 16:21:57 EDT 2012;Committer;nobu;5;20;6;26;0
977bec12363e7e87a19ad81aa063fbf2b4112493;Thu Sep 06 05:49:51 EDT 2012;Committer;nobu;3;13;2;15;0
38d0cbce65d97a8ddc61609d2a052cd91d4a2789;Thu Sep 06 05:48:34 EDT 2012;Committer;nobu;2;7;5;12;0
d80f56cba3eb0b920e02912243e4dc5ee965914e;Wed Sep 05 23:25:03 EDT 2012;Committer;svn;1;2;2;4;0
a3980eb2b6a88d4e95477f1e7cd29e9776a8396a;Wed Sep 05 23:24:58 EDT 2012;Committer;ryan;4;29;4;33;0
8ee2226068bca03aba3dade555ccce3d64e4397a;Wed Sep 05 10:22:49 EDT 2012;Committer;usa;2;14;8;22;0
b3c60b27e7e5bbde92613ef9a78382d76b6090a1;Wed Sep 05 07:00:36 EDT 2012;Committer;shyouhei;2;6;0;6;0
406f6a23d5f2f5bb8a454038b3e2100a9da44a5b;Wed Sep 05 06:23:20 EDT 2012;Committer;naruse;2;10;1;11;0
d4e2cb1564030010e54d367223cc261894a4414f;Wed Sep 05 06:23:13 EDT 2012;Committer;naruse;1;2;3;5;0
5809d668bc6b8e43e117925d10a41e9e62d1c629;Wed Sep 05 05:29:46 EDT 2012;Committer;nobu;1;2;2;4;0
ad2e34c6709a69dc748f8d33e4f541bee8c29f75;Wed Sep 05 05:29:44 EDT 2012;Committer;nobu;1;2;2;4;0
f961b80a787611c4235f617ebc2b3f5718ac1f02;Wed Sep 05 05:29:41 EDT 2012;Committer;nobu;1;25;22;47;0
a1fa2695e1cbb6580357d26e111cc604c6273f3c;Wed Sep 05 05:29:37 EDT 2012;Committer;nobu;1;3;1;4;0
83185f9181e90979dd698489cefd85514661265e;Wed Sep 05 04:30:10 EDT 2012;Committer;nobu;3;22;1;23;0
f1df537a831c57021508ac9ca03229550d99b4d8;Wed Sep 05 03:03:24 EDT 2012;Committer;nobu;2;7;5;12;0
f65e683ccc3b6689ac00e7c1fe0fd2c0384824b2;Wed Sep 05 01:44:36 EDT 2012;Committer;nobu;1;12;3;15;0
9e9dff33421b3a16d2b0a710479fcdd1eb44c082;Wed Sep 05 01:44:24 EDT 2012;Committer;svn;1;2;2;4;0
65a61792a96f478cbf8ff90b8a09b8b555f4d5c1;Wed Sep 05 01:44:20 EDT 2012;Committer;nobu;1;1;1;2;0
0dc94b8b3e6c9440c05f18387c7dc8207094d89a;Tue Sep 04 12:45:31 EDT 2012;Committer;shirosaki;3;15;2;17;0
4ef43fc02f9446da4eaa508c439d3caa1a244ebf;Tue Sep 04 02:52:44 EDT 2012;Committer;nobu;2;9;4;13;0
99e63fba29afb9f6dbf95396a12524ec8b8096ac;Tue Sep 04 02:35:47 EDT 2012;Committer;shyouhei;2;8;1;9;0
7d79f355fcfb39c52f5b47f44c99c0e645d1878a;Tue Sep 04 01:40:11 EDT 2012;Committer;nobu;1;3;1;4;0
af6c038b23c056fed1a8f5cbb8827b3a5061e893;Tue Sep 04 00:57:31 EDT 2012;Committer;nobu;14;57;57;114;0
4bb125f91a1df7d5252b1dd1f59c1ce0238e0192;Mon Sep 03 22:54:12 EDT 2012;Committer;emboss;7;22;14;36;0
b6c38f675356cf6da84e35c8a9ed57922130e580;Mon Sep 03 22:13:15 EDT 2012;Committer;emboss;1;1;1;2;0
a6a52c9c9db87bd25038bb553bdc0fcb6404398b;Mon Sep 03 22:09:43 EDT 2012;Committer;svn;1;2;2;4;0
78755b8d52101e3b85ebce3aedd97e4cce8ed6ad;Mon Sep 03 22:09:33 EDT 2012;Committer;emboss;2;7;1;8;0
2000173101bfa2a5beadca8d9c77b991354d30e8;Mon Sep 03 12:22:44 EDT 2012;Committer;nobu;2;6;1;7;0
1f29acae2873b7e6ceecf886ae4b088a197c93bd;Mon Sep 03 12:08:55 EDT 2012;Committer;nobu;1;2;2;4;0
98fded61f83f75b0c64806ef1c27a1c200868a47;Mon Sep 03 09:31:37 EDT 2012;Committer;nobu;1;59;0;59;0
7c2230bd8c8a16a976091f983737d94ce52959d1;Mon Sep 03 05:49:06 EDT 2012;Committer;nobu;3;21;1;22;0
a4ce3ab4fd5982af49662320839f8ec109d63881;Mon Sep 03 03:22:22 EDT 2012;Committer;nobu;4;5;5;10;0
c5ad3214391630a096db03decf8cb15f7046a7fd;Mon Sep 03 01:17:00 EDT 2012;Committer;emboss;1;2;2;4;0
e29819df6e6a644bbfadbdc706a472c413015286;Mon Sep 03 01:14:26 EDT 2012;Committer;emboss;9;56;10;66;0
9b6f66c74f367bbce13dc19bcc5e4d037ed290bf;Sun Sep 02 16:00:12 EDT 2012;Committer;svn;1;2;2;4;0
c38aee596f496a7500d2dbd84fd6a4cd8f70c01d;Sun Sep 02 16:00:08 EDT 2012;Committer;kazu;1;3;3;6;0
5aa3caaa5d68d6e62612574869f1dc6293ebb836;Sun Sep 02 12:50:02 EDT 2012;Committer;emboss;2;13;1;14;0
2c1939f458816d4d72187e7a1cee0add05f0ca53;Sun Sep 02 05:06:35 EDT 2012;Committer;naruse;1;1;1;2;0
271d557b8046141175e141afef1d13108d789e84;Sat Sep 01 20:46:31 EDT 2012;Committer;svn;1;2;2;4;0
8e9bbfd513899c285b6c6edaedc1216e39d6976d;Sat Sep 01 20:46:31 EDT 2012;Committer;naruse;3;11;0;11;0
b238b5be91433f824d92da976a94c84451a91023;Sat Sep 01 20:46:27 EDT 2012;Committer;naruse;1;1;1;2;0
d4fe9e004adbd6dc0ffbf2ff8626601da3a8fed4;Sat Sep 01 09:51:48 EDT 2012;Committer;knu;2;7;2;9;0
1f65a21b6fe389e5183b068e01d2ef5e18f89483;Sat Sep 01 07:41:51 EDT 2012;Committer;eregon;1;1;1;2;0
4d8cca98a951a68d91949f6e7ada14771d808ebf;Sat Sep 01 05:03:38 EDT 2012;Committer;svn;1;3;3;6;0
059f14a6c5a4f3d72da6c8a32b2a435a1f752197;Sat Sep 01 05:03:34 EDT 2012;Committer;nobu;1;1;1;2;0
ed9312527fa68d462b5a883d0de52aa81014677b;Fri Aug 31 12:50:16 EDT 2012;Committer;kou;2;19;0;19;0
25e6db3e3cb52c1a81e1e4a958a8d520a996812e;Fri Aug 31 09:47:36 EDT 2012;Committer;emboss;5;256;68;324;0
ca1c6093d69637ffeff4aba2abb0c3f2b98c939d;Fri Aug 31 08:44:02 EDT 2012;Committer;nobu;1;1;1;2;0
babb80f4a9562db3b45792059bf8e21c22ed2058;Fri Aug 31 08:43:09 EDT 2012;Committer;knu;2;18;12;30;0
e03d266c1dbf82c25fd63a2a4a1a9665dbc1bab4;Fri Aug 31 07:30:22 EDT 2012;Committer;knu;2;61;42;103;0
926552f58321ee38e5a3f94578a72c695ee19ae6;Fri Aug 31 06:35:21 EDT 2012;Committer;nobu;1;3;3;6;0
15293df7d7d278a6dac60ebd03cf76e6b37eb910;Fri Aug 31 05:52:10 EDT 2012;Committer;usa;2;10;0;10;0
1d1130eea1c47da679ac423ccfcb1a9bcec1c937;Fri Aug 31 05:34:08 EDT 2012;Committer;usa;2;8;2;10;0
470c941ce5bd1800fc24f271c6234cee096fd592;Fri Aug 31 05:31:20 EDT 2012;Committer;nobu;6;101;91;192;0
2e42f37a020ce9c94f7d41e69b3e3ffec43a54ce;Fri Aug 31 05:27:44 EDT 2012;Committer;nobu;2;8;2;10;0
dde690bc32f4e7f614bf46edc3f8bce8ad2e131b;Fri Aug 31 05:03:47 EDT 2012;Committer;nobu;2;7;15;22;0
4faf219853a67128c9bd3a1282f0419cd3def0fb;Fri Aug 31 05:02:47 EDT 2012;Committer;nobu;2;6;1;7;0
667a6a851656d5acdd6256301fc9bdf878089bef;Fri Aug 31 04:58:21 EDT 2012;Committer;svn;1;2;2;4;0
30fbd739a19cadb4b7c63ca1f982891a69ff17a8;Fri Aug 31 04:58:18 EDT 2012;Committer;nobu;1;1;1;2;0
76d0abd33451514e380f146155d6a7d4a8ef7f72;Thu Aug 30 09:22:18 EDT 2012;Committer;akr;2;5;0;5;0
d90b02360391a2e87dac58329316a87032ae6e70;Thu Aug 30 07:20:05 EDT 2012;Committer;nobu;1;3;5;8;0
d7ca01a73ad5287f9d063bbdf5b35f472affda9d;Thu Aug 30 07:17:56 EDT 2012;Committer;nobu;3;36;8;44;0
aa7dc0f305c11c2ef9e67f6d48acbd1264022024;Thu Aug 30 04:01:58 EDT 2012;Committer;knu;2;29;0;29;0
37cc18d54bf008cf4ab8e0c39829f96efdfe037e;Thu Aug 30 00:22:11 EDT 2012;Committer;naruse;3;10;0;10;0
ed491f2c8620a8edd860be8a9161198b8d9a0dce;Wed Aug 29 22:45:28 EDT 2012;Committer;svn;1;2;2;4;0
608a1f44761bc9a964fdf8a6c2a257374b89e761;Wed Aug 29 22:45:24 EDT 2012;Committer;luislavena;2;11;1;12;0
e7ddd1fdc3c7807cae6ffa3154bef585c7a4ee8c;Wed Aug 29 14:44:08 EDT 2012;Committer;akr;4;13;1;14;0
7c854d6d5e1611f0d4625637661dc03f49cbc942;Wed Aug 29 13:02:45 EDT 2012;Committer;akr;2;9;1;10;0
22c81db9d8bd5087e4c1a0d4771873ad7d58ad88;Wed Aug 29 06:03:09 EDT 2012;Committer;nobu;3;21;2;23;0
06d98b4d4dfa2f4d61373a4fe06a4fdaaedc9452;Wed Aug 29 05:59:07 EDT 2012;Committer;nobu;1;7;5;12;0
58d0277775487f835b6345c0c32c459163fd1f13;Wed Aug 29 05:59:05 EDT 2012;Committer;nobu;1;10;2;12;0
cc4c0ab8621a456cc070df9da74e58c4663b42d3;Wed Aug 29 05:37:28 EDT 2012;Committer;naruse;2;6;0;6;0
9871dd5783963ad3d341ddb58f6bfe7ca7ceb444;Tue Aug 28 20:03:32 EDT 2012;Committer;emboss;4;23;14;37;0
9b9e6875e8a151a925fb92370c07f13c045c0a87;Tue Aug 28 16:57:54 EDT 2012;Committer;svn;1;2;2;4;0
cb6fc579f462c17870bb78b50c2f1b9cb4019cc2;Tue Aug 28 16:57:50 EDT 2012;Committer;nobu;1;0;2;2;0
43b8ae46314a3154768b615f2b7d2538e293b1bc;Tue Aug 28 14:05:52 EDT 2012;Committer;nagachika;2;8;1;9;0
435827110622747500a77e8168fb128b9558fb6d;Tue Aug 28 11:05:23 EDT 2012;Committer;naruse;2;16;2;18;0
0cd1cf38766fd177554fe25fa9bb7b65e642a75b;Tue Aug 28 02:34:43 EDT 2012;Committer;yugui;2;7;1;8;0
234378d8bb8db94b483a50b10725aff930374875;Tue Aug 28 00:27:21 EDT 2012;Committer;usa;2;6;1;7;0
1a1583ca3b9b85dc457eae14c140dca52b1f3c21;Mon Aug 27 17:57:37 EDT 2012;Committer;svn;1;2;2;4;0
2caa432c6a3276c1793cc221fd876df6af12c805;Mon Aug 27 17:57:32 EDT 2012;Committer;tenderlove;1;13;0;13;0
a5849245c6ffb31053ab75ab2e36163674ca7c81;Mon Aug 27 11:57:43 EDT 2012;Committer;shirosaki;2;18;6;24;0
0b89d6d5f9f8c788f4391d8a0499f10aed624371;Mon Aug 27 09:22:21 EDT 2012;Committer;ko1;2;11;5;16;0
10d85333ac9e7a19c537a6000c614fdb67380426;Mon Aug 27 06:09:26 EDT 2012;Committer;yugui;2;5;1;6;0
6d66dbf25ec32968c133ca51b6d786b5dab581ac;Mon Aug 27 01:23:00 EDT 2012;Committer;yugui;2;8;0;8;0
753ea0dd29913413adad12108541dca70204946a;Mon Aug 27 01:22:58 EDT 2012;Committer;svn;1;2;2;4;0
a66b2c6df162f222f0adbbc027818326671fd9a1;Mon Aug 27 01:22:53 EDT 2012;Committer;yugui;3;43;8;51;0
51463abb6898e772ff360cb0a4497183776d0f89;Sun Aug 26 08:19:05 EDT 2012;Committer;nobu;1;1;1;2;0
567ae2a6c3ec8f03d14034499f93b80351f2ae0b;Sun Aug 26 07:53:26 EDT 2012;Committer;svn;1;2;2;4;0
68f3ece33f3dd3161b6729bbc365a683cbc65a67;Sun Aug 26 07:53:21 EDT 2012;Committer;nobu;4;15;6;21;0
87450541b34ffae190ecee290a6fbe308b241b3a;Sat Aug 25 07:21:07 EDT 2012;Committer;nobu;1;28;20;48;0
4d887d8b71f3c52d3639a76af394f9ff7154668d;Sat Aug 25 07:20:31 EDT 2012;Committer;nobu;1;2;3;5;0
bcbc1f722c0ab7e26334c6fdafab502f4f021860;Sat Aug 25 07:20:29 EDT 2012;Committer;nobu;3;21;18;39;0
67e79d1d372879dd9bd185b508aad150de76ff6f;Sat Aug 25 00:55:37 EDT 2012;Committer;svn;1;2;2;4;0
22bb811a733c5c402ba9e06c69b71a5b0e046ddb;Sat Aug 25 00:55:34 EDT 2012;Committer;nobu;1;1;1;2;0
b29a029768ab68a289536a43002550689f617239;Fri Aug 24 09:15:58 EDT 2012;Committer;nobu;1;1;1;2;0
b903ab940ca90188899a15ea0a04082aff795e10;Fri Aug 24 07:13:38 EDT 2012;Committer;nobu;1;2;2;4;0
9ae270bf8880d1e4e950556216e4db3150bd9b8b;Fri Aug 24 06:57:20 EDT 2012;Committer;naruse;1;6;1;7;0
d42794b78e769dacb2796a3c9ce6ae4c73dd9089;Fri Aug 24 06:56:58 EDT 2012;Committer;nobu;1;2;1;3;0
83e728a74ec54f3cbb5e024e2ec9c2868352a5e8;Fri Aug 24 06:42:34 EDT 2012;Committer;nobu;2;19;4;23;0
7611254f00c2427b11183195dc39a1cbc0d646eb;Fri Aug 24 04:53:50 EDT 2012;Committer;kazu;1;1;0;1;0
3d8d595932bef78aa3a175ea2150c88ad3582cba;Fri Aug 24 03:48:11 EDT 2012;Committer;luislavena;0;0;0;0;0
86df08dac6fc4642a6bac7bab6ccd5f44b7a293c;Fri Aug 24 03:44:56 EDT 2012;Committer;luislavena;8;909;13;922;0
d212a89c380683490dc735c770855f08391540a1;Thu Aug 23 22:42:12 EDT 2012;Committer;drbrain;2;9;1;10;0
ba475e4415736d50548c8ce42fbab7e67f740a35;Thu Aug 23 21:14:36 EDT 2012;Committer;svn;1;2;2;4;0
d3e0fe6b2f9ea2644137c1032fb579424ce3eac3;Thu Aug 23 21:14:31 EDT 2012;Committer;tenderlove;1;26;0;26;0
a7208d2a8196e83131d0354aba2b9244b75f76d1;Thu Aug 23 12:05:45 EDT 2012;Committer;kazu;2;6;2;8;0
1c9ba8330347f0fe6e47f89330126ec5b93eaff3;Thu Aug 23 12:05:42 EDT 2012;Committer;kazu;1;2;2;4;0
180a2fbf9d954d0d426fca7999fee7407a7d1eaf;Thu Aug 23 11:58:39 EDT 2012;Committer;naruse;1;1;0;1;0
1e73d66f6b1f70f87e2745ed529e1840b03577dc;Thu Aug 23 11:51:30 EDT 2012;Committer;usa;5;30;0;30;0
6a80947a4b7ebb637602ae105ee9b2d20ae62fce;Thu Aug 23 11:36:42 EDT 2012;Committer;usa;3;8;2;10;0
b2ea5504bc1c979f786a4ed121f76dd933fff2d0;Thu Aug 23 10:20:37 EDT 2012;Committer;usa;2;8;3;11;0
44a7c87076068d098b9bc11f70a1989f2cfdacc1;Thu Aug 23 10:18:23 EDT 2012;Committer;usa;2;9;10;19;0
c68d29960b4027da6fed55576a523f42f6182f28;Thu Aug 23 07:46:12 EDT 2012;Committer;nobu;5;43;6;49;0
2933909caf01896d45eefa23e9c839fd1e03d652;Thu Aug 23 07:45:46 EDT 2012;Committer;nobu;3;3;3;6;0
b3b5e626ad69bf22be3228f847f94e1b68f40888;Thu Aug 23 07:22:40 EDT 2012;Committer;ko1;13;324;104;428;0
ce5af582a0552d1ccbe66e8b3ee3ca046f6b18c3;Thu Aug 23 07:15:27 EDT 2012;Committer;usa;2;11;1;12;0
3721fb0106707de5d0a58af6bd5784053f379ab2;Thu Aug 23 07:03:46 EDT 2012;Committer;ko1;2;6;2;8;0
55cf24d3789486328e9a2ea734f42fb9122056e9;Thu Aug 23 04:00:25 EDT 2012;Committer;shugo;3;29;22;51;0
742a0d164e127394b438d6b83a8d65b4c16f1981;Thu Aug 23 03:33:53 EDT 2012;Committer;usa;1;2;0;2;0
7370aa3126e5bf27c26401389b4d87c377dbab10;Thu Aug 23 03:30:58 EDT 2012;Committer;usa;2;18;5;23;0
f896ad3b49461dbdee5e47e8224051ff46e75d95;Thu Aug 23 02:59:24 EDT 2012;Committer;naruse;3;18;4;22;0
a3946044125a890b3661f9a08d7a6fe68d275066;Thu Aug 23 02:35:01 EDT 2012;Committer;usa;2;7;1;8;0
ea16237c614f9261cedad243b311c0c76466aaef;Thu Aug 23 01:50:12 EDT 2012;Committer;naruse;2;27;16;43;0
bae282bc7421155ccd1ad656e466e79f220589d1;Thu Aug 23 01:38:14 EDT 2012;Committer;usa;2;10;3;13;0
5571c7315e118b339c6b6590e666dfda68a7327d;Wed Aug 22 17:43:16 EDT 2012;Committer;tenderlove;57;33;18722;18755;0
b8910f3751e985d04c2049be3c23c2ef5a9d9ecc;Wed Aug 22 16:51:13 EDT 2012;Committer;svn;1;2;2;4;0
51a41dd0569b27b80342aa4bd72e6b2c9f2c482c;Wed Aug 22 16:51:08 EDT 2012;Committer;tenderlove;3;27;9;36;0
c06924693158a17bad63f0f343c6e951d9b9b8eb;Wed Aug 22 10:47:05 EDT 2012;Committer;tadf;2;6;2;8;0
280681f40c8f3096fd4d7766fb1818ae67437687;Wed Aug 22 10:42:15 EDT 2012;Committer;tadf;4;17;1;18;0
69d6a825ae87300af604d9306800d5998300d4f5;Wed Aug 22 08:04:13 EDT 2012;Committer;nobu;1;2;1;3;0
4b448d36ea6728b871d548878281bd1cfa7b00a6;Wed Aug 22 07:57:22 EDT 2012;Committer;nobu;2;14;7;21;0
7861727ce94a5cc500aa75caa836886cc38131bb;Wed Aug 22 07:34:20 EDT 2012;Committer;nobu;1;1;1;2;0
36f93a0d67ea635458776cc0c01d9dce197fe5ad;Wed Aug 22 06:55:16 EDT 2012;Committer;kazu;1;1;1;2;0
051f12d368624fc7b9fc255efe8945e8f23ed25e;Wed Aug 22 06:54:20 EDT 2012;Committer;ko1;1;1;1;2;0
0a58a564c97cf75dba893ac9c7f9483a7f696985;Wed Aug 22 06:46:31 EDT 2012;Committer;ko1;1;4;2;6;0
c7ca25a04afc37b3da88feaf8af17c06d7ff2ccd;Wed Aug 22 06:40:41 EDT 2012;Committer;nobu;1;2;2;4;0
d5697825ef949712143325045b46fc8fe9aba507;Wed Aug 22 06:28:51 EDT 2012;Committer;ko1;2;10;4;14;0
d28e07d57bc15a4baf08f8f4fb64d27cf927aac7;Wed Aug 22 05:12:31 EDT 2012;Committer;ko1;5;658;50;708;0
22a173df3f462244103a02261c276eeee8926863;Wed Aug 22 02:38:55 EDT 2012;Committer;shyouhei;2;6;2;8;0
bf797ed9b094289d79b485fd3794cb40acb368b0;Wed Aug 22 02:25:16 EDT 2012;Committer;shugo;3;29;1;30;0
7a69af746135a2ecfc21cf717c4a4b217283ca15;Wed Aug 22 02:22:03 EDT 2012;Committer;naruse;3;9;7;16;0
1497959ef5b69c9680931237c7558010130de166;Wed Aug 22 01:14:14 EDT 2012;Committer;yugui;2;9;2;11;0
0d05a79bca35101e4adc4bcdeb07ecaacd9336d5;Wed Aug 22 01:12:52 EDT 2012;Committer;yugui;2;7;0;7;0
e782fb8eea88f9e36bd9efaa91c4613084a0105e;Wed Aug 22 01:11:30 EDT 2012;Committer;yugui;4;14;3;17;0
bbb6b5e84e53b17c5c08072cae05aed6de6e3abe;Tue Aug 21 22:30:47 EDT 2012;Committer;naruse;4;9;5;14;0
b0837c440eef2199eb1ef58f92b18cf0b5910d01;Tue Aug 21 22:30:43 EDT 2012;Committer;naruse;3;9;2;11;0
8de500cefca5e021f9fc792badddfddf48b1b409;Tue Aug 21 16:49:00 EDT 2012;Committer;nobu;1;1;1;2;0
3d23725ab9b0a01e747b78c46473c3bfa3ff31dd;Tue Aug 21 16:40:02 EDT 2012;Committer;nobu;1;1;1;2;0
2ed9b46b4f2dee7be51554d42745a74fa3fdf739;Tue Aug 21 16:18:10 EDT 2012;Committer;nobu;1;12;12;24;0
e32dd8b391fd4dffc824088afb6afea4b30bb2ad;Tue Aug 21 16:18:06 EDT 2012;Committer;svn;1;2;2;4;0
5eb9453fc3e2c22e72dda7624dedbee1e62afe9f;Tue Aug 21 16:18:05 EDT 2012;Committer;nobu;1;5;5;10;0
404cc1ae3ff26f045d5d6d7354406e167d1ea10b;Tue Aug 21 16:18:02 EDT 2012;Committer;nobu;1;3;6;9;0
b78fdf1a82347a0cc0ffda73cf4c7ef032ff6ea3;Tue Aug 21 13:32:13 EDT 2012;Committer;nobu;1;3;1;4;0
75e2a26b84e66496644a1a3c32067a7e17f1c7ae;Tue Aug 21 13:03:30 EDT 2012;Committer;ayumin;2;6;1;7;0
d4c84d175eb28d7c44a189f4fce6f23799465976;Tue Aug 21 11:32:18 EDT 2012;Committer;eregon;2;7;2;9;0
9bae83f89fa644d1572d2ce7dfd67170bf6ce3c2;Tue Aug 21 08:32:01 EDT 2012;Committer;usa;2;13;3;16;0
4259d2358860aefb7b2ef0c970ffbe41a168420b;Tue Aug 21 08:10:37 EDT 2012;Committer;shyouhei;2;59;5;64;0
3401fc59849c789df3893e514939f63ad0f2f26e;Tue Aug 21 06:53:40 EDT 2012;Committer;usa;2;9;1;10;0
68c09dec0ec57a7e620d42aceac2fdf8a952d53d;Tue Aug 21 05:29:42 EDT 2012;Committer;usa;2;4;2;6;0
3eb71e222112bce0e10a85263c63280985b269d3;Tue Aug 21 05:00:33 EDT 2012;Committer;nobu;1;2;4;6;0
d059d718b505bacbf7af6e9c473eb95391d481d0;Tue Aug 21 04:50:18 EDT 2012;Committer;nobu;24;45;45;90;0
9bb6a05283ce7f3deb57c707b16c60b43abd3e97;Tue Aug 21 01:57:19 EDT 2012;Committer;usa;3;19;1;20;0
dc78d90ad173936123d221aa7beba9acbb96e4c9;Tue Aug 21 01:41:07 EDT 2012;Committer;ko1;2;6;1;7;0
17dde49326abb035ef14cd4be8b33337c6248e82;Tue Aug 21 00:39:57 EDT 2012;Committer;ryan;7;336;420;756;0
ba661182a40a486f089e63889897ab98d9db85b5;Tue Aug 21 00:07:32 EDT 2012;Committer;usa;3;19;5;24;0
c50c1a0064ac9757fabf80ba16b324f5950af2c4;Tue Aug 21 00:05:29 EDT 2012;Committer;usa;1;7;7;14;0
ed720d55054c1c7167cd3da97b683e868351f9b8;Mon Aug 20 23:59:35 EDT 2012;Committer;ryan;1;2;1;3;0
3c3e659196b7511f02b03e2904c40a29993a184c;Mon Aug 20 20:52:36 EDT 2012;Committer;jeg2;3;66;3;69;0
6ac1d39acec4ccb01cca219e30d2ba4b3547a9e3;Mon Aug 20 20:26:06 EDT 2012;Committer;drbrain;2;9;4;13;0
edd67a6844b25ba5031be59daecd0aef0b8e954b;Mon Aug 20 20:19:25 EDT 2012;Committer;svn;1;2;2;4;0
decaaf845e78df6e3d888cf340a459a4a1984abe;Mon Aug 20 20:19:21 EDT 2012;Committer;drbrain;2;17;11;28;0
dde9f6958d169fe8d4f7f4c6cbc1e2e7f80a8683;Mon Aug 20 14:06:52 EDT 2012;Committer;nobu;1;1;1;2;0
89bcc681f076d46604bc706325155a676010ff0b;Mon Aug 20 14:02:32 EDT 2012;Committer;nobu;3;38;28;66;0
f4bc341b0083c2b59894c7f3b4af1bbf2af27cd9;Mon Aug 20 11:38:19 EDT 2012;Committer;nobu;1;0;8;8;0
ceece4650a1de6189f2705cbf8120f6679a1af8f;Mon Aug 20 11:36:34 EDT 2012;Committer;nobu;9;103;23;126;0
de83cb9b20f2fa6ee6bace04ff29462cedd02a6d;Mon Aug 20 07:31:48 EDT 2012;Committer;nobu;1;1;1;2;0
73eda1735f0d7d4c0e214cfd998ad01c2830ea64;Mon Aug 20 02:46:33 EDT 2012;Committer;kazu;2;6;0;6;0
e107833cb25381b09dc14eadd5db9a8ca1473208;Mon Aug 20 02:46:30 EDT 2012;Committer;kazu;1;1;1;2;0
1f07c9ab98bdb76373f8b4c236dc8d991aa61ca9;Mon Aug 20 02:07:28 EDT 2012;Committer;svn;1;2;2;4;0
5f4b7f5afa7fb91d93192f32e6eaf0e4e2a95870;Mon Aug 20 02:07:24 EDT 2012;Committer;sorah;3;11;6;17;0
8198cca945dba5bf43cd6bbca0d13add003f223d;Sat Aug 18 16:28:42 EDT 2012;Committer;ayumin;2;26;22;48;0
6a298a847edc3db84411ff41c4ca7682b7cea272;Sat Aug 18 15:55:20 EDT 2012;Committer;svn;1;2;2;4;0
6eb316780f49797a62cf1ee862168b91a913ea38;Sat Aug 18 15:55:15 EDT 2012;Committer;ayumin;2;6;1;7;0
504dece4ea471b99f0b7d191c468e2304fbd2b1e;Sat Aug 18 00:57:53 EDT 2012;Committer;svn;1;2;2;4;0
e6de05d7c45ae256195bc0648605d0017bc7ee76;Sat Aug 18 00:57:48 EDT 2012;Committer;nobu;2;7;1;8;0
cedb0db802c3bde6864beedcf13da60b49810e21;Fri Aug 17 14:52:37 EDT 2012;Committer;nobu;1;3;3;6;0
b421bd0e12fd8cb98e9ae4320c8db22454934324;Fri Aug 17 14:29:00 EDT 2012;Committer;nobu;3;35;5;40;0
f7c2791c6092728077777cd6ffbc3476e5a11a42;Fri Aug 17 08:35:12 EDT 2012;Committer;nobu;2;26;17;43;0
200cea63268d934e88d8b42a95e2f1172bf1b605;Fri Aug 17 08:35:08 EDT 2012;Committer;nobu;1;2;4;6;0
9e1b74ff5b5ff6c1550ea1154daf206142e279b8;Fri Aug 17 06:36:53 EDT 2012;Committer;nobu;2;1;3;4;0
42dc1e5ef8f8c003ef0cb5b78102044d2e800c44;Fri Aug 17 04:12:12 EDT 2012;Committer;nobu;3;5;9;14;0
4a097d2e3e37e66f0cac4db3d4916d673fcb0129;Fri Aug 17 03:42:19 EDT 2012;Committer;usa;2;9;0;9;0
211525d7102a562bb14259dbf11602021a09306c;Fri Aug 17 02:13:36 EDT 2012;Committer;svn;1;2;2;4;0
78f8ad683be65653d14b970674c5079b6f512cc6;Fri Aug 17 02:13:31 EDT 2012;Committer;nobu;1;1;5;6;0
4a4a702e61d1c5585d522f1185a82a5685c554f6;Thu Aug 16 11:41:24 EDT 2012;Committer;ko1;10;335;329;664;0
9528358120511f0587be39c853f5916cf8d05a9d;Thu Aug 16 10:15:28 EDT 2012;Committer;nobu;3;11;0;11;0
a39b94d3022e37f4a5c3ce7cd112ac01f6e2ceec;Thu Aug 16 05:33:03 EDT 2012;Committer;nobu;1;1;1;2;0
f230b1ec985696164b208e4e42687e572b82e5c1;Thu Aug 16 02:52:09 EDT 2012;Committer;nobu;2;13;11;24;0
5225cc16feaad1dced9a3056160f01c13f51abb6;Thu Aug 16 00:46:16 EDT 2012;Committer;svn;1;2;2;4;0
31bea5d436dc36b1af96acef2329e4790dcabd20;Thu Aug 16 00:46:12 EDT 2012;Committer;nobu;3;15;47;62;0
fd7dc23d281f38a71fa7f9c32812cd468c4b1788;Wed Aug 15 11:50:01 EDT 2012;Committer;eregon;12;72;39;111;0
e272790d1103d12afc98feac8e441fb66147836b;Wed Aug 15 09:08:09 EDT 2012;Committer;usa;2;9;1;10;0
665b06ec5bf747c13ff7c5fa9b003d5ca2540709;Wed Aug 15 07:26:55 EDT 2012;Committer;nobu;3;24;4;28;0
bb545e213146685e0cdddb064ecc3b22139e01f9;Wed Aug 15 07:23:38 EDT 2012;Committer;nobu;3;19;0;19;0
e7878d20822cf00556c5ab02d0eb0cfe1a76cb93;Wed Aug 15 07:20:12 EDT 2012;Committer;nobu;2;14;5;19;0
8eb93103e4651aa9d6ed147208f6d90b211e9bfa;Wed Aug 15 04:39:10 EDT 2012;Committer;ko1;5;612;555;1167;0
d2e9b54564fedd9ee4fff18c2a7f1df2d6dcdd93;Wed Aug 15 01:09:16 EDT 2012;Committer;svn;1;2;2;4;0
780e7d0951aefa64264e21d15d8deefeded6465f;Wed Aug 15 01:09:10 EDT 2012;Committer;naruse;10;37;67;104;0
e1aa72d44104297b51d0fd05dfb5858f3ccd8522;Tue Aug 14 10:21:04 EDT 2012;Committer;eregon;3;9;11;20;0
795c29dcda01fa81a3ccebee4433adabe6778d76;Tue Aug 14 10:20:44 EDT 2012;Committer;eregon;8;58;26;84;0
f42a7c09513b5f73e21e6fae881f3bc2f760b9af;Tue Aug 14 07:28:43 EDT 2012;Committer;shugo;2;8;0;8;0
a2884195e7461ce42ad19e52a1cdd55ac9e3f315;Tue Aug 14 07:28:41 EDT 2012;Committer;shugo;1;1;1;2;0
cb4e2b590eff76446023ce2305d82b9487df64ae;Tue Aug 14 07:05:12 EDT 2012;Committer;usa;2;13;1;14;0
104b5c7810b95741e45b5e01f7c557c96799c13e;Tue Aug 14 07:03:18 EDT 2012;Committer;usa;2;19;0;19;0
b3a4461df2c78b4828cf344789b80e3c3ebedd14;Tue Aug 14 06:52:41 EDT 2012;Committer;naruse;6;21;14;35;0
9933a6019f8e867a546723e983e0a50593d35cbd;Tue Aug 14 06:39:46 EDT 2012;Committer;usa;2;13;0;13;0
745ada86498cd80cf93610dd8d6d6b95f61ac327;Tue Aug 14 03:03:42 EDT 2012;Committer;xibbar;3;3;3;6;0
7fc28975bc3bd03c2c776a9df5b1f9e89bff0f08;Tue Aug 14 02:01:10 EDT 2012;Committer;svn;1;2;2;4;0
e9969414bbf3a3c386d2c3f56fea33eb7f5d67a7;Tue Aug 14 02:01:05 EDT 2012;Committer;naruse;2;6;1;7;0
4e75451a163bb439b6f5c92abe97338143a2ce16;Mon Aug 13 06:39:40 EDT 2012;Committer;shugo;1;1;1;2;0
eac25eed592cba18a170c2e48eb36cfc6684fb8b;Mon Aug 13 04:17:05 EDT 2012;Committer;svn;1;2;2;4;0
4093598bf6eca8fce16fcb8695c4717063a5f6a0;Mon Aug 13 04:17:00 EDT 2012;Committer;shugo;3;18;1;19;0
9564e9bd235c2c0b2bccda1849bba9c40b508c3e;Sun Aug 12 03:04:42 EDT 2012;Committer;ktsj;5;41;1;42;0
00468f21099d329de7a6665928f293f80632400f;Sat Aug 11 15:45:58 EDT 2012;Committer;svn;1;2;2;4;0
99556813791b2ca6b100c5be3550d6f690efae03;Sat Aug 11 15:45:54 EDT 2012;Committer;eregon;1;2;2;4;0
50d8501431abd88bba6ecc7ac87b9f76be12d73c;Sat Aug 11 08:02:47 EDT 2012;Committer;svn;1;2;2;4;0
66a40eccf474d024e956794ed037f691644eaa91;Sat Aug 11 08:02:43 EDT 2012;Committer;kazu;1;1;1;2;0
ccf911a02d35bf1d1667149d94b16da429049eee;Fri Aug 10 10:53:18 EDT 2012;Committer;naruse;1;24;6;30;0
89c88eb5a9318f763779968e4c80214319ecb870;Fri Aug 10 05:25:08 EDT 2012;Committer;naruse;1;4;4;8;0
7391ae231a3ab09b123044648c9453df4a3dc808;Fri Aug 10 05:25:04 EDT 2012;Committer;naruse;1;3;3;6;0
33a63355a7dd650940ce24f85f2f1f685d05689a;Thu Aug 09 23:42:01 EDT 2012;Committer;drbrain;2;11;6;17;0
bb979b86f8da41cf3144e40f2e3e5efda984b08f;Thu Aug 09 15:46:27 EDT 2012;Committer;nobu;1;1;1;2;0
773c7e949887aed1cddade4060bddee87e0a7f5c;Thu Aug 09 15:16:43 EDT 2012;Committer;svn;1;2;2;4;0
54f5d4ecab4b321c8668a8dc8c39b523c0efa31f;Thu Aug 09 15:16:37 EDT 2012;Committer;kazu;1;1;2;3;0
402edc568ac69051f4fc28bf1e4553d4afdbbf02;Thu Aug 09 14:46:53 EDT 2012;Committer;nobu;2;5;2;7;0
50f3d3feb545b750e06bb267b651cd12dfa1f1ce;Thu Aug 09 14:46:48 EDT 2012;Committer;nobu;2;4;2;6;0
1fcc1762ad0fa839bd4609371714d60e2aecbcbf;Thu Aug 09 14:46:44 EDT 2012;Committer;nobu;2;8;3;11;0
2b648fb7c490d9ebe46ff4b015bdd3632c3d7ca6;Thu Aug 09 14:37:55 EDT 2012;Committer;nagachika;1;1;1;2;0
dcd7f09be26dd85247f58354709e50e97b9c2291;Thu Aug 09 11:34:48 EDT 2012;Committer;shirosaki;3;60;16;76;0
0e92dc4b729970112e8205fa1dd55b17af38d27a;Thu Aug 09 09:33:49 EDT 2012;Committer;nobu;2;10;3;13;0
f207f7793da422b0a5fec771c5413fb9bd5b2bc0;Thu Aug 09 03:42:00 EDT 2012;Committer;kosaki;2;7;0;7;0
507dc62a34441cb9b016ce48e8181e9305559c27;Wed Aug 08 17:03:29 EDT 2012;Committer;svn;1;2;2;4;0
b2fbb39a4a35538f276432da6a7ee7267292bf03;Wed Aug 08 17:03:21 EDT 2012;Committer;kazu;1;1;1;2;0
393ed5c9504e688d3822d79f09d20da7f7195595;Wed Aug 08 13:51:32 EDT 2012;Committer;nobu;3;18;1;19;0
6b4ecb32fbaf41a97be27bf20781b5fdc38d7485;Wed Aug 08 13:46:09 EDT 2012;Committer;nobu;4;62;62;124;0
22e145141bcd98ab68ff57e9cd991796227b534f;Wed Aug 08 13:45:41 EDT 2012;Committer;nobu;2;14;2;16;0
dcfaf3e277fcadda493757e69b89e3260cd3636f;Wed Aug 08 08:12:24 EDT 2012;Committer;ko1;2;7;5;12;0
e2f5d4f9c780cf1c1ecf57f8265ef916f973dc1e;Wed Aug 08 08:11:12 EDT 2012;Committer;ko1;2;5;0;5;0
93b6f8d6195564d0884ee00f536a951f4c26288c;Wed Aug 08 07:52:19 EDT 2012;Committer;ko1;8;132;55;187;0
8637eac4066dedd2c716f385e22a9d31100b68c7;Tue Aug 07 20:51:51 EDT 2012;Committer;svn;1;2;2;4;0
292a319608bbd760a9eec9f8072c0cb9a970eb90;Tue Aug 07 20:51:48 EDT 2012;Committer;drbrain;2;19;2;21;0
a996b48515f67c8ccb7594d96a22a248a2461650;Tue Aug 07 11:22:04 EDT 2012;Committer;naruse;2;9;0;9;0
0d1a905edb43fe9260302b286d04cec66f7c4416;Tue Aug 07 11:13:57 EDT 2012;Committer;ko1;6;42;18;60;0
fca3c408a72cc11bb065bf253bfe00dde4f92b9e;Tue Aug 07 02:59:04 EDT 2012;Committer;usa;2;17;0;17;0
0f24f944705a3899f57f4c36f0a74d9438a09359;Tue Aug 07 02:44:24 EDT 2012;Committer;shugo;3;32;2;34;0
b361d7d0820592d0cdb2c72a257be0a29c04a4ef;Tue Aug 07 01:48:36 EDT 2012;Committer;usa;2;13;1;14;0
ac37fc37b1a8cb4d40b56885d7ebaee7e6538fdc;Tue Aug 07 00:43:44 EDT 2012;Committer;tenderlove;1;7;0;7;0
28827e61d153e39ad3fe1e6fecbf27c09140fe75;Mon Aug 06 15:31:13 EDT 2012;Committer;nobu;6;61;23;84;0
353833c466f30accbc96c5121d2b9487db411e2a;Mon Aug 06 15:24:09 EDT 2012;Committer;svn;1;2;2;4;0
6f677a5e0042442a6c70a8bcb003f702f4222e58;Mon Aug 06 15:24:01 EDT 2012;Committer;nobu;2;32;21;53;0
745de093dbe5d110e6cc7e5ab05e619f0f41b764;Mon Aug 06 13:06:37 EDT 2012;Committer;nobu;1;26;4;30;0
ddabdd44271e9e693232143e5ef84da74f470e7c;Mon Aug 06 13:06:16 EDT 2012;Committer;nobu;1;17;17;34;0
281e4b611f68cb5d0d6e42fa50cb491a5b54a832;Mon Aug 06 12:18:10 EDT 2012;Committer;nobu;1;3;5;8;0
906b2110d91a8e7c2319d8d4aa5fa797919fecf2;Mon Aug 06 10:21:12 EDT 2012;Committer;suke;2;21;11;32;0
9537e8ffe5b7a0e6a2a791e1886509dc98b6d3f9;Mon Aug 06 07:00:19 EDT 2012;Committer;shugo;6;110;4;114;0
3dd941b234ab6df52f72bb32e401f6669ef972c7;Mon Aug 06 05:55:19 EDT 2012;Committer;shugo;4;27;23;50;0
d93d45fea7598dccab03447a19988a05e6c55ae0;Mon Aug 06 04:14:00 EDT 2012;Committer;nobu;2;4;5;9;0
cc48423ead1d9e4b46dfeca7a45437793fc29521;Mon Aug 06 02:34:36 EDT 2012;Committer;nobu;3;24;1;25;0
7c5336b8f9f2e012194aed09658fdbeb3d6fe3de;Mon Aug 06 02:20:47 EDT 2012;Committer;usa;2;5;1;6;0
e7c6f87c89061b635a8a96dac17ccfa5f360afa9;Mon Aug 06 02:11:58 EDT 2012;Committer;usa;1;1;1;2;0
404bb0efce9ba520881f39ee72cac09b5dd6c2cc;Mon Aug 06 02:09:33 EDT 2012;Committer;usa;2;11;2;13;0
13527efd592483678b0738a2c7d6fb82c3f33150;Sun Aug 05 15:40:56 EDT 2012;Committer;nobu;2;5;1;6;0
d97cd39f42f1aebfab4e98fb78ea915bf448546b;Sun Aug 05 15:40:06 EDT 2012;Committer;nobu;1;2;0;2;0
95512f277788ec12b4d368e337dc7397944e1183;Sun Aug 05 15:39:26 EDT 2012;Committer;nobu;2;14;2;16;0
306a16d20126d1ec6e9d06f508aa95dd32ebe086;Sun Aug 05 15:39:00 EDT 2012;Committer;svn;1;2;2;4;0
09288de5dfec5deb9749c8551fbf502cee9d62cf;Sun Aug 05 15:38:55 EDT 2012;Committer;nobu;2;5;1;6;0
cf4aa712e4124862bf453f1ffc1e8ae432efb1f9;Sun Aug 05 12:17:33 EDT 2012;Committer;nari;1;1;1;2;0
8f1c81c610eb11b74f52fa1ae0a6b704ebced43e;Sun Aug 05 12:12:45 EDT 2012;Committer;nari;2;6;3;9;0
dd124a0f841f2e25daa4f4e3c9854618176a7743;Sun Aug 05 10:39:37 EDT 2012;Committer;nari;2;2563;2532;5095;0
800d9a7ac1abc61346c2006e7d7ac284ed3635a9;Sun Aug 05 05:14:35 EDT 2012;Committer;nobu;1;12;5;17;0
e57da6109cd7edc540245a387fbf71429a0fffda;Sun Aug 05 04:26:24 EDT 2012;Committer;naruse;2;6;1;7;0
949d740a323366997b410fba4681bb4e549e4240;Sat Aug 04 22:07:42 EDT 2012;Committer;tadf;1;0;2;2;0
a2c5d1557288eeaedffd55147511dfd023e37b12;Sat Aug 04 22:04:20 EDT 2012;Committer;tadf;1;1;1;2;0
7f13c5e42e328d5e1676128c616353e438a5acee;Sat Aug 04 21:59:38 EDT 2012;Committer;svn;1;2;2;4;0
ab67ba64ca4729725ae57ed4eda232851674e645;Sat Aug 04 21:57:48 EDT 2012;Committer;tadf;3;7;3;10;0
de0c788bb4d337d3bc2bb3f6fcac4b26cdccb8b8;Sat Aug 04 14:12:12 EDT 2012;Committer;nari;2;274;176;450;0
d7a33316825d3393f1f7e50ab76926b6891b5a89;Sat Aug 04 11:40:59 EDT 2012;Committer;nari;2;6;5;11;0
cd060b4588b80786f921ab8d8e80efc143dce5fe;Sat Aug 04 01:04:05 EDT 2012;Committer;shugo;2;30;0;30;0
260d02d91d769f4ef3075e9248e1aae73e22a22b;Fri Aug 03 16:56:08 EDT 2012;Committer;nobu;4;14;26;40;0
e421410edce497599d3cdf75d2dff90991b9ceba;Fri Aug 03 16:54:19 EDT 2012;Committer;nobu;1;1;1;2;0
2e2245bf181e9511d1c8e448dcd52c0ddce0bece;Fri Aug 03 16:32:59 EDT 2012;Committer;svn;1;2;2;4;0
9bef3f051990afb7a437ddc120bbeaaabcc573e2;Fri Aug 03 16:32:52 EDT 2012;Committer;shugo;3;48;2;50;0
2d3d84155d6c114a0f76888a8e2779e887722788;Fri Aug 03 10:27:21 EDT 2012;Committer;shugo;3;35;6;41;0
bea3f0df108ad4a983843eae83231cca2843b30d;Fri Aug 03 10:21:22 EDT 2012;Committer;nobu;2;10;4;14;0
a713b37640079e1f54fcb199541d64387a8ab016;Fri Aug 03 08:27:04 EDT 2012;Committer;naruse;2;11;3;14;0
7ed6c4eec87d0a9b11700acb0bd98c9f27e86119;Fri Aug 03 08:23:18 EDT 2012;Committer;nobu;1;5;5;10;0
a580c01dc0b40a4c69d016113f2761e6e88de924;Fri Aug 03 08:22:45 EDT 2012;Committer;nobu;1;3;2;5;0
5b657b5dcb70581778d7c0a9598bbf08e10e7002;Fri Aug 03 08:21:55 EDT 2012;Committer;nobu;2;6;0;6;0
b2acc2d501d1459d0da5fe185b5e7ed75fde7bbb;Fri Aug 03 07:46:31 EDT 2012;Committer;kazu;1;1;1;2;0
bb9fface13e2bbf12ec77f1093c121f86878d5e5;Fri Aug 03 07:41:18 EDT 2012;Committer;shyouhei;2;12;0;12;0
e07bdafbf4c3ef5e96ab026490302a2dd090572e;Fri Aug 03 07:25:55 EDT 2012;Committer;naruse;2;1;6;7;0
77ef86feaa7218500435c0851701e8a4688fa82a;Fri Aug 03 06:21:16 EDT 2012;Committer;naruse;2;6;1;7;0
e25baf1d6264d07f8c313b3982f2249bf436e94e;Thu Aug 02 18:45:26 EDT 2012;Committer;svn;1;2;2;4;0
0357f6775a61fce1affbdbf3f50262a805d1537a;Thu Aug 02 18:45:22 EDT 2012;Committer;kazu;1;1;1;2;0
ede1223028fed7c8a754ff63acdc6d70ce492565;Thu Aug 02 14:38:48 EDT 2012;Committer;ktsj;1;3;1;4;0
9dc1a421cc7a26b8b7a58f03036bb4f3e5f102dd;Thu Aug 02 13:57:19 EDT 2012;Committer;ktsj;1;1;1;2;0
2af6b06f9de995ee763b142e48c7605ec9e9b9ca;Thu Aug 02 12:52:50 EDT 2012;Committer;nobu;1;1;1;2;0
19ddfc2483bb82cfb241a58d4b25956f7b79d1ad;Thu Aug 02 11:34:19 EDT 2012;Committer;shugo;19;699;55;754;0
319088e9c7ae9836efd242592ea80c9794a45002;Thu Aug 02 11:08:44 EDT 2012;Committer;shugo;11;175;102;277;0
14bf66f25210248334f4730784ad00c18b7d651e;Thu Aug 02 04:24:13 EDT 2012;Committer;naruse;2;8;1;9;0
b79bf14ff26e11765c1605c7da9a3e72902c92d8;Thu Aug 02 02:47:12 EDT 2012;Committer;nari;3;16;1;17;0
df05bd2c82386e5897c4125576199e18a13712a1;Thu Aug 02 01:58:49 EDT 2012;Committer;emboss;3;32;0;32;0
cc59a581f1db0ffc6e8cac93cae50202e1ab81a8;Wed Aug 01 22:29:58 EDT 2012;Committer;nobu;1;1;1;2;0
5a832e1da3b07babffd8f23c400a6acef15bbd7b;Wed Aug 01 22:29:31 EDT 2012;Committer;svn;1;2;2;4;0
d28d075cc1a2907e2b9db0d37b52b1711c9097c3;Wed Aug 01 22:29:26 EDT 2012;Committer;nobu;3;21;15;36;0
61b624d149204c2b1c17a2852d088b2eb2aa010b;Wed Aug 01 13:30:51 EDT 2012;Committer;eregon;4;18;4;22;0
f52eefece1c24503c607be7b059fe82639f128f7;Tue Jul 31 20:58:08 EDT 2012;Committer;shirosaki;2;19;3;22;0
59c139306dc6d28d3f150743560ffda176191a58;Tue Jul 31 15:33:30 EDT 2012;Committer;svn;1;3;3;6;0
b283d01987291f92540e60a5887197b0945e3a84;Tue Jul 31 15:33:23 EDT 2012;Committer;nobu;3;16;1;17;0
bc08bdc013e82df978d72a1f9337fe47f5031e56;Tue Jul 31 09:22:36 EDT 2012;Committer;nobu;2;49;15;64;0
30d957fc612a51fab686af5c6c0dfb58b5e100a1;Tue Jul 31 01:37:06 EDT 2012;Committer;tenderlove;3;9;3;12;0
c7c4e87a409d401724be69de97c950e95409a97b;Tue Jul 31 00:45:57 EDT 2012;Committer;nobu;1;2;2;4;0
d604ac3f1d4c39ae11dde11d697335ababcfd01d;Mon Jul 30 21:18:53 EDT 2012;Committer;svn;1;2;2;4;0
b773a4f803c313db17a3b04e096448f1295195c0;Mon Jul 30 21:18:29 EDT 2012;Committer;drbrain;2;10;5;15;0
0357ac8a38a710a6b64bd8b2bb38f8ba91545eea;Mon Jul 30 14:04:48 EDT 2012;Committer;naruse;3;8;2;10;0
e62ee61262ec101b0456a17bb4ae71471ef8d91c;Mon Jul 30 14:04:44 EDT 2012;Committer;naruse;1;1;1;2;0
0e15934d7fe0244573526f5ff3c6232bb3de2662;Mon Jul 30 12:00:56 EDT 2012;Committer;nobu;3;33;15;48;0
e652ecfac71f0daf752e529dca6a9a0a444e26b3;Mon Jul 30 06:03:15 EDT 2012;Committer;naruse;1;4;4;8;0
787e40097bc59dbccd8a23f04f07de4965bc1b62;Mon Jul 30 05:56:51 EDT 2012;Committer;naruse;1;1;1;2;0
83940fc310d45010fe452fcf4f6ffbaba0c3f5d6;Mon Jul 30 05:24:24 EDT 2012;Committer;nobu;3;61;11;72;0
48d7aa4ae93265cef0d824abe7815befdb47235e;Mon Jul 30 04:11:56 EDT 2012;Committer;nobu;2;5;2;7;0
a18558140a9476d625bf12ed1df56467f971f25e;Mon Jul 30 04:11:21 EDT 2012;Committer;nobu;2;13;3;16;0
8800a83f85327c158b79eb377723d207207f6522;Sun Jul 29 16:31:15 EDT 2012;Committer;nagachika;2;5;1;6;0
9cdf55485ac9783b43975d1fa68f92ebfa6bbdcc;Sun Jul 29 16:00:36 EDT 2012;Committer;nagachika;2;6;0;6;0
b521dcb92d776f9c0112438a58fd20171f257f0a;Sun Jul 29 15:25:34 EDT 2012;Committer;svn;1;2;2;4;0
240dd36ffb40c86b6d87d4608d514ca4c556e671;Sun Jul 29 15:25:29 EDT 2012;Committer;nobu;1;1;1;2;0
dc40114781a776f95ac85e0e9d4cf79b030aada6;Sun Jul 29 14:57:30 EDT 2012;Committer;nobu;2;6;3;9;0
f9368f65b108264889d54855e687334f7e84f092;Sun Jul 29 14:56:52 EDT 2012;Committer;nobu;4;7;3;10;0
afde2e8d051c4bdfb62a5c31ad7c9425a4e5c4dc;Sun Jul 29 05:28:04 EDT 2012;Committer;ktsj;2;5;1;6;0
21aad667a56084896248918d18f6f8ed2a567753;Sat Jul 28 21:41:37 EDT 2012;Committer;shirosaki;2;10;6;16;0
208e8db622c9f30557bd28ac614274f81059605e;Sat Jul 28 17:04:58 EDT 2012;Committer;nobu;1;23;24;47;0
06fa39143e50450173efec850ed75bb4e3b98756;Sat Jul 28 15:34:49 EDT 2012;Committer;svn;1;2;2;4;0
631b6d5aaddf5eca047462113dafe1c8e3a78b14;Sat Jul 28 15:34:44 EDT 2012;Committer;nari;2;5;1;6;0
ce2a1e109c10d28f6f6908aff3a8b3209a77c5bb;Sat Jul 28 07:36:51 EDT 2012;Committer;shirosaki;2;23;3;26;0
c1ef657b39c153f49660c15f88c31645a710cb98;Sat Jul 28 02:15:48 EDT 2012;Committer;nobu;1;4;4;8;0
dc54eeccc83c8c8e868fe7a3c058cee80d3abb0c;Sat Jul 28 02:14:28 EDT 2012;Committer;svn;1;2;2;4;0
485181e4f714b12c4a6cea239d534da75454acdc;Sat Jul 28 02:14:23 EDT 2012;Committer;nobu;2;3;1;4;0
c05e6a8cda4701d995d8e4b2390ee2b88b51e6d6;Fri Jul 27 09:25:54 EDT 2012;Committer;nobu;5;27;2;29;0
a8aa1e2127e6329e2f632a2296d3f36f1c6de2ac;Fri Jul 27 08:58:15 EDT 2012;Committer;nobu;2;7;2;9;0
044aa29b7dbf395d90b27b97831e78df07a7f8aa;Fri Jul 27 08:09:03 EDT 2012;Committer;nobu;1;2;1;3;0
76ff1d90c809fe61616fac7ff26b3c98bdd49f3a;Fri Jul 27 08:07:21 EDT 2012;Committer;nobu;1;6;0;6;0
1d7ebc5c5ed3c9e11d297dc414bbaf4aafb4633d;Fri Jul 27 03:15:08 EDT 2012;Committer;svn;1;2;2;4;0
3f539a5b5966d00f28bbae2617c006d93b491d17;Fri Jul 27 03:14:49 EDT 2012;Committer;usa;2;8;2;10;0
9b16b7478a5e451f36d9be00977b3a16a3635b8e;Thu Jul 26 05:54:29 EDT 2012;Committer;shyouhei;2;7;0;7;0
22783fdbc5a5421b27a9707b9e681957f95aba67;Thu Jul 26 03:08:41 EDT 2012;Committer;nobu;2;11;2;13;0
48cb94779364a5f0e81fba0a702845a0ba5815d6;Wed Jul 25 22:26:41 EDT 2012;Committer;kanemoto;2;6;1;7;0
c08a213b9afd525931f5dd9963f88f93cc136f58;Wed Jul 25 16:40:09 EDT 2012;Committer;svn;1;2;2;4;0
ea637ebaa4491d50578002a9a7d26cf4f55c7a58;Wed Jul 25 16:40:04 EDT 2012;Committer;nagachika;2;10;3;13;0
003c45f9cd570335b7360241724b6967a8ab014a;Wed Jul 25 08:41:07 EDT 2012;Committer;nobu;5;80;35;115;0
681c1b9f1b86f2a1198229e40cfa64bbd52e02f9;Wed Jul 25 08:17:46 EDT 2012;Committer;nobu;1;24;5;29;0
ac64f196f814a30bbd8cc3de989240e1ebf3984d;Wed Jul 25 08:17:08 EDT 2012;Committer;nobu;2;25;19;44;0
61a67bc7200a5bf38ce77acc8fb11fa682bedbd8;Wed Jul 25 07:13:24 EDT 2012;Committer;naruse;1;3;0;3;0
131f694330d1d44add74643a264ff7c4d7f06216;Wed Jul 25 06:49:35 EDT 2012;Committer;naruse;6;35;29;64;0
c5581959992c3fd621b48f9fc506454993daf077;Wed Jul 25 04:12:44 EDT 2012;Committer;nobu;1;6;0;6;0
7edb26458688db159233895eba2ab0ac6c8dbb12;Wed Jul 25 02:20:07 EDT 2012;Committer;drbrain;2;5;8;13;0
970c5ac4ff3acf977a5dc6dea7beccbd5eef987c;Wed Jul 25 01:01:59 EDT 2012;Committer;usa;2;6;2;8;0
ba22341854a344727fe002c635594e1a8d40e217;Wed Jul 25 00:29:30 EDT 2012;Committer;naruse;2;22;16;38;0
347c554f7ee503f06b59dbe1bd3a6ae818a33efb;Wed Jul 25 00:19:09 EDT 2012;Committer;naruse;3;11;2;13;0
ead728ca7d7a42a3c1658d00102732947b514dea;Wed Jul 25 00:05:59 EDT 2012;Committer;drbrain;4;35;0;35;0
b8903f88f43b8dfa6e6bc0194182fffb83c07eb2;Tue Jul 24 21:54:50 EDT 2012;Committer;drbrain;2;7;3;10;0
a10f6137cc11598bab093ee694224cf4b5b15eb7;Tue Jul 24 21:49:31 EDT 2012;Committer;drbrain;2;14;7;21;0
ea6da56a655c115d82e04f42c6a74ab05d8e2721;Tue Jul 24 21:29:24 EDT 2012;Committer;drbrain;2;253;0;253;0
91bd6e711db3418baa287e936d4b0fac99927711;Tue Jul 24 18:10:35 EDT 2012;Committer;tenderlove;7;177;2;179;0
1a5773a8682e685c87652f02df167f697f9413f9;Tue Jul 24 15:12:30 EDT 2012;Committer;svn;1;2;2;4;0
4f8b1384df0009675263efeb56cb489b79addb14;Tue Jul 24 15:12:26 EDT 2012;Committer;shirosaki;2;21;0;21;0
0daf636e7a3bb46d42c26e90bc863682aff6c96c;Tue Jul 24 09:57:59 EDT 2012;Committer;naruse;1;1;3;4;0
cd1a6ab82bf4c7fd02701ba05272140fd2a670f5;Tue Jul 24 09:36:14 EDT 2012;Committer;nobu;1;1;1;2;0
756b6e661b7af89db464e369fca63237c7d65710;Tue Jul 24 08:47:51 EDT 2012;Committer;naruse;1;3;1;4;0
8122db83ce2110883ec7e50bcbecbaa16c342fd3;Tue Jul 24 06:05:29 EDT 2012;Committer;usa;2;44;11;55;0
7b8e78f74701a12aeab0de34a662d0a51610e722;Tue Jul 24 04:24:20 EDT 2012;Committer;nobu;2;3;4;7;0
2b4f1eed4ccd61708612e06b8476871066de4c0f;Tue Jul 24 03:36:29 EDT 2012;Committer;usa;2;8;2;10;0
989a6cb176522792198344fd041425e5891b2510;Tue Jul 24 03:32:55 EDT 2012;Committer;usa;2;5;1;6;0
3a4a494e024d010fb41e20d54d278ce37532db19;Tue Jul 24 03:14:31 EDT 2012;Committer;usa;2;17;11;28;0
040207ea01a0219d22b294e8c77faec5e235cb4a;Tue Jul 24 03:09:32 EDT 2012;Committer;naruse;1;13;3;16;0
f83a2eee050cc00872ccd4ba776e4d7902f85bca;Tue Jul 24 02:36:15 EDT 2012;Committer;usa;2;14;12;26;0
612ff592ffe01ec8305780f3aae08e01b41c6e04;Tue Jul 24 00:42:22 EDT 2012;Committer;naruse;1;2;2;4;0
505c4eae3220b3af74c91d8b6af0c3f2480fb85e;Tue Jul 24 00:31:31 EDT 2012;Committer;drbrain;4;24;6;30;0
c4348fcd7f6742337d8b2187d8c23182e5a6973d;Mon Jul 23 23:32:29 EDT 2012;Committer;luislavena;2;58;19;77;0
fa608f4af2468b97deef422c7c913c481968008a;Mon Jul 23 23:10:03 EDT 2012;Committer;luislavena;2;7;1;8;0
0d8bc52593328d3f9adaa67c79fdcff723534685;Mon Jul 23 22:23:41 EDT 2012;Committer;drbrain;2;11;4;15;0
00730b5e499fa4567263c618a58180a5ab1bff7f;Mon Jul 23 22:03:30 EDT 2012;Committer;drbrain;2;23;16;39;0
f6327e732fbc8c68dae163401d283924769dee8d;Mon Jul 23 21:37:39 EDT 2012;Committer;naruse;11;92;76;168;0
d1c42e4f341e063d3849a3a9e3622b7261735559;Mon Jul 23 19:04:19 EDT 2012;Committer;svn;1;2;2;4;0
787c12da0b76cc9b0bfce90229cb26cbf2594426;Mon Jul 23 19:04:15 EDT 2012;Committer;naruse;1;3;4;7;0
fbee46fe66a0a531ef834e823bd2e600fa3fa095;Mon Jul 23 14:58:42 EDT 2012;Committer;nobu;4;13;4;17;0
bec666ce78a897aab64649dcb31b2cf95637c860;Mon Jul 23 14:38:24 EDT 2012;Committer;kazu;1;1;1;2;0
ab63cdf1ab776ca7ff137c0969bef30965450566;Mon Jul 23 13:49:56 EDT 2012;Committer;akr;2;7;2;9;0
dafab791d56e25a02d58e0ddcfd969dabaf89014;Mon Jul 23 05:43:37 EDT 2012;Committer;nobu;2;7;1;8;0
aec333b7a2d11acc3345d7bfb31a813758bde34b;Sun Jul 22 23:11:05 EDT 2012;Committer;naruse;1;4;4;8;0
216b833003d60bb478d3e7292cafea5b36fd2174;Sun Jul 22 16:55:55 EDT 2012;Committer;kazu;2;13;0;13;0
89a030795a0ddadfdaabcd2f7a66b87eb92b8265;Sun Jul 22 16:50:49 EDT 2012;Committer;kazu;2;17;2;19;0
4ed06c9cb79b70da0b5a742cb789f4c22cd46d18;Sun Jul 22 16:48:49 EDT 2012;Committer;naruse;1;20;18;38;0
c7eb973984d71ae8dcb960e42134ee54a97c3a24;Sun Jul 22 16:09:03 EDT 2012;Committer;kazu;1;1;1;2;0
480d11390d59a643d299134fe40eb509c934fdb9;Sun Jul 22 15:04:19 EDT 2012;Committer;svn;1;2;2;4;0
ee755e2ce96c515336d65ea318692998fcf1547d;Sun Jul 22 15:04:11 EDT 2012;Committer;naruse;3;27;1;28;0
478d37da053f39608fa505991aa69bcff4ade998;Sat Jul 21 19:07:28 EDT 2012;Committer;naruse;2;9;6;15;0
e2f75afbfb5e6f156fad47b29979778dd4a47676;Sat Jul 21 15:51:14 EDT 2012;Committer;naruse;1;1;0;1;0
bae2c78f725c629bcae34d63da7fad10f31ad977;Sat Jul 21 15:45:14 EDT 2012;Committer;svn;1;2;2;4;0
07a6d0e9d112db7276492bcaf0856e04399232c1;Sat Jul 21 15:45:10 EDT 2012;Committer;naruse;3;54;11;65;0
36c45154d609e97f45ea1fca2477d9675f414616;Sat Jul 21 14:12:55 EDT 2012;Committer;nobu;2;6;0;6;0
d5a190c942ae29a6a5035bc095ed7ea37f563487;Sat Jul 21 06:14:24 EDT 2012;Committer;sorah;2;11;9;20;0
7773a911f5bd0b171ae0bc6c62dbf6ca58360776;Sat Jul 21 05:12:32 EDT 2012;Committer;sorah;4;44;0;44;0
c4827de949c6c1a940e1d3e48421397d01b0da8a;Fri Jul 20 23:41:51 EDT 2012;Committer;drbrain;2;17;9;26;0
e641eba963470607e6d08f55a24bbf72a0edea3b;Fri Jul 20 15:08:28 EDT 2012;Committer;svn;1;2;2;4;0
6dea097eb2e0017613dd6d5fe512d28cd3a1513c;Fri Jul 20 15:08:24 EDT 2012;Committer;kazu;1;4;4;8;0
1abd3d4e38fda91ebb19e3b169b3096f74c8b539;Fri Jul 20 08:20:56 EDT 2012;Committer;nobu;2;8;1;9;0
1ea6c81762ff15f5a4fc9c4e458a312492045c39;Fri Jul 20 07:27:28 EDT 2012;Committer;nobu;2;6;5;11;0
cfb55acaa7c5059020744429d54554f3c2eb691b;Fri Jul 20 07:09:22 EDT 2012;Committer;nobu;1;26;26;52;0
daf167644143fcfc69b3a30a30888bd360072cd0;Fri Jul 20 02:05:27 EDT 2012;Committer;drbrain;2;10;0;10;0
9416becda4592f7884460a054fe12b7761f6f055;Fri Jul 20 01:56:21 EDT 2012;Committer;drbrain;7;432;188;620;0
f35b1d0633a6423f1281fb3c2b29aa522090976f;Fri Jul 20 00:40:48 EDT 2012;Committer;drbrain;2;8;0;8;0
3efea48a70180aa981011a79d9a8d07d520f4321;Fri Jul 20 00:32:35 EDT 2012;Committer;drbrain;4;28;1;29;0
b1a0509b5465ce77f52e0384159237889a8d60ec;Thu Jul 19 22:43:38 EDT 2012;Committer;drbrain;8;387;45;432;0
ef19dcf96dd2e84c4fe0a46888a5afd0cd457f80;Thu Jul 19 18:43:29 EDT 2012;Committer;svn;1;2;2;4;0
7e9c25d0768f6bf897db31e2302ee573e3ef2350;Thu Jul 19 18:43:24 EDT 2012;Committer;naruse;2;6;2;8;0
f4a8db647ae66621f5d37402f5a11a3d57c69bb0;Thu Jul 19 14:19:40 EDT 2012;Committer;ko1;10;504;104;608;0
422e8d5adc3cf2d67b53cf9050c750eba7db3673;Thu Jul 19 13:47:08 EDT 2012;Committer;akr;2;352;319;671;0
f0810814bd9bbb4226ba55bb7e9e1f46d9fe2067;Thu Jul 19 12:21:49 EDT 2012;Committer;nobu;1;1;0;1;0
ff331d14420706de44204c046d6063b39a6ae88e;Thu Jul 19 12:14:30 EDT 2012;Committer;akr;1;20;1;21;0
1f03c90dbf40fdba75fdb150f6382f77efeda175;Thu Jul 19 06:41:47 EDT 2012;Committer;shugo;5;93;14;107;0
0e60c71038a754c0d1e06afd48c142a58240d275;Thu Jul 19 06:06:03 EDT 2012;Committer;nobu;1;46;46;92;0
f58feecd36f4f3e954038b8ff3c256b79f1a04f5;Thu Jul 19 06:05:58 EDT 2012;Committer;nobu;1;6;10;16;0
c5617b357ddfdaa9a05fce472c094a13ad58a470;Thu Jul 19 05:30:46 EDT 2012;Committer;nobu;3;12;7;19;0
2574b80d837d81406e9391617d579c94de9baec0;Thu Jul 19 05:20:08 EDT 2012;Committer;usa;2;6;0;6;0
5e7fa03bc0acf3c795d4dcc984ef62272e495736;Thu Jul 19 05:15:51 EDT 2012;Committer;nobu;3;4;7;11;0
b72fc0953792a71f34b0eb3bb266feccf9c94974;Thu Jul 19 04:29:14 EDT 2012;Committer;usa;2;5;2;7;0
8e66cbccb7e4ded8b492557bb049ebe9b9d7fb1c;Thu Jul 19 04:27:59 EDT 2012;Committer;usa;2;5;1;6;0
1ec93d92c7130f5b56fc87b2d811b42e1a26b6a2;Thu Jul 19 00:36:42 EDT 2012;Committer;tenderlove;4;62;8;70;0
ac80ad663ee907115bae310ae7f4d0bee6611f0a;Wed Jul 18 23:20:45 EDT 2012;Committer;akr;2;18;1;19;0
939b0e9c7db09921cea287846116ebc6684b4275;Wed Jul 18 22:39:28 EDT 2012;Committer;seki;2;10;0;10;0
7d4e7fe8341d6343cbd9650c6b41cf33c00e3a50;Wed Jul 18 18:48:14 EDT 2012;Committer;kosaki;2;8;0;8;0
0501be6f83945e11c975c5e482dd945ef373d3da;Wed Jul 18 16:59:01 EDT 2012;Committer;kosaki;2;6;1;7;0
da78490c807186230b9af22870ba91905820cc56;Wed Jul 18 16:48:54 EDT 2012;Committer;naruse;1;4;12;16;0
64b7aa9e2f17b2f226dd1759bc99e8c273120a8c;Wed Jul 18 15:23:40 EDT 2012;Committer;svn;1;2;2;4;0
c96b913ee017f68e32b68b3318cb27f68b3ce623;Wed Jul 18 15:23:35 EDT 2012;Committer;akr;1;1;0;1;0
c0087df04443e20ccd09cffe22d75774470f6853;Wed Jul 18 14:57:40 EDT 2012;Committer;nobu;3;11;0;11;0
68a01f9cdfa90dc0195b472c0ac49c8d6d8dfbad;Wed Jul 18 14:20:09 EDT 2012;Committer;nobu;1;2;1;3;0
7624e5d36c3b812dad23aba2eb470641c3c59ad8;Wed Jul 18 14:09:59 EDT 2012;Committer;naruse;3;8;2;10;0
5b7b60bb5954e73dada16bc6b342020878489bdc;Wed Jul 18 14:09:21 EDT 2012;Committer;akr;2;11;1;12;0
bc893dcf0753e5477170de2df476ed665f3e0b95;Wed Jul 18 13:43:22 EDT 2012;Committer;akr;2;16;0;16;0
d5e9b69629c9172c15944255e10c3390be0a48c1;Wed Jul 18 13:00:57 EDT 2012;Committer;akr;2;18;13;31;0
ea3edd2744f0e6b9ebf8e9ba112268fdd0883873;Wed Jul 18 12:07:19 EDT 2012;Committer;nobu;1;1;1;2;0
4db96fe42cbf48449ad9528624d5760d65f3e818;Wed Jul 18 10:42:40 EDT 2012;Committer;akr;2;13;0;13;0
0ff013398483fbb9507a661d02b9c5b64d9ed73c;Wed Jul 18 09:25:18 EDT 2012;Committer;nobu;1;2;2;4;0
6e018e3f492c791b725c9ee9d0b5fc023c88cd52;Wed Jul 18 08:45:29 EDT 2012;Committer;nobu;2;41;34;75;0
40ce1eb4035de0707549bcf2c7210b2ef11359ef;Wed Jul 18 08:41:01 EDT 2012;Committer;nobu;1;7;8;15;0
02f802f2cef1bdde8dae8cfe47a8ba06ea018491;Wed Jul 18 08:40:17 EDT 2012;Committer;nobu;2;6;8;14;0
f9c014d008e42eab79cffd6441147cbc95963cf5;Wed Jul 18 07:44:17 EDT 2012;Committer;nobu;2;8;10;18;0
5a03c2569046f9b3919429088f230b01e719360f;Wed Jul 18 07:17:43 EDT 2012;Committer;nobu;3;13;4;17;0
5d743d7662abaf99577d2d6dd4264ea02ba87087;Wed Jul 18 07:11:20 EDT 2012;Committer;shugo;2;6;1;7;0
bbaf9b28000d7e11d74c85a8312de856bef7ab21;Wed Jul 18 07:05:12 EDT 2012;Committer;shugo;3;31;1;32;0
e9a91d2c95dfe22ad0487952f7a1053ef9a5fd16;Wed Jul 18 06:47:43 EDT 2012;Committer;ko1;3;91;15;106;0
6684ade9a36f50f1e51709ff8b1c732a7be05dc2;Wed Jul 18 05:53:23 EDT 2012;Committer;nobu;3;14;4;18;0
eff4b2b2e11ec9f4ce0448af0308e29796a112b7;Wed Jul 18 05:47:48 EDT 2012;Committer;ko1;2;4;3;7;0
28144433b2f951279552b39bc358769a5267e26a;Wed Jul 18 05:46:40 EDT 2012;Committer;ko1;6;145;44;189;0
18c04b880a2ee244cf350ff88004e868d72836eb;Wed Jul 18 05:29:24 EDT 2012;Committer;shyouhei;2;57;50;107;0
8c36fc30c24bd34d2686e68fc6e1a5d6584bd248;Wed Jul 18 04:46:04 EDT 2012;Committer;shyouhei;3;12;3;15;0
39b33658e3764ee621a9c2c9cc003e21da4e327e;Wed Jul 18 03:56:58 EDT 2012;Committer;naruse;3;69;58;127;0
9844bc02a0004d6700b9daf88d089e0d9891fed6;Wed Jul 18 01:02:12 EDT 2012;Committer;drbrain;2;169;4;173;0
7a514fc6f190a1c935e1d63bd2cbd6af6764e627;Wed Jul 18 00:36:01 EDT 2012;Committer;usa;2;14;8;22;0
fe6aa0e16a900d09b6d7e4a832993932a7b602c4;Wed Jul 18 00:27:04 EDT 2012;Committer;drbrain;2;58;51;109;0
08f46f0818858bd58209d4766ea5a97266665b1d;Tue Jul 17 23:04:48 EDT 2012;Committer;xibbar;1;6;16;22;0
c47cca2f858f2665a6424e417745a9fd7e78003c;Tue Jul 17 23:04:46 EDT 2012;Committer;xibbar;3;19;3;22;0
ba2ed2edebb1d86bc23e84a1f5168cf3fba94f84;Tue Jul 17 19:07:15 EDT 2012;Committer;naruse;1;2;0;2;0
85dc1ab23b18ef7cb989eb4f4c704e8f8d30e12e;Tue Jul 17 18:08:40 EDT 2012;Committer;naruse;2;45;12;57;0
3d68a73687b1b64651fc814087ae928b42d48bf0;Tue Jul 17 16:13:13 EDT 2012;Committer;svn;1;2;2;4;0
b69f55a6733f6a70627d7ea809b8c9c026e7671b;Tue Jul 17 16:13:10 EDT 2012;Committer;ayumin;2;6;6;12;0
cb0d480532c416ca6db0ca4d0ec8c0461b58f84c;Tue Jul 17 13:17:49 EDT 2012;Committer;akr;2;9;1;10;0
da74f0f426072e97fee3494fbe9691e59bdf860b;Tue Jul 17 08:41:21 EDT 2012;Committer;naruse;1;6;4;10;0
c2bcae864e3d8ee4265d9b125f34af9236f5cea7;Tue Jul 17 07:47:52 EDT 2012;Committer;naruse;2;10;1;11;0
7d1f53e782b5340591c3788d369a2951e9707f9b;Mon Jul 16 19:00:59 EDT 2012;Committer;tenderlove;4;80;1;81;0
43395d53c9f9352f5fe9ed9a8ff443b62732f5f8;Mon Jul 16 15:28:34 EDT 2012;Committer;marcandre;3;9;18;27;0
1e18c8ebb2933da284af510d4a4ee523ff7e2445;Mon Jul 16 15:19:09 EDT 2012;Committer;svn;1;2;2;4;0
466f7f6c81fe36bed2c2359f0577c67492d82fd4;Mon Jul 16 15:19:03 EDT 2012;Committer;marcandre;3;18;9;27;0
fae19d62290763330d5b489dbc5d360c45be1ad7;Mon Jul 16 14:30:24 EDT 2012;Committer;akr;2;7;2;9;0
0e2aa330ec5e16b237127db46ebde4eacc84f8c5;Mon Jul 16 13:52:10 EDT 2012;Committer;akr;2;7;1;8;0
e985c49e64ab820b1386541646e9d59ad600106d;Mon Jul 16 13:08:04 EDT 2012;Committer;ayumin;2;6;1;7;0
04f09ef8a19663ec42158fda1c1b8332a8f0ce42;Mon Jul 16 10:39:42 EDT 2012;Committer;akr;4;46;3;49;0
858a832d40845a951e2cf01c0482e7d7014a8c81;Mon Jul 16 10:02:59 EDT 2012;Committer;akr;2;11;7;18;0
cf469774d1256ec25e1553e0153edb379b5abfb2;Mon Jul 16 09:41:25 EDT 2012;Committer;akr;4;25;17;42;0
94735e9e54b7a64af86adf36ad8a5b849f11a938;Mon Jul 16 09:08:58 EDT 2012;Committer;akr;3;83;1;84;0
984729ba3016a1fd4b371edef71fcb8b7f3956b4;Mon Jul 16 08:44:32 EDT 2012;Committer;akr;3;40;25;65;0
3fe481ae726a898b880a417d94185640ebcb6189;Mon Jul 16 08:15:12 EDT 2012;Committer;ayumin;1;1;1;2;0
d570a76cbabff8360b3df929e10967663982104b;Mon Jul 16 08:15:08 EDT 2012;Committer;ayumin;2;26;0;26;0
e6021a1be228d05ebd2657ff311664e542af5304;Mon Jul 16 08:15:05 EDT 2012;Committer;ayumin;2;6;3;9;0
8d0b1c25189fd0b52590b14c128999ebc650ac05;Mon Jul 16 06:38:28 EDT 2012;Committer;akr;2;5;8;13;0
6dd65bb3776eca2335e90ffd7a81b641d6404ce2;Mon Jul 16 06:02:21 EDT 2012;Committer;akr;4;60;34;94;0
06e9e202bdc6c66e5c54360876edb8c7be28eab5;Mon Jul 16 05:15:40 EDT 2012;Committer;svn;1;2;2;4;0
4cd00ffe2dd0255c13ce9b90d55a0c2583b5f87e;Mon Jul 16 05:15:36 EDT 2012;Committer;akr;2;29;13;42;0
051799b674580fb96b928d990045976e948f7151;Sat Jul 14 16:43:41 EDT 2012;Committer;svn;1;2;2;4;0
92bf85167ff6c1760fcaef7d262480fedd3cb43b;Sat Jul 14 16:43:35 EDT 2012;Committer;kazu;1;1;1;2;0
7a6542400dfce2ebb260da2c64cbb0e626b1243e;Sat Jul 14 09:18:51 EDT 2012;Committer;nobu;3;14;9;23;0
b0d53d51f5ce538095ffebaa0e8fd0552b5ebd75;Sat Jul 14 08:31:21 EDT 2012;Committer;ayumin;2;13;8;21;0
8d6add973ebcb3b4c1efbfaf07786550a3e219af;Sat Jul 14 08:08:15 EDT 2012;Committer;nobu;3;14;1;15;0
e81c1d53feb6c65b354c9a63b9da799ce4d82026;Sat Jul 14 07:29:53 EDT 2012;Committer;nobu;1;0;21;21;0
03e5fb6054fc0aacf1a0108652eb58e4a89f2c5d;Sat Jul 14 07:16:50 EDT 2012;Committer;nobu;2;5;7;12;0
cbbe2cbca473ef56e6ba4526c0f46c0d4acbcf39;Sat Jul 14 07:16:43 EDT 2012;Committer;nobu;2;51;64;115;0
688f2e1a893e04457a1a5aa3577b13f74b2bc080;Sat Jul 14 07:16:38 EDT 2012;Committer;nobu;2;39;29;68;0
4bbb49b8482003a131b4f3bcce8d17b63ce35943;Sat Jul 14 07:16:33 EDT 2012;Committer;nobu;2;11;4;15;0
4633ad5d0fdf060d7764812d81df9751c9fb9a4f;Sat Jul 14 07:16:29 EDT 2012;Committer;nobu;2;13;11;24;0
e9f68d7f69704558af0e0721f53c53687d5b187e;Sat Jul 14 07:16:24 EDT 2012;Committer;nobu;2;18;16;34;0
f09830603644e2c09a696b5c468b810b099f1896;Sat Jul 14 07:16:19 EDT 2012;Committer;nobu;2;20;15;35;0
b789a6b4d676975ed2092b8ed7903b87b8798286;Sat Jul 14 07:16:14 EDT 2012;Committer;nobu;2;37;11;48;0
d61dfcc7939199e19c2034c422f3473142c6d0a4;Sat Jul 14 07:04:28 EDT 2012;Committer;nobu;3;20;2;22;0
d12569b001fd915734a7f85de20e91a4234e381e;Fri Jul 13 17:32:02 EDT 2012;Committer;svn;1;2;2;4;0
bb575208bd8b12926b413774503df5fa965d7b69;Fri Jul 13 17:31:58 EDT 2012;Committer;nobu;2;7;3;10;0
d57103b9a2a62a67eb09fc9fb7c2828b53d1a590;Thu Jul 12 21:11:23 EDT 2012;Committer;nobu;1;1;1;2;0
b788ff5cf100d1157e97ad978ff43242459291b6;Thu Jul 12 21:11:19 EDT 2012;Committer;nobu;1;0;1;1;0
12b3c3e1e573178bd5af6b31c4762731f8a669c6;Thu Jul 12 21:11:19 EDT 2012;Committer;svn;1;2;2;4;0
e8f714b6345339efb2581a6749272a83ae467d71;Thu Jul 12 21:11:14 EDT 2012;Committer;nobu;1;4;1;5;0
c3521bf6313cbba26d3f407674b89180c8ba073d;Thu Jul 12 03:32:28 EDT 2012;Committer;nobu;2;14;0;14;0
d7444332257a6fb255300ee938a20dfa64cccf32;Thu Jul 12 02:44:27 EDT 2012;Committer;nobu;3;17;1;18;0
8cc3fef898e7e2edf2554c153318f6cc483a01f2;Thu Jul 12 01:48:23 EDT 2012;Committer;usa;2;8;0;8;0
558edd51921d1c2380a773c8e1785299bcfd9cbd;Thu Jul 12 01:27:42 EDT 2012;Committer;naruse;1;1;1;2;0
9696b3eb16acd9c90f32fd65e3ed95120d8e73c3;Wed Jul 11 23:52:04 EDT 2012;Committer;ryan;8;33;31;64;0
35784d10191308f39f694e8513cfc351d6712865;Wed Jul 11 20:11:45 EDT 2012;Committer;nobu;3;28;11;39;0
2642b69096210193015aee2216f8bea4d4c75d5f;Wed Jul 11 18:37:22 EDT 2012;Committer;svn;1;2;2;4;0
468985371143fc0f1f86c60897fa64c22321c8fc;Wed Jul 11 18:37:18 EDT 2012;Committer;naruse;4;65;1;66;0
dea582458af3ac34fcaad7fd8de46560c012fb3b;Wed Jul 11 09:02:06 EDT 2012;Committer;nobu;1;1;1;2;0
c9e4da2afc7d8c3db78e072cbef81b06effc7e91;Wed Jul 11 08:36:41 EDT 2012;Committer;nobu;2;6;1;7;0
04051396fd738abb97ebf2396c088520dd096da3;Wed Jul 11 03:46:37 EDT 2012;Committer;usa;2;14;7;21;0
412c5a96be804d33b322ffe6f55283b85c94b67e;Wed Jul 11 03:25:26 EDT 2012;Committer;yugui;3;68;11;79;0
64ef091a64d61dc0cef4508b70e64f91e4db865d;Wed Jul 11 03:25:16 EDT 2012;Committer;yugui;4;58;170;228;0
7bca2f031ae387f979397f73640f0c5b07dc313d;Wed Jul 11 03:17:35 EDT 2012;Committer;nobu;5;23;24;47;0
11bde3ae11838e3d257d3c887e496bfc1214a2a1;Wed Jul 11 02:00:08 EDT 2012;Committer;kazu;1;1;1;2;0
ce0b4fea35c8e692c636ac2cf051ab260e1166f1;Wed Jul 11 01:16:41 EDT 2012;Committer;nobu;2;6;0;6;0
c444a7e3adcc395cbd93673ceab4cf379cb2bb91;Wed Jul 11 00:23:34 EDT 2012;Committer;usa;1;1;1;2;0
8119a73dff00eabdf65528476223a422650053e9;Tue Jul 10 18:28:45 EDT 2012;Committer;svn;1;2;2;4;0
3cf7d1b57e3622430065f6a6ce8cbd5548d3d894;Tue Jul 10 18:28:40 EDT 2012;Committer;drbrain;4;307;51;358;0
c51a826764c3307a7fe9258e1d18ddca93cb7b5f;Tue Jul 10 13:57:11 EDT 2012;Committer;nobu;21;134;80;214;0
1a853390ee08af1b8ff3d1882a8762155d151306;Tue Jul 10 03:51:25 EDT 2012;Committer;drbrain;5;53;309;362;0
25f037377c9a537f624ba0f4d8e058fae84071db;Tue Jul 10 03:35:03 EDT 2012;Committer;nobu;1;70;52;122;0
9804e68f973716d31d1bdfbc132b801d22327772;Tue Jul 10 03:00:08 EDT 2012;Committer;nobu;1;1;0;1;0
64ae820d6991d87937dbe8b389a10dbf230b6af6;Tue Jul 10 01:49:43 EDT 2012;Committer;usa;2;4;3;7;0
8a02eed72334dfc4e4065d97cc39d543d25de2e9;Tue Jul 10 01:45:22 EDT 2012;Committer;usa;2;7;15;22;0
3e419e6c4aa3675d8b4aa4ae74610ec5289a9500;Tue Jul 10 00:04:47 EDT 2012;Committer;drbrain;5;309;53;362;0
428a5a9cd95b92b0a5570cb1154191c23453ebd4;Mon Jul 09 15:53:02 EDT 2012;Committer;kosaki;4;7;11;18;0
fe0b5d498b2c4721d9615f2bf1460456c1a828c9;Mon Jul 09 15:52:57 EDT 2012;Committer;svn;1;2;2;4;0
3e1d8aab1731e671b8daf266bbdb99196ff95421;Mon Jul 09 15:52:49 EDT 2012;Committer;kosaki;8;19;14;33;0
f40412e258012af48595fab97ac23365b9b117ec;Mon Jul 09 13:12:26 EDT 2012;Committer;kazu;1;1;1;2;0
2e5dcb53ce98f8422b093192be05deac37876be7;Mon Jul 09 08:38:19 EDT 2012;Committer;usa;2;4;1;5;0
284d912ecc494e8c048890c00aeaeec92b23179f;Mon Jul 09 08:33:47 EDT 2012;Committer;usa;1;3;3;6;0
9d2711691e932c95b41082aff819abd76a1be540;Mon Jul 09 08:25:06 EDT 2012;Committer;usa;8;20;159;179;0
9a8a2fd294ffa68bfed3d503090366faf0f45964;Mon Jul 09 04:35:53 EDT 2012;Committer;nobu;1;1;0;1;0
66f4c3f18c1f6eb4216556dd65463e6601ebca34;Mon Jul 09 04:35:50 EDT 2012;Committer;nobu;1;5;5;10;0
349ea593b6d440153a085031260c35fa49e35ebc;Mon Jul 09 04:28:45 EDT 2012;Committer;svn;1;2;2;4;0
37c8b685558aef2f081689e3ed9c419703a8af56;Mon Jul 09 04:28:40 EDT 2012;Committer;nobu;3;14;4;18;0
fbacb71b385958db8196f041b632e16ab555891d;Sat Jul 07 22:36:25 EDT 2012;Committer;nobu;3;22;7;29;0
cf06ed4f52c638fb428884bca0a0f59a3344505c;Sat Jul 07 21:38:07 EDT 2012;Committer;nobu;1;1;1;2;0
191f4734195382b2cb92714d29d3d112cef31867;Sat Jul 07 21:36:24 EDT 2012;Committer;svn;1;2;2;4;0
6e469999135bf3cb05bdda1bd8e598e82aa373dc;Sat Jul 07 21:36:08 EDT 2012;Committer;nobu;1;6;0;6;0
5f7cbbfb68fb7ad4e377eb58cdafd91cff9b3b26;Sat Jul 07 14:14:59 EDT 2012;Committer;svn;1;2;2;4;0
331352e676d914997b3876cf791d49d3d414de39;Sat Jul 07 14:14:54 EDT 2012;Committer;nagachika;3;7;0;7;0
8a995a56c7ce9a5e7688e20fdfa101b206407ae1;Fri Jul 06 03:46:39 EDT 2012;Committer;nobu;1;3;3;6;0
1474cfa8464113fef696ef0f6e8b785fdfc5fc76;Fri Jul 06 03:27:10 EDT 2012;Committer;nobu;2;0;6;6;0
a2d0ee620f8e0b3e2d820e84bf02e8e31f7d2462;Fri Jul 06 03:24:41 EDT 2012;Committer;nobu;1;21;12;33;0
cd0971e27f8da253918374e38c329fe709eed429;Thu Jul 05 21:50:13 EDT 2012;Committer;drbrain;3;25;7;32;0
9360721e5880fdeff4e72495991b3ffc8d94b190;Thu Jul 05 20:39:15 EDT 2012;Committer;drbrain;2;24;8;32;0
6b5a88a36dbd320466e4dcfb859a9ef4a6248e1d;Thu Jul 05 19:06:23 EDT 2012;Committer;svn;1;2;2;4;0
7182c0005c62d167770bb318dbc202e3d474a3dc;Thu Jul 05 19:06:18 EDT 2012;Committer;drbrain;2;6;1;7;0
e57bc077f330d81b5870d214087beb939062f2e8;Thu Jul 05 14:42:25 EDT 2012;Committer;nobu;1;3;1;4;0
0f020f7ca43f357ee93129fd5d216ff2677af9a5;Thu Jul 05 14:10:48 EDT 2012;Committer;nobu;1;2;2;4;0
85bb412ef94fc85ebc05d328e57fd4c1aaa6c63a;Thu Jul 05 08:32:23 EDT 2012;Committer;nobu;3;8;4;12;0
5425128e2b13e98fc31c7dedc65a6dac9e577ed4;Thu Jul 05 08:18:23 EDT 2012;Committer;nobu;1;1;1;2;0
51f458d4db1cb199a82ed6ae991bf2cf7c0e785e;Thu Jul 05 07:00:29 EDT 2012;Committer;nobu;4;53;49;102;0
6b801ac9f8d94c6d07a1e8b69449039e19544569;Thu Jul 05 06:15:00 EDT 2012;Committer;nobu;2;32;13;45;0
1b51476c1be1005ff5dde27f481d442ba51afe00;Thu Jul 05 03:31:36 EDT 2012;Committer;knu;2;29;0;29;0
cc6238083d8899e5dedf6a1d832316ecc02371f8;Thu Jul 05 03:31:34 EDT 2012;Committer;knu;1;5;0;5;0
be53f329f79c4f31ba29646be63061885fd6bbfb;Thu Jul 05 03:31:31 EDT 2012;Committer;knu;1;4;4;8;0
d5db3754f93f8497bd8517ea21c6813c664eadc2;Thu Jul 05 02:04:57 EDT 2012;Committer;kazu;1;1;1;2;0
0de9b0fee7dbe174e29208007ce9cb91d7487ea6;Thu Jul 05 01:53:30 EDT 2012;Committer;nobu;1;7;0;7;0
bc4cda4496450d262cd598fd9f0d038726a612fd;Thu Jul 05 01:41:03 EDT 2012;Committer;nobu;1;3;3;6;0
91337d00b25e0c6f1378aeab8e84ab8de25b5f01;Wed Jul 04 16:01:05 EDT 2012;Committer;svn;1;2;2;4;0
007c9aa2bf0ca503001e5ee2c2fc73566a09fbfc;Wed Jul 04 16:01:01 EDT 2012;Committer;naruse;3;22;7;29;0
87c25d897b4c9cef0c2031ddd9e75474383a2f04;Wed Jul 04 13:02:03 EDT 2012;Committer;ngoto;3;53;50;103;0
31f3a2e780330621b011f8631a6ebc6753341bb6;Wed Jul 04 11:23:13 EDT 2012;Committer;naruse;1;5;1;6;0
263cd01a31d65e0c58acf8df7a3f6a07c054b51c;Wed Jul 04 10:17:03 EDT 2012;Committer;suke;2;10;2;12;0
067b6e82376919a10f158237fe496fccbbc8150c;Wed Jul 04 04:42:35 EDT 2012;Committer;xibbar;2;3;10;13;0
9c746e35ad3c265704710934e9dc44b1ff7f741a;Wed Jul 04 04:42:32 EDT 2012;Committer;xibbar;2;7;6;13;0
38ca5cca0095d1a00a280009ab49772ce8749e91;Wed Jul 04 02:53:20 EDT 2012;Committer;usa;2;17;5;22;0
1655b26f678e7df7cb840194489095bea24e8dee;Wed Jul 04 02:46:33 EDT 2012;Committer;nobu;1;3;2;5;0
a7e1820a9f9c0b6c84c281c171c105a34aa16738;Wed Jul 04 02:11:37 EDT 2012;Committer;nobu;7;99;25;124;0
07132e0675ecacd9215504e9f9631fa1f83b7670;Tue Jul 03 23:32:33 EDT 2012;Committer;xibbar;2;10;3;13;0
ab63d24b049db35df4a68770b9fed6a11696961a;Tue Jul 03 23:29:56 EDT 2012;Committer;drbrain;3;67;38;105;0
ad187bde9ccbf1755d9c4dd4897f648e6666ae19;Tue Jul 03 23:19:29 EDT 2012;Committer;xibbar;1;4;4;8;0
b25f743057f4d9483655e66d3e9c38136f693253;Tue Jul 03 23:19:26 EDT 2012;Committer;xibbar;2;6;6;12;0
0e9b0c8c84e08bdb7a8308dfdafee2346ad9995e;Tue Jul 03 22:08:04 EDT 2012;Committer;drbrain;2;24;0;24;0
98cbc7070da28a544b68e6b9b311b90978c14e05;Tue Jul 03 21:19:57 EDT 2012;Committer;svn;1;2;2;4;0
91a254fd08eb7691387c6c253f85145ea0578163;Tue Jul 03 21:19:52 EDT 2012;Committer;nobu;1;19;1;20;0
1e972da39c58162672b4f0f2811145468303af0f;Tue Jul 03 14:25:32 EDT 2012;Committer;ngoto;2;6;1;7;0
a7c6f0afae80b3628e89693a3a80a5ce062a032a;Tue Jul 03 07:07:57 EDT 2012;Committer;nobu;2;58;10;68;0
1884f1c0ab470d26f571a8d4bbc9fae7d4035122;Tue Jul 03 05:52:22 EDT 2012;Committer;drbrain;2;11;3;14;0
c7c397f91757d2b1bcc9c21594bc1494750bc7cb;Tue Jul 03 05:37:29 EDT 2012;Committer;nobu;1;5;2;7;0
1f233501941fac4c546f6ab0a1945d2eeb56df43;Tue Jul 03 03:10:02 EDT 2012;Committer;usa;2;8;2;10;0
11387569670172ff66fff8fd289b2354dbab7ffc;Tue Jul 03 03:09:30 EDT 2012;Committer;drbrain;2;21;18;39;0
3fceaf10ab6c85032e381d8345dbf4e4b5e34f2d;Tue Jul 03 02:16:08 EDT 2012;Committer;nobu;6;77;0;77;0
66d0ad360719e9e0aa4b65b32849dbd9c24998a3;Tue Jul 03 02:11:01 EDT 2012;Committer;naruse;1;1;0;1;0
b697018e1b30bd702f79a6b299cc17493efe9676;Tue Jul 03 02:10:59 EDT 2012;Committer;naruse;1;5;5;10;0
c2a87e2733e19cc71435f36766835cb8dba56ceb;Tue Jul 03 01:52:51 EDT 2012;Committer;naruse;2;5;0;5;0
cda2bf5568ff81890011433853bd50407abc550e;Mon Jul 02 21:15:47 EDT 2012;Committer;drbrain;1;1;0;1;0
db0126b60976987dea24264e7aee44eeac56b65b;Mon Jul 02 21:12:48 EDT 2012;Committer;drbrain;2;10;4;14;0
7c3d6a8d99c0b45c3b5e38aad997a7da3b1b4779;Mon Jul 02 21:03:22 EDT 2012;Committer;svn;1;2;2;4;0
802c468fc6e8291710b785cd099ff288202b9978;Mon Jul 02 21:03:15 EDT 2012;Committer;drbrain;3;122;38;160;0
c03d1c273622c2a6de263f246bd5718eec08fb1f;Mon Jul 02 13:15:29 EDT 2012;Committer;akr;2;39;0;39;0
83eceb2a79188a54871b354d95f2e1fe352305b0;Mon Jul 02 12:26:50 EDT 2012;Committer;akr;2;18;0;18;0
5f8dfdd9c7e0b5f8666a4fba3fa06b54a17334dc;Mon Jul 02 08:07:01 EDT 2012;Committer;nobu;1;27;9;36;0
edb1fc4eb2f9b0bd69398362ae40100adfd5577e;Mon Jul 02 08:06:37 EDT 2012;Committer;nobu;4;68;55;123;0
bd52bed97be25e8f3344033ac01416349ec8be67;Sun Jul 01 20:56:50 EDT 2012;Committer;tadf;3;14;2;16;0
c8cde4e2be5a1cdc151e436d6d2189314902d748;Sun Jul 01 20:37:38 EDT 2012;Committer;tadf;3;63;5;68;0
2d3fd69503752ec41bdcb3ccd58ab253623625b1;Sun Jul 01 18:44:04 EDT 2012;Committer;svn;1;2;2;4;0
0de52e155a374adebe627c6d43772c3bd435c3cb;Sun Jul 01 18:43:59 EDT 2012;Committer;ayumin;2;9;3;12;0
fb3c4a2d1803531a1dc865f72d758ac794f8702d;Sun Jul 01 13:32:32 EDT 2012;Committer;ktsj;1;10;10;20;0
069fe9c68c269c01cb24759d82ef139ffec0802c;Sun Jul 01 05:46:30 EDT 2012;Committer;svn;1;3;3;6;0
e546302486c5b78cf04e845877f17ce8a8afb69f;Sun Jul 01 05:46:27 EDT 2012;Committer;ktsj;1;18;0;18;0
86c382a2d80c1d2a1e5ec6dce800fac79c4bb4e2;Sun Jul 01 05:46:25 EDT 2012;Committer;ktsj;1;0;11;11;0
706017578610c91beb5d906cca289f23c4afaa3b;Sat Jun 30 09:36:41 EDT 2012;Committer;svn;1;2;2;4;0
af2e9982d60637401bdc8ee2c439f09e1eacd08d;Sat Jun 30 09:36:36 EDT 2012;Committer;kazu;1;1;1;2;0
22113b1babc0dba9f616fb5b9eff14d7f6f8342f;Fri Jun 29 13:12:36 EDT 2012;Committer;naruse;1;2;2;4;0
13bc74fa748d2d947ee16f9a7436d374ced09db3;Fri Jun 29 02:26:46 EDT 2012;Committer;nobu;2;20;14;34;0
468c703d3065a443c134a3e04ff7a47b8645ee8d;Thu Jun 28 20:11:25 EDT 2012;Committer;svn;1;2;2;4;0
d42df4914631d7a2b96edc7ee0197f2ad47f5c8e;Thu Jun 28 20:11:19 EDT 2012;Committer;naruse;2;10;0;10;0
030111ac9c00f6437263134b33a4fa616bac864c;Thu Jun 28 12:33:12 EDT 2012;Committer;luislavena;2;10;4;14;0
f559d6160783da1b79aa928915890442d2eb587a;Thu Jun 28 10:38:26 EDT 2012;Committer;akr;1;3;0;3;0
912df4b615f30c5de468a3f214c86a1ec30cd22f;Thu Jun 28 00:39:52 EDT 2012;Committer;nagachika;3;22;2;24;0
a4932b54b561be04690ad45f103072e4ae75a0a4;Wed Jun 27 21:12:51 EDT 2012;Committer;svn;1;2;2;4;0
3f3225905b17b0088e7266d981200913edd778a2;Wed Jun 27 21:12:46 EDT 2012;Committer;nobu;3;49;5;54;0
c68698622021efa6cc5e70f082dba19885a6edb3;Wed Jun 27 14:18:26 EDT 2012;Committer;kazu;3;7;5;12;0
3e96f56f8ae9cb428e00aa0d60ddd18304a1f09e;Wed Jun 27 13:40:37 EDT 2012;Committer;nobu;2;10;0;10;0
d4269d7b7c5c89b98c3f920dcadde1a635f5d72d;Wed Jun 27 13:40:34 EDT 2012;Committer;nobu;2;10;2;12;0
cf3a8f09b806dc6f31363e845d9e93d5e046af91;Wed Jun 27 12:31:17 EDT 2012;Committer;nobu;3;36;6;42;0
48c04ad0d82ec4339ffd12ad4717b4dbde2aa74f;Wed Jun 27 12:01:39 EDT 2012;Committer;nobu;3;11;1;12;0
28cb8f5d201ba0c0507c79519c4e489039246b9c;Wed Jun 27 11:36:15 EDT 2012;Committer;nobu;1;3;1;4;0
8ddbbb33242f413845079b0274c28331cb4aa0f5;Wed Jun 27 07:48:50 EDT 2012;Committer;nobu;9;148;2;150;0
8634544fa74be0995582bc8056763fcfd38a0702;Wed Jun 27 07:46:54 EDT 2012;Committer;nobu;1;1;1;2;0
f4d2374b45bf893b5adf34470e9f20d55143c5ac;Wed Jun 27 05:37:15 EDT 2012;Committer;nobu;4;42;22;64;0
07d9c294a2c873db7b945fbaa0d2664a0eeeb76d;Wed Jun 27 04:10:12 EDT 2012;Committer;nobu;1;6;2;8;0
f70724c37d3a95bd2197f0521ec3be1eef41d9bb;Wed Jun 27 00:15:55 EDT 2012;Committer;svn;1;2;2;4;0
2240eb37b8c9abdfd1583bc29ea713695d6a2f6d;Wed Jun 27 00:15:51 EDT 2012;Committer;nobu;5;152;33;185;0
1ca611f360d96abf74d065f082e4b7d77fdfeb77;Tue Jun 26 13:35:00 EDT 2012;Committer;nobu;1;8;6;14;0
91aba07aff667eb31cf18d9b8849a60fcdc6e18a;Tue Jun 26 08:01:35 EDT 2012;Committer;ko1;2;16;2;18;0
5605afa5e218ea9ee62c4da358fab01b1bfa23e7;Tue Jun 26 07:46:26 EDT 2012;Committer;nobu;2;10;3;13;0
ffa20cf154591dbef2761ef7c61af534b4908f4f;Tue Jun 26 07:46:24 EDT 2012;Committer;nobu;4;6;6;12;0
9ac51c29930fa92a32186e7c217fa219915487c6;Tue Jun 26 01:02:04 EDT 2012;Committer;svn;1;2;2;4;0
876d4c4cc8f704029116b901ec4f696082a6ee30;Tue Jun 26 01:01:59 EDT 2012;Committer;nobu;3;43;63;106;0
f4af54f212907bd2ecd0be9d1e9a6237641b24b3;Mon Jun 25 10:21:37 EDT 2012;Committer;akr;1;34;1;35;0
82a408fb9d755b106be2cc23dd08831f158893f5;Mon Jun 25 08:49:32 EDT 2012;Committer;nobu;5;6;253;259;0
7c3d0ce3ccd5b3c1489dac2823f38d78f439456d;Mon Jun 25 08:06:43 EDT 2012;Committer;nobu;1;4;0;4;0
e6f1e3f49db1694116d286666ccaa026cad61f3e;Mon Jun 25 07:57:42 EDT 2012;Committer;nobu;3;13;5;18;0
0f0f0f4441e1e8845bf37f6eee712d9f4f73b908;Mon Jun 25 06:42:05 EDT 2012;Committer;nobu;3;63;38;101;0
0e8395d6cb5eb27f0a630be88839e6a11a2ea7c9;Mon Jun 25 02:35:29 EDT 2012;Committer;usa;2;6;1;7;0
7563b69cea7b731c8bfad2c5a3bd1b2d7c126f4c;Sun Jun 24 15:42:25 EDT 2012;Committer;svn;1;2;2;4;0
1ebe152edecb98f9f920dfc8cdc757883b8043ef;Sun Jun 24 15:42:21 EDT 2012;Committer;kosaki;2;9;5;14;0
cc1c97ae3113359628493e8139aaba538bed35bb;Sun Jun 24 14:02:19 EDT 2012;Committer;nobu;2;66;95;161;0
5be0ab591cbc71bdafe32bb1b86860da2fe7e03c;Sun Jun 24 13:53:44 EDT 2012;Committer;nobu;2;24;17;41;0
5cc2112ed1180635adad9d0ca5db162fc171d85d;Sun Jun 24 13:52:50 EDT 2012;Committer;nobu;1;5;5;10;0
78993d43c721713d6675b9ea5eac345d95250d8e;Sun Jun 24 13:35:56 EDT 2012;Committer;akr;1;6;6;12;0
de60be15e26ca85c3acf5d528e1b16dbba13c690;Sat Jun 23 22:48:17 EDT 2012;Committer;svn;1;2;2;4;0
72bbf9822db4ad7a1ef810d35f90268f07d79636;Sat Jun 23 22:48:11 EDT 2012;Committer;akr;3;6;10;16;0
1ad4751aac6d2f6e3277569397c605679c12c058;Sat Jun 23 14:50:38 EDT 2012;Committer;akr;2;10;3;13;0
f1734b4287e81ad281924c9acf89a754e43c6e2e;Sat Jun 23 14:21:47 EDT 2012;Committer;akr;3;20;10;30;0
345ecf3711998c8792c075e5d1093ca6a872474c;Sat Jun 23 11:35:32 EDT 2012;Committer;akr;3;73;52;125;0
fe688f2d302e3e3f70fba4bc93223740d9826e8e;Sat Jun 23 10:01:46 EDT 2012;Committer;akr;2;5;1;6;0
759c214a339e95f58ffe1fb2220541b1d23f6d73;Sat Jun 23 09:44:43 EDT 2012;Committer;akr;2;29;17;46;0
92af9dddc8f55e0331bf2fc0ee985be4f433b339;Sat Jun 23 08:22:53 EDT 2012;Committer;akr;2;8;3;11;0
26ecb6cbc4d6ebd3fcb7d8a1f829e2910ad26bdc;Sat Jun 23 08:18:34 EDT 2012;Committer;akr;3;20;8;28;0
f732c5046ed89b0ed669e97f36f5fa05b9a33b73;Sat Jun 23 07:30:26 EDT 2012;Committer;akr;3;25;15;40;0
b25b9569e55ece9e7a4f3971b412d67ff804c504;Sat Jun 23 06:23:35 EDT 2012;Committer;akr;3;19;9;28;0
f527ad625d39eac59dc687ae11f90cee107d4f0a;Sat Jun 23 04:23:03 EDT 2012;Committer;akr;3;24;12;36;0
40ae2e01084849672cc14feae3086526a85ac70e;Sat Jun 23 01:43:51 EDT 2012;Committer;akr;3;19;8;27;0
2a15a26c57faf4852a3f9b0afaafa886a78e7c96;Sat Jun 23 00:36:42 EDT 2012;Committer;akr;2;17;13;30;0
5c25fad66d614ad85cde6992c15b4dc422cec267;Sat Jun 23 00:18:32 EDT 2012;Committer;akr;3;55;48;103;0
0b3b2e885b2739769a4a0ca42420c708e084d547;Fri Jun 22 23:30:17 EDT 2012;Committer;tadf;2;0;4;4;0
3eafc1660f290da3939c8f4647907275ade8d0ac;Fri Jun 22 23:09:16 EDT 2012;Committer;akr;4;117;108;225;0
f7fc42a7af1c88dae8b2ab44eaeb7042fb8d3b11;Fri Jun 22 17:26:04 EDT 2012;Committer;nagachika;1;1;1;2;0
f120641e6527cd2af8f9605ef824bd714fa92dd1;Fri Jun 22 15:51:49 EDT 2012;Committer;svn;1;2;2;4;0
5a7db50517207df4ea6c86f4f7ae106966ff1cec;Fri Jun 22 15:51:41 EDT 2012;Committer;nobu;1;6;0;6;0
91fcdd186568931bd3ab36419ced4bf25b7fb27c;Fri Jun 22 13:37:16 EDT 2012;Committer;nobu;1;8;0;8;0
48fc312150b6ad1ff4219dd11da2cb0cae91aefe;Fri Jun 22 12:45:12 EDT 2012;Committer;nobu;1;9;2;11;0
6e4c82607b10ba87dd856db86156ca2ed9b858fe;Fri Jun 22 12:45:08 EDT 2012;Committer;nobu;1;1;0;1;0
5e06b53953883ba3317bc91573861e9e3fd0c276;Fri Jun 22 12:05:11 EDT 2012;Committer;yugui;2;17;8;25;0
bcadfd9c083c8893dcc428cbd969809c1db8dac1;Fri Jun 22 11:30:29 EDT 2012;Committer;akr;3;31;15;46;0
7b036a8ea78e713adbd29778612693d405b91813;Fri Jun 22 09:52:32 EDT 2012;Committer;kou;3;8;2;10;0
c4bc9b575898ba352d0fea8289ebcaf8921dacd1;Fri Jun 22 09:32:56 EDT 2012;Committer;ko1;9;109;37;146;0
471d8d2586d984fd70f6837b117d6f275201204b;Fri Jun 22 09:24:21 EDT 2012;Committer;akr;2;47;27;74;0
a359da842078ebfa13a70fd03fb4887030198db5;Fri Jun 22 08:58:29 EDT 2012;Committer;ko1;2;6;1;7;0
407e32746e1d1f77cf7d89e02fd4820f0f00a3a9;Fri Jun 22 05:22:46 EDT 2012;Committer;nobu;1;11;5;16;0
0b0dea752c0ef35d1a964b812a1a7fd033ab9e2e;Fri Jun 22 04:36:54 EDT 2012;Committer;nobu;3;29;0;29;0
77898c33e38be4333112986f9f4f68867f8ce7ca;Fri Jun 22 04:32:39 EDT 2012;Committer;nobu;3;21;0;21;0
47c6131b2987fe6158ebca009746a88e3c1b6a77;Fri Jun 22 03:07:26 EDT 2012;Committer;nobu;1;2;4;6;0
52d85c10144bc9b09987b21f9a2523c4b78b2684;Fri Jun 22 03:07:22 EDT 2012;Committer;nobu;1;4;4;8;0
fb120181f64eb5fe9724924cd07607b389a5df02;Thu Jun 21 20:56:35 EDT 2012;Committer;svn;1;2;2;4;0
62df750a4babea816d21092f57345c7a48b5d2dc;Thu Jun 21 20:56:23 EDT 2012;Committer;drbrain;2;6;1;7;0
c7a68e8d9d8cecd5b4305cb3787e843da1249c1b;Thu Jun 21 13:46:14 EDT 2012;Committer;akr;1;0;2;2;0
13ffa4c6ee87739e559d2db882e29b6ccf22ada2;Thu Jun 21 12:46:34 EDT 2012;Committer;akr;1;0;1;1;0
ed8040a62b9cd77d9c218eed0b993d4aa15eddc0;Thu Jun 21 12:18:40 EDT 2012;Committer;akr;4;26;16;42;0
511e25b2d597c86667a170b186e414cdd246acb6;Thu Jun 21 11:36:25 EDT 2012;Committer;akr;2;17;5;22;0
1b2c2316a52dca9769d5befd3a088a44564cb177;Thu Jun 21 10:48:48 EDT 2012;Committer;akr;2;9;3;12;0
0a431f6903c6dcf60353e6831d4efa1d2176e67d;Thu Jun 21 10:03:23 EDT 2012;Committer;akr;2;10;2;12;0
129cad739b2655f638e04aac11b6e648b5ecb5f8;Thu Jun 21 10:01:27 EDT 2012;Committer;akr;1;0;4;4;0
46e23dc03df77f6c3d4310233d2cf60902b98751;Thu Jun 21 09:39:10 EDT 2012;Committer;akr;3;18;6;24;0
64ae33a18ae0e13444b6ab7c043450b2fe68c62b;Thu Jun 21 08:20:51 EDT 2012;Committer;nobu;3;16;1;17;0
b8b67c0b9d7fc55a37647064f77a898f34abf89b;Thu Jun 21 05:08:24 EDT 2012;Committer;nobu;1;1;1;2;0
0cfee328281d98790e527f562eb2c89df51f6452;Wed Jun 20 22:25:46 EDT 2012;Committer;ko1;2;44;34;78;0
d73d3a743b78ed3532abb9ae97f0b4300963b15f;Wed Jun 20 21:25:20 EDT 2012;Committer;akr;5;33;24;57;0
06feb7b05721d1f92a90042fd4fbb5c1798d88f4;Wed Jun 20 15:27:59 EDT 2012;Committer;svn;1;2;2;4;0
4abc869c4d4cf44a5d9e4c45908467975042f73b;Wed Jun 20 15:27:53 EDT 2012;Committer;kazu;1;1;1;2;0
5309af971dd9588e142688d1130cb2a7ad0d26bc;Wed Jun 20 12:27:09 EDT 2012;Committer;akr;3;20;11;31;0
b60713de73dd3de6c610becb07ec30683d98af6b;Wed Jun 20 11:46:50 EDT 2012;Committer;akr;6;89;62;151;0
826f98e688c5608dcb5aeb749d0511cf2724c3a3;Wed Jun 20 10:31:02 EDT 2012;Committer;akr;5;129;22;151;0
2741a598ff9e561c71eb39a57bb19c0a3205eaef;Wed Jun 20 07:36:23 EDT 2012;Committer;nobu;2;12;0;12;0
50aab6d401b1dc1416558c08190068bb43f7c673;Wed Jun 20 06:31:35 EDT 2012;Committer;nobu;1;20;0;20;0
f96afe182ef7b6a45dbbeb9b796cf064a21ebe05;Wed Jun 20 06:31:32 EDT 2012;Committer;nobu;1;30;16;46;0
5a24475a133a74b84e8d6005a99fb4648580711f;Wed Jun 20 02:33:06 EDT 2012;Committer;nobu;2;6;1;7;0
5fe8065849039acbe859ea48a259ae8d5174da10;Wed Jun 20 02:24:42 EDT 2012;Committer;nobu;2;6;1;7;0
51c44ab1ec742018525391a37386fe8f8bc813bb;Tue Jun 19 21:50:32 EDT 2012;Committer;kosaki;2;5;1;6;0
6d69c3b0ce9dfdcf32383015a3514fe1a4624e44;Tue Jun 19 21:50:09 EDT 2012;Committer;kosaki;2;9;9;18;0
a57cbd7b27b3d254c71cb3b175e44e95550ef28d;Tue Jun 19 21:49:52 EDT 2012;Committer;kosaki;2;6;1;7;0
9021777282b038d1d83e758dcfca05cebc42d2b9;Tue Jun 19 21:49:27 EDT 2012;Committer;kosaki;2;6;1;7;0
7339e678f4a862071373d3bf9e17107b4302a3ad;Tue Jun 19 21:24:31 EDT 2012;Committer;kosaki;2;6;0;6;0
3307d65dc6a9c7290850f3f7b70af885d85d7653;Tue Jun 19 21:24:25 EDT 2012;Committer;svn;1;2;2;4;0
2fe6bd9a36353bd756b49195d543c74e7f05f765;Tue Jun 19 21:24:19 EDT 2012;Committer;kosaki;2;5;2;7;0
17e97a9b1064ea1961a4b3f8b18745d8235a9a7f;Tue Jun 19 13:58:30 EDT 2012;Committer;marcandre;1;1;1;2;0
c50f91f35b67c6418f3c5ef8b19e08543f2668f4;Tue Jun 19 09:43:53 EDT 2012;Committer;nobu;2;12;0;12;0
bdfd26b79506179a09a9cfa50eeba03741dc0d84;Tue Jun 19 09:22:01 EDT 2012;Committer;nobu;1;15;10;25;0
ab9560c953c90ede19b9f2f310502d91ff88571b;Tue Jun 19 09:21:58 EDT 2012;Committer;nobu;1;54;54;108;0
a60fe909d7244b961e5b56273309921b7b2cdd65;Tue Jun 19 09:14:18 EDT 2012;Committer;akr;1;6;6;12;0
52b497d8b7f5f05b7420b8200423304bb0c85ef9;Tue Jun 19 08:51:57 EDT 2012;Committer;nobu;2;10;1;11;0
6696fd0c49eca936c9f76738df587cda564fca90;Tue Jun 19 06:30:55 EDT 2012;Committer;naruse;1;1;0;1;0
9c6ae17a6606a01f57ef6ad302c90e488f188cba;Tue Jun 19 04:15:37 EDT 2012;Committer;naruse;1;22;0;22;0
2418f9cc5559ff9d9d62f2139ee7d7a971e7be20;Tue Jun 19 03:05:54 EDT 2012;Committer;naruse;1;1;1;2;0
5f883990182d2ea589a39f86c96f60df588bd736;Tue Jun 19 03:00:46 EDT 2012;Committer;naruse;2;5;6;11;0
44058a73a45df4fd71e28bf6dba6186fa1fb8090;Tue Jun 19 02:58:45 EDT 2012;Committer;svn;1;2;2;4;0
e47c4e38a8e9cdd82417ccb514b132e28ee084a8;Tue Jun 19 02:58:43 EDT 2012;Committer;naruse;3;10;4;14;0
d998ba1c3ca32260a111b85ddab1dd1e564b16f7;Tue Jun 19 02:58:40 EDT 2012;Committer;naruse;3;8;1;9;0
bcc4c40853d0140185f9bc9511beddeb3a33823a;Mon Jun 18 09:13:31 EDT 2012;Committer;nobu;1;1;0;1;0
3137b0819de753e7df671570b624229d7c583852;Mon Jun 18 08:10:13 EDT 2012;Committer;nobu;2;48;31;79;0
e2ad92a075bdcbffcae9afbb7dab9918f690fa14;Mon Jun 18 01:43:00 EDT 2012;Committer;nobu;3;33;4;37;0
90e812e81be93946a63f613e08e99a2508e39aa2;Sun Jun 17 15:38:27 EDT 2012;Committer;svn;1;2;2;4;0
7690aab8333387f2b09346c1290e9adcc664dad2;Sun Jun 17 15:38:22 EDT 2012;Committer;nobu;1;8;7;15;0
406a9fc5cf0ff3cde3a812b283e3376634601553;Sun Jun 17 13:23:56 EDT 2012;Committer;nobu;3;24;14;38;0
cdeff42cc1838fe71d562c6bd96e2437a3e90170;Sun Jun 17 07:21:03 EDT 2012;Committer;nobu;3;24;15;39;0
3c5664563446185c0b7d95de013d47b766122ba8;Sun Jun 17 07:20:58 EDT 2012;Committer;nobu;2;6;3;9;0
dc320f43e1421afaaba0ebe466e6c133978d599a;Sun Jun 17 07:20:57 EDT 2012;Committer;svn;1;2;2;4;0
34b6d066291fb54972c71033c856b78f9eac4ab4;Sun Jun 17 07:20:53 EDT 2012;Committer;nobu;2;8;3;11;0
7cc92034be348d72edfa769801a2e23f14233049;Sat Jun 16 10:25:30 EDT 2012;Committer;tadf;2;19;26;45;0
f5b033cd4ee66a2fe3123573478eedf5612ffb33;Sat Jun 16 09:49:17 EDT 2012;Committer;tadf;4;12;7;19;0
07784c78b95dc8cd88518387adb987433b37db61;Sat Jun 16 09:31:50 EDT 2012;Committer;nobu;2;6;1;7;0
c1740d890adfb9faa6086c1e54a8e46d768e3fed;Sat Jun 16 04:23:36 EDT 2012;Committer;nobu;1;1;1;2;0
c05042c95fda84874ee521fe897fd06fdf166be3;Sat Jun 16 04:23:34 EDT 2012;Committer;nobu;1;4;3;7;0
de7eb55f7fec837d43a6a1682a429d8108e657dc;Sat Jun 16 04:23:32 EDT 2012;Committer;nobu;1;11;8;19;0
04a7aabfbfc273e6d8edb21bef613f20da730b90;Fri Jun 15 22:46:10 EDT 2012;Committer;nobu;1;5;0;5;0
ff49900ab431e88dc05c14ffd65b92735dcf8bc9;Fri Jun 15 22:46:08 EDT 2012;Committer;nobu;2;6;3;9;0
3f6e8aef372dab1ece62c93e0d048d605f7aed15;Fri Jun 15 22:12:58 EDT 2012;Committer;nobu;2;6;2;8;0
3fb38c6178f64c99fba7a8b3ede3f2b3382337d0;Fri Jun 15 22:12:30 EDT 2012;Committer;nobu;2;7;0;7;0
7ed81c28e0a7f8a484f830724e2e7d16a1d9af6f;Fri Jun 15 22:11:55 EDT 2012;Committer;nobu;3;26;17;43;0
1eeaab8a39d704c465ad1f9fe8c67aed304ae5cc;Fri Jun 15 16:30:01 EDT 2012;Committer;svn;1;2;2;4;0
eac264632740577078d543822377b3fcdaa501a7;Fri Jun 15 16:29:55 EDT 2012;Committer;tenderlove;3;10;5;15;0
7889d3bea9c4db4c4f9a0b3be55cfdf66c20401d;Fri Jun 15 13:09:47 EDT 2012;Committer;kazu;1;4;6;10;0
064b70b60387d33f6d2e026477372699421d5c7e;Fri Jun 15 12:01:45 EDT 2012;Committer;kazu;2;9;5;14;0
7193f4ae280f55385a0f794884a846fb9398b03a;Fri Jun 15 12:01:41 EDT 2012;Committer;kazu;2;14;12;26;0
745c23b2d981e23024f044e934967bc6dae66d80;Fri Jun 15 10:22:34 EDT 2012;Committer;ko1;8;76;89;165;0
0dc5b8ce8c11d196ed44d333c4bfae8c7f2d0bac;Fri Jun 15 10:11:32 EDT 2012;Committer;nobu;2;20;7;27;0
19b4b7de3b82466eb99b4027430cdf88718610a0;Fri Jun 15 01:38:32 EDT 2012;Committer;nobu;3;3;3;6;0
fa6a2e03248840f4cb2308457abfd58e1244327b;Fri Jun 15 00:56:41 EDT 2012;Committer;nobu;1;9;3;12;0
0243943aad4302c1565c09d5a149fe1b96efd1ff;Fri Jun 15 00:56:39 EDT 2012;Committer;nobu;3;13;7;20;0
65672e63f52dc09c62eb2b75d5d24f710a30ee6e;Fri Jun 15 00:56:36 EDT 2012;Committer;nobu;2;6;4;10;0
a8ddde3b7802702414a7ea602720199de76051f1;Fri Jun 15 00:56:33 EDT 2012;Committer;nobu;1;2;0;2;0
88fa84a560ac72bce329929b545d1b5651a8392d;Fri Jun 15 00:03:56 EDT 2012;Committer;yugui;2;4;1;5;0
2c4b4a3091b942b13d686694c999c14df077ec9e;Thu Jun 14 22:54:10 EDT 2012;Committer;kazu;1;2;2;4;0
7931bbf1b3619ef84bc17073bef2388ca050b8c9;Thu Jun 14 15:14:05 EDT 2012;Committer;nobu;1;2;3;5;0
c50e1d3aef90d98a79e3986b367e3422b10f9e01;Thu Jun 14 15:07:25 EDT 2012;Committer;svn;1;2;2;4;0
a73d6eb0e471dfd62b0ff0541b6b0557336f0026;Thu Jun 14 15:07:13 EDT 2012;Committer;nobu;1;2;1;3;0
d1351e98fd001f613f35f0ea6e3b37c03baf26e8;Thu Jun 14 14:00:02 EDT 2012;Committer;nobu;2;7;2;9;0
b1644bfca9be98395eb951cccb592fe0bafc873a;Thu Jun 14 13:49:51 EDT 2012;Committer;nobu;2;8;2;10;0
ea325fcd6757b5cbd8060d216d7645be72da5e62;Thu Jun 14 13:11:41 EDT 2012;Committer;akr;2;9;3;12;0
f927ec15c9f9db9b213af2dad931fb8f386835c2;Thu Jun 14 07:01:08 EDT 2012;Committer;usa;2;11;5;16;0
6648846e05f760cf307f4c0122afb6cb4209f16b;Thu Jun 14 04:03:31 EDT 2012;Committer;nobu;1;1;1;2;0
207c58b518c31e6f54c0e4acab8dad76c3dda8c7;Thu Jun 14 03:03:52 EDT 2012;Committer;nobu;1;4;1;5;0
073297789aac2e4e4208d2bd228627a86c9f9460;Thu Jun 14 03:03:48 EDT 2012;Committer;nobu;5;15;15;30;0
22e7c535a663d1e309c23865d0abae95c9945650;Thu Jun 14 02:22:22 EDT 2012;Committer;yugui;2;34;77;111;0
8c9a453f2d8ac78943df98c61cdbb9e4a4ad0eda;Thu Jun 14 02:22:08 EDT 2012;Committer;yugui;5;306;97;403;0
f8601bd903d6c9f288fc39cc9f277c1275291ff3;Thu Jun 14 02:21:51 EDT 2012;Committer;yugui;6;89;0;89;0
e9e603145f48f352b08541187a7c4d528f8a6399;Thu Jun 14 01:16:33 EDT 2012;Committer;naruse;2;8;4;12;0
e901d2ce2caf11079391f97a20422f2b0cf38625;Wed Jun 13 23:18:35 EDT 2012;Committer;naruse;2;17;15;32;0
4230682d275e48b234eaf4f6d8255cdfc80dd8f6;Wed Jun 13 21:21:11 EDT 2012;Committer;drbrain;2;8;9;17;0
3d81b5c848c3cf01188d3d44885f78f09a4cfd08;Wed Jun 13 21:18:29 EDT 2012;Committer;drbrain;3;8;2;10;0
b41bc68688f098fce75ea4e7296e3e11783a7b97;Wed Jun 13 20:55:40 EDT 2012;Committer;akr;1;4;4;8;0
bad859ca3e54168c455dd41810b9c62cfd15d7d2;Wed Jun 13 20:46:11 EDT 2012;Committer;naruse;2;24;23;47;0
114ae69b457b1f02d2c63dd3c1b11bfffaf9b3fd;Wed Jun 13 19:57:31 EDT 2012;Committer;naruse;2;11;3;14;0
06d483006c727c922b8a099e66b4a3dfd8788270;Wed Jun 13 17:54:14 EDT 2012;Committer;naruse;6;63551;50667;114218;0
de08418fc65e1d1dfd759715df3f8945b32e1c33;Wed Jun 13 15:20:32 EDT 2012;Committer;svn;1;2;2;4;0
3703619ed970c5ebcf2ec7b2d8a848fa5550dcea;Wed Jun 13 15:20:27 EDT 2012;Committer;knu;4;71;4;75;0
a29bdaf63f941f760d6a2e4a42b1b6789e861550;Wed Jun 13 14:00:33 EDT 2012;Committer;akr;1;6;0;6;0
bff44ef4cd69dd073fbe85384c4eeff71cb8150f;Wed Jun 13 13:52:04 EDT 2012;Committer;ngoto;2;7;2;9;0
a9ff01cdae59a09c71d23c9197fa692be28c5c5c;Wed Jun 13 13:18:05 EDT 2012;Committer;nobu;2;8;3;11;0
0d86842f619413b1199a23ed4c4c4b5bb3f78af1;Wed Jun 13 12:46:38 EDT 2012;Committer;nobu;1;5;0;5;0
e985a6841c2c6cac330c9eb1a4669387f3df4b41;Wed Jun 13 12:46:36 EDT 2012;Committer;nobu;1;1;3;4;0
d793a86b434df237d62c70125db94bb0a0bc933b;Wed Jun 13 11:37:33 EDT 2012;Committer;akr;1;7;0;7;0
e9a1ba232ac7b8f0ec9a7044039986f03505ed70;Wed Jun 13 11:20:33 EDT 2012;Committer;akr;2;5;1;6;0
2c1322ec88df93ac9ff280e6164d8cead12f30b8;Wed Jun 13 08:58:05 EDT 2012;Committer;shyouhei;2;7;1;8;0
23838b93e8a4a9030ba28e5206f0f3e49cf59f6c;Wed Jun 13 08:51:04 EDT 2012;Committer;nobu;2;10;0;10;0
0c7dab5df958d65b0e4b3216c23f7b13a11eaeee;Wed Jun 13 08:50:42 EDT 2012;Committer;nobu;2;6;1;7;0
9c48976392ea40e2fefc1020366a227f66011bb1;Wed Jun 13 07:38:06 EDT 2012;Committer;nobu;1;2;0;2;0
43bc8f9beb0a495a715312b39cadde520799741d;Wed Jun 13 06:16:46 EDT 2012;Committer;shyouhei;2;21;4;25;0
24b9cf95e04bfb54d3f97dc7a2e67e7fb14b592a;Wed Jun 13 04:39:25 EDT 2012;Committer;nobu;2;29;21;50;0
da5ac6f565b134e42bcde3cced31b13b8b7fd569;Wed Jun 13 04:39:06 EDT 2012;Committer;nobu;2;11;1;12;0
6379978d453a910ad672f3def32b869a6cfa108c;Wed Jun 13 04:09:37 EDT 2012;Committer;nobu;1;3;1;4;0
9341988b4141534586c24d60265d45292dc8d505;Wed Jun 13 04:09:35 EDT 2012;Committer;nobu;1;2;0;2;0
621153bf3fb229a746a74aa1d64ab24622f91268;Wed Jun 13 01:20:29 EDT 2012;Committer;nobu;2;5;2;7;0
33b15cef6cc611fe8f5ee8a679b7b0c95f8d187f;Wed Jun 13 01:20:05 EDT 2012;Committer;nobu;2;5;2;7;0
2d460925f2e5beb24fb19dc4b0a07ce1598dac60;Wed Jun 13 00:56:31 EDT 2012;Committer;nobu;2;75;11;86;0
e6a6561121ef4475a0fd136524983bb22afbb3dc;Wed Jun 13 00:55:31 EDT 2012;Committer;nobu;2;12;1;13;0
fe5a15251fb931fad3823b5aacb297ccc2335d61;Wed Jun 13 00:54:36 EDT 2012;Committer;svn;1;2;2;4;0
18c32c9451b0a1b2bbb76cedc75b5a2dbc0eea93;Wed Jun 13 00:54:32 EDT 2012;Committer;nobu;1;4;4;8;0
720dc304583d7d7fb27333494968cc4657a32e10;Tue Jun 12 14:46:29 EDT 2012;Committer;naruse;2;6;0;6;0
3f4b0e17f4729facb1e6f3db6edf4fd63274f592;Tue Jun 12 13:55:42 EDT 2012;Committer;ngoto;2;5;1;6;0
f00d5d99f01fc6e7cc6aa2e3d13f29813cec80b7;Tue Jun 12 12:50:47 EDT 2012;Committer;akr;1;1;1;2;0
94b275c5b37cb84f5140c27b2428581499d6a29c;Tue Jun 12 12:44:26 EDT 2012;Committer;akr;1;6;0;6;0
640e0a33b7a198be030b4080e32404a319f4c468;Tue Jun 12 12:41:08 EDT 2012;Committer;akr;3;13;1;14;0
0dcc1f0dfe1e02e882f5f42c0c8a20cf371737e2;Tue Jun 12 12:09:16 EDT 2012;Committer;shyouhei;1;1;1;2;0
37a1355bf8d9f055661381b6dda41135776940cf;Tue Jun 12 11:34:51 EDT 2012;Committer;akr;6;93;34;127;0
0284e64922bae06a58bdc659022079729425117b;Tue Jun 12 09:41:07 EDT 2012;Committer;shyouhei;2;12;0;12;0
aa56c127b5f4fe02a060bca02bdda49ae4b36a76;Mon Jun 11 21:40:57 EDT 2012;Committer;svn;1;2;2;4;0
45e5f2f69003fd1dc22e7fe5081d7ddda81b1e28;Mon Jun 11 21:40:50 EDT 2012;Committer;akr;2;5;1;6;0
a903db9c231b6c22bcd216c386e910f3e95a6d19;Mon Jun 11 13:16:36 EDT 2012;Committer;akr;2;13;5;18;0
05a98ce736fc3c6d69b8a029d5c19f184721a87b;Mon Jun 11 12:58:55 EDT 2012;Committer;akr;1;225;103;328;0
ffe89b7621344e0bf420876bced1dc501d98626c;Mon Jun 11 12:37:55 EDT 2012;Committer;akr;1;24;0;24;0
f658207fe3716bfa6a784c0e857d4579ce03e6b7;Mon Jun 11 11:27:08 EDT 2012;Committer;naruse;2;7;10;17;0
0a71db8a7497df37b984ea97abfce6b6ffd82df3;Mon Jun 11 03:14:59 EDT 2012;Committer;ko1;14;413;334;747;0
9b29e5f7e1855f5381227363970e4ff21f3e4ae6;Mon Jun 11 02:57:02 EDT 2012;Committer;shyouhei;3;16;5;21;0
9ea35ccf306cda49f3ec1ab02ae1570f68e02765;Sun Jun 10 21:31:49 EDT 2012;Committer;akr;3;53;0;53;0
35973f273c3f6146a4b1a0c1597b0c1fc1d7b445;Sun Jun 10 21:21:51 EDT 2012;Committer;naruse;2;7;1;8;0
67b8c950bfebee48b1883321a404e760cd9b9044;Sun Jun 10 21:19:07 EDT 2012;Committer;naruse;2;7;1;8;0
cf8c5c14051dbb2b255bf7c0adde7d9e283b222f;Sun Jun 10 20:24:47 EDT 2012;Committer;svn;1;2;2;4;0
574024147b3ff9fb0f157a1387dc62403faed29d;Sun Jun 10 20:24:43 EDT 2012;Committer;ko1;2;8;0;8;0
cc4072b3db93fffb03f7a4e9a43bd02b6ae0500b;Sun Jun 10 12:51:40 EDT 2012;Committer;yugui;2;9;5;14;0
c3f3d77225499eba2e2f562024413dd2794c0139;Sun Jun 10 12:51:37 EDT 2012;Committer;yugui;3;149;65;214;0
fa5cd00340d81b9771866cf635ddc4266546a15f;Sun Jun 10 12:31:40 EDT 2012;Committer;akr;2;21;5;26;0
4fa66dc53ba7e6c975c71a7419e6081352dea250;Sun Jun 10 12:13:33 EDT 2012;Committer;akr;2;6;2;8;0
f589733a025de87929cf0b8f624aefc40faa63e8;Sun Jun 10 11:56:20 EDT 2012;Committer;akr;2;5;1;6;0
4b70fab9153e5082a68196f7a9287ba5685860f8;Sun Jun 10 11:21:07 EDT 2012;Committer;akr;4;22;4;26;0
a9e8b77697642e0be72af2a3198ddd025c2b31f3;Sun Jun 10 09:59:59 EDT 2012;Committer;knu;3;19;70;89;0
c541ff32238e10e25e4f3a220277a9bd3c882cc6;Sun Jun 10 09:39:17 EDT 2012;Committer;yugui;2;15;1;16;0
8706c00dfd65ae6c78f6fdac3688b224925c8d49;Sun Jun 10 08:54:38 EDT 2012;Committer;nobu;3;5;2;7;0
068dafd21f664e75bbadf958ad976afeeca45326;Sun Jun 10 08:54:32 EDT 2012;Committer;nobu;2;10;9;19;0
35c96b9003ee6c5a6af02113216ff37f7d1ebbaa;Sun Jun 10 08:54:28 EDT 2012;Committer;nobu;2;8;2;10;0
8fdd48d69fc41123e99da7761981d3c12eefc8d7;Sun Jun 10 06:51:05 EDT 2012;Committer;akr;2;14;8;22;0
d9f3198dd97333e5cf05572b41a73290713789c9;Sun Jun 10 06:49:16 EDT 2012;Committer;nobu;1;6;4;10;0
5c45a1373aa595d65ce796a24980c9804e58d8ec;Sun Jun 10 05:28:51 EDT 2012;Committer;naruse;2;12;2;14;0
c39fd4c34056fbebafc5ccfb3d63612538d3f234;Sun Jun 10 03:46:09 EDT 2012;Committer;akr;2;10;1;11;0
c27edd4a6e78d2545f67f1e04537f48ec2d8af10;Sun Jun 10 03:16:32 EDT 2012;Committer;akr;2;8;3;11;0
258716bd9d5398b7e6a6375ef5dd4f23790c6af5;Sun Jun 10 02:45:38 EDT 2012;Committer;akr;3;16;1;17;0
3ffd8a918ff2cfd555bf7e89329b275d1fe8ab12;Sun Jun 10 02:38:40 EDT 2012;Committer;emboss;3;97;0;97;0
43759fc1ed8f10fff50b4239089d02c0fbe6895d;Sun Jun 10 01:53:20 EDT 2012;Committer;emboss;2;11;1;12;0
839dc7d4092c0f53654e9625b71861e888e5a789;Sun Jun 10 01:46:45 EDT 2012;Committer;akr;1;4;4;8;0
7db3bb5c8fa6684f331b2aae79b59f5749cad0b9;Sun Jun 10 01:31:06 EDT 2012;Committer;emboss;2;11;0;11;0
18088467e7489eff252eeb5b904bc93c2949462f;Sun Jun 10 01:29:58 EDT 2012;Committer;akr;5;29;12;41;0
5bd7899b98fc4fd9631d08423f5c2fb6918c783d;Sun Jun 10 01:23:21 EDT 2012;Committer;emboss;8;66;7;73;0
8fcdb757a597b69d46216d7475ed4d07e6a330ef;Sun Jun 10 01:17:53 EDT 2012;Committer;akr;2;12;9;21;0
99c71b1ee4024bd9112e26cc442d9c91b2bc75e3;Sat Jun 09 21:48:42 EDT 2012;Committer;akr;2;30;7;37;0
e6424f805bffc64655cc80ede8bd6f396c57e306;Sat Jun 09 21:36:05 EDT 2012;Committer;nobu;5;18;18;36;0
f17591876595104a79b1a41e020bd379b781487f;Sat Jun 09 21:24:40 EDT 2012;Committer;emboss;2;15;0;15;0
21f1af2ec217c6e64af2095186c558b81a00e212;Sat Jun 09 18:16:18 EDT 2012;Committer;emboss;2;114;14;128;0
14ba7fab58329201aebdc49b83ca96dfbf0b13e6;Sat Jun 09 16:44:12 EDT 2012;Committer;emboss;3;71;98;169;0
f45eb45100e7a655c25629354c0a1c48c363360c;Sat Jun 09 16:37:44 EDT 2012;Committer;akr;2;5;1;6;0
18d03a9eb567c4ce5cfb2d301e13462e6ebd6e45;Sat Jun 09 15:25:45 EDT 2012;Committer;svn;1;2;2;4;0
b11046a61e2788bb8718a0bf87a45e1f3a452945;Sat Jun 09 15:25:34 EDT 2012;Committer;akr;2;75;30;105;0
14ec2c802d9ba09ba7e852136e184d0dc7f95ce4;Sat Jun 09 14:58:03 EDT 2012;Committer;akr;2;7;1;8;0
d074d0df9503b8df51c0ec5e5137c4729f511b17;Sat Jun 09 14:45:46 EDT 2012;Committer;akr;2;26;3;29;0
a1d6532ef658af477fc91fa27565983466500e1c;Sat Jun 09 14:36:56 EDT 2012;Committer;nobu;3;47;29;76;0
f64e7c834f95ecc1437394b2aba5ca03e9b10968;Sat Jun 09 14:36:17 EDT 2012;Committer;nobu;3;30;10;40;0
7057facef3376f5522783d70a2fa7d5396fabe1a;Sat Jun 09 13:28:02 EDT 2012;Committer;akr;2;12;3;15;0
1ad3f4b05d75383fa0cfc1e03c2abacc660812c0;Sat Jun 09 12:51:01 EDT 2012;Committer;akr;2;130;88;218;0
588d10180fbf05228aec2882f74dd3236dd3ad01;Sat Jun 09 08:21:52 EDT 2012;Committer;nobu;3;14;2;16;0
a46bf824bf3a6aace879b06159382e0905a48d78;Sat Jun 09 02:09:10 EDT 2012;Committer;akr;1;2;2;4;0
d410a38b8e8c89e50dcb28082d1e4cb5050a1d77;Sat Jun 09 01:57:46 EDT 2012;Committer;akr;2;18;8;26;0
4da82e58a19be2e49847f135f9f25697773a57ae;Sat Jun 09 01:40:22 EDT 2012;Committer;akr;1;4;4;8;0
4a9a7756da4b5fbf5b8e2b6191538e413022bb0b;Sat Jun 09 01:07:07 EDT 2012;Committer;akr;2;26;14;40;0
0ec4ae7c8edfaa1a7e48b59f95fabb141238a3c0;Sat Jun 09 00:01:58 EDT 2012;Committer;akr;2;8;1;9;0
c4c79e256bed22592c7faf9aa83cf7a943edd8a2;Fri Jun 08 23:30:55 EDT 2012;Committer;nobu;2;6;2;8;0
5b2df41b35f70c2abc4fc1ef430311e3967e999a;Fri Jun 08 23:21:50 EDT 2012;Committer;drbrain;3;31;108;139;0
a60a58b183cfef7fc53ef7e1d3b7c661bd97d3cf;Fri Jun 08 23:17:00 EDT 2012;Committer;drbrain;2;12;3;15;0
9fa6147b9cef00aa1fad47372aad6c8b237ad21f;Fri Jun 08 23:09:56 EDT 2012;Committer;drbrain;2;14;10;24;0
b2b93d4be1515575e4c70f52d804369f3d6fd8ff;Fri Jun 08 22:56:17 EDT 2012;Committer;drbrain;2;31;25;56;0
1d7798dc75218d3a3bffe7018afc341e04560187;Fri Jun 08 22:46:49 EDT 2012;Committer;drbrain;2;9;3;12;0
1102fd2f3e1fba09d6f78e677cf7fe969b68bb96;Fri Jun 08 22:44:01 EDT 2012;Committer;nobu;4;11;11;22;0
7b5fb62beef1027d8f7d232ba330611a1301bdc8;Fri Jun 08 22:41:06 EDT 2012;Committer;drbrain;1;1;1;2;0
0d7a94e31d3d0209c0dc520d55ff946f3e8c8bfc;Fri Jun 08 22:40:14 EDT 2012;Committer;drbrain;5;45;8;53;0
2fb032b74be9f306fbd2f95d85f8352f4a6027d6;Fri Jun 08 16:26:01 EDT 2012;Committer;akr;2;13;7;20;0
bf4ecf1d1a79a36cace3655e79631e8268fd36da;Fri Jun 08 16:13:32 EDT 2012;Committer;svn;1;2;2;4;0
b9824fbb0817da6ebc6b34c12c6be3373a8d4af4;Fri Jun 08 16:13:26 EDT 2012;Committer;akr;3;10;2;12;0
795c5f9b40e9b7ad35368a6a86c9c310a6c9a2d8;Fri Jun 08 14:46:23 EDT 2012;Committer;akr;3;7;18;25;0
ba1c1786d625a9477f029e153a5f10a7e9476319;Fri Jun 08 13:50:38 EDT 2012;Committer;akr;1;6;0;6;0
373a7d1a9552428d65b7f81527c77a5837410746;Fri Jun 08 13:43:48 EDT 2012;Committer;akr;2;8;2;10;0
c17c8ebb1467cc78028cf2794f666d7493f46caf;Fri Jun 08 10:57:10 EDT 2012;Committer;akr;2;11;6;17;0
86c82ad6478aa054adecd475eeb31c062c1e4a89;Fri Jun 08 10:02:00 EDT 2012;Committer;akr;2;7;6;13;0
2696fb950391fb74685caf0484f130430d2d2146;Fri Jun 08 07:19:38 EDT 2012;Committer;nobu;3;20;3;23;0
52c7036436f8cd5255103e37dde0720a997eec63;Fri Jun 08 03:04:42 EDT 2012;Committer;nobu;2;5;2;7;0
182dc9d40d7e32ef3782ad333613933afdc308f9;Fri Jun 08 02:26:39 EDT 2012;Committer;nobu;3;11;2;13;0
bc81a19e99ab99d4a1d8e4cedce3fbf87c52bda4;Fri Jun 08 02:25:55 EDT 2012;Committer;nobu;2;7;2;9;0
193681fb3bed526f4701393bc2e7eccb7c7a3728;Fri Jun 08 01:40:13 EDT 2012;Committer;svn;1;2;2;4;0
dbcda636a6a3d67e31ca76b5a31b6a99ea0bade4;Fri Jun 08 01:40:08 EDT 2012;Committer;usa;1;1;1;2;0
0d92aac60205ef80daae9b7b32e822c9f243549e;Thu Jun 07 13:13:52 EDT 2012;Committer;akr;2;6;2;8;0
13edb951b71881b6ef89d1ab10e2e50eadd5d8da;Thu Jun 07 11:29:43 EDT 2012;Committer;akr;3;31;28;59;0
425b78902d30e53e1b06f13ab7cc44a603cc53ec;Thu Jun 07 06:54:29 EDT 2012;Committer;svn;1;2;2;4;0
d556a4759893243b2a0c0322d75d12ac43869ca0;Thu Jun 07 06:54:24 EDT 2012;Committer;ko1;2;20;0;20;0
7e0c93b0c3225ff1ffe306af9e8ae34d3e7f57d3;Wed Jun 06 13:10:54 EDT 2012;Committer;akr;1;1;1;2;0
7f83b7e14f3dc2b4a7590d6ba6805ba628f64a9f;Wed Jun 06 12:34:51 EDT 2012;Committer;akr;1;3;3;6;0
3c3b563205c91ae38036d76e8c48bfd4a9980f0d;Wed Jun 06 12:33:28 EDT 2012;Committer;akr;2;21;13;34;0
ee011f7b1f7a994a8758a05410f639e9fe2b6aac;Wed Jun 06 12:20:58 EDT 2012;Committer;usa;2;6;1;7;0
78d7def61988764344d2630ae77113e1edb2af5d;Wed Jun 06 12:11:45 EDT 2012;Committer;akr;1;19;0;19;0
aaf6bde9780173a989acc3af7d25debc350f53e8;Wed Jun 06 11:58:09 EDT 2012;Committer;akr;1;13;13;26;0
70232e400cae3509b6b816e3c8beed8be6f55dd7;Wed Jun 06 11:49:30 EDT 2012;Committer;akr;3;29;6;35;0
7685837427e60770d7228cc1d3db97257521a606;Wed Jun 06 11:09:26 EDT 2012;Committer;akr;3;21;5;26;0
96b96832c13b1ef127262cec1104bc7cb7524b69;Wed Jun 06 05:04:50 EDT 2012;Committer;usa;1;1;1;2;0
f047b1f0dcaab60f22619046d419b36f2cc3f6b0;Wed Jun 06 04:29:38 EDT 2012;Committer;usa;3;53;0;53;0
4c3e402cda1347ebfd94d6070c28ec159f2767d9;Wed Jun 06 04:18:53 EDT 2012;Committer;usa;2;13;1;14;0
494d01410fff02ca7978b986b8010484253fbecf;Wed Jun 06 03:39:40 EDT 2012;Committer;usa;2;16;0;16;0
5e1e5d04ee0e661d7a9817c88502ea1a5c1562ac;Wed Jun 06 00:46:12 EDT 2012;Committer;usa;3;7;3;10;0
a4ef2bbdd1e3564e0440ac3feb90bf00d36be3ac;Tue Jun 05 20:29:15 EDT 2012;Committer;akr;2;6;1;7;0
1c4e6066bede05c7c437b7690ce67ef9e51439c0;Tue Jun 05 20:10:50 EDT 2012;Committer;naruse;1;75;42;117;0
c8d6b6e8fa5b3309d5ac1c879ebb69da814e1d1f;Tue Jun 05 19:59:43 EDT 2012;Committer;akr;2;7;3;10;0
0acd09c9e57dbaf506a5d2d6ac2bea5290994fce;Tue Jun 05 15:31:39 EDT 2012;Committer;akr;1;3;3;6;0
baf500dc03ba88521d2edc3796021aaf5764c05f;Tue Jun 05 15:24:37 EDT 2012;Committer;svn;1;2;2;4;0
3162e673a1f376ae2126c10eec0e97ae76181af3;Tue Jun 05 15:24:32 EDT 2012;Committer;akr;4;34;16;50;0
53b17a769b873a889c15c4cf4d34e9a58a03b552;Tue Jun 05 14:53:31 EDT 2012;Committer;akr;4;44;30;74;0
71e793533194e1dd03036b4e0c3cc4550d822477;Tue Jun 05 14:33:32 EDT 2012;Committer;akr;1;4;4;8;0
a79bbdf6b5c84a109747d54ac7a5a9449f11fc17;Tue Jun 05 13:29:54 EDT 2012;Committer;akr;3;27;20;47;0
60d5e14b92f6cbf4d6d6ac38abac964fc64b0610;Tue Jun 05 13:08:47 EDT 2012;Committer;nobu;1;3;3;6;0
ad5bfed17c7cfe9728ee4726a21cd8783756cd61;Tue Jun 05 12:59:40 EDT 2012;Committer;akr;3;43;19;62;0
2073258a7d192e8d2bc853e10464a7a5fcac8f2d;Tue Jun 05 11:13:18 EDT 2012;Committer;nobu;11;58;27;85;0
b1ae6e473e1c1865a1dcd5e4e5d242345c20cc77;Tue Jun 05 10:59:51 EDT 2012;Committer;akr;2;4;4;8;0
e3d685907c140bd780d4108b80a83b036a0e32d4;Tue Jun 05 10:35:47 EDT 2012;Committer;akr;2;10;22;32;0
e58ec3372190b0f9e294351a4e1ca603da01ca72;Tue Jun 05 10:21:22 EDT 2012;Committer;akr;2;8;2;10;0
5b13036fce91d8970448e565e4319939b27cdc00;Tue Jun 05 10:16:11 EDT 2012;Committer;akr;3;73;51;124;0
ff3b2cb1cef59787bcb125baeeef78a23e83e78a;Tue Jun 05 01:29:43 EDT 2012;Committer;nobu;2;68;68;136;0
5da6f554578e7d2ae8b5d8c05709a4235344cea2;Tue Jun 05 00:37:11 EDT 2012;Committer;svn;1;2;2;4;0
e1b230d557bbf27641e94f037c3d1a125215c74c;Tue Jun 05 00:37:08 EDT 2012;Committer;drbrain;2;193;180;373;0
07e222d720a8e6935d47f5747551a50f21016e76;Mon Jun 04 12:54:00 EDT 2012;Committer;nobu;2;8;0;8;0
9ab2ce20b3197b9f8c6bb8caca508ed6c04f1f5c;Mon Jun 04 12:52:35 EDT 2012;Committer;akr;1;16;3;19;0
993b4f391153dbc731af1c73b31bcec1690eed53;Mon Jun 04 11:13:47 EDT 2012;Committer;akr;1;3;3;6;0
71fd73dff88fa29b41f92e39412d31ad651dbea4;Mon Jun 04 11:01:41 EDT 2012;Committer;akr;3;17;7;24;0
41819dc447067891a2154f1c99c0cb4589f7b73f;Mon Jun 04 10:19:32 EDT 2012;Committer;akr;4;23;6;29;0
06513cc1cf5bbe1e23f871f920df7e2b7b793d9d;Mon Jun 04 07:24:44 EDT 2012;Committer;ko1;5;16;8;24;0
82aa43407ca3f4096ec2be2a13869fb584775952;Mon Jun 04 06:39:40 EDT 2012;Committer;nobu;5;379;9;388;0
de8eb56e8851cef0c7aec56594531589f5580a7a;Mon Jun 04 05:46:24 EDT 2012;Committer;nobu;1;8;14;22;0
b89e9bf5447cb47d567c7b5aa2d10b0a9352ea65;Mon Jun 04 05:46:22 EDT 2012;Committer;nobu;1;2;3;5;0
a99d3a62719b0266602e5eafe8a2c15d44ba5da2;Mon Jun 04 05:33:43 EDT 2012;Committer;nobu;2;2;2;4;0
9bb642d65aff38f5cf5eba30f3035ec3621a4c2f;Mon Jun 04 05:06:56 EDT 2012;Committer;usa;2;5;1;6;0
efebb5b1570eed385dc07deb6b0e92b55f8ba081;Mon Jun 04 05:02:27 EDT 2012;Committer;naruse;1;1;0;1;0
00e4c2e3620d8c16031821c64c41009b674e3c54;Mon Jun 04 04:10:44 EDT 2012;Committer;usa;3;10;2;12;0
2e7c7696334b1b69681cbc0315836fef8e06227d;Mon Jun 04 03:04:34 EDT 2012;Committer;ko1;2;8;14;22;0
bac9f65f707e8ffcb79389e5b10b32addc94dc01;Mon Jun 04 02:49:37 EDT 2012;Committer;ko1;11;164;139;303;0
81a0c608eb73f1a250ec9ec11107280b8d086ef8;Mon Jun 04 02:40:30 EDT 2012;Committer;nobu;7;138;11;149;0
2493e48d40bb984f315be0e478bf3b9f0dec588c;Mon Jun 04 02:36:11 EDT 2012;Committer;usa;2;66;1;67;0
859869e52285a36255c8bed6bc0bf5dd80ac0010;Mon Jun 04 01:44:27 EDT 2012;Committer;usa;3;15;44;59;0
436d819bf2f51b7e01aab070f92e8864793c8d16;Sun Jun 03 21:13:36 EDT 2012;Committer;nobu;1;18;18;36;0
f392a8aa9bcf80f57e6c7ac5ea5fd714922e2ac6;Sun Jun 03 21:12:46 EDT 2012;Committer;nobu;2;6;12;18;0
eb6579e6474126b56e32ff8951c2ba5fee064791;Sun Jun 03 19:26:58 EDT 2012;Committer;tadf;5;7;109;116;0
6b348951ca25f14088f05f782f1cbc70332d94a6;Sun Jun 03 15:45:46 EDT 2012;Committer;akr;2;15;4;19;0
78713916beb9e802bf14c081218e12ccf87860ee;Sun Jun 03 15:13:59 EDT 2012;Committer;svn;1;2;2;4;0
93e005d177bfbf82d7b8b8c3eedc0993f698edd6;Sun Jun 03 15:13:54 EDT 2012;Committer;akr;2;6;1;7;0
9ee4575ea418992d3a03eb7065d31159bb51fb72;Sun Jun 03 14:53:13 EDT 2012;Committer;akr;3;119;96;215;0
d70af743bf5d9d3a83d1b1a3ddfc0eb88ec93487;Sun Jun 03 13:07:58 EDT 2012;Committer;naruse;2;24;20;44;0
cb44ffc4af6ab85819492567e8ca63763bac45f4;Sun Jun 03 12:25:54 EDT 2012;Committer;akr;2;6;2;8;0
f5b06413cabbedfdd320eb36c68577db8fa99c4f;Sun Jun 03 12:21:18 EDT 2012;Committer;tadf;5;68;0;68;0
9977e1cbc799fc1710e65d7978b39a65e75f38b7;Sun Jun 03 12:18:45 EDT 2012;Committer;akr;2;7;2;9;0
033e2187c65918ee051553b57be9924878b3fda5;Sun Jun 03 11:12:20 EDT 2012;Committer;akr;3;35;7;42;0
190d319dab5184b1ef6ecb5df334f6345553b904;Sun Jun 03 10:47:45 EDT 2012;Committer;naruse;2;5;1;6;0
f4f28bf75f0aa534de3b1edcf46c8a6ee905e9af;Sun Jun 03 08:29:48 EDT 2012;Committer;akr;4;117;51;168;0
694035eb35d7dc52ae58d8306cad2c2d6b0bf240;Sun Jun 03 07:34:03 EDT 2012;Committer;nobu;4;17;18;35;0
5dc5a526125b25200fb6566257756bccbc4474c8;Sun Jun 03 05:17:38 EDT 2012;Committer;tadf;2;20;8;28;0
d9dd6f5d350ed90e82345aa9c717fa6fe6db2225;Sun Jun 03 05:15:56 EDT 2012;Committer;tadf;1;2;2;4;0
1ddb6f705979fdbc176b5c33e773689baf28fb24;Sun Jun 03 05:14:47 EDT 2012;Committer;tadf;2;13;0;13;0
bdc55aa0c690e343be3b31a62c5f44a41f22e330;Sun Jun 03 05:05:29 EDT 2012;Committer;tadf;5;69;0;69;0
89ae71d72157aa8800443741ff328199d7ba59e5;Sun Jun 03 01:26:41 EDT 2012;Committer;tadf;5;23;0;23;0
82cd48d7ee799ff1cd37c0ea0be2ab0d0aea9a2e;Sat Jun 02 21:34:14 EDT 2012;Committer;nobu;1;3;3;6;0
b4be4c7be315998f8301c21636aa7b4ab8c9e47f;Sat Jun 02 18:24:24 EDT 2012;Committer;naruse;2;5;1;6;0
f6f769d26d8ba3fa715cbb0e3717ff50207befaa;Sat Jun 02 16:46:08 EDT 2012;Committer;ko1;3;211;201;412;0
b57c81ae3efd33599e993500816bce18e108a2d3;Sat Jun 02 15:59:37 EDT 2012;Committer;ko1;8;165;140;305;0
ea5605dd4da8ed666a7bf14ef4af99d74d11af4f;Sat Jun 02 15:23:41 EDT 2012;Committer;svn;1;2;2;4;0
681d73a9232581df1d157cb3ae43a53be6c64e65;Sat Jun 02 15:23:37 EDT 2012;Committer;ko1;4;736;711;1447;0
d054eb96317445fb30ac6d8b67721b88927f3f17;Sat Jun 02 13:44:02 EDT 2012;Committer;naruse;3;58;0;58;0
866761d2e8e04e8dc39cb306d47ef6e8e0e362b7;Sat Jun 02 09:18:32 EDT 2012;Committer;knu;2;149;86;235;0
70be643c5bfe81e0aa6fbebec638d6806d707a08;Sat Jun 02 08:52:55 EDT 2012;Committer;naruse;1;0;4;4;0
7671e7dd35e5f116664d5bc7ae22438a6e40677b;Sat Jun 02 08:02:23 EDT 2012;Committer;naruse;2;13;3;16;0
5f85fcc11f9e1e06139af2794b23df4169dc86a1;Fri Jun 01 22:05:46 EDT 2012;Committer;drbrain;2;11;4;15;0
5c56ae7f810c1a323d1a3d0abdaec0c7e2a9227b;Fri Jun 01 21:35:10 EDT 2012;Committer;svn;1;2;2;4;0
8424e37992bec99e25dce69cb9fe04e61e9e630c;Fri Jun 01 21:35:05 EDT 2012;Committer;drbrain;2;7;2;9;0
5b95238aa7886a0c1de50895ebc98d1236eb914e;Fri Jun 01 00:31:00 EDT 2012;Committer;nobu;2;23;19;42;0
53b61ccb78244733bcac744bf0edadade6a3b5da;Thu May 31 23:51:33 EDT 2012;Committer;drbrain;2;642;518;1160;0
fe962cde158562e0d41b61ea48267cf0413f190c;Thu May 31 22:07:09 EDT 2012;Committer;drbrain;3;31;19;50;0
4f69926f75cd90822408c915c2b4ec637c749dd1;Thu May 31 21:41:21 EDT 2012;Committer;drbrain;2;18;0;18;0
ee4f9b7ce5c056c503a116b8eb2b8199b3d87609;Thu May 31 21:30:23 EDT 2012;Committer;svn;1;3;3;6;0
c458f08e90ca04bb2c201c55e510686853a86ce7;Thu May 31 21:30:18 EDT 2012;Committer;drbrain;2;8;3;11;0
960660353f59126d66b1bc2b08d97f5192acdf1b;Thu May 31 14:59:03 EDT 2012;Committer;nobu;1;1;1;2;0
2ab7c5306da3a122002c499afbcb7d78b5070fd4;Thu May 31 06:50:22 EDT 2012;Committer;nobu;1;10;5;15;0
711c067eb52e76bbaaf3a70a5b75e52a82a55ce1;Thu May 31 00:37:45 EDT 2012;Committer;drbrain;1;0;5;5;0
40cf3e0cca0a347bf8b6b44832fdcc358e068630;Thu May 31 00:27:34 EDT 2012;Committer;drbrain;3;64;20;84;0
0381ab07694668c4420307a6d8e9f0265ed9c56d;Wed May 30 23:41:07 EDT 2012;Committer;drbrain;3;20;13;33;0
f1cb6ea08f8fc897d914fc7c2c23701471657e4f;Wed May 30 23:20:29 EDT 2012;Committer;drbrain;3;27;11;38;0
e88c8880b13462be0e3f109bb61daa306d9ed1f9;Wed May 30 22:48:46 EDT 2012;Committer;svn;1;2;2;4;0
2e87e2150e04c37595c02095c410decadfb9977e;Wed May 30 22:48:42 EDT 2012;Committer;drbrain;6;153;3;156;0
d3a349bbc3d0cd61322b86b500032d75d25a6ec3;Wed May 30 07:30:46 EDT 2012;Committer;mrkn;3;9;2;11;0
ecb6bd90c01edc19165ff526ef15a59693b4f12f;Wed May 30 07:26:51 EDT 2012;Committer;mrkn;2;9;1;10;0
18805586d9a524f0a351a1affd950e50166ed5e0;Wed May 30 01:58:34 EDT 2012;Committer;nobu;3;25;11;36;0
7d303b2d10febdeafde9f70c1e8e54e91c54f42b;Wed May 30 01:29:08 EDT 2012;Committer;nobu;1;2;1;3;0
2f76e6d34c899d81f5c42e3b1e481c9e506a937a;Wed May 30 01:24:08 EDT 2012;Committer;nobu;2;26;3;29;0
a8f87d6d8d04d34ead8915ae350999c7875180ea;Wed May 30 01:24:05 EDT 2012;Committer;nobu;2;8;8;16;0
99c741c119e46ae4f12f68095ca6f9f1d6d2b58d;Tue May 29 21:20:49 EDT 2012;Committer;svn;1;2;2;4;0
9e84f837365c65afc21071fb431dc4d17154499b;Tue May 29 21:20:45 EDT 2012;Committer;drbrain;2;10;4;14;0
39a3d1793b67df8ef1aa48e2f813dcac13814544;Tue May 29 08:28:13 EDT 2012;Committer;nobu;3;53;13;66;0
241902e7091a0ad514683488020011e827ad7750;Tue May 29 08:28:09 EDT 2012;Committer;nobu;3;28;5;33;0
60683816be0674fc3e0a07855f5c2de68c4db771;Tue May 29 08:28:04 EDT 2012;Committer;nobu;3;31;18;49;0
4f4de9b858a3336e065b31dd7fa338d02a8a29eb;Tue May 29 00:52:46 EDT 2012;Committer;svn;1;2;2;4;0
44ae75a12746b05ebef5635a5142d7fb65d1513c;Tue May 29 00:52:41 EDT 2012;Committer;naruse;1;1;0;1;0
de7a47d1aac264be47583353739cc1a3dc138d91;Mon May 28 07:56:58 EDT 2012;Committer;nobu;2;6;0;6;0
49479c2dccbf5bac43278b85b3a28d4726e8ecbf;Mon May 28 04:54:04 EDT 2012;Committer;nobu;1;21;21;42;0
1cb2f961588d86737c4992fc3d06895e05d21fd5;Mon May 28 04:35:36 EDT 2012;Committer;nobu;2;12;7;19;0
3fcf82e27815db04da819a67bd112513f057a8b2;Mon May 28 03:15:04 EDT 2012;Committer;nari;1;1;1;2;0
e2f4f34467f90bc9bc30891c9cdb4aa82fa0e37c;Mon May 28 03:12:33 EDT 2012;Committer;nari;3;24;1;25;0
92b6597be67738490c0ab759303a0e81a421b89a;Sun May 27 16:25:19 EDT 2012;Committer;nagachika;1;1;1;2;0
77dc968e6c89fe9011d3049f5d5a5e336b8a005d;Sun May 27 16:14:46 EDT 2012;Committer;nagachika;3;129;129;258;0
233e48dc3cf3d975eb77c71c47045454d03a1307;Sun May 27 16:14:09 EDT 2012;Committer;svn;1;2;2;4;0
26282b5374f9473d9f62e5f287ad625a1f9f2053;Sun May 27 16:14:05 EDT 2012;Committer;nagachika;1;2;2;4;0
7796c7d75188ba20aa7f8fb0222f0d26fae7a27d;Sun May 27 14:41:01 EDT 2012;Committer;ko1;37;182;32;214;0
24b1d2f2f47288fb0a09eff601f377f15703e809;Sun May 27 04:47:43 EDT 2012;Committer;nagachika;1;1;1;2;0
06653c193384cbb89086213135c98b2d1c1638cc;Sun May 27 04:35:11 EDT 2012;Committer;ko1;2;9;3;12;0
2d8b8b4d3eee567237c4be24b615be65f9b98235;Sun May 27 02:27:53 EDT 2012;Committer;nobu;2;6;1;7;0
a000c52b83e73d6ea40b5ab72eef9d2c88842a1a;Sun May 27 02:23:14 EDT 2012;Committer;nobu;1;8;8;16;0
9f698ff1d533a5542ebbed0a96ef3bf40d72561d;Sun May 27 01:05:31 EDT 2012;Committer;tadf;1;9;9;18;0
83d8d057c2df674138187718eb2c9423506fa758;Sun May 27 01:04:41 EDT 2012;Committer;tadf;2;5;2;7;0
6ba96bbe4e74c5d6414184b186a6552d7fb23a13;Sun May 27 00:30:33 EDT 2012;Committer;tadf;2;6;3;9;0
9a6a94f770411435bcd92e030e622cc231453fd4;Sat May 26 18:18:49 EDT 2012;Committer;svn;1;2;2;4;0
18454e6f1030119c0504592ee34901a1c5e5cf68;Sat May 26 18:18:45 EDT 2012;Committer;nagachika;1;1;1;2;0
76547ea75f68aa22df91d5df9ffd2b46361631e3;Sat May 26 10:05:25 EDT 2012;Committer;tadf;2;12;8;20;0
43e8bf0c275988b7dc050e25058a0d0d6028976a;Sat May 26 09:21:21 EDT 2012;Committer;tadf;2;3;3;6;0
2199c85dd6eb6f912bf4502ceca27da1933e9d71;Sat May 26 09:16:26 EDT 2012;Committer;tadf;2;8;20;28;0
0976f312003c322db8a602dfd8e02ababdafa486;Sat May 26 09:10:42 EDT 2012;Committer;tadf;3;8;3;11;0
ec187ff8473f3c2091253496595b515ea59d2ec0;Sat May 26 08:08:16 EDT 2012;Committer;ko1;3;22;10;32;0
5212b7fb5206329151f52532e0818832186f0346;Sat May 26 07:26:36 EDT 2012;Committer;nobu;3;20;0;20;0
62bab7fc22ed4668fc2cca4b85965644046a1169;Sat May 26 07:24:59 EDT 2012;Committer;nobu;1;2;2;4;0
9c3d8bb0f26762d6809501a38be773de685764f0;Sat May 26 06:31:31 EDT 2012;Committer;ko1;2;6;1;7;0
a28b100f1c3ac22eed095e3a1fd6874ad5ecbb9f;Sat May 26 05:03:33 EDT 2012;Committer;ko1;1;4;5;9;0
ca433168bad83458e02309fca76d9a9e00541419;Sat May 26 04:51:32 EDT 2012;Committer;ko1;2;6;0;6;0
4f54d4710e1edfbcb8b0d7d7feea1bd8c519229f;Sat May 26 04:49:23 EDT 2012;Committer;ko1;4;300;51;351;0
fbf531c4a249e75260e80ed767114b02e0a1e985;Sat May 26 03:25:15 EDT 2012;Committer;ko1;3;72;88;160;0
6d597718cf45aff0dd25ee7c7e8bd8e158ac0268;Sat May 26 02:10:37 EDT 2012;Committer;ko1;2;76;21;97;0
2240dc2ed385551162d7460f5df85787169bb1e5;Sat May 26 00:56:37 EDT 2012;Committer;svn;1;2;2;4;0
50ba64ab87e1715cc0bf6d6c8bdfa330de4f6699;Sat May 26 00:56:33 EDT 2012;Committer;emboss;3;173;37;210;0
6f5582a2ae543eb8000deba997348fda189c166a;Fri May 25 14:44:15 EDT 2012;Committer;emboss;2;22;11;33;0
913827b6afd701f5f5b7461e3acf15c70ab4f22b;Fri May 25 13:24:47 EDT 2012;Committer;emboss;3;11;0;11;0
655a20ea9ddc13fc9359c3ae790371d658181db0;Fri May 25 12:14:48 EDT 2012;Committer;nobu;1;3;3;6;0
4258db79543d97845f0684f9b69911b67181cecd;Fri May 25 11:01:01 EDT 2012;Committer;ko1;3;67;11;78;0
a5f190615e894c0d1931300b27d8651f7eedf5e1;Fri May 25 08:07:16 EDT 2012;Committer;ko1;2;6;1;7;0
67075af60033d765ac468dee7645cbc4f15da5bd;Fri May 25 07:13:03 EDT 2012;Committer;usa;2;11;6;17;0
9a66f6f07e89f431476feff1798eefcb48b5a46d;Fri May 25 04:53:54 EDT 2012;Committer;nobu;1;57;57;114;0
1f3142a4477a10bfe566c17837c2a0b9f6cba00f;Fri May 25 04:50:10 EDT 2012;Committer;ko1;6;342;169;511;0
26f96fe1ce6178a83a0b3f0dbb9b4b9c7692103e;Fri May 25 02:20:36 EDT 2012;Committer;nobu;3;56;0;56;0
38f0dd0aba75a31008a698362e264ad894c10685;Thu May 24 23:51:56 EDT 2012;Committer;drbrain;2;9;5;14;0
80aaa3ef6c87a4cbb13c92097ee5170a663d4175;Thu May 24 16:15:42 EDT 2012;Committer;nobu;4;20;7;27;0
8996556b058b64226e15284d55f87640586b4315;Thu May 24 15:37:29 EDT 2012;Committer;svn;1;2;2;4;0
d176c4ee9908e416662e332eca37b851a7446d3c;Thu May 24 15:37:25 EDT 2012;Committer;nobu;2;11;0;11;0
ce8e2d54049ddbe4947ed90295b1b4d11ebaaa52;Thu May 24 14:36:54 EDT 2012;Committer;nobu;6;88;10;98;0
60e8cd2e686efd3a965cb43ae5963ce31fc90d71;Thu May 24 14:01:41 EDT 2012;Committer;nobu;1;1;2;3;0
ab42fe2a419d15df8f2a799204acb1580f7e96ea;Thu May 24 14:01:39 EDT 2012;Committer;nobu;1;4;2;6;0
e1c652bbaf47cb2049990c6ff370b9fb1ed5bfdd;Thu May 24 14:01:37 EDT 2012;Committer;nobu;1;1;6;7;0
a4a922e9bce0ba129d458f340b603a7a8c4b0bc0;Thu May 24 14:01:34 EDT 2012;Committer;nobu;2;10;10;20;0
04a03b34c3b5320c23d9e78f4acc884370e01bb1;Thu May 24 09:51:20 EDT 2012;Committer;nobu;2;8;8;16;0
d5893b91faa7dc77ca6c9728d1054dabd757aead;Thu May 24 06:36:44 EDT 2012;Committer;ko1;5;19;20;39;0
3dcebce5235276e99a75c6b0c71f4f3c4f4e225c;Thu May 24 06:09:23 EDT 2012;Committer;ko1;11;426;28;454;0
bd5c7507ec8dd484d5eab526c0ea1fa409d2959a;Thu May 24 04:05:09 EDT 2012;Committer;naruse;1;1;1;2;0
73f380478982c39ef1c9fd983128c680de02bff5;Thu May 24 03:07:54 EDT 2012;Committer;svn;1;2;2;4;0
3cc5ddcac142317709aa235a27d8ce0a84140150;Thu May 24 03:07:49 EDT 2012;Committer;nobu;3;88;35;123;0
3ba0abdb157b490644264c3bc45cb8fbc1e1f46b;Wed May 23 13:09:26 EDT 2012;Committer;naruse;3;61;12;73;0
b0dd250dc95ea0fae89c3201967039d582fbf156;Wed May 23 07:13:21 EDT 2012;Committer;nobu;21;46;46;92;0
87c8c5edf43a7f7d33d5fe75f51ef410a03b93b1;Wed May 23 01:21:33 EDT 2012;Committer;usa;2;28;8;36;0
510bbe015dcc1f4f6ecfceedbafed0fdef688961;Tue May 22 20:36:21 EDT 2012;Committer;drbrain;11;1448;1437;2885;0
8225fd3d4ca854f715ca8d59b6a4a4b219af0a24;Tue May 22 20:15:33 EDT 2012;Committer;svn;1;2;2;4;0
1d4e7d923266090844ef1bc1afc8704b75b7d057;Tue May 22 20:15:28 EDT 2012;Committer;drbrain;3;33;0;33;0
cb61ea5ef3aee59c0c5026c113ef5954992f7ca1;Tue May 22 13:20:52 EDT 2012;Committer;nobu;1;1;1;2;0
3cbf88d8d421ff9345466f6c7352e5b7b3940079;Tue May 22 12:35:18 EDT 2012;Committer;naruse;1;13;11;24;0
8bcf7fc40266faa09cf8b6cebb2d96c1bb8d51ee;Tue May 22 08:31:38 EDT 2012;Committer;ko1;10;114;77;191;0
9c46e774c15668b7fbf3df8a9a9ea912b5908738;Mon May 21 15:47:08 EDT 2012;Committer;svn;1;2;2;4;0
f9217681c5fd1d9bfc91945c7a32eb2fd76a7c98;Mon May 21 15:47:03 EDT 2012;Committer;mame;2;11;11;22;0
2f6c48e53b36397b7ef61fc3194d35aa2b89a1c6;Mon May 21 14:03:18 EDT 2012;Committer;naruse;1;1;1;2;0
f6fb038dee4a385e7d4e3b2816a96157401953b0;Mon May 21 12:56:17 EDT 2012;Committer;naruse;3;209;10;219;0
acb10b8c32a7235b56e4f4346e8ed6bf5026166a;Mon May 21 08:48:32 EDT 2012;Committer;naruse;1;1;1;2;0
e7ce7713545f06b33f020abb6b064283c78bbc92;Mon May 21 07:36:58 EDT 2012;Committer;nobu;1;1;1;2;0
05b26a85b86ea6fb458abb0aeff5970eb600f56d;Mon May 21 07:18:49 EDT 2012;Committer;knu;3;99;67;166;0
28fc368955fc94726ec95fcecb1f2aeab6d1aa64;Mon May 21 07:18:47 EDT 2012;Committer;knu;2;11;16;27;0
1b84082a613b7bf3a6a9380b095ee4df4f551011;Mon May 21 07:18:43 EDT 2012;Committer;knu;2;7;0;7;0
9c14029fce49322fc434bf59bfa99f71a9eb2dec;Mon May 21 07:05:50 EDT 2012;Committer;nobu;1;3;2;5;0
51a929c66d84a5a64ed82313ea995dcf3b82e93f;Mon May 21 03:45:52 EDT 2012;Committer;shyouhei;2;8;0;8;0
fb2e6803b0df64cadfc6b1189c25332e948e9ddd;Mon May 21 03:11:28 EDT 2012;Committer;nobu;3;36;3;39;0
52f0c6780e5abd58a68befdbf14a6a065161bf8d;Mon May 21 02:27:07 EDT 2012;Committer;naruse;3;30;12;42;0
d795f2d1a803c03a7180f6f5049d3a9a0e8849f0;Sun May 20 21:56:40 EDT 2012;Committer;naruse;2;14;0;14;0
03570f8091bc5641bdb0020eccfa6bdf8556c8c3;Sun May 20 15:58:03 EDT 2012;Committer;nobu;3;3;3;6;0
f244f525c5172d25dbfb5cb0ef3af4428144d224;Sun May 20 15:58:03 EDT 2012;Committer;svn;1;2;2;4;0
78990343431fbf3f4235ac9ec7dc136dcb9ac591;Sun May 20 15:58:00 EDT 2012;Committer;nobu;1;1;1;2;0
3f6ec3ddcc91e106b1fe9aa574632edcf9b9a80f;Sun May 20 14:18:04 EDT 2012;Committer;nagachika;1;1;1;2;0
e95d69038046f7929721905e95fb454a853b09e3;Sun May 20 14:00:15 EDT 2012;Committer;nobu;2;12;4;16;0
2dc01a5f2f0a0968cf142bf3de06bd0240476722;Sun May 20 14:00:13 EDT 2012;Committer;nobu;1;1;1;2;0
ea0c3a883262b826c2b0f4bc74910b15e8757342;Sun May 20 14:00:10 EDT 2012;Committer;nobu;1;1;1;2;0
2053b5f4538e157581b8fbf96a30624a2594158c;Sun May 20 13:32:16 EDT 2012;Committer;naruse;4;39;5;44;0
44faaf110f45bf5b2591409959f5af30f537007a;Sun May 20 03:25:19 EDT 2012;Committer;svn;1;2;2;4;0
a906a9d9bebe795eefc3811884c3249ca80e347b;Sun May 20 03:25:14 EDT 2012;Committer;nobu;5;13;2;15;0
9373d91585ac9d298ad32722d97bb4d065fc46a9;Sat May 19 10:13:32 EDT 2012;Committer;nobu;1;10;4;14;0
15bf3182c65bcd84fe1f4815c767730839f39082;Sat May 19 10:04:40 EDT 2012;Committer;nobu;2;5;2;7;0
e990086711a397a30245e90ecd6d941b7ae14d8d;Sat May 19 06:02:43 EDT 2012;Committer;nobu;1;1;1;2;0
a99bf256ff0384f2bd94a73d9f3f80371f947228;Sat May 19 05:57:32 EDT 2012;Committer;nobu;2;5;2;7;0
08b15235532a5af9ba9d2f6bebec5b5a41fecfa4;Sat May 19 03:44:04 EDT 2012;Committer;nobu;1;2;1;3;0
e546f716d09b413400733ad4218b6173cbb48764;Sat May 19 03:36:39 EDT 2012;Committer;nobu;1;1;1;2;0
0e60b2c6a3c5152fc4ff06054a4ae79edadf9276;Sat May 19 02:37:21 EDT 2012;Committer;nobu;4;21;7;28;0
1a6b07d71669658dcdb72d0937482aa6b9510e15;Sat May 19 02:36:25 EDT 2012;Committer;nobu;2;20;18;38;0
0a6700fec25027188f01105d1fcaa96a9d4fe385;Sat May 19 02:35:37 EDT 2012;Committer;nobu;3;8;3;11;0
2278902a765084a23201760a5c879882b8e4b239;Sat May 19 02:34:37 EDT 2012;Committer;nobu;2;5;1;6;0
54872dd7b3d33110812fe5ac8187baed5d4a164f;Fri May 18 19:51:58 EDT 2012;Committer;kosaki;3;15;10;25;0
5128c1732e38dea4aed204b06ad56c22cee30742;Fri May 18 16:22:09 EDT 2012;Committer;svn;1;2;2;4;0
60945b6162ca9e7e9fe4e612d895a65f37d968e6;Fri May 18 16:22:04 EDT 2012;Committer;kazu;1;8;9;17;0
2641f1d19f86404677bc49d81ca40c488c38f8cf;Fri May 18 09:13:47 EDT 2012;Committer;nobu;2;8;2;10;0
469cc485423c8abc268ff7cdd8c52e5cb7675f26;Fri May 18 09:10:46 EDT 2012;Committer;kosaki;1;1;1;2;0
1a2ef6bae3c0db71adbbe9e871ca87a87b4d647c;Fri May 18 08:47:54 EDT 2012;Committer;kosaki;2;13;4;17;0
c7c7dfd2fcbb7305d28cdff5d1ac44f4ad9c4fe3;Fri May 18 08:41:02 EDT 2012;Committer;nobu;2;6;1;7;0
5c56769118deac7f79030a87bb272bd82aeba2e4;Fri May 18 08:32:56 EDT 2012;Committer;kosaki;2;12;2;14;0
c196e22a42ccc7d9f8cdb58ec573c1c5e1ac950e;Fri May 18 08:26:10 EDT 2012;Committer;nobu;1;3;0;3;0
9381cd1184f8230de4c60b27d3c788107bfa292c;Fri May 18 07:32:08 EDT 2012;Committer;naruse;3;29;5;34;0
69305da74d9d6f3c0da668b9a95d872eee27e527;Fri May 18 07:02:56 EDT 2012;Committer;kosaki;2;5;2;7;0
2e4645ca166e3c3fab5f85159fd0b06e868a45fa;Fri May 18 07:02:39 EDT 2012;Committer;kosaki;2;5;1;6;0
6074032ae6afea7dd2cd12b6333ae01bab2c3159;Fri May 18 07:02:25 EDT 2012;Committer;kosaki;2;6;2;8;0
522627d5cc3b435b2f510057b24c75ad1dd26d7d;Fri May 18 07:02:10 EDT 2012;Committer;kosaki;2;7;3;10;0
933b5ced230b8b02c03133c55d65b23cbce22cb3;Fri May 18 07:01:54 EDT 2012;Committer;kosaki;2;6;2;8;0
4e9a880916bd99057a2af4ed022fdcb87de4d645;Fri May 18 06:24:34 EDT 2012;Committer;kosaki;2;6;1;7;0
899bf4981a17846ac205383e47fa0cf8428dacd0;Fri May 18 06:19:25 EDT 2012;Committer;kosaki;3;20;4;24;0
d17b97ce641ffa055f22ef8badcf4340909f643a;Fri May 18 05:06:49 EDT 2012;Committer;nobu;1;0;3;3;0
291f3a10f2979d17952e9af7ef103c3ccdfea697;Fri May 18 04:50:09 EDT 2012;Committer;nobu;1;1;1;2;0
8f231e1eeff8afc71193a5dccdb2916cbc9eab2f;Thu May 17 21:14:24 EDT 2012;Committer;drbrain;4;691;0;691;0
4a7add1a7410bf3ab067bea3e4337ea78fe2f639;Thu May 17 16:29:39 EDT 2012;Committer;tenderlove;2;7;2;9;0
cc8ed44f106c7b07d614a4963600b5e9716026fb;Thu May 17 15:13:32 EDT 2012;Committer;svn;1;2;2;4;0
d9b578f4a01c4d02ec4da24e7ee9451acbc1a8b7;Thu May 17 14:05:09 EDT 2012;Committer;nobu;1;1;1;2;0
7788d102c9fe6f58ec9413009374ffeb6b58c84f;Thu May 17 14:04:02 EDT 2012;Committer;nobu;3;11;3;14;0
315a0cb926ab5a4654a4e0a84eb600512e9960a3;Thu May 17 04:08:09 EDT 2012;Committer;nobu;1;0;2;2;0
82983e834d2122c3a53c30b166b7eb708da4885f;Thu May 17 03:54:50 EDT 2012;Committer;yugui;3;10;5;15;0
1d7dc02647c13c8f3884fcaa80b7f11415205384;Thu May 17 03:20:02 EDT 2012;Committer;yugui;2;7;2;9;0
76bc2d1ed7f13fb329c33f48756ea3c24c59a6ea;Thu May 17 02:48:59 EDT 2012;Committer;yugui;37;1855;36;1891;0
0a7aada5d18441b437f5e406a991d963b3613d9a;Thu May 17 01:55:00 EDT 2012;Committer;nobu;2;6;2;8;0
7333fbf0f79abe891e386e229a25e4848014c0b5;Thu May 17 01:39:39 EDT 2012;Committer;nobu;2;10;9;19;0
58e7c45fc7398496e17760ac4b4d588e51b6b9fc;Thu May 17 01:37:08 EDT 2012;Committer;nobu;3;21;14;35;0
9914991769fd9e4cf67e5a9f8c36f1f18efe9070;Thu May 17 01:34:40 EDT 2012;Committer;svn;1;2;2;4;0
77c4a51cef777dbbd7b8e4b8e010d6c5d11f9208;Thu May 17 01:34:35 EDT 2012;Committer;nobu;2;7;1;8;0
b85e3e70eee6905e34eb8efae9db9f9eb75d94f8;Wed May 16 09:05:59 EDT 2012;Committer;nobu;1;1;1;2;0
a2976afa0e922f8c62abbcb37e88754f347fd056;Wed May 16 06:47:49 EDT 2012;Committer;yugui;2;5;1;6;0
5950dd1967e69b1d8a0dda1e79685c2564d63183;Wed May 16 06:45:00 EDT 2012;Committer;usa;2;6;1;7;0
4407beaef971acd23726dc809dbc3826fa4bb9ed;Wed May 16 06:15:56 EDT 2012;Committer;nobu;2;22;17;39;0
3fa3f9abb9a187a12089c2c5a650a62dbd82a3dd;Wed May 16 05:39:06 EDT 2012;Committer;yugui;31;306;129;435;0
0923ae5ed1711d699ef2923c2223163646634a66;Wed May 16 05:31:27 EDT 2012;Committer;usa;2;6;2;8;0
80bd769f18179e7eb1bad63fc37cf005c5b5631d;Tue May 15 23:36:00 EDT 2012;Committer;nobu;1;22;0;22;0
00fd38644d905c9ce17f32ab6873ba8eeac57cd1;Tue May 15 22:03:37 EDT 2012;Committer;tadf;3;76;31;107;0
b4bdb2f2ebcdd8d77826706470fdeed642b3dee5;Tue May 15 20:13:21 EDT 2012;Committer;tenderlove;4;27;2;29;0
5341e3ccc4a58ae765e6d78c65bdc33157527aec;Tue May 15 16:34:21 EDT 2012;Committer;tenderlove;3;21;0;21;0
dcf9ae93866bb9c3605c44f6fba2ce184be84b7e;Tue May 15 16:24:34 EDT 2012;Committer;svn;1;2;2;4;0
f78fcf1010ce62cd4c52d124bd283fa398f5a9f1;Tue May 15 16:24:31 EDT 2012;Committer;tenderlove;2;7;0;7;0
5bca86dde251a9c03330737546256a9efcb046a5;Tue May 15 14:59:50 EDT 2012;Committer;nobu;2;37;14;51;0
b32388d5f805dd56dfc760662894893b6b3bdb92;Tue May 15 14:54:15 EDT 2012;Committer;nobu;1;20;0;20;0
0d9608eb3cc4d15c82692781cb608ce15c13c41d;Tue May 15 14:54:12 EDT 2012;Committer;nobu;1;4;2;6;0
498a001fa7a1d6a8a040b1725cd8551ad317c462;Tue May 15 14:54:09 EDT 2012;Committer;nobu;1;8;8;16;0
068253783e1dde29d5e03bb9566b22abcb1ed24b;Mon May 14 21:39:33 EDT 2012;Committer;svn;1;2;2;4;0
b6de661b54b00e92f175afb52c022d4f608f60cc;Mon May 14 21:39:25 EDT 2012;Committer;tadf;2;25;21;46;0
3e972bbaba4291ab0b22349a90d63cdcf035b5b3;Mon May 14 07:46:02 EDT 2012;Committer;naruse;1;17;3;20;0
45f6cdcdd3d11de1bf7691f732bc967880b4caad;Mon May 14 07:28:36 EDT 2012;Committer;nobu;3;14;0;14;0
c80308119b134e63fbc776aca077118ce3e7db4c;Sun May 13 22:39:13 EDT 2012;Committer;tadf;1;17;36;53;0
43d9f8972cd7fb0438c12f9be8174252cf4e14ba;Sun May 13 16:24:10 EDT 2012;Committer;nagachika;1;1;1;2;0
246a3058ea3c2da28e7db0ae81f28f371d98c8f6;Sun May 13 15:24:45 EDT 2012;Committer;svn;1;2;2;4;0
4007da1792091c8a3fae0380c139f7f3a434c0af;Sun May 13 15:24:40 EDT 2012;Committer;nagachika;3;19;1;20;0
526a853d6d6dbc126aa1e7ab113fc72a481c081c;Sun May 13 14:50:49 EDT 2012;Committer;nagachika;2;9;2;11;0
806018e8f4fed0e333c7233e5042fcfbdfdb8263;Sun May 13 14:47:29 EDT 2012;Committer;nagachika;2;5;8;13;0
23e7a4e285767b613349038b8601372e214342ec;Sun May 13 14:00:16 EDT 2012;Committer;akr;2;9;2;11;0
b1984f9d52e70dca65369b6a6a67c3881067a6ab;Sun May 13 09:14:46 EDT 2012;Committer;tadf;2;584;1085;1669;0
2168ae602f40c3be5ada5ca258a6ac52f0124f24;Sun May 13 08:39:18 EDT 2012;Committer;tadf;2;206;225;431;0
7c9430921bff932f708c016c99acc5d13f22bdea;Sat May 12 21:46:55 EDT 2012;Committer;svn;1;2;2;4;0
32ef61144b9556fd73bd6c5d953b74a163939047;Sat May 12 21:46:51 EDT 2012;Committer;luislavena;2;14;0;14;0
83d7576548cd26f59c283ec6e570df44f71f8394;Fri May 11 22:10:43 EDT 2012;Committer;drbrain;1;1;1;2;0
66796b4c7efefc71a9fe9c085d4669df0bb4e672;Fri May 11 22:00:43 EDT 2012;Committer;drbrain;2;342;3;345;0
dfa9522c338d06b709cc18bc7456e146491a33fe;Fri May 11 21:02:58 EDT 2012;Committer;drbrain;2;6;1;7;0
151093b97ed3c394a47d54bc59f299262d964360;Fri May 11 20:39:35 EDT 2012;Committer;naruse;2;20;1;21;0
2650c695841062316bd0af7340390a390973a8f5;Fri May 11 15:24:32 EDT 2012;Committer;svn;1;2;2;4;0
cc08e95b206f8c98af9509f99339f3c8655481e7;Fri May 11 15:24:27 EDT 2012;Committer;naruse;3;2;10;12;0
38d3b013b7733d9ccd66c011d74c00b35bb704c4;Fri May 11 14:03:40 EDT 2012;Committer;naruse;3;10;2;12;0
2f56c64b4f4686e7a5adac3dc486319694ad2828;Fri May 11 14:03:38 EDT 2012;Committer;naruse;1;4;0;4;0
4bbb0f9801a2d3ff3635078cb38e1b4922f32573;Fri May 11 05:23:14 EDT 2012;Committer;nobu;3;13;0;13;0
af310963abb1ef737d52b29ec77f6598ac505472;Fri May 11 05:09:58 EDT 2012;Committer;nobu;2;7;1;8;0
9cc7e9d1e8cea421808340ac2ccbc0c484b527fc;Fri May 11 04:50:54 EDT 2012;Committer;nobu;2;213;297;510;0
5f58cd09062f2c22f776e62ad5e0c4d28e4e8969;Fri May 11 00:51:10 EDT 2012;Committer;nobu;2;10;2;12;0
c8b35283832e157e4d4d7f78cc04783f420de542;Thu May 10 18:44:25 EDT 2012;Committer;mrkn;2;297;213;510;0
bc6a32cee6a3193aca176381ff54023712ec823e;Thu May 10 18:03:10 EDT 2012;Committer;svn;1;2;2;4;0
64c73b501bd45040a37436804e3e0c8d5baf0851;Thu May 10 18:03:06 EDT 2012;Committer;tenderlove;1;30;0;30;0
bfbf9d0956e05fb3b8d1025f21414d6ef7a3693e;Thu May 10 12:37:56 EDT 2012;Committer;naruse;1;1;1;2;0
ba8a74314e475631f5aa3353933d3b7768f30558;Thu May 10 08:29:33 EDT 2012;Committer;naruse;1;11;3;14;0
08b3a446e59aad15a30b7ee5246572c8eb7c84a5;Thu May 10 03:47:10 EDT 2012;Committer;naruse;1;26;8;34;0
989f5a1e6fc2074158456e70529002cb5e4d29d0;Thu May 10 01:55:38 EDT 2012;Committer;nobu;3;10;2;12;0
352010845b3c0294d9ecd14dd392fd0670d54ba6;Thu May 10 01:18:31 EDT 2012;Committer;svn;1;2;2;4;0
ae32e9a225d075d28a95da0537e098989fb42494;Thu May 10 01:18:27 EDT 2012;Committer;nobu;2;37;0;37;0
74134f57b15368f250e5e96a9d78ad6dfb5fe0f6;Wed May 09 07:36:03 EDT 2012;Committer;nobu;2;6;2;8;0
2e63cd97c1a1acf7cd93976c7e7531c46901e1d2;Wed May 09 07:03:19 EDT 2012;Committer;shugo;3;24;14;38;0
e62c35fb8f7bc9fd9bc7e99a603da492fc89d21c;Wed May 09 04:26:29 EDT 2012;Committer;nobu;2;15;7;22;0
a213c2ed9c84f0f64f0664e820227034d078f9f9;Wed May 09 04:09:25 EDT 2012;Committer;ryan;9;184;67;251;0
2dece928e085d25e8326455b9c0f508a2d70d02d;Tue May 08 21:33:31 EDT 2012;Committer;drbrain;2;6;1;7;0
16c364ade4331a8310624c220cd54975c7e69aa6;Tue May 08 21:25:34 EDT 2012;Committer;tadf;2;16;32;48;0
9fdf9df1b20fe0830075a7af9cb5f90e0391bdd2;Tue May 08 19:35:14 EDT 2012;Committer;svn;1;2;2;4;0
113b94e1452048cb88d512d3ab22dfa5f7c2930e;Tue May 08 19:35:07 EDT 2012;Committer;seki;2;11;2;13;0
a089fe010e673d2579250e3f0dc41ec89b2f8d26;Tue May 08 14:28:36 EDT 2012;Committer;kazu;1;2;2;4;0
5ccee663e9150df0de86f8eaaebed079c7561186;Tue May 08 12:47:25 EDT 2012;Committer;shirosaki;7;134;23;157;0
7e134cf71e2535b562cd2d81e3ff69cbe49d0ce0;Tue May 08 12:01:05 EDT 2012;Committer;shirosaki;3;32;0;32;0
c45d780b830dba93d67fd49bccafc401b3805bcb;Tue May 08 06:50:05 EDT 2012;Committer;nobu;1;6;2;8;0
63a164f32ed6c62cd40304837ad8f8a3f93a4296;Tue May 08 06:50:03 EDT 2012;Committer;nobu;3;16;7;23;0
a0d2cd2e1eee9765b14506360d51d6b1e2f23b58;Tue May 08 06:49:59 EDT 2012;Committer;nobu;5;29;26;55;0
965121cdc5675d6d6f3ed356210eb447e87f7b4d;Tue May 08 04:47:35 EDT 2012;Committer;ayumin;2;38;12;50;0
f8599f92e7057fb38dc7acf3639c06a348111ad4;Tue May 08 04:36:04 EDT 2012;Committer;nobu;2;7;1;8;0
b4b9183ffc44b03a12d7a4c3abfdc8bf9d197454;Tue May 08 04:35:13 EDT 2012;Committer;nobu;2;7;1;8;0
844ddfdd0da7f06edfda1fa960fd1609d1264565;Tue May 08 02:23:15 EDT 2012;Committer;usa;2;12;2;14;0
779922622b7016fd06d595f37378b26825a194c6;Tue May 08 00:25:47 EDT 2012;Committer;nobu;3;5;5;10;0
1af101f8edd4d0990fe275c11ffd282132055a81;Tue May 08 00:25:43 EDT 2012;Committer;nobu;1;2;2;4;0
79f28211fdf79759de17cd1c45ddeed460c0b0da;Mon May 07 23:55:53 EDT 2012;Committer;drbrain;2;14;4;18;0
c047e1ec12cfb945988a7b243e02b82121880975;Mon May 07 22:46:15 EDT 2012;Committer;naruse;2;6;1;7;0
f6e2081c1610dc3eab3f37fcb9d6b43e68873ef2;Mon May 07 20:35:59 EDT 2012;Committer;drbrain;2;7;2;9;0
bd62d2a95ee0d237defe4a0fe584324b6cb4f0e8;Mon May 07 20:12:20 EDT 2012;Committer;nobu;1;1;1;2;0
5789992f33b0755bfd462f4edb03a37e489e7fbc;Mon May 07 19:47:47 EDT 2012;Committer;nobu;2;9;2;11;0
13c76c07e4344d1426e5bbf3898067d939b57af6;Mon May 07 18:54:37 EDT 2012;Committer;nobu;2;14;1;15;0
fbebe84864319be9f31e2600d6a65cd01c20a13f;Mon May 07 18:54:23 EDT 2012;Committer;nobu;2;101;25;126;0
fca2ac964df30d102ff516ac5f58f42d3ee241fb;Mon May 07 18:54:09 EDT 2012;Committer;nobu;3;11;5;16;0
ec76e156feeb28b59de8fdc40ff0c40d6d44a378;Mon May 07 18:53:56 EDT 2012;Committer;nobu;2;11;16;27;0
a6003269b6a8c80496141c91c778d169386da486;Mon May 07 18:53:42 EDT 2012;Committer;nobu;2;29;2;31;0
8da4634bc31db3e8ec4f20ef734aac1e3053dc14;Mon May 07 18:51:26 EDT 2012;Committer;nobu;2;53;2;55;0
9c4fc91c6b98b8ebacc599ae2eadb1eea503fa93;Mon May 07 18:44:36 EDT 2012;Committer;nobu;1;39;0;39;0
49331ddec794834987ec5e7c4aa51264345a8ca0;Mon May 07 17:49:53 EDT 2012;Committer;naruse;3;18;2;20;0
40f1939614fe43244486fb9086e68dbf2135a506;Mon May 07 17:49:48 EDT 2012;Committer;naruse;1;1;1;2;0
8545d2f4b9b72606894cfb9219f7554e13c63a90;Mon May 07 17:18:55 EDT 2012;Committer;nobu;1;6;6;12;0
a135202990348bcf587d2f0a36be8cae06b9a0cb;Mon May 07 16:00:53 EDT 2012;Committer;svn;1;2;2;4;0
5a00be2bf75939fd3bb05dabbdf46244eaa6bb43;Mon May 07 16:00:49 EDT 2012;Committer;naruse;18;79;43;122;0
5f7be3150f0bffb6a958770c61270302123774c3;Mon May 07 11:57:01 EDT 2012;Committer;emboss;4;229;156;385;0
e1ee200bf711df20fc0c89e6b78de01ceb0ef86e;Mon May 07 11:15:46 EDT 2012;Committer;akr;1;1;1;2;0
e76660caad5cda23abd65b7431f2df635280a741;Mon May 07 11:15:28 EDT 2012;Committer;akr;2;6;1;7;0
34a8bfa971e19985224b42af087778a4c14e0e6e;Mon May 07 09:08:17 EDT 2012;Committer;naruse;2;15;4;19;0
251001c8298412def115fc10e0798f283956b5c7;Mon May 07 08:46:50 EDT 2012;Committer;naruse;3;1;13;14;0
e9231035b2db3e693b1f3731424152bb2f3e3a16;Mon May 07 08:25:02 EDT 2012;Committer;usa;2;5;1;6;0
0bd56268cbb79343be10923ebbf3f2d0655b2ccc;Mon May 07 05:11:45 EDT 2012;Committer;nobu;2;9;1;10;0
0be8f819218c3244f011e52f26bdf41c69a993ed;Mon May 07 04:41:02 EDT 2012;Committer;nobu;3;12;0;12;0
9be3aa1767681caf5a441336eaf6408979a26649;Mon May 07 04:05:44 EDT 2012;Committer;shugo;3;44;0;44;0
0fce0545b607e1ac92457cc8523645c294c2d411;Mon May 07 02:03:28 EDT 2012;Committer;naruse;3;15;4;19;0
cc3f33073dc1c475f59a14753a4203c193f9fbfc;Mon May 07 01:27:59 EDT 2012;Committer;nobu;2;11;3;14;0
298258891d2f8a80f8d1eac193c6609a256a3cf0;Mon May 07 01:23:07 EDT 2012;Committer;nobu;8;46;69;115;0
b5ba059a0b21ba6a198d8dca864045c37ce3babb;Mon May 07 01:16:32 EDT 2012;Committer;nobu;2;6;1;7;0
07ea7112dd5e94eb5f11542141eef7a52abcdb49;Mon May 07 00:37:59 EDT 2012;Committer;emboss;1;1;1;2;0
5aa9b57d419d9ec6dd67c4611575e7fab2b28364;Sun May 06 22:26:13 EDT 2012;Committer;svn;1;2;2;4;0
060184c347822b11dff3db6bef915c04a564c4e4;Sun May 06 22:26:08 EDT 2012;Committer;emboss;4;82;5;87;0
6a7666e56290bd3647b4996c265b6794c3c9d0a4;Sun May 06 12:39:59 EDT 2012;Committer;naruse;3;25;20;45;0
6051f542608d2fa86c84f45aeae847022550dfcc;Sun May 06 09:40:47 EDT 2012;Committer;ko1;2;5;2;7;0
0a983d5a5838496709dd59c5904a8cf65b810f11;Sun May 06 05:51:17 EDT 2012;Committer;svn;1;2;2;4;0
a961a8edf04c81a22686728d59f2cba0f1fc481e;Sun May 06 05:51:13 EDT 2012;Committer;akr;2;5;1;6;0
ae4fa7951fde1844a11dae3a2c15d10a5fa99f03;Sat May 05 13:15:29 EDT 2012;Committer;naruse;3;36;42;78;0
f406e3ac638abd09f4c2c3900d4028f6a8a64071;Sat May 05 09:27:06 EDT 2012;Committer;ayumin;3;42;36;78;0
6af843b9cb99fb844bf866e71e9ee52be126080f;Fri May 04 21:46:01 EDT 2012;Committer;ryan;13;1097;278;1375;0
95d4b3ba4974fdb9f08900267964949e30b1c821;Fri May 04 17:07:18 EDT 2012;Committer;naruse;2;15;0;15;0
b17158a287b17cdfb6d1f10a859a5b60e720e67f;Fri May 04 16:14:57 EDT 2012;Committer;svn;1;2;2;4;0
afd9ce9d9e00cfc940e4989a34033fa73268d969;Fri May 04 16:14:51 EDT 2012;Committer;naruse;3;15;12;27;0
66b0d426ed2e918aa4ea637faf208a30a0cb97c8;Fri May 04 13:26:39 EDT 2012;Committer;naruse;1;5;1;6;0
09063f9d30658da148b2a4dd40ceca7d150e4aa6;Thu May 03 22:50:30 EDT 2012;Committer;naruse;1;2;1;3;0
8109c530b25eaea436107060e44799169d49a3bb;Thu May 03 22:20:26 EDT 2012;Committer;naruse;3;9;1;10;0
c327407bdc3c7213301f8aeed9097d8e4d3e623c;Thu May 03 16:57:51 EDT 2012;Committer;nobu;2;2;2;4;0
9bee6cf51fbbb4c813e92b8dece3e92a84c3d5ed;Thu May 03 16:33:22 EDT 2012;Committer;nobu;4;37;4;41;0
1348e3b9ac686433047b30689159f0e5bc3279dc;Thu May 03 16:31:25 EDT 2012;Committer;nobu;5;14;9;23;0
19be9a8d80bb170b9189c997af90329e7e7af92c;Thu May 03 15:09:44 EDT 2012;Committer;svn;1;2;2;4;0
4b0e5edaeaf1d49b499a5732f1e8ff229a6d9b64;Thu May 03 15:09:41 EDT 2012;Committer;nobu;1;18;18;36;0
aa913eb6fa699db663bb23a456a7274bce657fdd;Thu May 03 15:09:39 EDT 2012;Committer;nobu;2;4;4;8;0
3f6349a1bfb9031af085c57905d858b765a688bb;Thu May 03 14:56:39 EDT 2012;Committer;nobu;1;3;3;6;0
cfcc9b53c2dc92879fda8f8d35e49c2720917e2c;Thu May 03 14:56:36 EDT 2012;Committer;nobu;1;2;2;4;0
f959f2afddd4ab608d8349e61883b3b360beee08;Thu May 03 14:05:34 EDT 2012;Committer;nobu;1;2;2;4;0
f2a1e50f4c271e9f5aa2950ca25a58fd044304fb;Thu May 03 00:14:14 EDT 2012;Committer;svn;1;2;2;4;0
fd7632ee8e89be3372670e3079e8328ec78f09e1;Thu May 03 00:14:10 EDT 2012;Committer;ayumin;1;3;3;6;0
db33b28cc3f990d50cb869729f4eaca2ad1ece5e;Wed May 02 14:55:53 EDT 2012;Committer;nobu;2;6;1;7;0
f0feb0a4f024f8763763005937c664ef3013a595;Wed May 02 14:30:48 EDT 2012;Committer;nagachika;2;6;0;6;0
9cf2170e78dd1f6f9f7978d05d6947e6025dd61f;Wed May 02 14:21:23 EDT 2012;Committer;nobu;3;11;1;12;0
6f72a6dcb5c5945bdf1727914a786451f9668b9e;Wed May 02 10:13:28 EDT 2012;Committer;ayumin;2;31;0;31;0
8de9bb275f575ba1b5a2e6d44372c2f536e6bde1;Wed May 02 04:06:40 EDT 2012;Committer;nobu;3;134;125;259;0
1451c619a776aae8cf75c31ad6f1a3759a9bbb4c;Wed May 02 00:48:42 EDT 2012;Committer;kouji;1;1;1;2;0
9683b27c39cc5c7887af4186bbf853950e50f699;Wed May 02 00:48:03 EDT 2012;Committer;svn;1;2;2;4;0
7c602ea07f5b89eac209b6c6a53f695e12f9f0ce;Wed May 02 00:47:57 EDT 2012;Committer;kouji;4;88;0;88;0
517f225306008bc31253726afee606dff7baba6d;Tue May 01 14:23:22 EDT 2012;Committer;kazu;1;1;1;2;0
7a4b214558009bcb64630ae06e552a9c0c0ffba4;Tue May 01 13:21:55 EDT 2012;Committer;kouji;4;179;29;208;0
28b7df782088e1e18b53659b0ba0c96a1b8b1c8b;Tue May 01 07:15:18 EDT 2012;Committer;nobu;5;1;16;17;0
d7228e5bbae6a81f57f0ba96cbdefa21a9f4a330;Tue May 01 06:52:28 EDT 2012;Committer;nobu;4;8;0;8;0
1735969296836546e5aa4672ec21dd6cae325f96;Tue May 01 06:52:25 EDT 2012;Committer;nobu;1;8;1;9;0
e6bd1496a8f6c57c2b876d321483782485252859;Tue May 01 06:49:00 EDT 2012;Committer;ko1;2;5;1;6;0
458c30e57d23bbef7fda89e436a463ab6800d1e9;Tue May 01 06:37:24 EDT 2012;Committer;ko1;2;32;26;58;0
d32155358c67466d038436e6f03d41494043c53b;Tue May 01 05:18:02 EDT 2012;Committer;nobu;2;12;2;14;0
633cebb0efdf00b9a49493b65614c2d2d3b84905;Tue May 01 01:56:25 EDT 2012;Committer;usa;2;31;17;48;0
e1d1397af89857897baa612164d0ca3ff5af9ea6;Mon Apr 30 21:04:16 EDT 2012;Committer;nobu;2;14;8;22;0
26e258c807c25097ae41e9c5d7dcb3b7a3bda64c;Mon Apr 30 21:03:38 EDT 2012;Committer;nobu;7;38;22;60;0
0f1181a5390df3ac3a8e2d9f8bd9815c1215e94b;Mon Apr 30 20:14:26 EDT 2012;Committer;nobu;1;1;1;2;0
fa9a1b62f14fb20971b39a9f015bac3b46017d13;Mon Apr 30 20:02:38 EDT 2012;Committer;svn;1;3;3;6;0
7d45d3f84d99b1485092b36e62e5275211987f41;Mon Apr 30 20:02:34 EDT 2012;Committer;nobu;2;8;6;14;0
52af87a5a75f1d5bba26b8884cfa6c466ffee680;Mon Apr 30 14:45:31 EDT 2012;Committer;akr;1;3;1;4;0
7d89ecdc523aab7b9908501b6743da2c26a53825;Mon Apr 30 14:37:54 EDT 2012;Committer;akr;3;43;4;47;0
c40e6f82579f54d0fb437876d875de87a2d16241;Mon Apr 30 14:09:36 EDT 2012;Committer;nagachika;2;10;2;12;0
860cf7b8121bbb7ca4fa0191fef08587a826ba0c;Mon Apr 30 12:09:09 EDT 2012;Committer;nobu;2;15;2;17;0
ce007c7c86b4f6793179088937d23b5b01962118;Mon Apr 30 11:11:21 EDT 2012;Committer;akr;3;13;1;14;0
3893159530be06b978b4f15e12c9840862b73cca;Mon Apr 30 03:51:03 EDT 2012;Committer;ayumin;1;1;1;2;0
0456c36d03adcdc93893395b91c789c02b1b4917;Mon Apr 30 00:11:44 EDT 2012;Committer;ayumin;2;7;1;8;0
746c080bf388e0c9859ca5e1c297fa8c40ace80a;Sun Apr 29 19:44:22 EDT 2012;Committer;svn;1;2;2;4;0
13edcbea75e88a176e7fbbd96ef88484991f53df;Sun Apr 29 19:44:18 EDT 2012;Committer;tenderlove;2;7;2;9;0
75cff1d7d079ebcd7688341cf80bba6d647fd331;Sat Apr 28 22:24:01 EDT 2012;Committer;tenderlove;1;7;0;7;0
874acd73476420e9b1bc0d63c292d772d1aa55d3;Sat Apr 28 21:12:10 EDT 2012;Committer;svn;1;2;2;4;0
3380974143d3fdf1721d9e28d6b2d42036f03bd2;Sat Apr 28 21:12:05 EDT 2012;Committer;nobu;8;104;5;109;0
82fa2995b5ca47d3383cce82ba5c75da4f09da5a;Sat Apr 28 14:22:25 EDT 2012;Committer;nobu;1;3;1;4;0
55ac2cac3c13932666324706b75fdc04ea18e413;Sat Apr 28 09:59:48 EDT 2012;Committer;svn;1;2;2;4;0
6978b8ca6767cf79840354f7e0472d9d635a95b9;Sat Apr 28 09:59:44 EDT 2012;Committer;ko1;3;23;7;30;0
62d71852df7947239930f04f4f756f40881cfdaa;Fri Apr 27 03:36:33 EDT 2012;Committer;usa;2;10;0;10;0
0a68f1200bc11367f944f2bfbda5e06ec92e8c0c;Fri Apr 27 01:58:21 EDT 2012;Committer;nobu;2;12;0;12;0
664a13b732d26607632e9c46deb791e5e7e85e5e;Fri Apr 27 01:41:02 EDT 2012;Committer;nobu;1;10;0;10;0
c746b6fa42b1e68fb7284aa616d5ba7aef404dee;Thu Apr 26 23:19:11 EDT 2012;Committer;naruse;2;37;0;37;0
da12c793c4c7ae60b50b944791ad057de86cb527;Thu Apr 26 22:18:03 EDT 2012;Committer;akr;2;8;1;9;0
0e01d836df460ebf8b224e8b28d0e41dbacb65bc;Thu Apr 26 17:38:55 EDT 2012;Committer;svn;1;2;2;4;0
9a92bcdb267ead97059cf9cc08ac11a1144e9a48;Thu Apr 26 17:38:50 EDT 2012;Committer;kazu;1;2;2;4;0
b82f8f7191985abe997a8886f2b67e3a310524c0;Thu Apr 26 13:24:52 EDT 2012;Committer;akr;1;1;0;1;0
4c87e9433a95101352e0e17b0bd59901d0680931;Thu Apr 26 13:24:34 EDT 2012;Committer;akr;1;1;1;2;0
1413510ed2d8175dcce7c2c14c02e720c8406429;Thu Apr 26 03:34:12 EDT 2012;Committer;akr;6;65;52;117;0
2bc4268e7900808b6965176a975c9d392a1239fa;Wed Apr 25 16:36:14 EDT 2012;Committer;nagachika;2;13;0;13;0
df79ded6911d3d3c65d53e71567f7d37c8148326;Wed Apr 25 16:22:10 EDT 2012;Committer;svn;1;2;2;4;0
f51e9cc0f6b8aee44b9502c5a0569598507e3d7d;Wed Apr 25 16:22:06 EDT 2012;Committer;nagachika;1;1;1;2;0
c1d27b8c8d29ffc69f12b87e6261ff8fc4fc3701;Wed Apr 25 14:05:10 EDT 2012;Committer;akr;2;20;5;25;0
16a285491efec73480384c9e498307b94670448b;Tue Apr 24 20:46:19 EDT 2012;Committer;svn;1;2;2;4;0
3c2f707f1688a23602b9fdbc42db1970658b9945;Tue Apr 24 20:46:14 EDT 2012;Committer;nobu;3;7;2;9;0
a06cddb466eafb046fcfdf0fd60684acb0b3d0a3;Tue Apr 24 13:52:13 EDT 2012;Committer;akr;1;3;0;3;0
7c346a46d34332e52baa762f2e0dca978db5f8cf;Tue Apr 24 12:59:32 EDT 2012;Committer;akr;4;15;6;21;0
606208becf49fbfa8bb3d7e14acdb3c5bd947205;Tue Apr 24 12:55:13 EDT 2012;Committer;mame;2;6;1;7;0
dd5ae05b05241e9d5ee8e0d246c4622b59c147c6;Tue Apr 24 12:17:05 EDT 2012;Committer;naruse;2;7;1;8;0
276d82a7c8cf8f5e80c057f3b85dc293eb573fd7;Tue Apr 24 12:17:02 EDT 2012;Committer;naruse;1;1;1;2;0
756ffef448f1d56a805dad4bda9b11aaf047f6db;Tue Apr 24 11:14:18 EDT 2012;Committer;usa;13;9084;4;9088;0
66d247bcb50a29769ff940100223544c125521aa;Tue Apr 24 09:20:42 EDT 2012;Committer;ko1;3;80;49;129;0
24f00be686bdd5dc78a59b7566e85ab70796de01;Tue Apr 24 08:05:25 EDT 2012;Committer;usa;2;13;1;14;0
5f34227718b20c1f7b10798ff2180629a391e1a8;Tue Apr 24 07:04:41 EDT 2012;Committer;nobu;3;52;1;53;0
4f2b00429e9f98a91ae94f10d2d0435a120ed5e7;Tue Apr 24 06:51:44 EDT 2012;Committer;nobu;3;8;5;13;0
a9917efd5d99d8ba7a8a573c1f6bfb024cfb316e;Tue Apr 24 05:54:08 EDT 2012;Committer;nobu;3;24;2;26;0
770ddcdfe069f8654a07e0fcc758aea591cdd17d;Tue Apr 24 03:46:55 EDT 2012;Committer;nobu;10;156;2;158;0
b05c95d93f39b95c6c743282ce4d9e674453f12f;Tue Apr 24 01:56:35 EDT 2012;Committer;usa;2;9;2;11;0
28a8188e4d8af61ce94554743706d3eee2d1189a;Tue Apr 24 01:41:15 EDT 2012;Committer;nobu;1;1;1;2;0
7320d83753d90ff7fcc78567589f1eb52a7de9a0;Mon Apr 23 15:27:00 EDT 2012;Committer;mame;2;6;1;7;0
02bc20ac81a19d821270e91ce97e7a65b82f6cee;Mon Apr 23 15:23:54 EDT 2012;Committer;svn;1;2;2;4;0
563762f6c54ac7f6ceaee49f7212ab56eb2d2d06;Mon Apr 23 15:23:41 EDT 2012;Committer;mame;3;21;2;23;0
b712455f98ad4e7ef9c44d8384192369aaa77b62;Mon Apr 23 14:05:49 EDT 2012;Committer;naruse;1;3;0;3;0
19787c403858166b8a4def5dd7aab91e43cf947f;Mon Apr 23 13:57:53 EDT 2012;Committer;nobu;1;0;4;4;0
ce2dc60216934e01910d2a3424c2aa0fe3ce4736;Mon Apr 23 13:56:11 EDT 2012;Committer;nobu;15;4;1653;1657;0
82801b9113222c21b088e173521eda99277d1b1b;Mon Apr 23 13:48:47 EDT 2012;Committer;nobu;1;3;1;4;0
e0431daa00c45948d21ff46304aa885d465c9f57;Mon Apr 23 13:48:45 EDT 2012;Committer;nobu;1;5;2;7;0
c2cc5fc9618cb408f13e8ec16060274d3cbe6019;Mon Apr 23 13:48:43 EDT 2012;Committer;nobu;1;1;3;4;0
77b1d88513cb4aea0183fef256dc2d7f168a2b4b;Mon Apr 23 13:48:41 EDT 2012;Committer;nobu;4;34;32;66;0
535a28c73748874eed9016e48515f01a71c507eb;Mon Apr 23 13:48:38 EDT 2012;Committer;nobu;1;2;2;4;0
cf6116150c43ffa8cce7c4d0696bb54a2c8e49a8;Mon Apr 23 13:48:36 EDT 2012;Committer;nobu;1;1;1;2;0
7255d93b08909a0117840083322dc27d5568c423;Mon Apr 23 13:48:31 EDT 2012;Committer;nobu;1;3;3;6;0
146aff91c43bf19f753a928410f9e55b2a17868f;Mon Apr 23 13:09:48 EDT 2012;Committer;akr;2;7;1;8;0
ee8c98e5ccdc6a421d52652ae560f2efcb850749;Mon Apr 23 11:47:02 EDT 2012;Committer;usa;3;64;51;115;0
c2086cc7ff1142b14c95c8758af24b8689b78ffc;Mon Apr 23 11:15:35 EDT 2012;Committer;akr;2;10;2;12;0
8f16d22e99db6b3a2298d2bd6bc99ffd196bed33;Mon Apr 23 10:55:39 EDT 2012;Committer;akr;2;13;2;15;0
90d99ef1bd1ac0d76a163bafe96da986f158a167;Mon Apr 23 05:19:54 EDT 2012;Committer;naruse;2;6;2;8;0
e2b54072b5f3b93a15056efdf54697f36f674eb8;Mon Apr 23 01:43:35 EDT 2012;Committer;nobu;2;11;1;12;0
c9bbb3a8b8c2c09bd42af684319bcfb1983a6a6c;Sun Apr 22 15:04:53 EDT 2012;Committer;svn;1;2;2;4;0
eab4183f14c4441275a1df398a2df6434b1bc2d2;Sun Apr 22 15:04:44 EDT 2012;Committer;naruse;1;3;0;3;0
628d3807d2011d04cb0c8af2b1d482ae61d4c3ac;Sun Apr 22 12:43:53 EDT 2012;Committer;nobu;1;2;2;4;0
f2e9040aff1c4d32ee8dc0302f0d214ea2609a94;Sun Apr 22 12:39:55 EDT 2012;Committer;nobu;1;5;3;8;0
ec646dccdd208802f571afe6fff71f67de62029c;Sun Apr 22 12:22:57 EDT 2012;Committer;nobu;1;0;7;7;0
f7d01d27a60a53862e3d62dae80bee8d7ec23db5;Sun Apr 22 11:37:22 EDT 2012;Committer;akr;1;2;0;2;0
e16e961bab2c4f8ae66c2b19f638c63a48f19ae4;Sun Apr 22 11:35:03 EDT 2012;Committer;akr;6;53;11;64;0
f46ffca1c766cdb20dabb27e9bbe60a124e28bcd;Sun Apr 22 01:46:45 EDT 2012;Committer;naruse;1;8;3;11;0
cc19bcf11fdb008e74efdffab78b6680d2728385;Sat Apr 21 22:52:23 EDT 2012;Committer;akr;2;10;1;11;0
5849614d026501d810d45c25926c719313fe82e9;Sat Apr 21 16:21:46 EDT 2012;Committer;svn;1;2;2;4;0
2346056e6ae121253ab2ac9b4d792a62d851b1a7;Sat Apr 21 16:21:41 EDT 2012;Committer;nagachika;1;1;1;2;0
694fbfd6c07b0b0347f1229f5cdb027920b8eebe;Sat Apr 21 06:10:25 EDT 2012;Committer;svn;1;2;2;4;0
b384fe5e4fe0148157ee90b72ee6ca555d764bce;Sat Apr 21 06:10:21 EDT 2012;Committer;seki;2;6;1;7;0
d6ba4bcaa5d20c5e92b0108092eebea5231d383c;Fri Apr 20 10:51:25 EDT 2012;Committer;akr;1;10;1;11;0
b68e0dbfdf06ec50d10d1de34d21db9446c534f4;Fri Apr 20 03:28:49 EDT 2012;Committer;drbrain;4;9;237;246;0
4dd74831411cec03a4c3b2d34775e09d534c0e46;Thu Apr 19 23:41:36 EDT 2012;Committer;nobu;1;1;1;2;0
064bf602e0f42a925f470c219962e3a430bc5ca8;Thu Apr 19 23:07:48 EDT 2012;Committer;drbrain;14;3877;8;3885;0
83ed985182c5bbaba2c2a3c32bf1a4ecb6c0edde;Thu Apr 19 15:34:06 EDT 2012;Committer;svn;1;2;2;4;0
0968c22e10a858db44d233753d55c9889c022851;Thu Apr 19 15:34:01 EDT 2012;Committer;kazu;1;2;2;4;0
e0ffb9b59be89bc0434ebeacafa2bb0160306423;Thu Apr 19 07:33:55 EDT 2012;Committer;nobu;3;27;2;29;0
ec0bd633e274544391d5f7899d0bfd5b7c63f872;Thu Apr 19 03:21:23 EDT 2012;Committer;naruse;1;11;20;31;0
c1903a9f17ebda5c7c6d94e634d90e7ee0f98a72;Thu Apr 19 02:49:48 EDT 2012;Committer;naruse;1;2;3;5;0
1ff181cf8c8bc2226d947bbb04d7129767f6ccf6;Thu Apr 19 00:40:00 EDT 2012;Committer;nobu;2;11;2;13;0
0ba3c640f574764bd6dabaffb8d90e34dcfe0ec5;Thu Apr 19 00:38:11 EDT 2012;Committer;nobu;1;2;1;3;0
42a9234cc48382c3ea89ea04edf1b4d6e4b7972e;Thu Apr 19 00:35:32 EDT 2012;Committer;drbrain;2;9;3;12;0
6878e597c4412e5b5ca2539ed74ddd2455576f50;Wed Apr 18 23:59:22 EDT 2012;Committer;drbrain;2;13;3;16;0
ab0eb272f9e73123211574081aa8a0943678d80d;Wed Apr 18 23:48:27 EDT 2012;Committer;drbrain;6;101;6;107;0
aa883f84da4f3e4e82ecf2feaddca31d015f590e;Wed Apr 18 23:14:29 EDT 2012;Committer;svn;1;2;2;4;0
61c1fb7058b5c4b586bc77a808ace94cc0b8c2e8;Wed Apr 18 23:14:26 EDT 2012;Committer;naruse;1;10;0;10;0
7cfc4be29850673034fd2d121dcf6fb4d9892bdb;Wed Apr 18 13:59:00 EDT 2012;Committer;nobu;2;13;4;17;0
336cf57584dd8c055325da950c3f7c45dd8c1345;Wed Apr 18 07:10:38 EDT 2012;Committer;nobu;1;18;8;26;0
ab649ef3c4847e98d1712a7bd77ed3bd9ac44681;Wed Apr 18 05:50:45 EDT 2012;Committer;usa;1;4;0;4;0
ff19b1d81e330b8212d61288712e8cd436dd2990;Wed Apr 18 05:00:07 EDT 2012;Committer;usa;1;4;0;4;0
62c9ecfa122da546af36ed5a31e8696c62ced036;Wed Apr 18 03:59:15 EDT 2012;Committer;naruse;6;18;116;134;0
cc6ab53f592016daf6f4ef0075e4f33f365d638f;Wed Apr 18 03:38:09 EDT 2012;Committer;naruse;1;2;5;7;0
8de83c5198d72edeb0f65229bea535d7062689da;Wed Apr 18 03:31:11 EDT 2012;Committer;naruse;1;4;4;8;0
9d96fc17d7ed40ae7e0be723e1ae008cd4d0424a;Wed Apr 18 01:58:49 EDT 2012;Committer;nobu;1;11;6;17;0
62885f1ed1b7e4808c062194025c03b55f5d8a7e;Wed Apr 18 01:58:46 EDT 2012;Committer;nobu;1;0;5;5;0
085ae60ab9ef90df9b7e4cc2328a2557fdabb5e0;Wed Apr 18 01:46:42 EDT 2012;Committer;drbrain;1;0;9;9;0
442fefc78ac5230bda2c2fd78b9375091bcf193f;Wed Apr 18 01:23:00 EDT 2012;Committer;nobu;2;7;2;9;0
9e56e14f50d6b9de3654538af7a44f1f6ac8894f;Wed Apr 18 01:08:34 EDT 2012;Committer;naruse;1;21;20;41;0
5383ccd9814c2ec81413ed51f5ff8775497ebe5a;Wed Apr 18 00:58:47 EDT 2012;Committer;drbrain;2;9;0;9;0
6c1da63bd77b4caa409b919f8c9893b27f9ae1be;Wed Apr 18 00:04:12 EDT 2012;Committer;drbrain;36;1084;153;1237;0
0ebe38eedd3b0b0771f57e1d4a85d472a1b6b64f;Tue Apr 17 21:17:56 EDT 2012;Committer;drbrain;36;153;1062;1215;0
02dc9ae773d458be60f3fa656d5bb50f41a1c9e2;Tue Apr 17 20:50:07 EDT 2012;Committer;svn;1;2;2;4;0
22d9456b7917fe96fa81fd1d994073312753af8b;Tue Apr 17 20:50:00 EDT 2012;Committer;drbrain;36;1062;153;1215;0
22263729af357eb86e8bc2165a9eaa6f25eec8a6;Tue Apr 17 14:21:18 EDT 2012;Committer;nobu;1;5;4;9;0
902084a60a0e4d47621bdfc458480f42135d3da7;Tue Apr 17 13:35:40 EDT 2012;Committer;nobu;1;2;2;4;0
43dbbefbdf9cf46933bb4c24929de9e8b1a66429;Tue Apr 17 13:18:51 EDT 2012;Committer;nobu;3;28;3;31;0
77321aeed941c7fd2e09c881e636562440217511;Tue Apr 17 11:14:24 EDT 2012;Committer;naruse;1;1;1;2;0
f5659a911c48ddfdc33f3b6ad0b71752e46047c7;Tue Apr 17 05:12:53 EDT 2012;Committer;nobu;1;1;1;2;0
0a706449d149650e35cdb839a6a504a589b78dd5;Tue Apr 17 04:55:14 EDT 2012;Committer;nobu;1;1;1;2;0
561e61a430e49b25326bac833f450498ea02afce;Tue Apr 17 04:55:12 EDT 2012;Committer;nobu;1;1;1;2;0
485f88e62e1e00a5a49ca9054ecadfb101ad7a89;Tue Apr 17 04:55:10 EDT 2012;Committer;nobu;1;6;9;15;0
854a6e47a5eeabd177f23dae121c07e36c9eab38;Tue Apr 17 04:55:07 EDT 2012;Committer;nobu;1;2;0;2;0
68bf309945986fd2d4ad8ee9b266a53bf4f371f0;Tue Apr 17 04:17:05 EDT 2012;Committer;nobu;1;1;2;3;0
cc433788dec1a0a259cc106125a5c2e14a94c9da;Tue Apr 17 04:11:22 EDT 2012;Committer;svn;1;2;2;4;0
dad31f6e5047272cea5a65c764281bcaa7284131;Tue Apr 17 04:11:17 EDT 2012;Committer;nobu;7;69;6;75;0
6655667d738d59cc824b264eef4587fe9700af15;Mon Apr 16 12:25:29 EDT 2012;Committer;nobu;2;11;2;13;0
e0e479fbc58e18e323c9a57bb16773b7a1e8cb50;Mon Apr 16 09:23:50 EDT 2012;Committer;naruse;2;10;4;14;0
f2979f3101a0cb1467971ea3b4794c19c6b639dd;Mon Apr 16 07:22:43 EDT 2012;Committer;nobu;5;114;1;115;0
72fffe5cee069d9f47a7a8dc808885aec67da225;Mon Apr 16 07:08:27 EDT 2012;Committer;nobu;5;17;7;24;0
8b25f42046871e94a857dab5ecfb49a8d8fec4c1;Mon Apr 16 06:19:46 EDT 2012;Committer;nobu;2;5;1;6;0
7d84f55f3ed8fcecdb5994b607e749b0be22e60a;Mon Apr 16 03:22:05 EDT 2012;Committer;usa;1;1;1;2;0
b62792e54065cc2539985ccabc6426ec05dc60f2;Mon Apr 16 03:17:45 EDT 2012;Committer;marcandre;2;6;1;7;0
fc7676fcd6c66e6696008ef190d796d740b686a7;Mon Apr 16 03:16:40 EDT 2012;Committer;marcandre;3;20;1;21;0
db66739c7ce253a9051df316518948361787b50b;Mon Apr 16 03:16:25 EDT 2012;Committer;marcandre;2;16;17;33;0
1dbe0f0672cfc16c875d0a47bde266ddbaa8ba98;Mon Apr 16 03:16:10 EDT 2012;Committer;marcandre;2;31;0;31;0
33399fe8248a25132343b1b5be3a35357c3d9099;Mon Apr 16 03:15:56 EDT 2012;Committer;marcandre;2;22;0;22;0
f92be2c01a7417c88b47373a4e43aabd7918f225;Mon Apr 16 03:15:42 EDT 2012;Committer;marcandre;2;27;0;27;0
0c7163ae5ea5f701f13726e39729e0727b53bf55;Mon Apr 16 00:44:52 EDT 2012;Committer;svn;1;2;2;4;0
e6882349c09d3fd7d01478dd378994502777a164;Mon Apr 16 00:44:47 EDT 2012;Committer;usa;2;7;1;8;0
164ced04de494d709f9006cac920579d84b6befd;Sun Apr 15 07:37:45 EDT 2012;Committer;naruse;3;17;15;32;0
57fb2199059cb55b632d093c2e64c8a3c60acfbb;Sun Apr 15 00:06:13 EDT 2012;Committer;nobu;11;62;99;161;0
b860144680e3af51f7fc0d7185185a92c4fa6aca;Sat Apr 14 18:56:16 EDT 2012;Committer;svn;1;2;2;4;0
05af801f4cc6936a58ec5ba65584bff25db2863b;Sat Apr 14 18:56:12 EDT 2012;Committer;naruse;1;9;3;12;0
d2e2b309e82f9f0f68f62952673233331465917f;Sat Apr 14 03:55:06 EDT 2012;Committer;nobu;3;10;1;11;0
c26ea74ad670be16cab2f38ec557d1d0505e5d39;Sat Apr 14 02:30:43 EDT 2012;Committer;naruse;3;15;6;21;0
e95f7ea80d096cf27ea0ae5f7dc712ad72e71f3c;Sat Apr 14 00:36:26 EDT 2012;Committer;drbrain;22;110;39;149;0
da39d32f60778b111c6cf063ae74e2627be14b77;Fri Apr 13 23:45:37 EDT 2012;Committer;drbrain;27;124;1;125;0
d377a6fffe362b90833ac3c4ed43c7c8af40cef9;Fri Apr 13 15:34:39 EDT 2012;Committer;svn;1;2;2;4;0
24476c0c0baaea216d3a4756c4ebea4dfd265b1a;Fri Apr 13 15:34:34 EDT 2012;Committer;nobu;2;8;10;18;0
723bfaba5944a205844ef37456d5dbf2e92291ee;Fri Apr 13 11:30:39 EDT 2012;Committer;nobu;1;5;6;11;0
99d38f82e0ff0480822fe25047b07a07030a7c3e;Fri Apr 13 08:39:13 EDT 2012;Committer;naruse;2;6;2;8;0
2d74f3e682a706857cc6f9891180f6a33d1bfa9f;Fri Apr 13 06:26:53 EDT 2012;Committer;nobu;2;89;21;110;0
deb0519aec1e68bdcf019d99e3e8be55fd5b2faf;Fri Apr 13 06:21:50 EDT 2012;Committer;naruse;3;23;15;38;0
d2e69f8584577240d59560d0f68300af59430a4c;Fri Apr 13 02:51:45 EDT 2012;Committer;svn;1;2;2;4;0
bb8446205f297e31c04a3aef9bd92075bba6bfb5;Fri Apr 13 02:51:40 EDT 2012;Committer;nobu;1;2;2;4;0
3a71da583076f6a827005c87f2d85843d125c4d6;Thu Apr 12 10:52:58 EDT 2012;Committer;tadf;2;13;5;18;0
2417bd10d2fcf2e561bb777ace7fb5c6262af7c7;Thu Apr 12 07:16:14 EDT 2012;Committer;nobu;1;2;0;2;0
871cd27c8dd54e2fac7205d91b419a8a6ed82412;Thu Apr 12 06:10:33 EDT 2012;Committer;nobu;1;2;2;4;0
e2aaf978b52b1d7134b9722dc6ac6b3e108168a3;Thu Apr 12 06:10:31 EDT 2012;Committer;nobu;1;8;10;18;0
1d6d4d2461674e2014c878c0ec64603aa19b98bb;Thu Apr 12 02:51:02 EDT 2012;Committer;naruse;1;1;1;2;0
45b3509ce1c34eb8fcca864ade6a42d6ca9e9249;Thu Apr 12 01:47:31 EDT 2012;Committer;ko1;1;1;2;3;0
ee7f8d4805fb4a661b8e8328be49f32cbc3e606d;Thu Apr 12 01:33:34 EDT 2012;Committer;ko1;8;225;53;278;0
655738577ffd90df3796c73afd8be84cd89091f6;Wed Apr 11 22:11:07 EDT 2012;Committer;drbrain;3;13;1;14;0
ea9b6997cc8bcb70ea82cb0535d1a4b5a5fd5508;Wed Apr 11 21:20:51 EDT 2012;Committer;drbrain;8;50;21;71;0
8c5c5a221f3bd3b0bdf6304b924630c35c7f8631;Wed Apr 11 20:28:11 EDT 2012;Committer;drbrain;4;102;32;134;0
2fe9d4642e4e68538112ea6045cc9a456d7a67b5;Wed Apr 11 18:55:36 EDT 2012;Committer;svn;1;2;2;4;0
ce0223b15b23afb6a49bc18fc7c642e68eb2fc7e;Wed Apr 11 18:55:32 EDT 2012;Committer;naruse;2;6;0;6;0
db5265a82c221887faf0dfd0d04e47cf11a08e3a;Wed Apr 11 13:31:23 EDT 2012;Committer;nobu;7;58;5;63;0
a5d1da5d74560c812acb8db6242e389d2f27e368;Wed Apr 11 13:01:16 EDT 2012;Committer;nobu;2;48;9;57;0
51f2207fc9be8b356601b5505dfdffef2db5e5dd;Wed Apr 11 13:01:14 EDT 2012;Committer;nobu;1;8;1;9;0
23ba7541e5ead7341bdf1106c361006e42c687fe;Wed Apr 11 12:43:56 EDT 2012;Committer;nobu;2;9;4;13;0
2f7290d4b3b1fd01f840f07c1db46929e3319db2;Wed Apr 11 12:05:19 EDT 2012;Committer;shirosaki;3;31;0;31;0
3e130812146aadaf36e0b6a027e7f79d9e96b055;Wed Apr 11 01:15:56 EDT 2012;Committer;naruse;1;6;2;8;0
bab146b689043962de105882a4716c34114e2805;Tue Apr 10 22:41:04 EDT 2012;Committer;drbrain;2;9;3;12;0
6ba4bd5858753c1aff9d11cfa7c478b9616c109a;Tue Apr 10 22:33:58 EDT 2012;Committer;drbrain;3;47;0;47;0
38ce9797c1b0b5b89cbff9bde72a50fa55f4f335;Tue Apr 10 21:11:37 EDT 2012;Committer;drbrain;2;47;15;62;0
d8164e5724ca29e50679524913d818adc0cb3b29;Tue Apr 10 20:15:05 EDT 2012;Committer;drbrain;2;15;9;24;0
1a7f3d7cb7e36ed57d6acd0538e9db69ad050481;Tue Apr 10 19:34:34 EDT 2012;Committer;naruse;1;0;1;1;0
85820f091a1ac51157d73fb80dc49dea09916839;Tue Apr 10 18:06:30 EDT 2012;Committer;svn;1;2;2;4;0
cee4c0bfb1a595fae424c8cd884ebebe026433c1;Tue Apr 10 18:06:26 EDT 2012;Committer;ayumin;2;7;2;9;0
a69e190e9685fb9e34ec3961c0dde289ece84dae;Tue Apr 10 11:56:09 EDT 2012;Committer;naruse;1;1;1;2;0
66fd3a4eb531bb51dd8d548acd0279f708b5b3c9;Tue Apr 10 10:19:28 EDT 2012;Committer;naruse;1;3;0;3;0
f45fc7daa00faa561c1bce32b598c06e1ec0d978;Tue Apr 10 10:07:07 EDT 2012;Committer;nobu;7;67;0;67;0
a59dd4b489a86e4a2560e8f56a642b7e87550da8;Tue Apr 10 09:23:14 EDT 2012;Committer;naruse;1;1;1;2;0
b386b25aac3ce3a372d1c7ff601e2d737932be5a;Tue Apr 10 09:23:11 EDT 2012;Committer;naruse;2;31;7;38;0
6a1f41867229528e90d94081b38fcc838b4b25f4;Tue Apr 10 07:53:24 EDT 2012;Committer;nobu;2;7;0;7;0
99fd04b46fd863a348ee03e328bf65af69d7f11b;Tue Apr 10 07:26:35 EDT 2012;Committer;nobu;1;14;4;18;0
9a269ab175a432b861f613c0d3ac59c72428868a;Tue Apr 10 07:19:08 EDT 2012;Committer;naruse;1;1;0;1;0
6da0604df71d66b7484e77b92e5c13154664b06e;Tue Apr 10 06:39:02 EDT 2012;Committer;ko1;2;7;1;8;0
2eb5d1dea4d9a604405f6725ef967a450218408d;Tue Apr 10 03:41:50 EDT 2012;Committer;naruse;1;6;3;9;0
e5c418d9910b3170ca13aee161ac6b08e9ae3a0c;Tue Apr 10 00:57:40 EDT 2012;Committer;drbrain;2;10;0;10;0
830ff445f9728c1d4aa50ef4a44a34427e8bfa7a;Tue Apr 10 00:48:54 EDT 2012;Committer;svn;1;2;2;4;0
718ab93d4df1f655abf5f5724f59fd91762b79f1;Tue Apr 10 00:48:49 EDT 2012;Committer;drbrain;2;6;1;7;0
04e3e2de568956030c1868c9846506989d8a2392;Mon Apr 09 14:14:39 EDT 2012;Committer;nobu;1;1;0;1;0
3ed259abbc4317322a6354ab1a2fd7a92a845551;Mon Apr 09 14:10:32 EDT 2012;Committer;nobu;3;23;3;26;0
8c8796333afcfc6a889cb7af614b4bf6b5d16057;Mon Apr 09 10:49:46 EDT 2012;Committer;naruse;1;6;3;9;0
41c199130a526efe27c39ea8e9d3f0134a8dfa5d;Mon Apr 09 06:16:07 EDT 2012;Committer;nobu;4;23;8;31;0
6b18a8c2e9540f67de5887f899d73e100c3ce13f;Mon Apr 09 04:07:53 EDT 2012;Committer;marcandre;4;22;2;24;0
6cb7ac7e155b15d542297eac32b2cd03efca8b60;Sun Apr 08 23:12:30 EDT 2012;Committer;tadf;2;21;6;27;0
228a99a0b2ff60f5bcc276981b47873ab39fe063;Sun Apr 08 23:05:08 EDT 2012;Committer;naruse;1;1;0;1;0
08df8218659167a99cd1b1a52c5eab0519c515dc;Sun Apr 08 22:00:32 EDT 2012;Committer;tadf;2;5;4;9;0
e0ba59b708edb0fb5fdde4c7a2364d5e006705f7;Sun Apr 08 19:17:32 EDT 2012;Committer;naruse;3;3;3;6;0
a4d3990f25af1cca8f409a1a783b37dc32bf894d;Sun Apr 08 17:53:56 EDT 2012;Committer;svn;1;2;2;4;0
71d114297f6891937ec680c4fa0e2455e12af4f4;Sun Apr 08 17:53:51 EDT 2012;Committer;naruse;3;11;2;13;0
fdc3882820d425b85082d5b871060aea39e6be81;Sun Apr 08 13:46:53 EDT 2012;Committer;naruse;2;7;0;7;0
63467e52633f90e6a402bce0daf11662ef3e9564;Sun Apr 08 13:46:50 EDT 2012;Committer;naruse;1;1;1;2;0
8474c90eaceb27fbf21b97ffebbfa976e7851c07;Sun Apr 08 06:26:48 EDT 2012;Committer;naruse;1;2;2;4;0
7b18633804c606e8bcccfbb44e7d7b795e777ea6;Sat Apr 07 23:41:30 EDT 2012;Committer;naruse;2;9;1;10;0
9ec849ee085393c2dc08dc07616184e74d81a3b5;Sat Apr 07 23:41:27 EDT 2012;Committer;naruse;1;4;4;8;0
2f6ff54e3111835ae41fcbf073dbd90899090be6;Sat Apr 07 21:53:05 EDT 2012;Committer;naruse;2;6;1;7;0
0304254bba87d2a922c66a4e145f43744b2e7823;Sat Apr 07 21:50:39 EDT 2012;Committer;svn;1;2;2;4;0
56206ab8cd0e822e861ae963fc02e2343652d8e2;Sat Apr 07 21:50:34 EDT 2012;Committer;naruse;3;83;7;90;0
42109a02f02b5e55a45df4f6bf3103c88be340cd;Sat Apr 07 14:10:30 EDT 2012;Committer;shirosaki;6;117;26;143;0
fc83ebb037bfecfd5abfd6dc92517870d65541b3;Sat Apr 07 14:10:25 EDT 2012;Committer;shirosaki;3;13;1;14;0
5638bbdab693d619c29a5e651b28bca542191931;Sat Apr 07 01:29:29 EDT 2012;Committer;tenderlove;3;9;3;12;0
8354d2f700b0f432c6868a0b8e5eb4d1f823d79a;Fri Apr 06 18:17:01 EDT 2012;Committer;nobu;2;22571;18147;40718;0
e02ad7327ec249e52425bbb7828f9b28c3dbc356;Fri Apr 06 17:09:08 EDT 2012;Committer;svn;1;2;2;4;0
85e4c89675d601fb9fc81b7e8985a166757c7509;Fri Apr 06 17:09:03 EDT 2012;Committer;tenderlove;3;11;4;15;0
611159923088a098ee5903e7fb356ec7f12debd1;Fri Apr 06 07:23:40 EDT 2012;Committer;duerst;4;20503;24921;45424;0
529827d711b1a5ed06bea18af8770d13d4f44e0e;Fri Apr 06 05:28:14 EDT 2012;Committer;svn;1;2;2;4;0
7b8bdf575b6a32f9dba6ecfa739651d9d9626758;Fri Apr 06 05:28:10 EDT 2012;Committer;kazu;2;5;1;6;0
1ba77338732714eb8f245a98bbef125d0e1cf808;Thu Apr 05 04:26:24 EDT 2012;Committer;svn;1;2;2;4;0
789f9c22042eabaabde09cbbe80b6c73fb11efe0;Thu Apr 05 04:26:20 EDT 2012;Committer;nobu;2;5;2;7;0
3f443e6115cb4502f200db53e231487f83555d72;Wed Apr 04 12:49:12 EDT 2012;Committer;naruse;2;12;13;25;0
223e0212e9db42ba1a4f737df4132c47fd8897c8;Wed Apr 04 07:58:19 EDT 2012;Committer;naruse;1;6;5;11;0
7865005fa1a42803124ecf5f0538c3753bc7f91c;Wed Apr 04 04:10:58 EDT 2012;Committer;naruse;3;14;5;19;0
f0cd9107dfae482ca8b7d68f5fb834648f8bd50f;Wed Apr 04 04:01:05 EDT 2012;Committer;nobu;1;0;1;1;0
f9b8e21fd1575523e7dc8ce68db7cbea2035e4b6;Wed Apr 04 03:21:43 EDT 2012;Committer;nobu;1;1;1;2;0
096ffa2a633e7d78d773c9b8f487c5cb9170d7e1;Wed Apr 04 01:33:58 EDT 2012;Committer;naruse;2;8;3;11;0
58a9bf0c4c2fc5aa70d4b1875ea59332191cf112;Tue Apr 03 19:30:10 EDT 2012;Committer;naruse;1;1;1;2;0
d374004467bfa9873db630e726fb2d2c242dba4b;Tue Apr 03 19:24:35 EDT 2012;Committer;svn;1;2;2;4;0
bc2ece6cf8e9c96f94ba7335cef886b7c5c0f833;Tue Apr 03 19:24:30 EDT 2012;Committer;naruse;3;27;14;41;0
d7655cc292c431264723547bbf8ea946517ca92c;Tue Apr 03 14:30:08 EDT 2012;Committer;nobu;1;1;1;2;0
5c67392c958aef7c639d04cd7d86eb923f5083c9;Tue Apr 03 14:30:05 EDT 2012;Committer;nobu;1;0;1;1;0
995d212a64ccf25d4a117e5413d03dfdfbb71752;Tue Apr 03 10:03:30 EDT 2012;Committer;usa;2;8;0;8;0
9102ee7be2586b5206a9ad40c1bb5f0624911931;Tue Apr 03 09:41:14 EDT 2012;Committer;nobu;4;8;0;8;0
ca512bdaa878df34fd27b720998d40fbc68a5e0f;Tue Apr 03 09:33:40 EDT 2012;Committer;nobu;2;13;6;19;0
31bd33a6624768c7c14d0681b3c1908f3c988307;Tue Apr 03 04:27:30 EDT 2012;Committer;naruse;1;1;1;2;0
b30aa267072ea05f32146621a51e0f3e983eb8dc;Tue Apr 03 01:24:51 EDT 2012;Committer;nobu;1;12;9;21;0
63e8110bfc153acc858dbe51017fbb2395f559d7;Tue Apr 03 01:18:31 EDT 2012;Committer;nobu;3;16;3;19;0
ecabd1692355ea81d120a5f34f1f36046de92167;Mon Apr 02 15:29:17 EDT 2012;Committer;svn;1;2;2;4;0
0ec539240cdac4b9645687328c5197ecabbe3d83;Mon Apr 02 15:29:12 EDT 2012;Committer;kazu;2;2;2;4;0
c00b706cbe0cf0d93d3031b545506d9c06619bfd;Mon Apr 02 09:44:09 EDT 2012;Committer;nobu;1;7;11;18;0
a59bfa76e51cb3ddf41fe15c239d3872b73a1e85;Mon Apr 02 04:25:14 EDT 2012;Committer;nobu;3;117;0;117;0
38b8afcf5a4abfc5d8319bcb30a239668eccfb9f;Mon Apr 02 01:34:11 EDT 2012;Committer;nobu;3;28;8;36;0
86300419455029ed1e1aa7d344c7e070c1e99d8d;Sun Apr 01 21:06:13 EDT 2012;Committer;naruse;1;3;3;6;0
61fcda16fd69aa3c3926af8ac30260042b89dad1;Sun Apr 01 21:00:54 EDT 2012;Committer;naruse;1;0;1;1;0
9d8ca7e15ee825067cae53abff2a65baba897696;Sun Apr 01 20:59:02 EDT 2012;Committer;naruse;1;4;5;9;0
8520505e44fce5910ed795cbbb5df3e9f898568e;Sun Apr 01 18:42:22 EDT 2012;Committer;naruse;1;4;4;8;0
1c6d6cad2143c5f69242bc1d62ed10f55dbc0da3;Sun Apr 01 18:36:50 EDT 2012;Committer;svn;1;2;2;4;0
f898efd8a8e6e2331f63358a242759b69ddf5a54;Sun Apr 01 18:36:46 EDT 2012;Committer;naruse;2;6;1;7;0
4179e0b5c692f19a5b6559665b905b9457d38424;Sun Apr 01 14:06:42 EDT 2012;Committer;naruse;1;1;1;2;0
ae79409db498bb04ec5de54f851d0ac7aa8af78d;Sun Apr 01 14:06:38 EDT 2012;Committer;naruse;3;74;1;75;0
69fa2fe929c2e339d73c8d0dc05d0d9c1fb57f55;Sun Apr 01 12:18:32 EDT 2012;Committer;nobu;1;4;0;4;0
19c9ac249b4d43348993b9968efe163fee6d413a;Sat Mar 31 15:56:22 EDT 2012;Committer;svn;1;3;3;6;0
d8438024a242e38ad8af87364ef69d1e111d9217;Sat Mar 31 15:56:18 EDT 2012;Committer;shugo;2;6;2;8;0
3c491a92f6fbfecc065f7687c51c7d6d52a38883;Sat Mar 31 13:30:10 EDT 2012;Committer;naruse;2;6;1;7;0
bfdccf09c79262d10e42c8b4eeb8bb2cacada74f;Sat Mar 31 08:13:58 EDT 2012;Committer;nobu;1;1;1;2;0
160d02d830d93316a8b4afd54138c1a8bfb8a6b3;Sat Mar 31 05:23:01 EDT 2012;Committer;nobu;3;30;13;43;0
15ca66efb0292388e2c8b6772bf0549a7c396eb9;Sat Mar 31 05:20:07 EDT 2012;Committer;ktsj;1;1;0;1;0
e8a1874c198dcb0c84bef4d783fbc6bfc025cd04;Sat Mar 31 05:16:04 EDT 2012;Committer;nobu;2;26;18;44;0
5f81a53fd2939c8618b4ba3e01052333e584ba56;Sat Mar 31 04:44:36 EDT 2012;Committer;shugo;3;505;8;513;0
a3626110d9d67cba3dea060821c453a218023c57;Sat Mar 31 04:20:45 EDT 2012;Committer;nobu;3;16;36;52;0
d4f379ad93dbd667a80bc286073b22354a755a88;Sat Mar 31 03:07:53 EDT 2012;Committer;emboss;2;5;1;6;0
94d0221df4c20cbb3084cc412d98cf94127731cb;Sat Mar 31 01:13:26 EDT 2012;Committer;nobu;2;5;3;8;0
44e6f5a1bb3eb37d37d9d8e14e970fa05e1a0724;Sat Mar 31 01:01:41 EDT 2012;Committer;nobu;2;5;1;6;0
d481e34e3c1a69b4c2142d2e7ac64ff2f962efe4;Sat Mar 31 00:48:56 EDT 2012;Committer;nobu;1;3;2;5;0
197627354e3c065542d92f5541425df699f4b204;Fri Mar 30 22:53:26 EDT 2012;Committer;nobu;3;18;10;28;0
d0380e2e567d9ffa1423c8b6fda3470f11b753c3;Fri Mar 30 22:47:33 EDT 2012;Committer;nobu;2;6;2;8;0
4fa32366008a81c8ea398ce36e53f23f659530c2;Fri Mar 30 22:44:33 EDT 2012;Committer;nobu;2;8;9;17;0
4b3a1f77e14696780265f4c05bfa01a5216f8f99;Fri Mar 30 22:40:54 EDT 2012;Committer;nobu;5;46;13;59;0
db5ede2236ab49aaf6fca49ecbef7594eed97e8a;Fri Mar 30 22:18:54 EDT 2012;Committer;svn;1;2;2;4;0
becc3000ca471424c819f5e0c251a27b06718924;Fri Mar 30 22:18:52 EDT 2012;Committer;nobu;1;34;34;68;0
fc4e79e301f33086512e1728af4fa0fda952173f;Fri Mar 30 22:18:50 EDT 2012;Committer;nobu;1;2;1;3;0
67d4eb32ae1d608f6ec446dc96634b4084c39440;Thu Mar 29 15:03:08 EDT 2012;Committer;svn;1;2;2;4;0
efd6f6b85636e066e8d377f42e13fbe2a99d083b;Thu Mar 29 15:03:05 EDT 2012;Committer;nobu;1;4;4;8;0
28cc4f75437eec9e76f52723f042445332fd86f5;Thu Mar 29 14:50:20 EDT 2012;Committer;nobu;7;16;11;27;0
6da92c3e89697e1263248ab56e2ad33381429d6c;Thu Mar 29 07:38:14 EDT 2012;Committer;nobu;1;2;0;2;0
30cea657676db0ba703ae769fed4eafd5abc27fc;Thu Mar 29 07:36:12 EDT 2012;Committer;nobu;7;38;21;59;0
95b30b0d07c40a3f7e0f0d8c74b1ae058034c8ad;Thu Mar 29 07:35:38 EDT 2012;Committer;nobu;3;43;16;59;0
aad347f5ec7f32c55dea663b3216f4bead993c9a;Thu Mar 29 01:27:17 EDT 2012;Committer;emboss;3;19;4;23;0
8e601a20f4a41bc1016c3c0a45fd9cbd1840e158;Thu Mar 29 01:17:39 EDT 2012;Committer;usa;2;6;1;7;0
fea7a74ee3b0b1920a956ca3cc7faaf60b216c35;Thu Mar 29 01:15:37 EDT 2012;Committer;usa;2;9;1;10;0
836af4e5dc7ef3293a68e07fea47385e2e5942ed;Thu Mar 29 00:32:09 EDT 2012;Committer;emboss;2;10;1;11;0
7d8a8956de4a099f0d1916caf8fd35e9a8fbb517;Wed Mar 28 23:28:17 EDT 2012;Committer;emboss;2;12;0;12;0
0443aeab77b0f9542fa16b06e368939ab385495c;Wed Mar 28 22:53:22 EDT 2012;Committer;svn;1;2;2;4;0
5bef1c9223ffecbef27f01498f353087eb6c9275;Wed Mar 28 22:53:18 EDT 2012;Committer;emboss;3;32;3;35;0
9bf9b3ef95e5a699b931435f482087c57439eda3;Wed Mar 28 07:40:02 EDT 2012;Committer;nobu;4;224;86;310;0
1521f9331e2aa74fd3248d9cb5392735a2eb36cc;Wed Mar 28 06:06:20 EDT 2012;Committer;nobu;3;16;2;18;0
113c6d58e70dc426e6bd20b4d42043985b9ef43f;Wed Mar 28 06:05:20 EDT 2012;Committer;nobu;1;1;1;2;0
b95b56cc3a5c75cb33830cd649a78c17eb777e38;Wed Mar 28 01:28:51 EDT 2012;Committer;nobu;1;90;45;135;0
4e3809123799df4465293b26ee52a8147e7087bb;Tue Mar 27 23:45:48 EDT 2012;Committer;svn;1;2;2;4;0
a2c56d53ea610c4caacb3d5ebaa8d027cc06f574;Tue Mar 27 23:45:44 EDT 2012;Committer;tenderlove;4;15;8;23;0
9073db5cb1d3173aff62be5b48d00f0fb2890991;Tue Mar 27 14:44:32 EDT 2012;Committer;usa;2;6;0;6;0
61dc4a8dbc2cdc9a24ce206ad0ec911267bb6782;Tue Mar 27 13:44:25 EDT 2012;Committer;nobu;5;34;21;55;0
c2d7776f855420f5e728608c9e361dcfdf32aecf;Tue Mar 27 13:43:43 EDT 2012;Committer;nobu;2;6;2;8;0
35259b72f20eb289f6ca0e8c1a9e368f47193420;Tue Mar 27 08:27:19 EDT 2012;Committer;kazu;2;14;16;30;0
2434ad11e4f6df96a33bac95b8c1576c6d63e96a;Tue Mar 27 08:06:17 EDT 2012;Committer;kazu;1;1;1;2;0
ab9c982cc0299435a795000d68eb9472d8ecfde0;Tue Mar 27 04:13:54 EDT 2012;Committer;nobu;3;26;0;26;0
9052a8cd948840068c8a6a51850f421fff11c887;Tue Mar 27 03:11:51 EDT 2012;Committer;nobu;1;1;0;1;0
be42c354246aca869e17e159b2654a283666fd5e;Tue Mar 27 03:11:48 EDT 2012;Committer;nobu;1;4;1;5;0
f25efeb82f012b6768f5b5c96c363e7f1176a185;Tue Mar 27 01:41:18 EDT 2012;Committer;svn;1;2;2;4;0
bb314d33479b324c73da92292ba74117f45b8dce;Mon Mar 26 14:43:27 EDT 2012;Committer;shugo;2;12;8;20;0
d68b3a38e956507329496b42c164876e7529d01e;Mon Mar 26 14:39:21 EDT 2012;Committer;shugo;2;10;4;14;0
422c8baeb9639cc51a9f7d458c521f9bd4d98969;Mon Mar 26 14:39:16 EDT 2012;Committer;shugo;3;15;2;17;0
cae1d532f5969d794179f398a6c867d5f402c21c;Mon Mar 26 10:52:06 EDT 2012;Committer;shugo;2;107;0;107;0
8c89d8ef727d7c7099ed92b21bf8de12ffbeb197;Mon Mar 26 10:52:04 EDT 2012;Committer;shugo;2;33;42;75;0
b9f67c4149f5f8888ac4681e15695deecd213136;Mon Mar 26 10:52:02 EDT 2012;Committer;shugo;3;87;38;125;0
ddc7bcd60eaa0e470bf2837af31992f1599ef41f;Mon Mar 26 05:08:55 EDT 2012;Committer;nobu;3;18;4;22;0
7a0d81eaa25edf97a413c85e5560a05a30aaa5ad;Mon Mar 26 04:51:27 EDT 2012;Committer;nobu;3;28;8;36;0
06fba52338e439fdaca5ddf0b35947259aaa7a1c;Mon Mar 26 03:57:07 EDT 2012;Committer;nobu;1;7;6;13;0
1b2a60759bd191d19d32fa6cb8bf8ac3bda52322;Mon Mar 26 03:57:03 EDT 2012;Committer;nobu;1;6;11;17;0
764d54788a85b2238cb9f5e93dfaa0385c02f47f;Mon Mar 26 02:46:04 EDT 2012;Committer;nobu;3;18;1;19;0
8a57e0bf8274ad22f21671d452db1bd3b59b2834;Mon Mar 26 02:41:10 EDT 2012;Committer;svn;1;2;2;4;0
b83ad31c437ca05a3eaa899f4426d2f217212678;Mon Mar 26 02:41:04 EDT 2012;Committer;nobu;2;38;4;42;0
73a184cc3a4ead8a3242a8f04c4e65fa99026eef;Sun Mar 25 09:20:04 EDT 2012;Committer;naruse;3;20;3;23;0
0c9f66eb400a78ef2e201a30a3904f59033d0439;Sat Mar 24 15:53:38 EDT 2012;Committer;shugo;3;20;22;42;0
fa288063e0159374a9a5f06a4d9b52785778b926;Sat Mar 24 15:17:36 EDT 2012;Committer;svn;1;2;2;4;0
6b885f6e74a48c1b43cfbce1298cda98a64fe6bc;Sat Mar 24 15:17:31 EDT 2012;Committer;shugo;3;86;25;111;0
576a69a5645c455a5faf1e1fa2205a60c7caec7f;Sat Mar 24 13:22:28 EDT 2012;Committer;svn;1;2;2;4;0
28e48d3fd8b7e9ae4d540a0111342a444a9ac061;Sat Mar 24 13:22:22 EDT 2012;Committer;nobu;3;14;8;22;0
463633e4a934a00f869086a6ffbf84c6cb8ad630;Fri Mar 23 06:12:02 EDT 2012;Committer;duerst;2;11;0;11;0
163ab0a4da61699c84bba46cd9d7bdd6c67ba1e5;Fri Mar 23 04:19:24 EDT 2012;Committer;nobu;6;32;10;42;0
a13486997a65320f3abcded92e9edc9433a42a43;Fri Mar 23 03:14:49 EDT 2012;Committer;nobu;1;5;3;8;0
2bf3b20dbe58b8a67adec3e6dd51c00040d496ca;Fri Mar 23 03:04:20 EDT 2012;Committer;nobu;1;2;2;4;0
ee3e7dcf68765157eb4c32a491279239da3d7eb6;Fri Mar 23 02:33:05 EDT 2012;Committer;naruse;2;9;4;13;0
cca049e0d03c1e4ca3b627321f2abcd95d2eeece;Fri Mar 23 02:02:54 EDT 2012;Committer;naruse;2;3;8;11;0
6d8580fe254d24b3868fb558ada142cd36242d63;Fri Mar 23 00:56:46 EDT 2012;Committer;nobu;1;17;7;24;0
e91983b471246104ade82a4257b71a77107b6921;Thu Mar 22 22:52:10 EDT 2012;Committer;svn;1;2;2;4;0
4725c9880d162868cfb569f87ad73aa9ab7d1787;Thu Mar 22 22:52:05 EDT 2012;Committer;naruse;1;4;2;6;0
2b84626193c43ba49f2f4663aad76810684bd45c;Thu Mar 22 14:14:39 EDT 2012;Committer;nobu;3;20;0;20;0
7cbff3b9dd51dbb43cbd3757bd719b52eb03a3b1;Thu Mar 22 14:05:31 EDT 2012;Committer;shirosaki;3;79;16;95;0
3d22e33a0636eaf4ea659372b59c3f98fb247b7c;Thu Mar 22 11:47:19 EDT 2012;Committer;nobu;1;2;3;5;0
ff075693c9038cdd666676a5d55e0bbccaaa8a2b;Thu Mar 22 10:55:11 EDT 2012;Committer;nobu;3;34;27;61;0
0b83d3b27bebe0eb90a6e5f31f6fb36da57c5c10;Thu Mar 22 09:37:47 EDT 2012;Committer;nobu;1;2;2;4;0
d28c18966d57ea62c0e210a7d7ecd27cf7aa0c17;Thu Mar 22 09:37:44 EDT 2012;Committer;nobu;1;3;3;6;0
9accaad5c4fff11f09b8d5fc7b8009785dbeac27;Thu Mar 22 06:04:09 EDT 2012;Committer;nobu;1;1;1;2;0
cd71db0ad6c0382e99c0ba7fe5e5cfadedbe5557;Thu Mar 22 05:59:48 EDT 2012;Committer;nobu;1;8;5;13;0
11c57111f94ce73fba40ac3649001a8810ec7f9b;Thu Mar 22 05:59:45 EDT 2012;Committer;nobu;1;2;4;6;0
3417dd28a6f358733b5a5107f2ed74118255da79;Thu Mar 22 04:57:04 EDT 2012;Committer;nobu;1;1;1;2;0
3911327572439a4c8786531b2251306f71799a3a;Thu Mar 22 04:43:38 EDT 2012;Committer;nobu;2;8;3;11;0
24513fe21eddef33d513413c0541d8935ec5ad80;Thu Mar 22 02:17:30 EDT 2012;Committer;nobu;1;6;3;9;0
b1bdada158244e16bab6456e68b39ce48a2a2f58;Thu Mar 22 02:17:26 EDT 2012;Committer;nobu;1;8;4;12;0
99594056559c13e2b5653a94ea6ef1fe85c4057b;Thu Mar 22 02:14:47 EDT 2012;Committer;svn;1;2;2;4;0
caf627afce53cb5dfd34c435e1be030724043cbb;Thu Mar 22 02:14:42 EDT 2012;Committer;usa;2;22;15;37;0
b2cc0976a7e167f47d3f71fb637af699950f15f9;Wed Mar 21 10:53:06 EDT 2012;Committer;naruse;4;14;5;19;0
51f41bb843845dee4b9ada16a8100a3f558d70cd;Wed Mar 21 08:03:14 EDT 2012;Committer;svn;1;2;2;4;0
af86dba25a9b2c580fc10a8fe169f41c8385a22d;Wed Mar 21 08:03:08 EDT 2012;Committer;usa;2;27;0;27;0
905eb21dcad8c935fb6fa21362eda9163c26ec85;Tue Mar 20 13:55:03 EDT 2012;Committer;svn;1;2;2;4;0
1e42030f2a5518956c234a32c6c6cf1655519940;Tue Mar 20 13:54:59 EDT 2012;Committer;nobu;2;2;9;11;0
ded27bf5dc25d61c1483ae2a79570b1435c8348b;Mon Mar 19 08:22:29 EDT 2012;Committer;shugo;3;59;2;61;0
592a629bd0185060101f14db80fa1d5552380031;Mon Mar 19 07:39:12 EDT 2012;Committer;shugo;2;6;1;7;0
831898bd9971ec5997267226417ce0ce6f76ecd7;Mon Mar 19 06:41:02 EDT 2012;Committer;shugo;2;12;3;15;0
0d1c2268a81268e0026230d4d55cf73931665fcd;Mon Mar 19 06:20:55 EDT 2012;Committer;nobu;2;33;55;88;0
d4f0f28430c29d6d33621852640fbbccdd666b65;Mon Mar 19 06:08:44 EDT 2012;Committer;shyouhei;2;13;0;13;0
27c538987932686105b958433cce4914043cd30d;Sun Mar 18 15:21:04 EDT 2012;Committer;svn;1;2;2;4;0
f4aff7feb18bac8f15494ac36c5027d216aac5f8;Sun Mar 18 15:21:04 EDT 2012;Committer;nobu;2;8;5;13;0
bd377449f01c033b6fd2c8c880611c1777c8e87d;Sun Mar 18 15:21:00 EDT 2012;Committer;nobu;1;1;1;2;0
e30dbb36718a3a1b6c5f7cd2701e46c9b4f285b9;Sun Mar 18 14:21:31 EDT 2012;Committer;nobu;2;8;2;10;0
1d006f353d77d3f297c9ee42149eeca45bf90117;Sun Mar 18 11:15:50 EDT 2012;Committer;yugui;2;20;2;22;0
3175fbf194acfa93282cdd6bc03ec29fb4fd608a;Sun Mar 18 10:45:05 EDT 2012;Committer;nobu;1;8;5;13;0
ed4c5f38ba25e61a8c65abad4254317e253e36e8;Sun Mar 18 08:17:50 EDT 2012;Committer;nobu;3;12;3;15;0
2555f3f5bf0c2c343fdbec6c42570c781cbbe7c8;Sun Mar 18 08:17:39 EDT 2012;Committer;nobu;3;20;1;21;0
7e78f6f52631d6ae00e7300df16ad2d3a73e862b;Sun Mar 18 06:28:41 EDT 2012;Committer;akr;2;6;1;7;0
ef4ea58cbf89413e60a013a458317eed61ccd427;Sun Mar 18 01:03:39 EDT 2012;Committer;svn;1;2;2;4;0
42c18fe764afe5fa4aaf3d18af539263ee7005b4;Sun Mar 18 01:03:35 EDT 2012;Committer;ktsj;2;16;3;19;0
30c0db4a85501e52ad01d4f9af6e45d260b068ce;Fri Mar 16 22:05:31 EDT 2012;Committer;kazu;1;1;1;2;0
db3bce11ddd45838022b321c1dd0a80c7662b5bf;Fri Mar 16 21:57:24 EDT 2012;Committer;drbrain;2;7;3;10;0
ea6511c63ae463ec63c51f344ee0a2fe83e8c9d0;Fri Mar 16 16:49:44 EDT 2012;Committer;kazu;3;13;2;15;0
2cab78a9ff5f14b657bed44bb71c124a33b107af;Fri Mar 16 15:30:01 EDT 2012;Committer;kazu;1;1;1;2;0
9a4c2a98ed98e3eddc7fd5000d2c21810be4280f;Fri Mar 16 15:20:07 EDT 2012;Committer;svn;1;2;2;4;0
25755e38b781f9459aaa408acf178fca43641912;Fri Mar 16 15:20:03 EDT 2012;Committer;kazu;1;1;1;2;0
ba20fe6289984abf051f86e4dae254dcb071c86e;Fri Mar 16 11:06:27 EDT 2012;Committer;nobu;3;13;4;17;0
7af3e9f08b6f277b7f96d7ed2a0115d1452d98cc;Fri Mar 16 08:42:16 EDT 2012;Committer;nobu;3;13;1;14;0
be2dc4434a3f854d32b24fe08fbbc28116df7a7f;Fri Mar 16 08:38:27 EDT 2012;Committer;nobu;1;1;1;2;0
2b906bf2267dc2d9a6c33a6338d405f2346a2aaf;Fri Mar 16 08:38:24 EDT 2012;Committer;nobu;1;1;1;2;0
d19e5328d895ab4cc533127064bb385a54e0a889;Fri Mar 16 08:38:22 EDT 2012;Committer;nobu;2;3;3;6;0
36ada1b318dcc0539c81bba3ef9db301f0eeb9fd;Fri Mar 16 08:38:20 EDT 2012;Committer;nobu;1;10;10;20;0
9faa910961511e9154abe9464bc4a1c848c5bed9;Fri Mar 16 08:38:18 EDT 2012;Committer;nobu;1;10;6;16;0
62cdd6e64a946ab40a83a5017330cca2fde70099;Fri Mar 16 08:38:16 EDT 2012;Committer;nobu;1;1;1;2;0
a87f0aa071992e9cfba6b83b6d596a9f414f767a;Fri Mar 16 08:38:13 EDT 2012;Committer;nobu;1;5;5;10;0
19451891d8750a44097fae76422642bd288e9197;Fri Mar 16 08:33:10 EDT 2012;Committer;nobu;2;5;2;7;0
a920c29c16c8ffa2afe3f4126d307ee0001d5bc8;Fri Mar 16 06:02:37 EDT 2012;Committer;nobu;2;7;30;37;0
a157c85a7f1e6e11399c682218a60ebcdd093686;Fri Mar 16 05:45:39 EDT 2012;Committer;yugui;2;8;2;10;0
58d1b85c78df06ca734dcb266d4d8ec17f7bdd39;Fri Mar 16 05:38:52 EDT 2012;Committer;shugo;2;10;4;14;0
a377ef5e6386ee526ddb1687a49ec26002107f98;Fri Mar 16 05:28:55 EDT 2012;Committer;shugo;2;11;4;15;0
6853b44a9260390b6e688e7c42aedcd5540e291f;Fri Mar 16 05:12:39 EDT 2012;Committer;shugo;3;29;0;29;0
ed07df5ab5e183aed62cbe33f50a57640617d7a4;Fri Mar 16 04:56:18 EDT 2012;Committer;shugo;3;26;0;26;0
5308538befe847d3b9774257a54d9c4d5b47bd94;Fri Mar 16 03:09:03 EDT 2012;Committer;nobu;1;1;1;2;0
817eb7d17d3f1327dfb4c706ef6604dd1483ece7;Fri Mar 16 03:00:44 EDT 2012;Committer;nobu;3;25;6;31;0
e2ca7837d1d8afbbcb2387d1c22a016e799024e4;Fri Mar 16 03:00:00 EDT 2012;Committer;nobu;3;6;2;8;0
29f73009ca934cfa7b51d1de4d22933ab56dc602;Fri Mar 16 02:22:20 EDT 2012;Committer;shugo;3;25;5;30;0
a1f4163dd330d2cddbde0fa3407713e2338a2e7b;Thu Mar 15 21:30:12 EDT 2012;Committer;nobu;2;5;2;7;0
641e9e7bcea438c5c43b7863ae3afd380069e149;Thu Mar 15 21:29:32 EDT 2012;Committer;nobu;2;5;1;6;0
25ac2aaf81e6fa4b0ce910af3853c98e5b046b25;Thu Mar 15 20:53:27 EDT 2012;Committer;svn;1;2;2;4;0
5e72676688025ac0e3330e09b0b5c4c88896e0bb;Thu Mar 15 20:53:23 EDT 2012;Committer;drbrain;2;5;1;6;0
2baeb78294ecc18f2889eaa3d9a74d6f37ba8791;Thu Mar 15 14:20:27 EDT 2012;Committer;shugo;5;120;41;161;0
d135138f9b7b64dc49025e27b5a7c9f97b11fa6d;Thu Mar 15 10:14:22 EDT 2012;Committer;shugo;3;25;1;26;0
032861ade7bdbe2c7e939b9b2995ed2ad1a1cdc6;Thu Mar 15 09:25:03 EDT 2012;Committer;shugo;3;28;27;55;0
ff1f6107f98261774739a6824fa80b1eba7b58ef;Thu Mar 15 08:47:09 EDT 2012;Committer;shugo;3;7;2;9;0
4a1db362f0c716dfdca7289a8c61d160b8356093;Thu Mar 15 07:38:11 EDT 2012;Committer;shugo;2;6;2;8;0
bf87ec4eb9927930d18b91220bddbe2b1a5f9cd4;Thu Mar 15 06:37:46 EDT 2012;Committer;nobu;3;13;1;14;0
b30c4aa8d7e1781b71ec0a9fa4826d58030101f9;Thu Mar 15 06:24:10 EDT 2012;Committer;nobu;1;1;12;13;0
fbdce669086c99212384d7168777e7017690829e;Thu Mar 15 06:19:42 EDT 2012;Committer;nobu;2;14;8;22;0
a258d6f4157908b8360ee005b20bddb0969ce0aa;Thu Mar 15 06:04:56 EDT 2012;Committer;nobu;2;9;3;12;0
375aedbfb4d1a93ab2d9573fcb34cf4d6c474de2;Thu Mar 15 06:04:44 EDT 2012;Committer;nobu;3;31;19;50;0
36f6ce40832a8c19301898ff20c370d5d4638923;Thu Mar 15 06:03:02 EDT 2012;Committer;nobu;2;6;1;7;0
65fcaf4113e5e9855e98c3f483f34e1bfe077203;Thu Mar 15 05:49:34 EDT 2012;Committer;nobu;2;5;0;5;0
f59caa2950d454f651438cccff6298c4e13dc354;Thu Mar 15 04:49:20 EDT 2012;Committer;usa;2;10;5;15;0
fcaee4bd64eb06ec4d0afd4e7e32ccf57acb5dc8;Thu Mar 15 03:57:02 EDT 2012;Committer;usa;4;86;8;94;0
c6671f1005a19ee755c066fd882271afb86ccbbf;Thu Mar 15 03:31:50 EDT 2012;Committer;nobu;1;2;1;3;0
d18dc746986e1611a11c46c0f728fd9f08bbdfc7;Thu Mar 15 02:00:30 EDT 2012;Committer;shugo;3;57;3;60;0
c037f1f61696d64cbe42b6bb4bd1f0558578146d;Thu Mar 15 01:39:00 EDT 2012;Committer;nobu;6;16;9;25;0
9f9201b85d282d6f1f1999bfab7ac22b26e2d768;Thu Mar 15 01:31:43 EDT 2012;Committer;nobu;5;11;7;18;0
724e683e86f19cda02dfe3906fdf5adca539b94b;Wed Mar 14 22:12:53 EDT 2012;Committer;drbrain;3;29;1;30;0
7316302483182a73136b00ad368585e551cbd86f;Wed Mar 14 21:10:34 EDT 2012;Committer;marcandre;20;130;137;267;0
35c356ea72094dbbf1397d8f5acd065bd23d1177;Wed Mar 14 21:10:16 EDT 2012;Committer;marcandre;3;85;21;106;0
74bdcfe81643866c5d72383f5b5b16d70123fdee;Wed Mar 14 16:00:34 EDT 2012;Committer;svn;1;2;2;4;0
552adf8c5bc518839aa191e05875d3e0bdb251cd;Wed Mar 14 16:00:30 EDT 2012;Committer;shugo;2;13;4;17;0
0562e3ff400b7ecd7e65d03b6ae5dd95ddf16e40;Wed Mar 14 13:52:49 EDT 2012;Committer;nagachika;1;3;3;6;0
c8860b504e0a31b72725f130a2c43670908cb1b8;Wed Mar 14 13:04:18 EDT 2012;Committer;shugo;3;130;9;139;0
0b35e9e5ddb329dac027d72851db015a738852d7;Wed Mar 14 10:29:25 EDT 2012;Committer;shugo;5;53;10;63;0
0d94434eca76abeb13dda88d2695777bbca7f31a;Wed Mar 14 09:41:44 EDT 2012;Committer;shugo;2;7;3;10;0
449c8a2ba3a8b11e4f875f1ae76664b7deb5112a;Wed Mar 14 09:26:27 EDT 2012;Committer;shugo;2;51;47;98;0
cc3d03b196dd3205ac8798db938711598c99d413;Wed Mar 14 08:56:42 EDT 2012;Committer;usa;2;9;4;13;0
005953a17b68f11e430a467d48531668b3f8e9b1;Wed Mar 14 07:42:30 EDT 2012;Committer;usa;2;5;0;5;0
4c2e2d8bdefa8cd43adf1e28358353c1ded53049;Wed Mar 14 06:10:01 EDT 2012;Committer;marcandre;6;48;27;75;0
092db4dcf0a6c9b0dc0408d4f29189754a07212e;Wed Mar 14 04:48:02 EDT 2012;Committer;marcandre;1;3;4;7;0
4bce9fc7bd4a0909e5f484fbf9fd5dac4012ed53;Wed Mar 14 02:29:48 EDT 2012;Committer;nobu;1;4;2;6;0
cb1d290886b9239487bf5d4d9bdfa7005ec0fdd5;Wed Mar 14 01:44:37 EDT 2012;Committer;nobu;3;11;2;13;0
8f30190dfecd4b32ca3d82515b8f59e959eed8a3;Wed Mar 14 01:35:12 EDT 2012;Committer;nobu;1;8;2;10;0
8cdfe403d3d79f997fdfdb9af3096110e5d84150;Wed Mar 14 01:35:09 EDT 2012;Committer;nobu;2;10;7;17;0
48f9f0bda9c09f946b912e954f755591966ee703;Wed Mar 14 01:35:06 EDT 2012;Committer;nobu;1;21;24;45;0
6b4525912b67b085b1c6d958fdca8aef87a6c28d;Tue Mar 13 23:16:37 EDT 2012;Committer;shugo;3;27;8;35;0
22434473c72b27bbf699cfcb62f2df38c71cfe10;Tue Mar 13 23:08:15 EDT 2012;Committer;shugo;3;87;0;87;0
f24d9fcd7510dfa0ac9ab22111de48592313db6e;Tue Mar 13 22:56:03 EDT 2012;Committer;tadf;2;45;1;46;0
db68d5ba7b4eb98166fd9df2b5670932e5525393;Tue Mar 13 15:26:07 EDT 2012;Committer;svn;1;2;2;4;0
08d81f26833a7741eb85525d0e8f641f8b8a53b6;Tue Mar 13 15:26:03 EDT 2012;Committer;nobu;1;16;13;29;0
8fe3fb4c0f69535b302e124f3afc58dce4be5dbb;Tue Mar 13 13:00:17 EDT 2012;Committer;nobu;6;177;644;821;0
d6a977f667f9d824cfe95976f3afc31e55580edb;Tue Mar 13 06:17:08 EDT 2012;Committer;nobu;3;27;0;27;0
db83618d2c49cbab8b78e31ecf5a8979895bc5d6;Tue Mar 13 04:03:06 EDT 2012;Committer;naruse;3;43;1;44;0
272d72efc07c78d62d56cc10dbb30094083fb01f;Tue Mar 13 04:03:03 EDT 2012;Committer;naruse;1;3;2;5;0
df058ea0e3e13ad52fd3a3490b1e3bd56db044b2;Tue Mar 13 03:37:06 EDT 2012;Committer;nobu;4;249;46;295;0
826cdd67a043b520c70cc9fcf66028603a130560;Tue Mar 13 03:34:11 EDT 2012;Committer;nobu;2;7;14;21;0
7e82db2e1e3b3c101988d6b01564529944cdef95;Tue Mar 13 01:59:54 EDT 2012;Committer;nobu;2;31;14;45;0
8a8936cbd0680db20357858f65f64ceb6d20d069;Tue Mar 13 01:59:50 EDT 2012;Committer;nobu;1;3;1;4;0
7f199d12e0ee9a095d186a8667f78f31fa0a2dca;Mon Mar 12 15:17:27 EDT 2012;Committer;naruse;2;15;60;75;0
6c698654bbbeda3f6ecf5e7cac10ce7504d48d50;Mon Mar 12 15:12:14 EDT 2012;Committer;svn;1;2;2;4;0
f0f777bc4af05b3d9ef30967e828542ba667d6d6;Mon Mar 12 15:12:07 EDT 2012;Committer;shugo;2;25;0;25;0
b681457f018c9d8ef2233a2f97ab998d629182c9;Mon Mar 12 11:19:42 EDT 2012;Committer;akr;2;12;4;16;0
5e3009aa4557bdb7e5e70e4e38fea7b21d1867f0;Mon Mar 12 11:09:11 EDT 2012;Committer;akr;2;6;1;7;0
33ceea5cdbed60cdc2108b456c739808f3d58179;Mon Mar 12 10:23:17 EDT 2012;Committer;nobu;5;59;7;66;0
c60602acbc0d003162ddd72b7e9e55454fbe640e;Mon Mar 12 10:03:36 EDT 2012;Committer;nobu;2;10;5;15;0
c5feeb9ac11863086e7a3a8239dbc13cce988876;Mon Mar 12 05:56:57 EDT 2012;Committer;nobu;3;11;14;25;0
a2229db3e8a88002697ee2fcb45128bcf4914bbd;Mon Mar 12 03:44:40 EDT 2012;Committer;nobu;3;39;0;39;0
b19f3a8a1592bf32bd83e02c433715cd67923d1d;Mon Mar 12 01:13:40 EDT 2012;Committer;nobu;3;23;0;23;0
90b7ddb89fb5625df1292e766604372ddf26ada1;Mon Mar 12 00:32:16 EDT 2012;Committer;naruse;1;1;1;2;0
48b5b163fcb6dbf20402ae319114583d00a77805;Sun Mar 11 22:37:04 EDT 2012;Committer;akr;3;21;2;23;0
bcb9e567c422f535b4871ce2795179af808d0077;Sun Mar 11 22:19:06 EDT 2012;Committer;nobu;3;34;2;36;0
42437780d62e5ddaf0c7bb5ec320f85970b0ee42;Sun Mar 11 22:04:13 EDT 2012;Committer;nobu;2;19;7;26;0
b87f2fe1e44acd66a30fad24bad2d21ddb01e8a2;Sun Mar 11 22:03:36 EDT 2012;Committer;nobu;3;37;2;39;0
1100fdfc6558e4460610f7856d04296ecae1870e;Sun Mar 11 21:48:45 EDT 2012;Committer;nobu;1;2;2;4;0
966eacca9580ec565dd58c7ec8a6dc19517de17b;Sun Mar 11 17:42:23 EDT 2012;Committer;svn;1;2;2;4;0
199d1fa924a120cca46182746b0e326baee35660;Sun Mar 11 17:42:18 EDT 2012;Committer;naruse;11;472;0;472;0
b7df3e9f4eb31886354b4fdb1622c7b839ae7db1;Sun Mar 11 14:59:42 EDT 2012;Committer;naruse;3;22;1;23;0
4d8d3184d18b1a9d2eadb86a6688dc62eca7eabc;Sun Mar 11 13:36:06 EDT 2012;Committer;naruse;15;409;573;982;0
9d9ab5a384de3877f29cef8c0293c1caa432692c;Sun Mar 11 12:59:40 EDT 2012;Committer;nagachika;1;1;1;2;0
cfbdbd9b29762bb868175c7fe9ada053ba1e54aa;Sun Mar 11 08:38:44 EDT 2012;Committer;sorah;1;1;1;2;0
42b1df08fc39bd990c0dd3c97e2689a085f9ce14;Sun Mar 11 08:28:48 EDT 2012;Committer;sorah;3;46;23;69;0
605f4baef74582341397b02bc3ac00eddeaf4581;Sun Mar 11 06:49:49 EDT 2012;Committer;sorah;2;8;10;18;0
290f7cd7c0103ec9d50380cf15bcae7d651075c8;Sun Mar 11 05:53:24 EDT 2012;Committer;svn;1;2;2;4;0
ed924d2fa98428e684eeec06a43e687bf6adf0e9;Sun Mar 11 05:53:20 EDT 2012;Committer;akr;1;1;2;3;0
3007acfbc6faaf65148697edcb9907ba23551e85;Sat Mar 10 14:52:30 EST 2012;Committer;nobu;2;67;39;106;0
a73d958c33904fdabac95f49d9834779ca33c599;Sat Mar 10 14:52:19 EST 2012;Committer;nobu;7;112;23;135;0
efae6194582001cb12108bc101d22dc1ed9a660c;Sat Mar 10 14:52:06 EST 2012;Committer;nobu;5;73;35;108;0
0934e6c014fdbf178b1dd0d4f27c3e857491d641;Sat Mar 10 13:33:16 EST 2012;Committer;ktsj;1;1;1;2;0
c7c91247e25ad535f3182e84e3fc33972c94447d;Fri Mar 09 19:21:01 EST 2012;Committer;akr;1;1;1;2;0
05630f51034554e4185db40142d48f0314ff6981;Fri Mar 09 18:54:23 EST 2012;Committer;svn;1;2;2;4;0
4dbafb0d89376a9a05c8de9729a5e604ce470b52;Fri Mar 09 18:54:12 EST 2012;Committer;akr;1;8;4;12;0
3c45e3f1b77ddbc63ed8528a71f959ff5dfaf272;Fri Mar 09 05:52:18 EST 2012;Committer;naruse;1;5;4;9;0
a21d0f72c280a3effe15554279ae006918cd97ce;Fri Mar 09 05:34:41 EST 2012;Committer;shugo;3;40;0;40;0
5452b18f9905ea404cd0bbfff5536f031bb83450;Fri Mar 09 01:13:59 EST 2012;Committer;nobu;1;104;0;104;0
240c9acb5c3ee0b3d538cf9ba12cb27f5e469dca;Thu Mar 08 21:31:05 EST 2012;Committer;tenderlove;3;21;2;23;0
a2e3de1b3f876dd9b14fa3a6291a202719405382;Thu Mar 08 21:21:52 EST 2012;Committer;tenderlove;4;101;6;107;0
e7d4e659a070f6e188f3924bd8efb65e6919d2ef;Thu Mar 08 15:35:05 EST 2012;Committer;nobu;2;14;22;36;0
0b2c4f43d27510cd0f51a260b5b21fc7e39a5e85;Thu Mar 08 15:30:28 EST 2012;Committer;nobu;3;181;1;182;0
e1606102001b088e345c87f57dfa56d1c82a9118;Thu Mar 08 15:26:01 EST 2012;Committer;nobu;4;51;9;60;0
0aa05d97b360a34533ea83df84f031645f655ede;Thu Mar 08 15:25:09 EST 2012;Committer;svn;1;2;2;4;0
e78ff08968357431c87914641f294185cfda3218;Thu Mar 08 15:25:04 EST 2012;Committer;nobu;5;26;5;31;0
729e66b3c1d90547c9b4eb2a045d9095075f71b8;Thu Mar 08 07:44:13 EST 2012;Committer;svn;1;2;2;4;0
eec65961d033e155a0bbb724ad788066da12c03e;Thu Mar 08 07:44:08 EST 2012;Committer;nobu;2;12;7;19;0
0c8ae9165180e39c8a18e2172876eef83cd3eae9;Wed Mar 07 13:45:04 EST 2012;Committer;nagachika;3;41;2;43;0
075d98c7dc0cee294f03ed0ed26e1e8d8876b2b9;Wed Mar 07 07:30:31 EST 2012;Committer;nobu;6;30;17;47;0
8e07edf364398a9843dc939ec7e5ec7acdf62b95;Wed Mar 07 05:22:43 EST 2012;Committer;nobu;1;0;1;1;0
81809e27567739d0663ffe152941b8fdecf78495;Wed Mar 07 03:38:05 EST 2012;Committer;nobu;1;0;2;2;0
72de92d1f9f7ad5861f151f972db085cdf3e0edb;Wed Mar 07 03:26:30 EST 2012;Committer;nobu;5;16;8;24;0
a555b762b51d41225135a2baffd7c9c0cdefead3;Tue Mar 06 23:49:27 EST 2012;Committer;tenderlove;1;1;0;1;0
d576a25c26ea6765254e7ec247f951d6bb944703;Tue Mar 06 23:38:33 EST 2012;Committer;tenderlove;7;59;7;66;0
c95cfa0a16305ffb2d701cb2f54bac8b501d86d5;Tue Mar 06 23:30:15 EST 2012;Committer;tenderlove;1;1;1;2;0
ce2f69862e019a570b6793b1a4753476a9cb72a6;Tue Mar 06 23:30:03 EST 2012;Committer;tenderlove;3;26;5;31;0
9e9264c8d55b63e1033ed1a415ca9280744cf446;Tue Mar 06 22:45:43 EST 2012;Committer;tenderlove;3;35;2;37;0
8029539d029fc36ff8d09cc88ce821c7b4c6035f;Tue Mar 06 22:40:42 EST 2012;Committer;svn;1;2;2;4;0
1ac1163f562cc026199c81abefe4c8f9ab840b24;Tue Mar 06 22:40:38 EST 2012;Committer;tenderlove;3;116;15;131;0
2fbc01fb56332d5a611984570ff7346acd844eeb;Tue Mar 06 09:47:17 EST 2012;Committer;naruse;1;1;1;2;0
f35fa23852e46e3c6e29372db73e4a5033735869;Tue Mar 06 09:44:27 EST 2012;Committer;naruse;1;4;5;9;0
bc6dde94202d8c75ac2efae6a7667202c6cb3bb6;Tue Mar 06 07:24:07 EST 2012;Committer;nobu;3;53;2;55;0
8a4de7abf8850f330f9201fb07aba16a622d1fd2;Tue Mar 06 04:09:04 EST 2012;Committer;marcandre;1;10;10;20;0
dd9569ded88cf09e20a8ba9e341dc7236c12d73c;Tue Mar 06 01:11:47 EST 2012;Committer;nobu;3;38;12;50;0
2706b60ccbc5ebdf810bc496307815fa125647df;Mon Mar 05 22:19:35 EST 2012;Committer;tenderlove;2;12;3;15;0
8456c0603e8a121416445fad5cbe4527db8ca1af;Mon Mar 05 21:48:49 EST 2012;Committer;tenderlove;1;1;0;1;0
62ffffbe25a7a61a825f5b04399b9250f1af5ec0;Mon Mar 05 17:32:53 EST 2012;Committer;tenderlove;2;7;0;7;0
c46bdadb84bec5fd4484e4375e2935d740984618;Mon Mar 05 16:34:21 EST 2012;Committer;nobu;3;44;0;44;0
45f3651d1c0fbc286a3083eb03624fc9bc696232;Mon Mar 05 16:24:15 EST 2012;Committer;nobu;2;8;22;30;0
68ff00d9e3381f4f960bc7669045fdb3a448551f;Mon Mar 05 16:17:33 EST 2012;Committer;svn;1;2;2;4;0
0827c3848a771748a60cc6a7a08889eb8503b9f5;Mon Mar 05 16:17:29 EST 2012;Committer;nobu;1;9;8;17;0
bc4ef96c9e5d8670013a83644783b33de34f8c1f;Mon Mar 05 09:29:24 EST 2012;Committer;kazu;2;7;2;9;0
eb1eee03ca13eb13f8bfd02f18d9f5a0d5537ca6;Mon Mar 05 08:11:48 EST 2012;Committer;nobu;3;12;2;14;0
a2749dbbf16d46a5a510e925941ea9fa397f353c;Mon Mar 05 07:52:43 EST 2012;Committer;nobu;1;2;2;4;0
842c6f605bdd87bc931b1426bd9f1ea3ca1ba3dd;Mon Mar 05 07:51:31 EST 2012;Committer;usa;2;8;1;9;0
bfba60f8fea397e1cb0e2860d43294dbd1a070e4;Mon Mar 05 07:40:51 EST 2012;Committer;naruse;1;2;4;6;0
1d30263d345bfeb500f9ac67615de5f47be5690c;Mon Mar 05 07:36:47 EST 2012;Committer;naruse;1;1;1;2;0
4a6e738a46868fad414921a3ba54d3134ebe35bd;Mon Mar 05 03:44:14 EST 2012;Committer;nobu;2;37;12;49;0
4a8c531a26f2e6b33b6910731869488f93c77775;Mon Mar 05 03:44:05 EST 2012;Committer;nobu;3;24;10;34;0
5bd91964b2ca867579a9e243e8545872700e200c;Mon Mar 05 03:43:55 EST 2012;Committer;nobu;2;9;11;20;0
e5ac15998d29d5a239827fadc95ec3ff6d8f455a;Mon Mar 05 03:43:45 EST 2012;Committer;nobu;2;11;0;11;0
697b53d8a96db8ad797baa5fca37d6cec5d7ca9d;Mon Mar 05 02:53:36 EST 2012;Committer;naruse;3;8;2;10;0
2a70ec059b01153996170c44767b6c1b71fbdc66;Mon Mar 05 01:16:23 EST 2012;Committer;svn;1;2;2;4;0
14e1137989d39f818fe3bdb8f328e493361c9d6f;Mon Mar 05 01:16:19 EST 2012;Committer;naruse;1;2;1;3;0
68a16f9a2dfbb773744adaa63468449838761015;Sun Mar 04 14:21:13 EST 2012;Committer;nobu;3;17;3;20;0
b212b84fc1ebe42e559a078ef9e78e9b7e51907b;Sun Mar 04 13:59:23 EST 2012;Committer;ktsj;1;2;2;4;0
44281c8102e34258a709d7e1a6a9c5459483f7f8;Sun Mar 04 11:39:59 EST 2012;Committer;svn;1;2;2;4;0
b586af26e86e7843ab9fc716438fd2f2fff84758;Sun Mar 04 11:39:55 EST 2012;Committer;nagachika;1;1;1;2;0
61c148723d128db48196a7f46e9ba2b7e704fc37;Sat Mar 03 13:53:53 EST 2012;Committer;akr;3;35;20;55;0
cb5217088bfa512c359cbcd5d2ec177590bd13f0;Sat Mar 03 03:29:01 EST 2012;Committer;tadf;2;3;3;6;0
7aa308f8842c47e4d2e49a491a1c80ee85920b45;Sat Mar 03 03:22:44 EST 2012;Committer;tadf;1;1;1;2;0
e3b989c768b5c91dace8e57bb92821e7a2914328;Sat Mar 03 03:21:53 EST 2012;Committer;tadf;2;38;35;73;0
9a0cb802523549298df7c49dbcd5705fb477113b;Sat Mar 03 03:14:27 EST 2012;Committer;tadf;3;19;14;33;0
85e866978fb54cddf2692a9d3e439c709956eb62;Sat Mar 03 01:12:24 EST 2012;Committer;tenderlove;1;0;1;1;0
46e293ec0d3a7b6522101d17bb44d76f2ba8b827;Sat Mar 03 01:10:37 EST 2012;Committer;tenderlove;2;5;1;6;0
1836f44fe937bce25e77bbd1c9b881e0df38b42c;Fri Mar 02 23:46:17 EST 2012;Committer;tenderlove;3;31;15;46;0
cd85cd25b4f129225d20d36fa5326e9e57901da0;Fri Mar 02 23:21:17 EST 2012;Committer;tenderlove;3;42;2;44;0
60282ebfe5ddb283fc2312fb6a2ce9e928cb2ad9;Fri Mar 02 23:12:32 EST 2012;Committer;tenderlove;3;115;1;116;0
b854733d518fcd72b14cea5d7fed6512550a3572;Fri Mar 02 23:03:32 EST 2012;Committer;nobu;3;10;2;12;0
5c9d7c54ab3ca9933be70781777022d55e654309;Fri Mar 02 21:57:16 EST 2012;Committer;nobu;2;8;1;9;0
d45a9e77c20df00b7001b26901f56cdd55aabbad;Fri Mar 02 21:02:51 EST 2012;Committer;svn;1;2;2;4;0
4525bcae0b98e750fd28c29030bccd378c69406f;Fri Mar 02 14:05:28 EST 2012;Committer;nobu;1;7;0;7;0
9dcddfbaf56e62679edebcce157e03af4121ebe9;Fri Mar 02 08:50:13 EST 2012;Committer;nahi;2;5;0;5;0
effb5248a261aa4f197a3fd549f7c71f2e39bca9;Fri Mar 02 08:16:14 EST 2012;Committer;nahi;2;7;3;10;0
8d07e0870f575e970d922c76423f8f8d4e988aa8;Fri Mar 02 07:37:58 EST 2012;Committer;nobu;1;3;0;3;0
ee98d58f1c7d650706229e75f7a85b181a34a707;Fri Mar 02 07:37:13 EST 2012;Committer;nobu;2;6;1;7;0
ac018e7b3e4f4c5e6f251f38c95d66640c1be82d;Fri Mar 02 07:36:34 EST 2012;Committer;nobu;2;6;1;7;0
9d4207214a7dbbd6904210af0197c60331e34bd9;Fri Mar 02 07:36:06 EST 2012;Committer;svn;1;2;2;4;0
825430438debeed9fe7208b69c923594be8b063e;Fri Mar 02 07:36:00 EST 2012;Committer;nobu;2;6;2;8;0
0b89081bbb4b69c70596107d834031974a857177;Thu Mar 01 07:13:22 EST 2012;Committer;nobu;3;7;2;9;0
27fbcb8e786f7b2049fea860a36217393a377423;Thu Mar 01 06:44:37 EST 2012;Committer;nobu;1;3;3;6;0
29c630e71da649039d2210c8c737483d44a8f2c3;Thu Mar 01 06:40:09 EST 2012;Committer;nobu;3;12;2;14;0
f9cec70898560505f89b7f75b7fe7eabea6a4632;Wed Feb 29 16:29:11 EST 2012;Committer;svn;1;3;3;6;0
291fa223cfb2349c5e7fc5bb0e7729a2cfcc52cf;Wed Feb 29 16:29:06 EST 2012;Committer;naruse;4;32;9;41;0
31eb29fe975bdf1d1e7ed5f3eb991430b381bc06;Wed Feb 29 07:13:04 EST 2012;Committer;usa;3;13;2;15;0
70581477da30ee63c790dee451172c0ae340f667;Wed Feb 29 06:40:41 EST 2012;Committer;usa;2;6;0;6;0
74b70ad879d90a8bf8f5adf0f4461b4e0fa56485;Wed Feb 29 06:39:22 EST 2012;Committer;usa;2;5;1;6;0
1673881f58371f441d23987c676e36322f566ade;Wed Feb 29 04:07:10 EST 2012;Committer;nobu;2;7;2;9;0
fc493491fe4ca9c17ab5e7b9af5efbf9bfc8f7ae;Wed Feb 29 04:07:08 EST 2012;Committer;nobu;1;11;11;22;0
23008fcc2e10430163332972f82821be28f7b1a2;Wed Feb 29 04:07:06 EST 2012;Committer;nobu;2;3;1;4;0
afa7b27e8b40a6820d13290aa607247db1e7e90a;Wed Feb 29 04:07:03 EST 2012;Committer;nobu;2;2;2;4;0
329ae7470ee851c6f8ae26804bf2b3069ff81457;Tue Feb 28 21:53:54 EST 2012;Committer;tadf;1;1;1;2;0
f400ba1082df5b70d88f6000a31f005ab9213d6b;Tue Feb 28 21:17:49 EST 2012;Committer;tadf;2;21;18;39;0
f3b685d198e7758dc9444d01c212b0a37e52bc9c;Tue Feb 28 15:51:31 EST 2012;Committer;svn;1;2;2;4;0
4b1e9f0c476879242ce3dab2e430deb28651d54c;Tue Feb 28 15:51:25 EST 2012;Committer;shirosaki;7;105;20;125;0
3486a98a71d3d2d09258cbd0ab13dc715f750f25;Tue Feb 28 11:28:23 EST 2012;Committer;tadf;3;12;1;13;0
97d6e56b0e68d5361809c4571fd1003ee41bffb0;Tue Feb 28 09:47:47 EST 2012;Committer;nobu;2;8;1;9;0
9b02a72d7183f3a76636f1168429e5d229409c66;Tue Feb 28 09:33:35 EST 2012;Committer;nobu;3;44;0;44;0
007b7fcdcf709cbffb2ee2c6c01f9edf4daaccac;Tue Feb 28 08:16:03 EST 2012;Committer;nobu;3;18;13;31;0
3ee4c4fdf0250181fd1438b1e2cd5b3bcdc5f0e5;Tue Feb 28 06:49:52 EST 2012;Committer;drbrain;1;0;9;9;0
09f27873ed653bd4afb5538b669e2362f3b1bf6e;Tue Feb 28 05:15:54 EST 2012;Committer;drbrain;7;34;15;49;0
8a7da58c0fe28af09ce0631d6ada79e47cc7b98f;Tue Feb 28 04:51:37 EST 2012;Committer;drbrain;4;35;20;55;0
1c85a648febde2176493b26130b08c742b3de305;Tue Feb 28 02:44:52 EST 2012;Committer;nobu;2;9;2;11;0
0cb987bc514495c99c3f5c3ee373594507d1c115;Tue Feb 28 01:30:15 EST 2012;Committer;tenderlove;3;9;3;12;0
58fb7e9151dfd749832ab4edee0a2380cebaa906;Mon Feb 27 16:27:26 EST 2012;Committer;usa;1;6;6;12;0
d8c26724e8de20320f7929f3cbfa13e3d50fd31b;Mon Feb 27 15:11:04 EST 2012;Committer;svn;1;2;2;4;0
9f0de403c5a87b361430af1defea46009799f6eb;Mon Feb 27 15:11:00 EST 2012;Committer;knu;1;2;2;4;0
f3e1c29b2414510b4622336bed790960c0762057;Mon Feb 27 14:47:02 EST 2012;Committer;matz;2;11;4;15;0
d74ccf8fc1cc4ce67d0c498a3c963f08ba4b8530;Mon Feb 27 11:46:43 EST 2012;Committer;usa;2;8;0;8;0
475422fac63b3a3436dc1af45a471041ca05a611;Mon Feb 27 08:40:37 EST 2012;Committer;nobu;1;2;2;4;0
2a19074c6531fca99743a033b48a815d01f09409;Mon Feb 27 08:27:39 EST 2012;Committer;nobu;1;10;0;10;0
34205bc4ec63f693d2ebab1b1371b2119d7c4391;Mon Feb 27 08:07:24 EST 2012;Committer;knu;2;19;6;25;0
f5482e4c38732db8912a68652735f8ddac020141;Mon Feb 27 08:03:24 EST 2012;Committer;nobu;3;14;1;15;0
ce2211bf04e31676609b2c842aa609ba8e249ce6;Mon Feb 27 01:54:23 EST 2012;Committer;nobu;2;23;0;23;0
8e683a8a97dedf214b894dfa4391954dac766518;Mon Feb 27 01:53:47 EST 2012;Committer;nobu;2;6;2;8;0
90080e3a2efa4443fce2c3f8201fbc62bb356a3c;Mon Feb 27 01:53:14 EST 2012;Committer;nobu;2;6;0;6;0
80429eed638c36baa3574704b1b567aa7acb4fa6;Mon Feb 27 01:50:27 EST 2012;Committer;nobu;12;79;65;144;0
2c3cc479a9b7d55e48d50d3c1712f28855faea12;Mon Feb 27 01:48:58 EST 2012;Committer;svn;1;2;2;4;0
4c12eb747e36b99fc3831bf1d8ffca1777581870;Mon Feb 27 01:48:52 EST 2012;Committer;nobu;6;20;0;20;0
a77ea177fe6609137c677d2c33453467eaea30df;Sun Feb 26 14:32:54 EST 2012;Committer;naruse;3;23;6;29;0
6a8d0097095d975fbd19cf62c83645b51886025b;Sun Feb 26 02:26:49 EST 2012;Committer;nobu;4;19;3;22;0
767848e0b782152fa2652a37532950f42e0c3012;Sat Feb 25 20:37:17 EST 2012;Committer;svn;1;2;2;4;0
d068ac8e0c2efad8230bedc57ceddf2d413231d6;Sat Feb 25 20:37:15 EST 2012;Committer;naruse;2;10;2;12;0
2646c694794888572d4f9e903f4b148628e7ec3d;Sat Feb 25 20:37:12 EST 2012;Committer;naruse;4;13;0;13;0
a38958a521a72efdb209a83fbb81911ced919d00;Sat Feb 25 08:42:00 EST 2012;Committer;akr;2;7;3;10;0
9a93699a49c1c5d2baff2d82a865f3ccf7b5150d;Sat Feb 25 08:08:55 EST 2012;Committer;naruse;2;9;4;13;0
9167535c503f526e6555d413b4151e5ae51fc30b;Sat Feb 25 07:58:14 EST 2012;Committer;nobu;1;2;2;4;0
aced01eeb4b700473032be252f23d937f798bda6;Sat Feb 25 07:41:07 EST 2012;Committer;naruse;1;1;1;2;0
51438b1c150d225e13f96b2167217e38a441df8d;Sat Feb 25 07:31:13 EST 2012;Committer;akr;1;9;0;9;0
905609851690f3c67c1b54186535dc9b7acf697d;Sat Feb 25 07:26:22 EST 2012;Committer;akr;1;12;0;12;0
eeff98c4308b47dfec68c5c41c02736fca451e2f;Sat Feb 25 07:20:00 EST 2012;Committer;naruse;4;23;0;23;0
57657a0b9bf558477d5e9c1a3f4a3b89cd5006d1;Sat Feb 25 07:08:47 EST 2012;Committer;naruse;3;12;14;26;0
6f24054f6e529efb2d825d7aef03588692d1effc;Sat Feb 25 07:08:44 EST 2012;Committer;naruse;1;2;0;2;0
b4288080e7d025729f88479c44ed054f65b30f60;Sat Feb 25 05:47:16 EST 2012;Committer;nobu;11;270;11;281;0
d9adb03dd902c1cf7e5fadc8320dccec0ef73139;Sat Feb 25 02:09:22 EST 2012;Committer;akr;3;34;23;57;0
aa281e75179caa27228a0051efb94d14f7c553e4;Sat Feb 25 01:36:33 EST 2012;Committer;akr;3;10;3;13;0
785521bd5133501c7315c5aace783a8d8ef6b5ac;Fri Feb 24 22:54:00 EST 2012;Committer;nobu;3;15;5;20;0
eec0b2d88a68d7931ff1d41c5cc2c773f7f22c6c;Fri Feb 24 22:53:51 EST 2012;Committer;nobu;5;44;15;59;0
85738261a582ceef498b86b784171fba59bf60cc;Fri Feb 24 22:53:42 EST 2012;Committer;nobu;5;38;9;47;0
cc07e34bfcc9675924fd0546b46eb53c3d972ab8;Fri Feb 24 21:55:48 EST 2012;Committer;svn;1;2;2;4;0
cbd6a464ce5556a364ac51b7d5716214d8c8b389;Fri Feb 24 21:55:34 EST 2012;Committer;nobu;2;6;1;7;0
d77f31b6352799c7df440b81af4a91ad76734089;Fri Feb 24 09:25:14 EST 2012;Committer;nahi;2;23;0;23;0
79bd9c3e4da4418b8282fe1cd2a9709aa318ce94;Fri Feb 24 08:58:24 EST 2012;Committer;shyouhei;2;6;0;6;0
adcb7e9e7b142427c97251fdb6340433f65fe811;Fri Feb 24 07:48:34 EST 2012;Committer;nobu;4;36;46;82;0
7d742d47cc2f0023c4aeffdec6a6296f6c69a10f;Fri Feb 24 07:39:59 EST 2012;Committer;nobu;3;56;1;57;0
9acf2091e14e49949aab6f38e1a41dd3d7d3077e;Fri Feb 24 07:37:48 EST 2012;Committer;nobu;4;30;23;53;0
b8729f117cd1821ed48d57a894f78af25315bd25;Fri Feb 24 07:13:24 EST 2012;Committer;nobu;1;3;1;4;0
d573446841743e709c3da79b28051ab4fc18d3fd;Fri Feb 24 06:49:09 EST 2012;Committer;nobu;3;20;0;20;0
0d1c8fd9d6407a1c58d329f2b4f53b16494cce84;Fri Feb 24 04:55:33 EST 2012;Committer;tenderlove;3;155;24;179;0
0e896b99bffb710fc557a0ccfd25c1d94b89dbc5;Fri Feb 24 03:15:10 EST 2012;Committer;ayumin;1;1;0;1;0
e0f4a550e548a41fe6930f236fd99f2748092ab4;Fri Feb 24 03:10:25 EST 2012;Committer;ayumin;2;6;1;7;0
7e76ab5e5e083d195647240580d1581f019396d3;Fri Feb 24 02:56:30 EST 2012;Committer;ayumin;2;8;3;11;0
7a1180c7457b9ac79d4fa37e296a74e0e6655f79;Fri Feb 24 01:10:07 EST 2012;Committer;drbrain;3;44;23;67;0
af9398ab38fa7b1f177b3079c80eb1131a2d693b;Fri Feb 24 00:10:53 EST 2012;Committer;drbrain;2;8;0;8;0
45c6daeed7e02fab59bf9aedcaf42be64b4ea61d;Thu Feb 23 23:52:12 EST 2012;Committer;nobu;3;14;4;18;0
455c23fa015c76dde765b5b417e93ce24bb43ae7;Thu Feb 23 23:35:21 EST 2012;Committer;drbrain;1;18;18;36;0
b52b1f6a7d1ed9451c067736b7d554fcb41d32ee;Thu Feb 23 23:16:21 EST 2012;Committer;drbrain;1;4;4;8;0
480ea9ffae1b656a129f2f9f1d900d9d7d88d25e;Thu Feb 23 23:15:44 EST 2012;Committer;drbrain;2;64;0;64;0
774cf315e838216aa8b4c138173484aa2388c380;Thu Feb 23 23:12:57 EST 2012;Committer;tenderlove;5;174;3;177;0
0e0286404ff2a3b4298d1ebab65d0f351caf098e;Thu Feb 23 23:03:39 EST 2012;Committer;drbrain;2;50;0;50;0
6d6b4569fc153149ce648268e4d1df00f7dfa1bc;Thu Feb 23 22:36:40 EST 2012;Committer;drbrain;2;28;15;43;0
9802ce8bd2a3df806b3f5a513422f5677e3ba9ca;Thu Feb 23 22:23:58 EST 2012;Committer;drbrain;2;17;8;25;0
f51ad04324b66403a872c8b4a8c343d19059273f;Thu Feb 23 15:22:10 EST 2012;Committer;svn;1;2;2;4;0
427035c0bbed108cfc305b55a4773072362504dc;Thu Feb 23 15:22:06 EST 2012;Committer;akr;1;4;1;5;0
cd390b1ec501c20cec43ee91a2b153b8ed1057db;Thu Feb 23 14:02:01 EST 2012;Committer;akr;2;4;1;5;0
e5cf1dcf7be412eebb9b3b14e516f363aab1167e;Thu Feb 23 13:27:29 EST 2012;Committer;akr;2;16;0;16;0
a49fc9beb620090bbca309cfb1c1167644a38d46;Thu Feb 23 10:59:00 EST 2012;Committer;akr;2;5;1;6;0
57e95f86be629449cba21e4d1893bb5e11214e5d;Thu Feb 23 10:57:55 EST 2012;Committer;akr;2;9;1;10;0
845b21064cb2638e26e11b77de58ba616fbaf183;Thu Feb 23 10:52:51 EST 2012;Committer;akr;1;9;1;10;0
fd2e0e3dac68bd45fac8a51abf76408383ef0452;Thu Feb 23 03:23:40 EST 2012;Committer;akr;2;9;6;15;0
0585853c6916557dffef0a91635bc0004f70d68f;Thu Feb 23 02:00:39 EST 2012;Committer;drbrain;2;5;1;6;0
8a5b4ad1153ee725e30030963aa7787e683a8922;Thu Feb 23 01:58:01 EST 2012;Committer;drbrain;2;10;0;10;0
dfb1a7122250bba977fee5d27226a2226b0fc62a;Wed Feb 22 18:59:03 EST 2012;Committer;marcandre;3;8;2;10;0
9c8d348d4973784c16db6fd24e547b217a7bc592;Wed Feb 22 17:33:14 EST 2012;Committer;svn;1;2;2;4;0
4341c58c399e7f855da23b8d3ee795e0ff3e8397;Wed Feb 22 17:33:10 EST 2012;Committer;nobu;3;18;5;23;0
f56c6318de7332e1a6c930f2ddc8ed93ab55d96a;Wed Feb 22 14:27:11 EST 2012;Committer;nobu;2;5;1;6;0
01433e4d53c37ac3620a72ec1b155e3e7be6ab7b;Wed Feb 22 12:46:44 EST 2012;Committer;akr;2;6;2;8;0
7c80d15165022a040805001586472fa89dd266d9;Wed Feb 22 12:45:04 EST 2012;Committer;akr;2;23;19;42;0
c01d52e8d9e3f1596d3bbbebaa8ea35c330f8763;Wed Feb 22 11:44:26 EST 2012;Committer;akr;3;53;1;54;0
fa65fc9aeb5e73b84ce80c4c2c3edaa888362e03;Wed Feb 22 10:48:59 EST 2012;Committer;akr;2;8;1;9;0
8cd604c6c7bb27545bf7fcecf06cad673ab4131d;Wed Feb 22 10:23:23 EST 2012;Committer;tadf;5;21;5;26;0
9fc31792ce55306e977f65d9a44f3da3e015a4cf;Wed Feb 22 10:09:31 EST 2012;Committer;akr;2;35;20;55;0
1a6b0bab94a1594d892afd498b08830a29089422;Wed Feb 22 09:47:28 EST 2012;Committer;sorah;2;14;3;17;0
c0ec3efcae87aab655738ff7fa2ea16986b9ef84;Wed Feb 22 09:47:24 EST 2012;Committer;sorah;3;16;0;16;0
b67bc8d722e9351b34e68ac77d397aead29961cc;Wed Feb 22 09:34:59 EST 2012;Committer;nobu;5;6;20;26;0
9e4ddb8f18ea3e88ae93ff669deb2bd1c0a372b7;Wed Feb 22 09:06:40 EST 2012;Committer;naruse;2;1;5;6;0
31d8a976575d38bd912b7e4aa5204fd88b5a97fc;Wed Feb 22 08:36:25 EST 2012;Committer;nobu;3;14;1;15;0
873b56fd50e12294601bbe96b1bef3b2c2428010;Wed Feb 22 08:07:38 EST 2012;Committer;nobu;3;9;1;10;0
e093cfae7af6304d3ba4427ab27ac6e2d352bf82;Wed Feb 22 06:47:09 EST 2012;Committer;nobu;2;5;1;6;0
0c8811595a16bd69c8d751194e092a07078822fd;Wed Feb 22 06:39:57 EST 2012;Committer;nobu;1;4;4;8;0
86716b9768e1e6636321421bc7d0b2b0f9265bb2;Wed Feb 22 03:50:02 EST 2012;Committer;kazu;1;1;1;2;0
a23f06358ee3e8267650b400f31f0f57ba6c9756;Wed Feb 22 03:22:08 EST 2012;Committer;naruse;2;4;5;9;0
b790678398beff2669ec8a91e25d8e5ce6390659;Wed Feb 22 02:03:56 EST 2012;Committer;naruse;2;5;1;6;0
8e799c3e5b66b7a0d51ba9e904eec89ad719fb1d;Wed Feb 22 01:32:14 EST 2012;Committer;nobu;2;8;2;10;0
1aa4e11d163cf452b59114ad9a5b3908a11fd797;Wed Feb 22 01:18:09 EST 2012;Committer;nobu;2;6;2;8;0
9dc0d6fe638371fe42c5e985f0992b8071f8297b;Tue Feb 21 23:02:29 EST 2012;Committer;drbrain;2;7;4;11;0
8963f50f269f93d2ca7034cf3c6508e9df1686f6;Tue Feb 21 21:13:52 EST 2012;Committer;akr;3;14;2;16;0
80a6b1474d2238bde20fc770bc51792ebef0e892;Tue Feb 21 21:04:09 EST 2012;Committer;svn;1;2;2;4;0
eac1d9cfcad5d2d56951e540eb7023eccf7a3593;Tue Feb 21 21:04:04 EST 2012;Committer;akr;3;19;0;19;0
ca9b0f56fc25a2b98c0646014f5fb352319e8070;Tue Feb 21 11:23:50 EST 2012;Committer;nobu;2;10;14;24;0
bc3b4ddddd686e380c921c0f33213ddb61a2a0b4;Tue Feb 21 11:22:49 EST 2012;Committer;nobu;2;6;1;7;0
25df75e1195fe6c9d957ef8123096275ade04467;Tue Feb 21 10:40:20 EST 2012;Committer;akr;2;6;1;7;0
c98fd7da8a7b9a1e388daf4a68e41a1d8d3d64d2;Tue Feb 21 09:41:09 EST 2012;Committer;nari;1;22545;17685;40230;0
0d44bf83dac7d4abd939273aeccd9182a2b353b8;Tue Feb 21 09:35:07 EST 2012;Committer;nari;3;20046;24915;44961;0
2e733be0b2a4f590532a78e4b4539ff539f69d0e;Tue Feb 21 07:08:21 EST 2012;Committer;nobu;2;7;4;11;0
a5e49f99011163ef264cb6ad834496426ff57e85;Tue Feb 21 05:41:12 EST 2012;Committer;nobu;2;12;0;12;0
f12c14d3ef2474631c78d28b45d15db1d2cc668c;Tue Feb 21 00:13:44 EST 2012;Committer;marcandre;6;63;4;67;0
3052f75db499d18a7954766e1178a8d7e06c1867;Mon Feb 20 17:59:43 EST 2012;Committer;matz;2;6;1;7;0
8e6dfeecc932ce0be2d61e7e12365d788cb898e9;Mon Feb 20 15:59:15 EST 2012;Committer;nobu;1;1;0;1;0
e5cb1bb9300e14eb6334ea70d0b2acd4c686d7ec;Mon Feb 20 15:00:39 EST 2012;Committer;svn;1;2;2;4;0
a1292c72efae2aae02009de870c8a144083b6c02;Mon Feb 20 15:00:35 EST 2012;Committer;akr;1;18;12;30;0
07d8dffe827d3d94637ea51fe27b167b8032f498;Mon Feb 20 14:40:01 EST 2012;Committer;usa;2;6;1;7;0
b17bc954001848da03b12639ee459860fb584006;Mon Feb 20 12:41:23 EST 2012;Committer;akr;2;14;2;16;0
5cfba33a77d73bc09df850858ccd8ed8eb7014d4;Mon Feb 20 12:30:11 EST 2012;Committer;shirosaki;2;7;1;8;0
83f742f86fd20527b5568dca7bdf2b251c511f55;Mon Feb 20 12:10:00 EST 2012;Committer;akr;2;10;0;10;0
9f6f0788d29e5883bd45f5f4e326e5a9ea9f12bf;Mon Feb 20 12:09:25 EST 2012;Committer;akr;2;27;4;31;0
faf4c9db80b12e590c38863604889032ea097711;Mon Feb 20 11:05:31 EST 2012;Committer;akr;2;11;1;12;0
f8015c23c48bb65cf057480e6436aa0c9cad1f4f;Mon Feb 20 10:16:25 EST 2012;Committer;akr;2;18;14;32;0
aa27e42fd371728db751b6fcc83a62b9bec9573c;Mon Feb 20 06:50:40 EST 2012;Committer;svn;1;2;2;4;0
032d0a4cf7cd000214ad0347242b09f7039edbcc;Mon Feb 20 06:50:36 EST 2012;Committer;nobu;2;7;0;7;0
05a2cd709f4b223c1e3c32d7699b31d7dab20591;Sun Feb 19 14:44:36 EST 2012;Committer;akr;1;4;0;4;0
d7bf156afd420a6a77ca2fac30c333e860243121;Sun Feb 19 14:44:24 EST 2012;Committer;akr;2;7;0;7;0
0e8cd8ae575e60c6cdfeed9898034c1373a9fd79;Sun Feb 19 14:14:44 EST 2012;Committer;kazu;1;3;3;6;0
95f3f9829f8a5e8ff29c5c6b26f1062c7cb23786;Sun Feb 19 14:02:14 EST 2012;Committer;akr;3;28;11;39;0
87a15a6981b8c44c15667f01914e64add1348a6d;Sun Feb 19 10:18:16 EST 2012;Committer;nari;2;4;11;15;0
1efa14169ac0b3f55b9026985095ca256c1315e9;Sun Feb 19 08:33:01 EST 2012;Committer;akr;1;5;0;5;0
460bb8a829904476bd8b8006f0274499d23b991a;Sun Feb 19 08:08:37 EST 2012;Committer;akr;2;7;0;7;0
310c2adf1bc92af3b68da64d57a6752fc1e48310;Sun Feb 19 06:36:45 EST 2012;Committer;nobu;1;1;1;2;0
f0e9fa3cb12a9f9a14b5b77d872bce8cc027b829;Sun Feb 19 04:11:19 EST 2012;Committer;nari;2;4;2;6;0
55e6e9e3848433ccb095b352545bb97b0fb21603;Sun Feb 19 03:07:59 EST 2012;Committer;nari;2;7;2;9;0
541e1aff202013c1de8c4e462e070bbe40b283c4;Sun Feb 19 01:51:05 EST 2012;Committer;nobu;1;1;2;3;0
c509bec71deb3a757a090ab9dc1a6d64f38c72ff;Sat Feb 18 18:05:24 EST 2012;Committer;akr;1;1;1;2;0
62debc952d23dad49611393bb0889a6c4a75bad2;Sat Feb 18 18:01:02 EST 2012;Committer;akr;2;32;1;33;0
0187905af2e16438606ead7618328bf062cc3339;Sat Feb 18 16:06:52 EST 2012;Committer;akr;3;34;3;37;0
0ffc74dece854ae8baa7a42342cab0fe29df04e9;Sat Feb 18 15:41:59 EST 2012;Committer;nobu;2;3;1;4;0
ca5a0db67bf1389588a8495a5954162bd3346df1;Sat Feb 18 15:31:13 EST 2012;Committer;svn;1;2;2;4;0
fcd8f78ea354d250353b693567a0eb68798844a8;Sat Feb 18 15:31:09 EST 2012;Committer;akr;2;13;0;13;0
923bff74b1f63e0edb6a3f6d648dbf66b9196631;Sat Feb 18 14:28:42 EST 2012;Committer;mrkn;2;4;2;6;0
90cc116431fa4e946d8c8ea9cdba7b492da11ea4;Sat Feb 18 10:06:24 EST 2012;Committer;akr;1;6;6;12;0
fc0111cce1bc77a277b1f098027a898a919f0981;Sat Feb 18 09:47:07 EST 2012;Committer;akr;3;80;32;112;0
4c1ea85dd892fa557205d0c85b60e59415cc2ae8;Sat Feb 18 04:54:09 EST 2012;Committer;akr;2;8;0;8;0
48a97f2c949a1ab22bc11c0be6b5da30a6ce6e72;Sat Feb 18 04:41:15 EST 2012;Committer;akr;2;19;0;19;0
e7a1d4a309152582215fe23799491e31d802d90d;Sat Feb 18 03:51:52 EST 2012;Committer;akr;2;9;0;9;0
622769060445a2c37c3fbc09cfc6ccbe9cda7f10;Sat Feb 18 02:47:41 EST 2012;Committer;naruse;2;8;4;12;0
e0f059a105029bb447a380b9718ff755ec62faee;Fri Feb 17 17:59:52 EST 2012;Committer;svn;1;2;2;4;0
ace46301d8299c1e010eb7bb858bffc471be6763;Fri Feb 17 17:59:47 EST 2012;Committer;tenderlove;5;212;201;413;0
92e7c2d3eab31487164a41984a246f5809936b1a;Fri Feb 17 12:41:54 EST 2012;Committer;akr;2;5;1;6;0
6d1f751207de36053d061657691603a47a4c6496;Fri Feb 17 12:29:50 EST 2012;Committer;akr;2;48;3;51;0
fbca1d0da135b29f311dff5afcc6d6a3cbc597c7;Fri Feb 17 12:10:32 EST 2012;Committer;akr;2;7;2;9;0
242994f33dcadfe50220edb07a92c64774c5c347;Fri Feb 17 08:18:16 EST 2012;Committer;nobu;1;0;5;5;0
0424e152c684a85f4b0691f1e84aec203115333d;Fri Feb 17 07:42:23 EST 2012;Committer;naruse;54;28950;20307;49257;0
5362e7fcddf70d16fc4261383f99175c90881353;Fri Feb 17 06:20:56 EST 2012;Committer;nobu;2;5;1;6;0
41e331cc361a1ba89a5663d2cec7505f5bc82552;Fri Feb 17 04:24:48 EST 2012;Committer;nobu;3;374;297;671;0
3b243514ffc9f185000f0051fa109b9c3b534b46;Fri Feb 17 03:37:44 EST 2012;Committer;naruse;2;6;1;7;0
68262a2048d3253b279d990acdd403cdeaf5a83b;Fri Feb 17 02:50:22 EST 2012;Committer;nobu;2;15;10;25;0
7d0066c542628b0d356de76617ac980292c1c583;Fri Feb 17 00:56:25 EST 2012;Committer;nobu;2;8;3;11;0
375fd3152f21feeb3e3cf2b02449c3a495b349a9;Fri Feb 17 00:53:13 EST 2012;Committer;naruse;3;12;5;17;0
f5d724ab19eb2b83f54331b55fed8d867836c0ed;Thu Feb 16 22:33:31 EST 2012;Committer;nobu;2;12;7;19;0
2f92a267f4d0c4aad1c414515092ca7bf99206fe;Thu Feb 16 22:32:10 EST 2012;Committer;akr;2;41;26;67;0
d698ea8991ff6f0d6160838bdd5785a01fdf266d;Thu Feb 16 15:25:06 EST 2012;Committer;akr;2;8;2;10;0
2e544c33624614cf5c8f4948168f9aa2106fa8ed;Thu Feb 16 15:05:51 EST 2012;Committer;svn;1;2;2;4;0
078b3cf95e454e5e87a27dcff20f52f4a58ad2d8;Thu Feb 16 15:05:46 EST 2012;Committer;akr;2;7;1;8;0
fde3c421bea8bd514acddb4c1b2d5f81afd1af36;Wed Feb 15 20:41:38 EST 2012;Committer;nobu;4;17;2;19;0
e315f8471d2c2fbe3c5d96a9bf8d987fe5786f3b;Wed Feb 15 15:16:24 EST 2012;Committer;svn;1;2;2;4;0
f2c84d2da035e73c432e4ba182b5eb077aa90384;Wed Feb 15 15:16:20 EST 2012;Committer;kazu;2;5;1;6;0
0328ab1d0a3677be6dbd93eb8ffc7b05d3921ef0;Wed Feb 15 14:02:34 EST 2012;Committer;nagachika;1;1;1;2;0
2910f6736e09d1faa3b06db65e44193bdd2077c0;Wed Feb 15 14:00:11 EST 2012;Committer;nagachika;6;69;1;70;0
ac43a903b061c8e04e25efa457ca21c7e49cc693;Wed Feb 15 12:24:43 EST 2012;Committer;kazu;1;1;1;2;0
34be46a32e6a8c88866c6dd9e42705ed63ed5d2a;Wed Feb 15 10:57:05 EST 2012;Committer;nobu;5;80;31;111;0
fa65df0d084077f6766c8a2580016de49cbf42f9;Wed Feb 15 10:52:31 EST 2012;Committer;nobu;3;30;1;31;0
df5867a2a7f08af8239b4c7a1eaf961bd9019c11;Wed Feb 15 09:47:22 EST 2012;Committer;naruse;1;5;0;5;0
7eed0ca619fc7602737bb81d42a63dc60751367b;Wed Feb 15 08:45:15 EST 2012;Committer;naruse;2;9;1;10;0
ff4c13688ec7f4ea212fadf16c6ad7c4d9f5ba11;Wed Feb 15 06:52:10 EST 2012;Committer;naruse;2;10;1;11;0
b6c604d757d67085c5b2cfb7e38ebebfa6d9aa63;Wed Feb 15 04:30:37 EST 2012;Committer;drbrain;2;15;0;15;0
72282ab1e2a9c85b0c38e1e78c50fe8ea2f138ed;Wed Feb 15 04:25:11 EST 2012;Committer;drbrain;2;102;199;301;0
2d952c6d16ffe06a28bb1007e2cd1410c3db2d58;Wed Feb 15 03:31:55 EST 2012;Committer;marcandre;2;6;0;6;0
3281b90ecb96f2579cf4b9893abffd45a0993313;Wed Feb 15 03:31:30 EST 2012;Committer;marcandre;1;3;15;18;0
8b4b4032f711766c3863c40fff33acde9a5bc331;Wed Feb 15 02:09:44 EST 2012;Committer;nari;2;7;1;8;0
623169a5c6cbad1ae6d8969f273f534cbd0c3fe4;Wed Feb 15 01:28:05 EST 2012;Committer;drbrain;3;30;1;31;0
a1aeb842d01d1fd979f709600087be87ae549f94;Wed Feb 15 01:23:00 EST 2012;Committer;naruse;1;39;24;63;0
b52693b5a8618f672b32aeb7d06bb036672d1b48;Wed Feb 15 01:12:08 EST 2012;Committer;drbrain;2;173;112;285;0
776197f80deba91da96259ac0a3ff75e3f722643;Wed Feb 15 00:53:37 EST 2012;Committer;naruse;1;2;2;4;0
b14b83ae9295d130a21c1b5f75a3154c3a297631;Tue Feb 14 23:29:14 EST 2012;Committer;drbrain;2;39;3;42;0
6d76f39fc857b3d9e1b929a48cb6e81760594c2f;Tue Feb 14 22:59:15 EST 2012;Committer;drbrain;2;161;1;162;0
02d1912ed98a826bd62cee42b42253b9bc137ff2;Tue Feb 14 20:13:32 EST 2012;Committer;svn;1;2;2;4;0
1c923eb2306a7782b6bd3f0d8cb30ad6dde21104;Tue Feb 14 20:13:27 EST 2012;Committer;naruse;1;1;1;2;0
0da31416f1b0d3b24e09fb19a6576bb3254c7e91;Tue Feb 14 11:26:24 EST 2012;Committer;nari;2;6;2;8;0
c104867ebc1471854d5506b5a2be3dd0992f587f;Tue Feb 14 09:14:08 EST 2012;Committer;nari;1;1;0;1;0
64e7aedceef872e8f942cb8eb672d0bc32c13984;Tue Feb 14 09:11:24 EST 2012;Committer;nari;2;7;3;10;0
52cb46337e9e5bd78f0a64a114ec8004173b2525;Tue Feb 14 07:00:33 EST 2012;Committer;nobu;2;12;3;15;0
799680354ebe7cc7af7fed9766451df27e2f28fc;Tue Feb 14 06:06:40 EST 2012;Committer;nobu;2;6;1;7;0
391b579097f233cb734f89c6c39257e77473fa51;Tue Feb 14 03:10:11 EST 2012;Committer;nobu;2;13;5;18;0
9d7573c41a33f7759ea62b7f0d273bdcd90f2171;Mon Feb 13 21:24:01 EST 2012;Committer;drbrain;2;9;4;13;0
a63b86e2a8e18cef7406ad0c1b404dce1aa60ccc;Mon Feb 13 21:19:11 EST 2012;Committer;drbrain;2;71;4;75;0
b2994527d607caf876f18ef2ec5cb1307651f6fb;Mon Feb 13 16:05:05 EST 2012;Committer;svn;1;2;2;4;0
4349b42e82ff95fab9d66dd54686bf76b12a5dba;Mon Feb 13 16:05:00 EST 2012;Committer;knu;1;5;0;5;0
23473d1f9fc33151f0d5804e0cca824794a0bfe6;Mon Feb 13 14:02:26 EST 2012;Committer;knu;3;21;9;30;0
261400e7a9b4e8774a058e9a6f53fc885329c5f8;Mon Feb 13 12:57:16 EST 2012;Committer;nari;2;13;2;15;0
df77202b372535d58fccc244113fd9944c7b01c0;Mon Feb 13 09:30:40 EST 2012;Committer;nobu;3;46;34;80;0
23ebb5ea6cdff94d840b34ab7ef78e73ee442e75;Mon Feb 13 01:24:51 EST 2012;Committer;svn;1;2;2;4;0
b7ef9fa2a4933f1a0fe0ebd4176e01cdff9a8a9f;Mon Feb 13 01:24:45 EST 2012;Committer;nobu;2;10;4;14;0
0229827c8b6f567c4c7a36945c966e8a676a1159;Sun Feb 12 11:44:06 EST 2012;Committer;nobu;2;5;1;6;0
24dbd1979108d3ca95aa4e86e56e5d6dd922b835;Sun Feb 12 07:33:09 EST 2012;Committer;knu;2;7;1;8;0
0d0344c1f0f912ad048406762c6518cf997237b3;Sun Feb 12 06:17:25 EST 2012;Committer;ktsj;2;8;5;13;0
691a3a2bdc3495860405b1173d9081804a55c350;Sat Feb 11 19:15:36 EST 2012;Committer;drbrain;3;23;1;24;0
3ab9be9245c1e49ee40c4e7b728feddc2368fbd0;Sat Feb 11 16:48:04 EST 2012;Committer;akr;1;1;1;2;0
0dee30091bdaa87b1a7ac313b4f408fdff329afa;Sat Feb 11 16:28:18 EST 2012;Committer;svn;1;2;2;4;0
4e8d188ead792761c590e7c313039176f66e4df5;Sat Feb 11 16:28:13 EST 2012;Committer;akr;1;6;0;6;0
f119915f5139a33273363c64ca1f3862f171e71c;Sat Feb 11 12:05:57 EST 2012;Committer;akr;1;1;1;2;0
cd339692eff0568d15b8971738d2e35610d1ae8b;Sat Feb 11 03:04:23 EST 2012;Committer;nobu;3;59;12;71;0
c25f3d785dd8257fe89959087cd057d4c480296e;Sat Feb 11 01:22:05 EST 2012;Committer;nobu;1;3;3;6;0
1516f8eb9f1c3957d5d97c85e35fdefade9ae137;Sat Feb 11 00:37:44 EST 2012;Committer;drbrain;3;60;3;63;0
403dc5357dddd1cd8af4b73bc658fcbf3b91643c;Sat Feb 11 00:29:52 EST 2012;Committer;drbrain;3;47;2;49;0
c13d0b0c9cee4757428c5843b2e3217be2ec315c;Fri Feb 10 21:12:44 EST 2012;Committer;naruse;2;7;1;8;0
198736fb402b54b79facbaedf6ab57a08aa48341;Fri Feb 10 17:37:32 EST 2012;Committer;svn;1;2;2;4;0
6a8c05e31478ebaaa4ee4cabef2664666a685575;Fri Feb 10 17:37:28 EST 2012;Committer;marcandre;1;2;2;4;0
59a13448083080407e33c90ca0f02166ce88c01c;Thu Feb 09 18:44:27 EST 2012;Committer;tenderlove;4;21;33;54;0
14c97cf9b6721d55f8f5afa0e7be7e7e80311aea;Thu Feb 09 16:41:08 EST 2012;Committer;nobu;1;2;1;3;0
96ab37015ecb57a65c80f4ae92dcf241dacb161e;Thu Feb 09 16:30:43 EST 2012;Committer;nobu;2;12;18;30;0
196151158fa777dc88fa54825250898ff1ab5410;Thu Feb 09 16:29:08 EST 2012;Committer;nobu;2;6;3;9;0
5ee0135a2f32ea4bb8be5a4cd0a9541f9789f155;Thu Feb 09 15:47:11 EST 2012;Committer;nobu;3;31;17;48;0
ba89c7d70e754baa34e7bd5e9f7426069a71d25e;Thu Feb 09 15:16:04 EST 2012;Committer;svn;1;2;2;4;0
d77b2387cf8af6cef49ed19d6680a06612099975;Thu Feb 09 15:15:57 EST 2012;Committer;nobu;1;2;1;3;0
42144fc3bb3ec87c8b7a619d0957aa907eea56b6;Thu Feb 09 14:44:10 EST 2012;Committer;nagachika;2;8;1;9;0
3b1276eb390779a79d42bfabd588567efadcb72d;Thu Feb 09 13:18:26 EST 2012;Committer;akr;1;1;0;1;0
c7f16b8662a92cab7e079971b799ccffe44eb1f8;Thu Feb 09 07:53:04 EST 2012;Committer;kazu;1;4;4;8;0
f90f02ab200041c6a9bd3ed9d2bbde0aea239549;Thu Feb 09 07:48:22 EST 2012;Committer;nobu;2;20;16;36;0
71837f629e3fb0923a16897d1a499515c585dfdf;Thu Feb 09 07:11:23 EST 2012;Committer;usa;2;9;1;10;0
b2ba3242ea433a807264563c0f2d84652c537637;Thu Feb 09 07:10:26 EST 2012;Committer;usa;2;7;2;9;0
da098bd36e31dea28cbc58ed25bcb621e8b0a778;Thu Feb 09 07:03:07 EST 2012;Committer;usa;2;7;1;8;0
57b21752078e3a2e8c4afc53cbbb6ab0c049769d;Thu Feb 09 03:25:07 EST 2012;Committer;nobu;3;5;5;10;0
70b504badbf9a0852fe73af26bbd602619286fc7;Thu Feb 09 02:32:58 EST 2012;Committer;usa;2;13;1;14;0
7bde0843a2ce0680d1cefb8f4acea6ea56491008;Wed Feb 08 19:13:14 EST 2012;Committer;naruse;2;6;1;7;0
7fa3f1c5a9ecba4cc6586f9eca79647193e841df;Wed Feb 08 18:29:52 EST 2012;Committer;naruse;1;1;1;2;0
ee827e52a7e953771d8339ab0a351699c775c8e4;Wed Feb 08 18:03:51 EST 2012;Committer;tenderlove;1;4;4;8;0
bbc50e2a2851ce3db6f0cb3ba50ee30fefb26a6c;Wed Feb 08 15:44:44 EST 2012;Committer;svn;1;2;2;4;0
de25f35c986512dab1059f7655380bf7c3f7e814;Wed Feb 08 15:44:41 EST 2012;Committer;akr;1;1;1;2;0
fc018c9b346702dae0917f5312927c3beab1c0ec;Wed Feb 08 13:35:27 EST 2012;Committer;nobu;2;121;0;121;0
83c7d9df2b0fce04c9f06911d0ed21153ba29fa2;Wed Feb 08 13:30:04 EST 2012;Committer;nobu;4;25;4;29;0
54b90b7be8d38fea97251a89f23380facb8d7475;Wed Feb 08 11:47:00 EST 2012;Committer;naruse;1;1;1;2;0
f75a30776c38f1f9c0a36cae1639244ceb275a90;Wed Feb 08 09:49:36 EST 2012;Committer;naruse;1;28;9;37;0
3ff2f9f3a32fbd87caab29f7fe163c63ab50e305;Wed Feb 08 05:27:14 EST 2012;Committer;nahi;3;64;13;77;0
45706e70c9e5bfefc3921c6fc406aabe83c19768;Wed Feb 08 04:19:33 EST 2012;Committer;emboss;3;74;6;80;0
1a991ffebcd51ffd0df80a82c2b5fe4c65f2d2c0;Wed Feb 08 01:04:07 EST 2012;Committer;naruse;2;5;5;10;0
460c8907c99e2b90a5fb0cb6c18f2537fd4e60e1;Wed Feb 08 01:03:16 EST 2012;Committer;emboss;2;7;1;8;0
539d6ba2fabea1ebfccd083f8ef51aa6d5d315ad;Wed Feb 08 00:29:31 EST 2012;Committer;svn;1;2;2;4;0
aa3854e33d898885d067b5055d7e0f0db38a9c0d;Wed Feb 08 00:29:26 EST 2012;Committer;emboss;2;10;0;10;0
89a2a1050863dfa7b3adbf39db3a92b8320deaa6;Tue Feb 07 11:13:40 EST 2012;Committer;ayumin;2;6;1;7;0
4a43f9203b5a9005108ecc59e01737597072433c;Tue Feb 07 10:37:40 EST 2012;Committer;nobu;2;40;20;60;0
cf1a22fdf914f96126f5a8b671dab9a69db236f8;Tue Feb 07 05:52:15 EST 2012;Committer;nobu;4;48;3;51;0
af01b0fb07af13238cf4a881853d3f8c8787649e;Tue Feb 07 05:43:49 EST 2012;Committer;nobu;1;7;1;8;0
d82aafd1b03af181429002008a072c541c0d6f28;Tue Feb 07 05:29:27 EST 2012;Committer;svn;1;2;2;4;0
97c3c98762db01d5e85ce7198d540d2b46cca578;Tue Feb 07 05:29:20 EST 2012;Committer;nobu;5;107;11;118;0
b33dc193c84598c71e088010f40267dce141fda0;Mon Feb 06 12:55:56 EST 2012;Committer;naruse;2;12;0;12;0
730d3c566c149cc22997828e5941699280958ac9;Sun Feb 05 15:17:54 EST 2012;Committer;svn;1;2;2;4;0
b346d7a69cc7e768ee4ac105e53726c87fe1ba0a;Sun Feb 05 15:17:50 EST 2012;Committer;naruse;3;8;1;9;0
546eeb5f4bd0dfbda947a960e2ec918f8fa2ed14;Sat Feb 04 13:12:50 EST 2012;Committer;svn;1;2;2;4;0
40f4c9291bef6de1715994aaca3dacdfd151b46d;Sat Feb 04 13:12:45 EST 2012;Committer;kazu;1;1;1;2;0
42ffb2ed151814c2f53f0316b8bee2f4ab6966b8;Thu Feb 02 23:17:24 EST 2012;Committer;drbrain;3;37;4;41;0
30f0e97ef08e1518069c36b861d9d6a6ea4035e3;Thu Feb 02 22:54:10 EST 2012;Committer;drbrain;2;44;0;44;0
3d14e356a843d0e8c3cc2217267e1882614f6070;Thu Feb 02 15:55:12 EST 2012;Committer;svn;1;2;2;4;0
ca0bb51887a5682f1211c6fe627df778783ba0fd;Thu Feb 02 15:55:07 EST 2012;Committer;kazu;3;22;0;22;0
ca77bce66d8b32816fd9cf4c7ee228bb5e3dfa7f;Thu Feb 02 12:48:45 EST 2012;Committer;kou;2;17;13;30;0
92cecf79b428cfe1c8fc83a9b25ca5a99e867d83;Thu Feb 02 12:42:27 EST 2012;Committer;kou;3;46;1;47;0
5525d821344f6807af4e81d9fe572703f6e9ba9e;Thu Feb 02 11:51:25 EST 2012;Committer;akr;1;5;4;9;0
2a6ccf6c136ff7f8311b7a1a0e05081b2e872367;Thu Feb 02 08:52:55 EST 2012;Committer;naruse;3;24;0;24;0
a267b9512afdd66498872484d24542c810f65b99;Thu Feb 02 07:22:17 EST 2012;Committer;usa;2;5;2;7;0
8107587039a3ab096b5d0a183e36b20b8602c876;Wed Feb 01 16:28:14 EST 2012;Committer;mame;2;7;2;9;0
3b94b32dd93b301f629ae3434eda564ff3183a96;Wed Feb 01 16:12:47 EST 2012;Committer;svn;1;2;2;4;0
1f1196fae381d6c03545d95806929b297b2d48df;Wed Feb 01 16:12:44 EST 2012;Committer;knu;2;26;16;42;0
dc82e7e7496f1c22750a58c456cdea849751b70b;Wed Feb 01 01:50:52 EST 2012;Committer;nobu;1;0;15;15;0
01d54bc2c7f9baaa86b5444e799f9c00cd9cabe7;Wed Feb 01 00:50:17 EST 2012;Committer;nobu;2;6;1;7;0
25cd6d14e43ad1835adb73f83c8bc71f35223b80;Tue Jan 31 21:39:04 EST 2012;Committer;svn;1;3;3;6;0
0470ce53c5f055a7c5e26f8e7c5ab753820c0950;Tue Jan 31 21:39:00 EST 2012;Committer;nobu;3;30;0;30;0
a42cc41ba1abacd37e1922965fae641e537a6b5f;Tue Jan 31 12:36:50 EST 2012;Committer;nari;3;33;1;34;0
487cc8b5cebfcdfe218058ff9de31d2231e1d5cb;Tue Jan 31 05:29:52 EST 2012;Committer;nobu;1;15;12;27;0
8dd4353968d672ccd1aa189e1781d7472dd6bcff;Tue Jan 31 05:27:27 EST 2012;Committer;nobu;2;6;1;7;0
95b2f4107edbe57274f7b4eddd5e193b9994faa1;Mon Jan 30 21:47:40 EST 2012;Committer;svn;1;2;2;4;0
ef84b7c67898646394e4cef8fd475cb652f2f0ca;Mon Jan 30 21:47:35 EST 2012;Committer;nobu;3;9;14;23;0
72969cd348ac6f00bbe71ad63120db0114b35367;Mon Jan 30 10:08:23 EST 2012;Committer;nobu;4;63;0;63;0
cba57022b0685690b29bae9f8d9e8c264ab76fe0;Mon Jan 30 05:37:28 EST 2012;Committer;nobu;1;27;11;38;0
bfaba73ebbb798d9ecfda47ecf2b0c0a14edc4b4;Mon Jan 30 03:31:58 EST 2012;Committer;usa;2;5;1;6;0
44666293ffe2b29d77ed2bae78702242b30acb6b;Mon Jan 30 01:39:57 EST 2012;Committer;svn;1;2;2;4;0
5625355c9b4641cdd315a8b7ed6696fbf8980291;Mon Jan 30 01:39:52 EST 2012;Committer;usa;2;18;8;26;0
197189789033b8fb8dce27b4c09a6cffb3672fa2;Sun Jan 29 14:24:05 EST 2012;Committer;naruse;1;5;3;8;0
b80154157a59c15693a12b442c01caf3e6f25b43;Sun Jan 29 13:50:18 EST 2012;Committer;kanemoto;3;257;166;423;0
d5258cbe0f4bb2400bb6fd331168fe56a9bf8eb6;Sun Jan 29 03:18:16 EST 2012;Committer;svn;1;2;2;4;0
f3dabacefb43f3ce2e4f5ea09ff09af7c226e48b;Sun Jan 29 03:18:11 EST 2012;Committer;nobu;3;65;20;85;0
a65f6649dd71136ada6adabf65d3aa5e2b9bee36;Sat Jan 28 00:51:43 EST 2012;Committer;shirosaki;2;12;1;13;0
bb65920642330cb375b3649496dca95e27aee04b;Sat Jan 28 00:51:40 EST 2012;Committer;shirosaki;3;30;5;35;0
494fd237f00f166cf024a51fd04e064fc94e0f82;Sat Jan 28 00:51:36 EST 2012;Committer;shirosaki;2;21;4;25;0
11de7c034ba07d1ca2f66870f47376dd2cba56e6;Sat Jan 28 00:51:33 EST 2012;Committer;shirosaki;2;8;0;8;0
8f655293ed47ddc4381ccc0afe36130b0d1d51d5;Fri Jan 27 20:53:42 EST 2012;Committer;svn;1;2;2;4;0
ef72bdf2deda76ca8a537d3eeaa9c3f2111017de;Fri Jan 27 20:53:37 EST 2012;Committer;nobu;3;28;2;30;0
0c5cfb68c89d9e521fa8a43afc233764d0934703;Fri Jan 27 07:35:13 EST 2012;Committer;nobu;1;1;1;2;0
c940d3fac522d1d5d2e61cdb728237d1dc5d497a;Fri Jan 27 07:31:55 EST 2012;Committer;svn;1;2;2;4;0
a92dd46dd529a0a48c37db08c3101e9677d0638d;Fri Jan 27 07:31:50 EST 2012;Committer;nobu;2;7;2;9;0
68bf801c39c439d274844b56e763f27634ee452f;Thu Jan 26 03:04:11 EST 2012;Committer;drbrain;2;97;93;190;0
16249968835355afac48f5c03dce4da7226c1155;Wed Jan 25 18:24:18 EST 2012;Committer;svn;1;2;2;4;0
8335ce7065be10565e0c1fb8971df2b43d9d4d95;Wed Jan 25 18:24:09 EST 2012;Committer;nobu;4;53;19;72;0
97f0b0f55818420b4c7a7002c92c08ad78a7e579;Wed Jan 25 04:27:45 EST 2012;Committer;nobu;3;11;8;19;0
b094ab09486e4ccd8c656e214e574524919c76fb;Wed Jan 25 02:40:29 EST 2012;Committer;nobu;2;4;2;6;0
a2905fb2a06b5fcae9d398ad60ba296790cad856;Wed Jan 25 02:32:12 EST 2012;Committer;svn;1;2;2;4;0
ed469831e44f2b5a9384b18e660677b20a5ab664;Wed Jan 25 02:32:06 EST 2012;Committer;nobu;8;334;179;513;0
abd135d36bef0f340fd914405c8cfe0c0e579f86;Tue Jan 24 07:21:33 EST 2012;Committer;nobu;1;3;1;4;0
e187c4ca1f5ae20361714507c65281572c88ad19;Tue Jan 24 06:28:26 EST 2012;Committer;nobu;2;21;0;21;0
04726dd749f1f93eca39584311e224e2465fca5c;Tue Jan 24 05:20:48 EST 2012;Committer;nobu;7;43;4;47;0
d03199b6d6cedc9c5d1059aa58e5211af6b479b3;Tue Jan 24 04:29:07 EST 2012;Committer;nobu;2;5;5;10;0
498838c6627c82befd3c6dcd5c5d6870b38db5e7;Tue Jan 24 04:02:30 EST 2012;Committer;matz;4;53;0;53;0
ac2683c80978dabb24ec367141427c62f1dc5a20;Tue Jan 24 04:00:44 EST 2012;Committer;naruse;1;1;0;1;0
b9e480613327dd4c585e7e05172d59340849d423;Tue Jan 24 02:52:14 EST 2012;Committer;svn;1;2;2;4;0
edb7cdf1eabaff78dfa5ffedfbc2e91b29fa9ca1;Tue Jan 24 02:52:09 EST 2012;Committer;naruse;2;23;28;51;0
e1fbcc4cf91803fbe243e60067d7d58392299202;Mon Jan 23 12:25:22 EST 2012;Committer;shyouhei;1;13;0;13;0
5de2c3c2d3aedc304ca87ff224c9e4a6ec7cb14a;Mon Jan 23 12:25:19 EST 2012;Committer;shyouhei;1;5;5;10;0
44d72332014b5feac64efd25cde6d122067b7019;Mon Jan 23 08:12:52 EST 2012;Committer;naruse;3;16;1;17;0
aa5b65b2edf4e79f09b6e9dd488bf160b6a39260;Mon Jan 23 07:56:25 EST 2012;Committer;naruse;3;43;4;47;0
e7d83904cb0698d304fb8631ca34d4434152fd17;Mon Jan 23 07:56:20 EST 2012;Committer;naruse;3;14;1;15;0
4c9968c9d9775a442346b0bd6d53e4bd95f69c15;Mon Jan 23 01:09:06 EST 2012;Committer;mrkn;2;20;0;20;0
ca516aad53c79bc9c92df98f2760c187d97072af;Sun Jan 22 15:56:07 EST 2012;Committer;svn;1;2;2;4;0
e21d7c12841be9d2ae6166b0c6c09dd752b7e625;Sun Jan 22 15:56:03 EST 2012;Committer;knu;2;64;11;75;0
bb19bcf93ed0414ebe7542f20f395388d325c157;Sun Jan 22 06:41:29 EST 2012;Committer;nobu;2;46;15;61;0
2d87a5c1500ccf40141216bf44629d324ce9bf53;Sun Jan 22 06:23:45 EST 2012;Committer;svn;1;2;2;4;0
f1dc132b41fc3f10a8ba8990cfd070ac49155762;Sun Jan 22 06:23:38 EST 2012;Committer;nobu;2;17;22;39;0
86d4d10479821090160fe1258b86cb61a812e083;Sat Jan 21 13:21:10 EST 2012;Committer;nobu;2;5;1;6;0
b1428ace6b786947fff9c964069adf5dd42f1fe0;Sat Jan 21 12:57:37 EST 2012;Committer;naruse;3;25;8;33;0
c8f98a75d854115c60555c088ecd95e4f8e40cb8;Sat Jan 21 02:43:51 EST 2012;Committer;svn;1;2;2;4;0
c3d6f8d74f444fd6a4681016b62f0d00d6200846;Sat Jan 21 02:43:48 EST 2012;Committer;nobu;2;11;10;21;0
338a3073bdc581676ce9fb4632d119e7a585de57;Fri Jan 20 11:51:00 EST 2012;Committer;mrkn;1;1;1;2;0
ce8d368b1ea4d6b97b7493074a0c041f59d5a5c1;Fri Jan 20 11:48:52 EST 2012;Committer;mrkn;3;18;2;20;0
587135e9941306efee72346b0d00c82d8e8574e0;Fri Jan 20 08:39:24 EST 2012;Committer;naruse;3;6;7;13;0
a903f89a23f0babeefabda3adb7b8d4c26fc4a0b;Fri Jan 20 08:27:24 EST 2012;Committer;nobu;1;1;1;2;0
d02b0d955877987cb67aac86a35c051a4753e9f0;Fri Jan 20 05:56:40 EST 2012;Committer;svn;1;2;2;4;0
bee7ccddd254c7b6e781f5ea9bbf651b50b590ee;Fri Jan 20 05:56:35 EST 2012;Committer;naruse;4;90;2;92;0
87daaf61b9a6db7d4e4c7df9c72c4621ef0162c2;Thu Jan 19 06:28:48 EST 2012;Committer;nobu;1;1;1;2;0
d6c22be4e7dd9a4931461043580fc29f8439d692;Thu Jan 19 06:20:49 EST 2012;Committer;nobu;1;6;5;11;0
81d3b071b909bd3c8c00c5b2dc5b175113ca82a2;Thu Jan 19 06:01:29 EST 2012;Committer;nobu;1;8;0;8;0
1d794b933582604fd541479999bc7e3cc3bed0f0;Wed Jan 18 22:54:09 EST 2012;Committer;tadf;2;14;11;25;0
6bada9cc0a930c003b2b12892153e373046b7e54;Wed Jan 18 22:13:27 EST 2012;Committer;svn;1;2;2;4;0
49d65bc4d62d0ad09adaac897edbeb192f2c125d;Wed Jan 18 22:13:10 EST 2012;Committer;tadf;4;80;14;94;0
0a99ea86f47656eede005c5ebc25947e0e79a67b;Wed Jan 18 14:38:34 EST 2012;Committer;nagachika;1;3;3;6;0
10e85b7f84ec538ed60c2a70986c196d655c5b1b;Wed Jan 18 09:12:54 EST 2012;Committer;knu;2;7;0;7;0
d3b540cf40aa76a5eb13551a733cd2b91cd8eee4;Wed Jan 18 09:06:48 EST 2012;Committer;nobu;2;52;21;73;0
8c6e0d3007ad6cba3674dd4bc2259f17696f1887;Wed Jan 18 07:02:58 EST 2012;Committer;naruse;1;7;7;14;0
8cf05741bc4d94ba2b0aa53d876738b7fd5fc747;Wed Jan 18 03:52:01 EST 2012;Committer;tenderlove;4;55;4;59;0
99840a64b6687f3ae229f779152c7a37f7046d0b;Wed Jan 18 01:44:25 EST 2012;Committer;svn;1;2;2;4;0
ee3ebc2de5a2d65c718190e8dc230964b683c167;Wed Jan 18 01:44:21 EST 2012;Committer;tenderlove;4;92;3;95;0
e58d77bdda5b905f6694e19bd3e7289597a49c22;Tue Jan 17 08:18:46 EST 2012;Committer;nobu;2;4;2;6;0
b3e2baa3b5469141b6618386e679cf168332cc56;Tue Jan 17 08:13:50 EST 2012;Committer;nobu;3;7;2;9;0
eec5d2014ff4287ab2d8de7e495f8c8291572394;Tue Jan 17 08:10:00 EST 2012;Committer;nobu;1;1;1;2;0
e87c0e657422f5aea30d3b15a25a9895ff74d07a;Tue Jan 17 03:32:50 EST 2012;Committer;nobu;2;9;4;13;0
e8590143a0606ce2f8f067ada24e4af4558deaf2;Tue Jan 17 02:40:42 EST 2012;Committer;nobu;1;1;2;3;0
270ac46a7c93019e13a51f3410c4a54782a8135f;Tue Jan 17 01:54:50 EST 2012;Committer;nobu;2;8;5;13;0
07b9002d4cfda2436406b49344952c3a15037e41;Mon Jan 16 22:38:09 EST 2012;Committer;svn;1;2;2;4;0
84f204046b64feb38873845612b8177c663b7960;Mon Jan 16 22:38:05 EST 2012;Committer;naruse;2;10;2;12;0
de1e4881d4c29e71086e9885c7f1a48452aa6780;Mon Jan 16 07:42:01 EST 2012;Committer;nobu;6;32;1;33;0
688d00d23b9280d75a75c129382408a057c7109d;Mon Jan 16 02:22:47 EST 2012;Committer;nobu;2;7;6;13;0
d3f8488b1cdcd210515e1a81afdc8e3e4a7920b3;Sun Jan 15 15:46:44 EST 2012;Committer;shyouhei;2;19;10;29;0
9ed8c1f15e3f755a6421a37ba114562071a98404;Sun Jan 15 15:46:41 EST 2012;Committer;shyouhei;1;8;13;21;0
638f696b6ea07878f6f9dada116cb93aed596176;Sun Jan 15 15:46:37 EST 2012;Committer;shyouhei;1;33;23;56;0
93829abc0f016dc9c0fae8c3551900e2aaa092eb;Sun Jan 15 15:46:36 EST 2012;Committer;svn;1;2;2;4;0
cada5343a6fb66185f7e34da71b42d8fa5765935;Sun Jan 15 15:46:34 EST 2012;Committer;shyouhei;1;49;43;92;0
978a4ef1542cbce0b70e8391795b031483409a43;Sun Jan 15 15:46:30 EST 2012;Committer;shyouhei;1;161;159;320;0
ef18be23664d105954a2685a28e5deb868fa6a8e;Sun Jan 15 07:28:50 EST 2012;Committer;naruse;3;53;3;56;0
4c5171bb17198984de8424d3e1b5f2652f3256a9;Sun Jan 15 06:52:41 EST 2012;Committer;svn;1;2;2;4;0
c358a4cba1064162b5c78e4919aca77fd249e844;Sun Jan 15 06:52:36 EST 2012;Committer;naruse;3;8;2;10;0
67bf09903f9391181841f3a6194282dd43c05ff2;Sat Jan 14 13:24:12 EST 2012;Committer;nobu;2;14;5;19;0
45fd88877fe91f2d73c971e87e513fb445d502d9;Sat Jan 14 13:16:29 EST 2012;Committer;nobu;1;3;3;6;0
e72ae8cc0fe471b5426c7babbcf8f7191f3b6d48;Sat Jan 14 12:56:46 EST 2012;Committer;nobu;3;20;2;22;0
3772335ae6dad3f65ad42cf5986068a4a7293141;Sat Jan 14 12:47:06 EST 2012;Committer;nobu;2;4;0;4;0
15e1ff7f2398f03d392fb1aeea355c124dfa4874;Sat Jan 14 09:36:18 EST 2012;Committer;nagachika;3;28;1;29;0
c53470fd47fa62eed38af281017e10a41ef8ff2a;Sat Jan 14 03:02:57 EST 2012;Committer;nobu;2;9;2;11;0
f2aa0fd5d4ffa77a5c4bdd8698ac774b20540c62;Sat Jan 14 03:00:24 EST 2012;Committer;nobu;3;28;0;28;0
1648e9442dd4a6824bef16f7a45e8cc927aef4f5;Fri Jan 13 23:41:55 EST 2012;Committer;naruse;3;1;16;17;0
23506c427d35bca172a3fd5cd2a5e2187c60c6c4;Fri Jan 13 21:59:41 EST 2012;Committer;svn;1;2;2;4;0
90943649fe9fa474d6404acc3b9915e0388a14b5;Fri Jan 13 21:59:36 EST 2012;Committer;drbrain;2;21;12;33;0
23b4c10dd8dcde2b955072ef0f014bb291866e89;Fri Jan 13 09:41:22 EST 2012;Committer;nobu;2;12;1;13;0
6b1bae96414470aba86b8ba7a5822d7d634da8d9;Fri Jan 13 09:29:13 EST 2012;Committer;nobu;2;7;16;23;0
80323714621e71c2e379a6c20db310f584ddb72e;Fri Jan 13 09:25:54 EST 2012;Committer;nobu;2;7;3;10;0
db02621bfbee60aa373c1b032b34dad6dcbcbd29;Fri Jan 13 08:23:43 EST 2012;Committer;nobu;2;17;9;26;0
a5bfe7ca837c81e2df0329d4004fabfb4178362e;Fri Jan 13 07:44:50 EST 2012;Committer;nobu;3;16;1;17;0
1c58146ee508ee8d0621c4163b84676011a11ad0;Fri Jan 13 06:10:37 EST 2012;Committer;knu;1;5;0;5;0
d00fe54803361cb0a63325427f91a745a2488b72;Thu Jan 12 18:49:30 EST 2012;Committer;knu;3;24;2;26;0
c100aeb8384ce45a073741b649b14be6c211d2e6;Thu Jan 12 18:49:27 EST 2012;Committer;knu;2;10;17;27;0
8c72fc9bf09071300b6283411b4481456aac7e34;Thu Jan 12 18:42:03 EST 2012;Committer;knu;3;16;1;17;0
44d20d61c7babae9fd2ac3c6578208efa631d5a3;Thu Jan 12 18:28:17 EST 2012;Committer;luislavena;2;7;1;8;0
92498834b1eccc574cc71426c4fda702f6e405af;Thu Jan 12 16:37:07 EST 2012;Committer;svn;1;2;2;4;0
dea6efb5de7f18d6cded73a1afb16eac2852f98e;Thu Jan 12 16:37:03 EST 2012;Committer;marcandre;1;13;5;18;0
912b6606b3aabe9ed33062be52159603f4e58d6a;Thu Jan 12 09:44:34 EST 2012;Committer;nobu;2;72;76;148;0
ca227314390b75a59f718618281ab5f7dfa184c4;Thu Jan 12 05:12:03 EST 2012;Committer;naruse;2;14;5;19;0
32e6600128a073821b80aaf8ab40561e694f7733;Wed Jan 11 17:19:54 EST 2012;Committer;ayumin;2;21;4;25;0
c6fb7c1c877c64e62b9239ca6ce114e6e508b9cc;Wed Jan 11 16:04:25 EST 2012;Committer;kazu;2;18;13;31;0
674a6834c518e40bc25293bc257507a11c13cac1;Wed Jan 11 15:01:02 EST 2012;Committer;svn;1;2;2;4;0
c5831f39267e836bab7d541fe1cb91231beab5f1;Wed Jan 11 15:00:57 EST 2012;Committer;ngoto;2;8;1;9;0
28d28e844e58d0f6f17866b4fae5db19cba805db;Wed Jan 11 14:09:10 EST 2012;Committer;nagachika;2;15;3;18;0
2afa0b4ccaeef334b897ad33ddd4f36c7e51dbf9;Wed Jan 11 13:46:32 EST 2012;Committer;nagachika;2;16;3;19;0
0e454c181809401f128372f794dda9cbfad0ba15;Wed Jan 11 13:34:29 EST 2012;Committer;svn;1;2;2;4;0
3551b72566b17c9d4b1ae2f862f0e14315e70584;Wed Jan 11 13:34:24 EST 2012;Committer;kazu;1;1;1;2;0
9678dce5a41e14c4a4b3148c8f8a575e01a9d44f;Tue Jan 10 13:21:54 EST 2012;Committer;shirosaki;2;8;2;10;0
1aa408971f36db70447c816a805ca97fc10a4b46;Tue Jan 10 07:13:04 EST 2012;Committer;nobu;2;2;2;4;0
a54832714d89dbd5f6a86d7d8abe270b59d364d8;Tue Jan 10 06:52:24 EST 2012;Committer;nobu;1;1;1;2;0
37b8092c3bec8ba2be7ebab82ca9099b5bcb23f2;Tue Jan 10 06:43:13 EST 2012;Committer;naruse;2;6;2;8;0
b04814bf711ed170c674ca874d28dba8faed9484;Tue Jan 10 06:14:42 EST 2012;Committer;naruse;2;6;1;7;0
931459d974390436161aa98fa5a4fc94e00c3951;Tue Jan 10 03:50:23 EST 2012;Committer;naruse;2;4;3;7;0
56dc6f5acc944e06420614b6c2a475376a887d95;Tue Jan 10 03:49:10 EST 2012;Committer;naruse;6;42;6;48;0
107b713438a54770d68be98f3c385e77aecd056e;Tue Jan 10 03:14:52 EST 2012;Committer;kazu;2;6;1;7;0
7ef154f83313316d8096a89057c89090283ec66e;Tue Jan 10 01:45:09 EST 2012;Committer;nobu;1;3;3;6;0
9fa668f34aa13367a9adc9903de9a8a782cf2910;Tue Jan 10 01:41:15 EST 2012;Committer;nobu;3;31;14;45;0
71935466b7d42eb883c76c472f07913dd85e550e;Mon Jan 09 17:25:53 EST 2012;Committer;nagachika;2;39;10;49;0
c572ed2d25c290de7f518278dcae29d375c49d2d;Mon Jan 09 15:46:25 EST 2012;Committer;nagachika;2;14;4;18;0
896844a0cc9da1516a05b174158567d391f33288;Mon Jan 09 15:35:11 EST 2012;Committer;svn;1;2;2;4;0
fcb05d868316ebee7750537dea40e9de584aabf3;Mon Jan 09 15:35:06 EST 2012;Committer;nagachika;2;8;0;8;0
d4b2957781b4582ae1f9571b25226a6a074d6a32;Mon Jan 09 14:43:55 EST 2012;Committer;nagachika;1;1;1;2;0
41889c5adc046b4842120e1f535f627c30d721a8;Mon Jan 09 14:38:52 EST 2012;Committer;nagachika;2;9;4;13;0
b78bddee35fa426bf9286bcb3af4170282369a91;Mon Jan 09 11:58:12 EST 2012;Committer;nari;2;36;13;49;0
afb5eef4e2a96934a188e1622c51636b5665fc8d;Mon Jan 09 11:28:00 EST 2012;Committer;akr;2;24;0;24;0
bb1115a2d6b1ab37a1ae725bc26a965884f44029;Mon Jan 09 11:18:00 EST 2012;Committer;akr;2;10;1;11;0
268d1a2244b0179848a10a2841b4c037db52d3bd;Mon Jan 09 11:11:24 EST 2012;Committer;akr;3;27;0;27;0
98ddbafb265324e9f89b2546dc85d2b54dac4c43;Mon Jan 09 10:42:18 EST 2012;Committer;usa;2;6;0;6;0
2cf2416ea09ca63efb8469650809bd5fd1707460;Mon Jan 09 06:02:01 EST 2012;Committer;nari;2;12;15;27;0
a408b64c6205198135e90ac4c23c632828737be1;Mon Jan 09 05:09:57 EST 2012;Committer;akr;1;3;2;5;0
5335b4b608405efe33ca09c359988e8cd0bc87ee;Mon Jan 09 04:02:08 EST 2012;Committer;akr;1;3;1;4;0
471394f647953117af078ce38ad61fc6b241cc42;Sun Jan 08 22:50:59 EST 2012;Committer;naruse;2;9;3;12;0
88b16cebc818a75f36005f25998ea1a2e35fdfee;Sun Jan 08 21:02:08 EST 2012;Committer;naruse;7;40;19;59;0
a7c9064c8bb9a90ea0bba0863a38d3ef72c94252;Sun Jan 08 20:42:50 EST 2012;Committer;svn;1;2;2;4;0
800f04c6a521c007e9837813b3564ae6b491e31c;Sun Jan 08 20:42:45 EST 2012;Committer;naruse;9;79;20;99;0
5393622dad7f5204333b8aa6a39263a961bdc77a;Sun Jan 08 11:55:04 EST 2012;Committer;nari;2;12;7;19;0
cd73f29465310e55f36e001a7964f4be3d2a833a;Sun Jan 08 02:59:04 EST 2012;Committer;nari;2;7;1;8;0
94fd32b80a585750427836a1e22d05c0ee3d09ad;Sun Jan 08 02:46:19 EST 2012;Committer;nari;2;5;3;8;0
6e9a14aabeceb169c789ee56647a047834267b5d;Sat Jan 07 23:04:20 EST 2012;Committer;naruse;1;6;0;6;0
0713603b6f87473dfcb4c9cec16f6ccebd5e8706;Sat Jan 07 16:22:47 EST 2012;Committer;ayumin;2;7;1;8;0
e3b07320500d117df3b56250bcf51bd30eeaa3cb;Sat Jan 07 15:47:45 EST 2012;Committer;kosaki;2;5;1;6;0
8d4baab08fd1ae6499406c527db5d5fd6a014e02;Sat Jan 07 15:21:09 EST 2012;Committer;naruse;1;2;2;4;0
1edaa8ac6a8a0bedd19cba3a89f2529e7039a002;Sat Jan 07 15:21:06 EST 2012;Committer;naruse;1;5;0;5;0
7e5cb466d115414459f9ab714d82c6c3345f71dd;Sat Jan 07 15:13:41 EST 2012;Committer;svn;1;2;2;4;0
411fa36c7344c3ef6f82a296131cae373e40f8f0;Sat Jan 07 15:13:37 EST 2012;Committer;naruse;3;17;6;23;0
50675fdba1125a841ed494cb98737c97bd748900;Sat Jan 07 14:02:23 EST 2012;Committer;nari;7;250;117;367;0
9060e87fa88155a203b69aeb2f05319b20796465;Fri Jan 06 15:52:48 EST 2012;Committer;svn;1;2;2;4;0
3ba49c9ebb8837a4070b5b1a6fc45c535c9e888c;Fri Jan 06 15:52:44 EST 2012;Committer;nagachika;2;6;3;9;0
a06a1772f3c7d7703adcad05ba10711212b1d154;Fri Jan 06 14:13:27 EST 2012;Committer;ayumin;2;7;3;10;0
fb08cd16f250f95c090404c03d0dce8ddbaeea2a;Fri Jan 06 07:06:26 EST 2012;Committer;svn;1;2;2;4;0
e945532350dd070a6a6c9e2524e088f63dbdd83d;Fri Jan 06 07:06:22 EST 2012;Committer;naruse;3;53;6;59;0
4729382e4efa9cf464ad51dcfc31c7be03ea466b;Thu Jan 05 14:42:49 EST 2012;Committer;nagachika;1;1;1;2;0
cef30c7a417b1e4fa57369792201aa0625b5fceb;Thu Jan 05 06:29:31 EST 2012;Committer;usa;2;8;1;9;0
0d8ad1a96be13d90c314774867418bbdd1719c4d;Thu Jan 05 03:18:18 EST 2012;Committer;naruse;2;6;1;7;0
87fe4480919baaa9f0a37b9444912bae98220395;Thu Jan 05 02:57:21 EST 2012;Committer;naruse;3;16;10;26;0
4157d6f2f3b49a809da95acd9cce8ed677a072b8;Thu Jan 05 02:52:16 EST 2012;Committer;svn;1;2;2;4;0
32e79b64eab63970b8dc9c6d254513f6e2d5e5ad;Thu Jan 05 02:52:10 EST 2012;Committer;ayumin;1;1;1;2;0
7c3a00a1fe73ed45050fe74f61c3e0cd8ff7768a;Wed Jan 04 09:27:58 EST 2012;Committer;ayumin;1;15;15;30;0
6992be63d89406222e1857ed9b8fa9a7e2c1a1c4;Wed Jan 04 09:03:20 EST 2012;Committer;ayumin;2;9;0;9;0
460528289ab3b22f373c00a8494f65e5c3dcfdde;Wed Jan 04 05:24:39 EST 2012;Committer;nobu;3;16;0;16;0
79e0379a7573e998d52ea42242ea0cc96fa81738;Wed Jan 04 02:33:37 EST 2012;Committer;usa;2;19;1;20;0
bd895ab17616bfae882990e302aa1b9036043129;Tue Jan 03 15:21:53 EST 2012;Committer;kou;2;9;2;11;0
b53d9940f966aac8b52119ed125ac4a99725057b;Tue Jan 03 15:05:24 EST 2012;Committer;svn;1;2;2;4;0
5eac56441ca1bfe38fdf3ffc1893d9cbc431529f;Tue Jan 03 15:05:20 EST 2012;Committer;ayumin;2;15;13;28;0
c5335bd18fdca8e02662ae2b768e30501624b40a;Tue Jan 03 11:48:20 EST 2012;Committer;ayumin;3;18;0;18;0
966d1f8962e8c00c8c85c4f2be9ecbb83a55b2f1;Tue Jan 03 07:01:15 EST 2012;Committer;ayumin;2;11;6;17;0
9ecd19a7f841bf3c8b94507b295ac2e6207510ad;Tue Jan 03 06:53:49 EST 2012;Committer;ayumin;2;5;1;6;0
c38dec6d3b1c775b93289c4f3086a87787d4c959;Tue Jan 03 04:45:08 EST 2012;Committer;kosaki;2;6;2;8;0
f9042329dd48b1c09751a93624ef5eb1e826074e;Tue Jan 03 02:39:20 EST 2012;Committer;svn;1;2;2;4;0
b60a01db6a18e8e196f5277b0f9bf8684377471e;Tue Jan 03 02:39:15 EST 2012;Committer;kosaki;2;7;1;8;0
c093401b0e81f3b6d58a623f75a77a90f6e86fcb;Mon Jan 02 13:14:24 EST 2012;Committer;knu;2;20;3;23;0
432a992aafc6756a02963629f49ff26b1489ddc8;Mon Jan 02 11:54:52 EST 2012;Committer;akr;2;6;1;7;0
519187a259e4ddc27a4273fed241cf600a844f14;Mon Jan 02 08:28:05 EST 2012;Committer;ktsj;1;6;6;12;0
e98e56e6c4db2a528c882bf12d6499da0bacc566;Mon Jan 02 06:29:03 EST 2012;Committer;ktsj;2;8;0;8;0
66f9d5fe11ca774b850cd55ca3476eb23d6db08a;Mon Jan 02 06:25:01 EST 2012;Committer;ktsj;3;19;13;32;0
7d9fe82be47d67e44069e80904ef06d34d2cce29;Mon Jan 02 06:13:29 EST 2012;Committer;kazu;3;11;5;16;0
38cee6b43eeba043de8f126852f5f75702e4742d;Mon Jan 02 06:08:29 EST 2012;Committer;kazu;2;6;1;7;0
3c969a7c10aeb54fcbfbb2f6a71bab65deb47243;Mon Jan 02 05:56:59 EST 2012;Committer;svn;1;2;2;4;0
bb28d902e8ce770e7971505c28fa31f441969776;Mon Jan 02 05:56:55 EST 2012;Committer;kazu;2;7;1;8;0
1cf47c4cc0ef262fad10b9f46f4d5a28d9b4caf4;Sun Jan 01 03:26:31 EST 2012;Committer;svn;1;4;4;8;0
d367b1b9f1cb7447fede62d987dbf6e8586d8f15;Sun Jan 01 03:26:20 EST 2012;Committer;knu;3;22;3;25;0
069f7ec90a6ef2ecb938fd2bcc1a44f65fbac485;Sat Dec 31 08:04:37 EST 2011;Committer;ayumin;1;1;1;2;0
e4513cbeac56a5c8485fe5d3b132e4d07ca373d1;Fri Dec 30 22:25:18 EST 2011;Committer;svn;1;2;2;4;0
82ab1e189b7761c6e871176a2dcff3a867940270;Fri Dec 30 22:25:16 EST 2011;Committer;naruse;3;32;21;53;0
035e4949c5f3c1dda9a9bf31db3f29201d70a25f;Fri Dec 30 22:25:13 EST 2011;Committer;naruse;2;7;0;7;0
85bc3bdb08ef4380d3d4c78e773a02dadc011558;Fri Dec 30 08:07:27 EST 2011;Committer;ayumin;2;7;2;9;0
b906a46edd76e873cec0714eb1e96d68caec363c;Fri Dec 30 06:04:04 EST 2011;Committer;marcandre;1;3;2;5;0
f965d513846cdd9775d022f1463d5097e10a9620;Fri Dec 30 05:55:41 EST 2011;Committer;svn;1;2;2;4;0
6c38e611e4d40bc6a7d3a1673e7630932af1e9c2;Fri Dec 30 05:55:37 EST 2011;Committer;marcandre;3;7;7;14;0
59130ced833ef34c24f11d47ebd56af0ba3b5164;Thu Dec 29 13:42:18 EST 2011;Committer;nagachika;2;9;1;10;0
de5c0b839b25c0b482f7a849cb2965c67b5c4073;Wed Dec 28 16:56:21 EST 2011;Committer;svn;1;2;2;4;0
98696bd2427a3c96640a8ff809d0047616bdcaad;Wed Dec 28 16:56:16 EST 2011;Committer;nagachika;3;8;2;10;0
d5c889cf9d82a585b03e248b5ae5ce743c3cf5e4;Wed Dec 28 09:13:12 EST 2011;Committer;kazu;1;1;1;2;0
15fb1619e31c3a55fd5a4a03aabd2cf07a8494ed;Wed Dec 28 02:40:28 EST 2011;Committer;nobu;2;2;2;4;0
6a6c314fd0e2e6e3e370478dd8ee8d11ae285e58;Wed Dec 28 02:22:52 EST 2011;Committer;nobu;2;6;1;7;0
ddec35cf3db81fae5c46f3ed6f3eac5dbf4a5c17;Tue Dec 27 17:19:55 EST 2011;Committer;nagachika;1;3;3;6;0
ec5483c36b6bed1f2e8d4e93b79c9da0cd709575;Tue Dec 27 17:12:30 EST 2011;Committer;svn;1;2;2;4;0
0d9710692e49d8d42bd02997f62cf325f8f1812b;Tue Dec 27 17:12:24 EST 2011;Committer;nagachika;2;6;0;6;0
2828593e1adb682d802d40570cadd0ff1b246bb2;Tue Dec 27 13:37:49 EST 2011;Committer;sorah;2;6;1;7;0
2f6d8bdc94926a625f769f72b890ed78553c928f;Tue Dec 27 13:04:30 EST 2011;Committer;nobu;6;136;0;136;0
7f649d10ed8055214e0062800b2d117453b2304f;Tue Dec 27 12:17:42 EST 2011;Committer;svn;1;2;2;4;0
731e45216ae4adf4122f0515d3056e1579efb0f9;Tue Dec 27 12:17:36 EST 2011;Committer;nobu;4;15;7;22;0
c5e372ff277af2b69c785290389f638dbfef820d;Mon Dec 26 14:20:20 EST 2011;Committer;mame;2;18;4;22;0
d0baa0dd52fb1d72e23633bb2ba5a551957a4776;Mon Dec 26 14:20:15 EST 2011;Committer;mame;6;43;12;55;0
a0a2c144b8b078cea668a703e2308ea64d4eb161;Mon Dec 26 14:20:09 EST 2011;Committer;mame;7;238;3;241;0
1ab3974b0efea5155da005ec08a1feee90023d98;Mon Dec 26 14:20:03 EST 2011;Committer;mame;5;650;75;725;0
afb10c62c2e45801df4245e6131af3a98efdebd1;Mon Dec 26 14:19:58 EST 2011;Committer;mame;6;83;102;185;0
90b1afa3104659898aad5978b164d48e1809e228;Mon Dec 26 14:19:52 EST 2011;Committer;mame;3;9;5;14;0
68fde4449ac3a085a6fb47b44f983d547b9fece2;Mon Dec 26 13:49:31 EST 2011;Committer;shirosaki;3;61;26;87;0
fb37a14aa258d817391d7ff6314c2baefce4d81c;Mon Dec 26 08:01:18 EST 2011;Committer;nobu;2;6;1;7;0
8f37f68c0df9e8edda88fc5b853081a3a3d1307c;Mon Dec 26 04:33:32 EST 2011;Committer;sorah;1;2;2;4;0
bec52ad7879ef96a2a27d9c2d1bad20efc266539;Mon Dec 26 04:21:15 EST 2011;Committer;usa;2;25;23;48;0
48053fe6156f9387996930d5ae3e05a650b42b96;Mon Dec 26 04:08:44 EST 2011;Committer;sorah;2;9;1;10;0
7a9b2cad172060201d63118eeccec074eb4e44f3;Sun Dec 25 20:47:48 EST 2011;Committer;emboss;1;4;4;8;0
91785eca932bcd215989c2be6c51bbc1b6f0fd14;Sun Dec 25 20:09:59 EST 2011;Committer;emboss;1;1;1;2;0
16558749948b053e0b55d79efa267a3dba2591df;Sun Dec 25 19:02:16 EST 2011;Committer;emboss;1;1;1;2;0
684d7b8e5bdff8287f26a7be9eb0fed4dc850d1a;Sun Dec 25 18:53:49 EST 2011;Committer;svn;1;2;2;4;0
976aba43c30c3fcd86fb36b68a829751a9a1b697;Sun Dec 25 18:53:45 EST 2011;Committer;emboss;2;208;23;231;0
38ade501405d713b1f02ae02d9c359d5a4f0122c;Sun Dec 25 14:17:28 EST 2011;Committer;sorah;2;11;0;11;0
60da7a36f52bc1d558aa1ed44090259c37ac7bd4;Sun Dec 25 13:47:21 EST 2011;Committer;sorah;3;45;8;53;0
f8a4e2331b293178a8d137846875f5ce9119be82;Sat Dec 24 15:05:37 EST 2011;Committer;svn;1;2;2;4;0
60b99d05c65261d329bfec7365486b9bf45acd28;Sat Dec 24 15:05:33 EST 2011;Committer;luislavena;2;9;4;13;0
3cbf3e207d460302a90b292304169f0b07397830;Sat Dec 24 14:24:32 EST 2011;Committer;luislavena;2;14;0;14;0
8af67e3072e7c6a778c72de01e32988a70dd5bc5;Sat Dec 24 03:38:56 EST 2011;Committer;nobu;2;20;3;23;0
1dec79c324d93b365f699bafa1a65de5752988ea;Sat Dec 24 01:56:36 EST 2011;Committer;nobu;3;27;0;27;0
8397134330c388e562a8f7aa255b36dbcd7efecf;Fri Dec 23 21:59:54 EST 2011;Committer;nobu;2;28;2;30;0
db9657a8bf962e29a3258f4dab62d216c5137a54;Fri Dec 23 16:39:11 EST 2011;Committer;ktsj;1;1;1;2;0
dd834c683de09ae4f4ccfefbdaf4a36f20abc307;Fri Dec 23 16:23:13 EST 2011;Committer;ktsj;3;21;1;22;0
c6cbbd6eea91906d376636458fa24ebabc122beb;Fri Dec 23 15:56:37 EST 2011;Committer;svn;1;2;2;4;0
c5485f41ea6a5b5691164924842250fcf893f770;Fri Dec 23 15:56:33 EST 2011;Committer;akr;2;7;0;7;0
dc42e8bbe89fe194805a1371276edaf83ec069c2;Fri Dec 23 07:55:39 EST 2011;Committer;akr;1;3;3;6;0
5191ecad6c4deb8d52391661377b91c8613830de;Fri Dec 23 07:38:14 EST 2011;Committer;kouji;2;19;0;19;0
ec4f9d1c60a81ea45d11c0eb0c3c8930564e66a8;Fri Dec 23 07:02:42 EST 2011;Committer;kouji;2;17;6;23;0
e89bebdab448f20555a322d84ef42eea531c51cc;Fri Dec 23 01:15:35 EST 2011;Committer;akr;2;28;12;40;0
8beb0d358782c08d8b529c7ba655b196573328f4;Fri Dec 23 00:24:52 EST 2011;Committer;akr;2;9;3;12;0
b32f79e0db67f12d3f11ba76a304034f409e7422;Thu Dec 22 21:06:23 EST 2011;Committer;kazu;4;9;2;11;0
0212af1733d6e246e2d1b91e62e0d5e637c2e0f9;Thu Dec 22 21:06:19 EST 2011;Committer;kazu;3;9;4;13;0
9ce124dd1ac9bc55c620ad2077568dac853b30ba;Thu Dec 22 15:10:37 EST 2011;Committer;svn;1;2;2;4;0
37b79d03a6ed4c6eee5d15a76b44334832796c83;Thu Dec 22 15:10:20 EST 2011;Committer;akr;2;8;3;11;0
92c5d84a4000ae496b92ef2313a1f1038abb3442;Thu Dec 22 14:58:16 EST 2011;Committer;naruse;1;1;1;2;0
3be2c7db1e458a6954cd501f5067a3d46dcf5222;Thu Dec 22 14:39:46 EST 2011;Committer;akr;2;5;1;6;0
b288aa2d89c2f5b2ce771cfe5531e4e2960208ae;Thu Dec 22 13:45:58 EST 2011;Committer;nagachika;2;22;6;28;0
afbcfdf96184fc5548bb697ba513785e7891981d;Thu Dec 22 09:48:50 EST 2011;Committer;naruse;1;17;10;27;0
c9a9036d0b198f4571a41ca0f32e869ea00b4c54;Wed Dec 21 15:50:15 EST 2011;Committer;nagachika;1;6;0;6;0
5136e61c92560a58bd5da5d938ce6656e57dd1a8;Wed Dec 21 15:44:19 EST 2011;Committer;nagachika;1;1;1;2;0
4af11279c6887aa40fa9463df5d90f443356a864;Wed Dec 21 15:42:41 EST 2011;Committer;nagachika;2;7;8;15;0
b3369100b668e279217240ab7ef4ad8b03443e4a;Wed Dec 21 15:37:11 EST 2011;Committer;svn;1;2;2;4;0
af845f352893442e56141787fb5da9c5277a0311;Wed Dec 21 15:37:07 EST 2011;Committer;nagachika;1;0;6;6;0
2e683de901f6f3ed086f320d578f11053880a3b0;Wed Dec 21 09:30:26 EST 2011;Committer;usa;2;8;2;10;0
75583e52ce1303d142f9f34abe8e01e66f917cb6;Wed Dec 21 07:03:06 EST 2011;Committer;nobu;1;8;2;10;0
7bc839bdd2befe13cbb41081cb430c28bcc1974c;Wed Dec 21 06:23:15 EST 2011;Committer;nobu;1;28;0;28;0
f9a4d5717c2cc4eddb44439f7d85d6840e928127;Wed Dec 21 03:35:27 EST 2011;Committer;nobu;4;95;29;124;0
1c6226b67d22057ec09948adc7d48426ed355ec2;Tue Dec 20 20:37:43 EST 2011;Committer;nobu;1;1;0;1;0
934b954a368ae4c5e9e20f6de4f9ad28c119d92f;Tue Dec 20 17:37:41 EST 2011;Committer;tenderlove;2;5;1;6;0
0afb73c603a0add19a5bb6e5e8fedf481f6a8c0c;Tue Dec 20 16:09:26 EST 2011;Committer;svn;1;2;2;4;0
327ea26b59816e15a99afa420331f9d3e3d8be22;Tue Dec 20 16:09:17 EST 2011;Committer;kazu;6;13;7;20;0
a934aeb619929bc9a971fcd173c3e1f54c60d6a0;Tue Dec 20 14:57:29 EST 2011;Committer;nahi;1;7;17;24;0
fcec6b5c0d72288aebce9b18e25e6e92772a2eb8;Tue Dec 20 14:56:07 EST 2011;Committer;nahi;2;24;29;53;0
5aea2ad18c622cfa5bb53f1d94e058ac7fc41ad3;Tue Dec 20 12:03:42 EST 2011;Committer;tadf;4;90;21;111;0
15e6d26049f5637277e2f4da3b43422e5b41a126;Tue Dec 20 07:07:46 EST 2011;Committer;marcandre;1;10;6;16;0
be4f7bf51253b5a0519126fb742b8de514bad278;Tue Dec 20 06:06:46 EST 2011;Committer;nahi;3;40;4;44;0
0ead5c4983edcdef071eb4317b904d9d0419b388;Tue Dec 20 05:57:53 EST 2011;Committer;nobu;1;25;25;50;0
f26ee7454fbd4ad2fcd5fa4e2e503eef8cb0acc8;Tue Dec 20 02:49:15 EST 2011;Committer;nobu;2;12;0;12;0
a9b0e34b97e872ab9eb4ff21e8a55a63ecfa2a88;Tue Dec 20 01:22:50 EST 2011;Committer;naruse;2;5;1;6;0
80101267217aad1deb5c87c72840b8df15272008;Mon Dec 19 21:07:09 EST 2011;Committer;drbrain;10;24;10;34;0
7e17872012e5789a48d48b5f1863f50fb8d2b1b0;Mon Dec 19 17:16:55 EST 2011;Committer;svn;1;2;2;4;0
305cd3fb00629cb2a7d77daa7a9dc91d75cf5c34;Mon Dec 19 17:16:48 EST 2011;Committer;tadf;2;21;4;25;0
8457bea9ab5394cb43f4d5019ccb8836675366ad;Sun Dec 18 09:58:31 EST 2011;Committer;ngoto;2;8;2;10;0
9c00c1234d39eef8d42c63aa95353def7ee6a1da;Sun Dec 18 05:34:34 EST 2011;Committer;nobu;3;13;0;13;0
cf2bbc89d26ef29ab33b3a11a71c30ffba35fe2f;Sun Dec 18 03:44:09 EST 2011;Committer;tenderlove;4;26;0;26;0
7cabeff61a25e37517afcdc4fb164a9365f5e30c;Sun Dec 18 03:16:05 EST 2011;Committer;tenderlove;1;1;1;2;0
9f688d53c2b5af5960d1e8d8fb09b26aa9d8b5f9;Sun Dec 18 03:05:02 EST 2011;Committer;tenderlove;3;35;2;37;0
07fa1c9144aaf58414df1a27c06fb4a78683717d;Sun Dec 18 00:46:32 EST 2011;Committer;nagachika;2;7;2;9;0
1c0e4232749840d88c205cfc6136f369e46ce367;Sun Dec 18 00:38:38 EST 2011;Committer;svn;1;2;2;4;0
e9300c4a6978dc51ebff1aa41d27644de452ef52;Sun Dec 18 00:38:35 EST 2011;Committer;nagachika;2;6;1;7;0
b06e85817d2b1ca9cd728e3ebd04d82a3473aad5;Sat Dec 17 01:17:26 EST 2011;Committer;svn;1;2;2;4;0
48c7c84e46809291746ff4229a30e8da9b6cde3a;Sat Dec 17 01:17:23 EST 2011;Committer;akr;1;5;5;10;0
9ef4a0aa5264769d446935c4b73e1091bc8652e5;Fri Dec 16 08:18:44 EST 2011;Committer;svn;1;2;2;4;0
c17c0030be2e92de78aa04e14023c35c0b72029f;Fri Dec 16 08:18:40 EST 2011;Committer;nobu;3;6;2;8;0
d95ce7fc033067872c25d294205414cea939b389;Thu Dec 15 14:19:59 EST 2011;Committer;nagachika;2;10;3;13;0
73768d54d3af644dab3dc3a5fd12aa75961f3c28;Thu Dec 15 08:57:01 EST 2011;Committer;nobu;3;32;1;33;0
2a5ddef59feb5b79e097e8b9de1b1f2b3b37b887;Thu Dec 15 08:40:29 EST 2011;Committer;nobu;2;5;1;6;0
00e6c80221738880477638fb3cae02ca63e4f5f3;Thu Dec 15 05:48:39 EST 2011;Committer;nobu;3;40;20;60;0
9dccfb5513d6344b1fd113c403255b44c486fc3e;Thu Dec 15 05:33:34 EST 2011;Committer;nobu;5;74;17;91;0
57537ccb0ef8ccd644e0ca4196aebb834970f3f8;Thu Dec 15 04:29:20 EST 2011;Committer;naruse;1;1;1;2;0
84dcc38273665cba3f3756a454697edf11ab168a;Thu Dec 15 04:15:54 EST 2011;Committer;nobu;5;22;1;23;0
15f26afdf0cf3f188a20456512c829290187b68d;Thu Dec 15 01:44:58 EST 2011;Committer;nobu;3;12;2;14;0
f281353ffda7672f668a49090314fc9d2384a529;Thu Dec 15 01:10:50 EST 2011;Committer;svn;1;2;2;4;0
15a66805d846b0a964c7a0a450c5b92f18a40ce9;Thu Dec 15 01:10:45 EST 2011;Committer;nobu;2;9;5;14;0
7c5105c1202ead44c79786af607740d4aeb8d412;Wed Dec 14 12:59:45 EST 2011;Committer;usa;2;8;3;11;0
3fbc62445e7637ff81fa42c6b20f43b9d9607709;Wed Dec 14 11:02:00 EST 2011;Committer;usa;5;13;6;19;0
0c6103cf50fd3d7c43ff264c9cc9d62c1f723067;Wed Dec 14 10:38:12 EST 2011;Committer;usa;5;194;17;211;0
4474c83a9d2baca7c263009e722c02d105ae9336;Wed Dec 14 06:28:32 EST 2011;Committer;nobu;2;8;1;9;0
8fbf055e330fa7d62184ca5c5155064d7e8ecba4;Wed Dec 14 05:42:34 EST 2011;Committer;naruse;1;1;1;2;0
50c1985555b00bf8e19646a5aad7e881ac84401b;Wed Dec 14 03:20:02 EST 2011;Committer;nobu;3;27;8;35;0
23f9e7460462efa9273c05b8c616ca9dfa6e24af;Wed Dec 14 02:26:20 EST 2011;Committer;naruse;3;24;2;26;0
24c376662401a2d9886d63423ddfb72d697747fb;Wed Dec 14 02:26:17 EST 2011;Committer;naruse;1;11;10;21;0
f2fff83e96fe5faea36354993602195881ee8ba3;Wed Dec 14 01:20:11 EST 2011;Committer;nobu;3;29;3;32;0
aa432d233491abc0d5e271f8e73345edb49348b7;Wed Dec 14 00:28:26 EST 2011;Committer;naruse;1;1;1;2;0
8cec0d5653110b5dd4c7484b13c561bc1cbb950d;Wed Dec 14 00:23:43 EST 2011;Committer;naruse;1;17;0;17;0
8e9ab339881873bba8889fef7210cf47d9892510;Tue Dec 13 16:33:15 EST 2011;Committer;okkez;2;6;0;6;0
07e447fb7441550b82a9fc90f35d19d416bce72f;Tue Dec 13 15:01:32 EST 2011;Committer;svn;1;2;2;4;0
d62f56b04182f5b7b02944d5c169fe44513135b1;Tue Dec 13 15:01:20 EST 2011;Committer;nobu;4;77;28;105;0
3dd1e6a91bdd1d743c6f47c910e94b707b7eb190;Tue Dec 13 14:56:12 EST 2011;Committer;nagachika;1;1;1;2;0
3cf0a6e3e816730c2b4e4c5f5c40e11c139eab9d;Tue Dec 13 14:51:26 EST 2011;Committer;nagachika;1;1;1;2;0
d61d9d5e8e5a6f7f56e54a2a35e82e209dad6e08;Tue Dec 13 14:50:12 EST 2011;Committer;nagachika;3;29;1;30;0
ab6c8910f47a2b95f7338a182715ee0bee5ec45d;Tue Dec 13 07:13:31 EST 2011;Committer;nobu;5;79;3;82;0
5e12ce3c69bf881c7ec607980f89410c5fb7dd76;Tue Dec 13 04:33:30 EST 2011;Committer;ktsj;1;2;2;4;0
0cbec6027cfb755972f80aab57920008d50fe842;Mon Dec 12 22:33:56 EST 2011;Committer;tenderlove;3;25;15;40;0
6ef323d6f8a4cb768ce8217171487d8932bc7bd8;Mon Dec 12 22:15:31 EST 2011;Committer;tenderlove;3;54;1;55;0
0f9662f3660bd98a0a31196b4bef82aa78b0529c;Mon Dec 12 21:29:53 EST 2011;Committer;nobu;3;8;2;10;0
a3eaaf89679b2e0c5c834d00fdaf7b6fabc271e4;Mon Dec 12 20:50:14 EST 2011;Committer;svn;1;2;2;4;0
50ae8a8651044de5956675ad87bc6bc2c9c32e6f;Mon Dec 12 20:50:09 EST 2011;Committer;nobu;3;280;1;281;0
900b4a6db63012d9ce32a1019a7c9d5b014a0047;Mon Dec 12 13:43:56 EST 2011;Committer;shugo;3;39;9;48;0
cc006d368c64ec3fdf51280f93b23155d95e1884;Mon Dec 12 08:30:27 EST 2011;Committer;naruse;3;7;2;9;0
f2323dee148b5ca9a186e19432ac7b4fc28491d6;Mon Dec 12 08:30:24 EST 2011;Committer;naruse;1;6;0;6;0
2e16e8a60e3ebdfe20e933c8447153915d474ee0;Mon Dec 12 08:26:54 EST 2011;Committer;nobu;2;8;1;9;0
1297bedc5cdb869d0c9ed0580671917369de12c6;Mon Dec 12 06:41:10 EST 2011;Committer;svn;1;2;2;4;0
5c68e601e89d3a6959ede99de1bf0565a7632529;Mon Dec 12 06:41:05 EST 2011;Committer;nobu;2;7;1;8;0
e48c8be89b6324d817e46e3feadfc207226d93a6;Sun Dec 11 03:21:43 EST 2011;Committer;shugo;3;19;3;22;0
9952139011c0e8a28e29c7d9f65edf5912a334fb;Sun Dec 11 02:44:04 EST 2011;Committer;ktsj;2;5;1;6;0
ea82d4809d6ad0cfcd0cfc351d1bc1f0fb92fe5c;Sun Dec 11 01:48:21 EST 2011;Committer;nobu;3;54;5;59;0
c5fc4da7a22fa4125afc8b70876b3f7d52404001;Sun Dec 11 01:37:50 EST 2011;Committer;nobu;3;13;0;13;0
0468b1bd6ae3197bd4b6fbb09a7b60d609d49604;Sun Dec 11 01:34:47 EST 2011;Committer;svn;1;2;2;4;0
fefba781bc0c4ba675d62bd29ecb0a2c4c5d134d;Sun Dec 11 01:34:42 EST 2011;Committer;nobu;2;30;26;56;0
5f3470b3a018fbe47480900330dd1a12e745ad08;Sat Dec 10 08:12:33 EST 2011;Committer;svn;1;2;2;4;0
242c7b7b7d6fbea4d28e6a79e00af91a43709973;Sat Dec 10 08:12:31 EST 2011;Committer;nobu;1;13;13;26;0
d51ce05213188eea5cf4cbd6b9ea06c537726c64;Sat Dec 10 08:12:28 EST 2011;Committer;nobu;1;2;2;4;0
a03a2d713c566f7ab909433667cf5760e45cd369;Fri Dec 09 13:50:18 EST 2011;Committer;nagachika;1;1;1;2;0
2eddb786ab577b6ae85245374bb10cab0bee788a;Fri Dec 09 12:40:59 EST 2011;Committer;nobu;1;1;1;2;0
c1d369b0abd42dc93a767570ca0b0f44b016e6ac;Fri Dec 09 10:27:37 EST 2011;Committer;naruse;3;105;0;105;0
33e7c896ca6fd4321bc843cd81bd096bb8e3f5d8;Fri Dec 09 06:36:43 EST 2011;Committer;naruse;1;1;1;2;0
8e411664ab7f565ec30718529202e8013e8a3076;Fri Dec 09 06:01:41 EST 2011;Committer;naruse;3;29;1;30;0
11d85dc1ec5775855cfd4986bd54410389fd1fd1;Thu Dec 08 23:00:42 EST 2011;Committer;svn;1;2;2;4;0
ef9bbba96f41d94c125460d4ca6a293996b8c09b;Thu Dec 08 23:00:36 EST 2011;Committer;luislavena;2;6;0;6;0
b8b5f5d437e6e7266e06f5d7c526553f39278590;Thu Dec 08 14:52:13 EST 2011;Committer;naruse;1;12;4;16;0
1fd41dce10a93ce89a098ffc33f40d5243f5e140;Thu Dec 08 14:47:19 EST 2011;Committer;nagachika;3;38;3;41;0
f6a2a4311647d2dd4d90c012cc3128eac96e255b;Thu Dec 08 14:28:28 EST 2011;Committer;usa;2;7;1;8;0
63fe8b697cd886beecb06f4020cab58676aa2a80;Thu Dec 08 13:50:10 EST 2011;Committer;akr;2;21;2;23;0
d9d841e35319353b8ed7174e48af7d9f84197c9c;Thu Dec 08 13:34:33 EST 2011;Committer;usa;2;8;1;9;0
518a3402531ea898c6fc72bb8ce5a381eb4f06ef;Thu Dec 08 13:22:27 EST 2011;Committer;nagachika;1;2;2;4;0
2fbf66a7e1fd2296c8e9bcb14ac223ea631bd55e;Thu Dec 08 10:27:01 EST 2011;Committer;naruse;1;7;1;8;0
0bfa4abd1bb6e57d854a0f4436354d5d00203313;Thu Dec 08 04:31:56 EST 2011;Committer;usa;2;9;1;10;0
bb3298720646891f5853bf676b3fb83ae5e99449;Thu Dec 08 04:12:55 EST 2011;Committer;usa;2;7;0;7;0
2470d7811fcd2d19e0075e171b2ffc106ddd9d91;Thu Dec 08 03:59:10 EST 2011;Committer;usa;2;6;0;6;0
f2747b578245160fd900af7cdd828360ec7939a5;Thu Dec 08 03:11:11 EST 2011;Committer;nobu;2;11;4;15;0
3e204989c1196982c0d016ff69d005c26885f824;Wed Dec 07 23:22:30 EST 2011;Committer;drbrain;2;75;2;77;0
52654367f6a4caa131e809b2067a5e2b45f0893a;Wed Dec 07 23:02:58 EST 2011;Committer;drbrain;2;8;3;11;0
253079bc154e9e24a15253526a162a501cd859b8;Wed Dec 07 22:13:08 EST 2011;Committer;svn;1;2;2;4;0
09c399b68e6162b68e52dfd22763408def2f813e;Wed Dec 07 22:13:04 EST 2011;Committer;naruse;1;1;1;2;0
aecd98a212016f991f1243f0734238b71702e6f6;Wed Dec 07 10:04:26 EST 2011;Committer;nobu;2;7;1;8;0
054dbe2a43c6c2183bd018a15724a59bb8fd48d3;Wed Dec 07 09:56:01 EST 2011;Committer;nobu;3;18;6;24;0
3a5daefe1f3e7b55571febe2e50d736fa7bed82e;Wed Dec 07 01:58:59 EST 2011;Committer;drbrain;2;29;0;29;0
12e7e79727527175572f74b144a331d288d620c2;Wed Dec 07 01:49:40 EST 2011;Committer;drbrain;3;63;0;63;0
1b99ecc5a22e1665b75a56e12b3f831397fc4539;Wed Dec 07 00:32:37 EST 2011;Committer;naruse;1;2;2;4;0
7c5aa76f5303c7f9442c2247588409df8dd4a972;Tue Dec 06 23:12:42 EST 2011;Committer;svn;1;2;2;4;0
54b214cc23652250c2dde01940d8778360363d54;Tue Dec 06 23:12:37 EST 2011;Committer;tenderlove;4;136;15;151;0
c5fada686d160b0caedb9af40ffcc75995e88edb;Tue Dec 06 10:38:28 EST 2011;Committer;akr;1;3;3;6;0
bb1875175bd683014008e23cde429d8508d5524e;Tue Dec 06 10:21:12 EST 2011;Committer;akr;3;20;7;27;0
1ff15071d05f343206318b6f06b45c43dec814f1;Tue Dec 06 06:59:29 EST 2011;Committer;naruse;1;2;2;4;0
0209f8d476470226103857db21f8f6967870a37b;Tue Dec 06 06:41:38 EST 2011;Committer;naruse;1;2;2;4;0
20c91cafba7a5f1c212d500810d5675edab4cca3;Tue Dec 06 04:40:04 EST 2011;Committer;naruse;1;2;4;6;0
2f49f5ee0b257a2cb52b66ba36ab65bb2fa4641a;Tue Dec 06 03:38:07 EST 2011;Committer;akr;3;55;1;56;0
79bc357902ff3ba94805a08557f741a6c389d759;Mon Dec 05 23:36:53 EST 2011;Committer;drbrain;2;122;81;203;0
03c02865c8feeda9badd864a379a11a6d82007ad;Mon Dec 05 21:47:44 EST 2011;Committer;svn;1;2;2;4;0
52f61eaef7cb1d022db1d67c4e0bafaf7bf7fea6;Mon Dec 05 21:47:16 EST 2011;Committer;naruse;1;6;0;6;0
3581d76bbbd06f147ce08fb3047c704900af9198;Mon Dec 05 10:12:02 EST 2011;Committer;nobu;1;1;1;2;0
c09f46301b20f7e86ff776fd8000d47c3f94c93f;Mon Dec 05 10:08:07 EST 2011;Committer;nobu;2;9;0;9;0
8bce84fe5dbb07260f33235f7ebb393ff140df72;Mon Dec 05 10:02:02 EST 2011;Committer;nobu;3;21;1;22;0
74b985acedd741b2755a9965e663b95a7c2b399a;Mon Dec 05 10:01:06 EST 2011;Committer;nobu;1;0;8;8;0
b526738c3b27bc67a3e1017a051aab1163a34117;Mon Dec 05 09:57:00 EST 2011;Committer;nobu;14;63;23;86;0
8baffe6ef664e53a6acf0c3f52e900d37780fabb;Mon Dec 05 09:50:12 EST 2011;Committer;nobu;8;24;35;59;0
0e4b86b5b94c8ce6abedde5a525f0a48c36ddd1d;Mon Dec 05 08:13:28 EST 2011;Committer;nobu;1;2;2;4;0
bf0d8b7e64e8aca381259d5e412e3a766b511878;Mon Dec 05 05:33:49 EST 2011;Committer;nobu;2;6;1;7;0
1dea1927752dfb4e09b2db6fc13589eb16a7e336;Mon Dec 05 05:29:31 EST 2011;Committer;usa;5;102;95;197;0
8229b9dd3f57a965872734f2b97f98a512979560;Mon Dec 05 01:25:47 EST 2011;Committer;usa;2;9;8;17;0
7f654692260c710406eed0c8e993eb1b79efa1d9;Sun Dec 04 23:57:03 EST 2011;Committer;svn;1;2;2;4;0
39a9b9ba7e00c2f7493be86ada7c2b3af7e2eaff;Sun Dec 04 23:56:59 EST 2011;Committer;nobu;1;4;4;8;0
b8f3ef613613b5d9b275f84fa774b03ef493ac21;Sun Dec 04 13:53:59 EST 2011;Committer;akr;2;6;24;30;0
250d10b21f7f4482ab33da91a699c4b542c92b33;Sun Dec 04 13:50:58 EST 2011;Committer;akr;1;1;1;2;0
7b18746587b25ab1438be4b20ea7d59e99db84f1;Sun Dec 04 13:35:50 EST 2011;Committer;akr;2;4;1;5;0
483fd7485ba07a03426900da7d8397c0b0d99af7;Sun Dec 04 03:12:54 EST 2011;Committer;ktsj;2;9;3;12;0
6e56d645f0e176f7186027d0e0964ca62f4d4b6f;Sun Dec 04 03:05:03 EST 2011;Committer;naruse;4;17;3;20;0
e21f885bb024a622b7b95c3f13f2bda582dfbf0b;Sun Dec 04 01:10:12 EST 2011;Committer;svn;1;2;2;4;0
f9a6a1dd0c687dfc6e63e5d20bc3812416def301;Sun Dec 04 01:10:06 EST 2011;Committer;luislavena;6;214;19;233;0
4a1cfe70dc31f9be8a12908d85b51297d61b8eae;Sat Dec 03 11:52:14 EST 2011;Committer;mame;3;17;0;17;0
d267b2e347b0ef226c132a881ed11a89e622df24;Sat Dec 03 11:52:08 EST 2011;Committer;mame;3;22;1;23;0
53df70d92b8073dc5602aff912b657869c4d7524;Fri Dec 02 22:17:34 EST 2011;Committer;nobu;4;11;7;18;0
5569d35044f35a313db88521cb1511c20e0fb0de;Fri Dec 02 22:14:36 EST 2011;Committer;svn;1;2;2;4;0
2748f58dcee9ed31c8732b16b5cd0b4ffe7f1c38;Fri Dec 02 22:14:30 EST 2011;Committer;nobu;2;6;1;7;0
d0b2816d02f49e19a18cbedb7b9f5601ef0b691a;Fri Dec 02 06:48:10 EST 2011;Committer;nobu;2;12;6;18;0
5fce7630c74fa3cfdfd7a7a3f28af913e5d2a137;Fri Dec 02 06:43:57 EST 2011;Committer;nobu;1;2;2;4;0
0755d415bb6f89575d753d6b37638ad67c5a2830;Fri Dec 02 06:41:27 EST 2011;Committer;nobu;2;15;3;18;0
55cae8834019d9112e31cad097ecb3beff5e244c;Fri Dec 02 06:18:21 EST 2011;Committer;nobu;2;7;2;9;0
9b69817ac0bfdd5b63ff7ac67905a4c1251b9496;Fri Dec 02 04:02:20 EST 2011;Committer;naruse;2;3;8;11;0
6ec1902a2d0f83484cd3b0d046f29f8b1a0eb435;Fri Dec 02 02:30:38 EST 2011;Committer;nobu;2;8;3;11;0
12697d5078436faca0a96273e19fb02d6f49e01d;Thu Dec 01 22:15:00 EST 2011;Committer;svn;1;2;2;4;0
0b1651753c0ddbad69c20904aa44acf667b8c6ae;Thu Dec 01 22:14:45 EST 2011;Committer;naruse;2;9;14;23;0
72af26207b6e4600e540ec0158cde30df86f7864;Thu Dec 01 14:28:42 EST 2011;Committer;nagachika;2;6;1;7;0
eecacaa024d59dc7cd7c9ff37a017478082b0a89;Thu Dec 01 13:31:58 EST 2011;Committer;akr;2;8;4;12;0
c6dec376494db7886388b34943d4d3550fe99d09;Thu Dec 01 11:46:31 EST 2011;Committer;marcandre;2;14;9;23;0
b0f588fe0e3bb79b69eddbcaf4c651489c6e3cc5;Thu Dec 01 08:45:22 EST 2011;Committer;nobu;1;5;4;9;0
05e2da638f2fbb5da018c9585dea066e9de5f979;Thu Dec 01 07:59:21 EST 2011;Committer;nobu;2;11;6;17;0
b5be93097941c246fd43218e810b7be2ec2955a4;Thu Dec 01 07:20:20 EST 2011;Committer;nobu;2;5;1;6;0
abb40f8eb315e847e8811db1d72337a4995c2b13;Thu Dec 01 06:19:57 EST 2011;Committer;nobu;2;31;38;69;0
f274088eec6b2e069c01e2d71d218bb91ffdce06;Thu Dec 01 05:48:05 EST 2011;Committer;nobu;2;37;30;67;0
a394c59be36d8b318e158db4ad852a107121c590;Thu Dec 01 05:43:22 EST 2011;Committer;nobu;2;12;1;13;0
b2e137c81e70ca23676d5847be8719db8df2e5a6;Thu Dec 01 01:32:02 EST 2011;Committer;nobu;2;7;0;7;0
0d0bd1642acc24c104e7fbdce193deb165feecf8;Wed Nov 30 22:17:48 EST 2011;Committer;kosaki;3;14;1;15;0
5ee348fd0e067cf4152df301fedb06517207181b;Wed Nov 30 15:19:11 EST 2011;Committer;svn;1;3;3;6;0
4c5c26cec13e0c604d4bc50109776394f21ea362;Wed Nov 30 15:19:02 EST 2011;Committer;naruse;1;2;0;2;0
f6f453438242fe724dcf0d2d5c968a5861820848;Wed Nov 30 14:44:06 EST 2011;Committer;naruse;5;34;1;35;0
ed73a902b80cec1bc42465fba4a07b8a6503e6ab;Wed Nov 30 11:03:22 EST 2011;Committer;duerst;2;18;27;45;0
1d234a16143f26c2ea10ea35afbbb0c7c19bdeee;Wed Nov 30 03:32:05 EST 2011;Committer;nobu;1;8;31;39;0
6a894686d604f62b08da02cd89cd231e5260684c;Wed Nov 30 03:20:04 EST 2011;Committer;naruse;1;2;0;2;0
8b7ecdc11e1569e8e2cea4842156e419977ff16e;Wed Nov 30 00:57:24 EST 2011;Committer;drbrain;5;1874;1826;3700;0
434a5f93adc435207aa0c2074558646753766a4d;Wed Nov 30 00:13:02 EST 2011;Committer;usa;3;12;10;22;0
b62aadf0ddc080a1c3456bfa43227a9660819d2f;Wed Nov 30 00:10:36 EST 2011;Committer;svn;1;2;2;4;0
0df90074c740c2c106051b44fcebaf36b103485b;Wed Nov 30 00:10:31 EST 2011;Committer;tenderlove;3;24;8;32;0
302b6f6e0264dc7f03cfb1a55829ef60af1e96b0;Tue Nov 29 08:42:13 EST 2011;Committer;naruse;3;1863;1926;3789;0
2ba247275a19558ef4aa51facad80e6b87b40533;Tue Nov 29 01:08:16 EST 2011;Committer;drbrain;2;71;39;110;0
82d138f749e150955db443f56eacaaedd010191b;Tue Nov 29 00:58:28 EST 2011;Committer;nobu;2;10;4;14;0
9fe88af9ef088445a334e782eb063879aab333aa;Tue Nov 29 00:51:40 EST 2011;Committer;nobu;2;9;8;17;0
4659b00b9a9c0ef818847186782babc43e09772f;Tue Nov 29 00:51:37 EST 2011;Committer;nobu;1;3;0;3;0
b1f1e46ce2725324aacbfc79c5dad3fe4b89e9a3;Mon Nov 28 23:45:42 EST 2011;Committer;drbrain;2;210;183;393;0
194882cc40ea7e97e0cd990099c87852134bd249;Mon Nov 28 21:54:33 EST 2011;Committer;drbrain;4;1828;1808;3636;0
22702f927894bb0b73bc90ddfeaeff3861ad7606;Mon Nov 28 17:44:25 EST 2011;Committer;nagachika;1;0;1;1;0
97c3d78cef321c8d6c0c8b23f7725e36211556c0;Mon Nov 28 17:36:46 EST 2011;Committer;nagachika;1;2;2;4;0
2ffeb686df9605efafb133c449501499181013e8;Mon Nov 28 15:14:17 EST 2011;Committer;svn;1;2;2;4;0
0f7e05a0a275b93b17b50ea5a1f99a63048b2378;Mon Nov 28 15:14:14 EST 2011;Committer;yugui;2;19;7;26;0
81ef9c66b7aef992239840b1cb2d0c8377a760af;Mon Nov 28 13:28:26 EST 2011;Committer;usa;2;24;11;35;0
fb8ff8de93455f6d2195c2233e45e639800fabad;Mon Nov 28 03:57:31 EST 2011;Committer;nobu;2;5;1;6;0
4d6de2f7c4fec2ea9388a9c74adb8d8f921e75c8;Mon Nov 28 03:49:00 EST 2011;Committer;usa;2;7;2;9;0
2d0c17d4fbc910c2f24c6ed30b2d43b5c2c29a0c;Mon Nov 28 03:38:52 EST 2011;Committer;usa;2;5;1;6;0
2d6a401ecf966a2b6bfdb06c3bb1d60ccb6eecf8;Mon Nov 28 03:33:10 EST 2011;Committer;usa;2;5;17;22;0
70edc47dcad27c8fdfa6df77472e3f9126280d0a;Mon Nov 28 03:29:56 EST 2011;Committer;usa;2;4;1;5;0
b03817234803da053d0977fae2f84ef1f64ada27;Mon Nov 28 03:15:31 EST 2011;Committer;nobu;2;16;6;22;0
02f9b4d60611016f06e3eae774c1ad9140780217;Mon Nov 28 02:47:51 EST 2011;Committer;usa;2;16;9;25;0
d81c20771d440001295945086d0c58e4125b5660;Mon Nov 28 02:00:53 EST 2011;Committer;usa;2;5;1;6;0
1510ad86c4c8ab2e28387b8a8327a752f062782e;Mon Nov 28 01:36:09 EST 2011;Committer;nobu;4;101;93;194;0
61b3acd568e057074dea5007a8eb6dfa55b1cbc4;Mon Nov 28 01:23:49 EST 2011;Committer;usa;3;11;2;13;0
4ccc50f436d6de11fef2f610bc988b31ec060a60;Mon Nov 28 00:33:22 EST 2011;Committer;svn;1;2;2;4;0
5bc28059b0f85cd473ea4934bc1fd7fb76006e8e;Mon Nov 28 00:33:18 EST 2011;Committer;usa;3;16;1;17;0
543820885ee691d70e0d5c36246bdfdf8a1eddd3;Sun Nov 27 12:27:00 EST 2011;Committer;kosaki;2;11;0;11;0
8cee31214df54281a93c8fe135a5fd36fd7e288a;Sun Nov 27 12:06:10 EST 2011;Committer;kosaki;3;11;2;13;0
9b58c2edf3dbb9adc4355e642e4124eeb47a43d5;Sun Nov 27 10:09:11 EST 2011;Committer;nobu;2;10;2;12;0
41f756eaf3648156ad9645705bf843acdae73f2f;Sun Nov 27 09:54:12 EST 2011;Committer;nobu;3;3;4;7;0
c4cd97a56359a800f94ceca7fbb4450ff30359ca;Sun Nov 27 09:25:38 EST 2011;Committer;nobu;2;11;2;13;0
929e69fdca0a95c83040fffaccff055f615bb5e6;Sun Nov 27 08:26:54 EST 2011;Committer;nobu;1;4;4;8;0
a072b2dfd24dbc71910891ed38aca7a9dbb82153;Sun Nov 27 08:24:29 EST 2011;Committer;nobu;1;2;2;4;0
0a420f2274941b84f639b551411ce677c830b7df;Sun Nov 27 08:24:26 EST 2011;Committer;nobu;1;2;2;4;0
2d14b798c27b432434e05a9e9e680a24c952b299;Sun Nov 27 08:24:19 EST 2011;Committer;nobu;1;1;1;2;0
a4d38daecef8729cd1b61de6bc02cfbfd68f18fe;Sun Nov 27 07:15:04 EST 2011;Committer;kosaki;2;7;1;8;0
63e65fd4b10630484fe563eee1443332465cabe5;Sun Nov 27 06:50:55 EST 2011;Committer;kazu;1;7;7;14;0
ef05fbd0fbde7e526ebfa0b3e314379ef7fc45b8;Sun Nov 27 06:22:00 EST 2011;Committer;nobu;1;2;0;2;0
358216cf3f36fd45b7bd454201ccecf0356bb7cc;Sun Nov 27 05:20:31 EST 2011;Committer;naruse;1;1;1;2;0
ed78271c49bb405b202322ee39a4db919e2fdb3d;Sun Nov 27 04:55:27 EST 2011;Committer;kosaki;2;58;10;68;0
0e28532a52fd7f60da1ad47453a43edfde1e588f;Sun Nov 27 04:30:44 EST 2011;Committer;kosaki;2;9;1;10;0
5fa2d2b793837a6e249afa9245b9a31b8cc5bb2a;Sun Nov 27 03:54:09 EST 2011;Committer;naruse;1;1;0;1;0
7d11b9e2892df8e3936a2079bb101b2b27111937;Sat Nov 26 22:49:28 EST 2011;Committer;naruse;2;4;4;8;0
b361c5adeca7027546373f5d6e2d1da0fff16184;Sat Nov 26 20:03:32 EST 2011;Committer;naruse;1;1;1;2;0
01a64885c3fc6a3fbf03e6565932eb36f697670a;Sat Nov 26 19:59:13 EST 2011;Committer;naruse;2;13;3;16;0
b6b8cc01a5bd3d72e3824c915fcbb913d82334d8;Sat Nov 26 19:59:11 EST 2011;Committer;naruse;2;25;8;33;0
e125a38c6648d0b715f192f5340c9e72f6415fd9;Sat Nov 26 15:18:09 EST 2011;Committer;svn;1;2;2;4;0
5f652716ca9d49cc1b89525b4c877d0bd426da91;Sat Nov 26 15:18:05 EST 2011;Committer;akr;2;6;1;7;0
0f59228a0b08bf59e4f9747b9272adca0899b157;Sat Nov 26 14:04:52 EST 2011;Committer;emboss;2;20;16;36;0
708d76a3b1ab9d5b888a9e68773406e289860aa0;Sat Nov 26 11:44:45 EST 2011;Committer;naruse;2;12;2;14;0
9d4db2d4d9549d5547c50d8049c4448d10816651;Sat Nov 26 11:06:53 EST 2011;Committer;naruse;2;18;14;32;0
5fa9e5c3668bb947039146e8dc6279ce71d8d9fe;Sat Nov 26 06:41:29 EST 2011;Committer;shyouhei;2;5;1;6;0
474635843b840e508841278fc65d5979bcc52bc2;Sat Nov 26 06:39:54 EST 2011;Committer;shyouhei;2;5;1;6;0
5606f11e36db91220a6f9ad57901c7d2b8589de0;Sat Nov 26 06:32:54 EST 2011;Committer;shyouhei;2;5;0;5;0
c36ee7bd385991f4eda57b043379ced9a7c21d1b;Sat Nov 26 06:26:44 EST 2011;Committer;shyouhei;2;10;0;10;0
41fa4bd7151f0a3c713d2bb3f4c08d2e8099b294;Sat Nov 26 01:49:36 EST 2011;Committer;emboss;3;7;15;22;0
bdf357bf5eae625c606bff423a2299ba0cd69853;Sat Nov 26 01:25:07 EST 2011;Committer;emboss;2;6;0;6;0
b079453dc65873306ee0f218c3491f7cb81e7eba;Fri Nov 25 20:00:36 EST 2011;Committer;svn;1;2;2;4;0
8b83ea9ef1452e74f3a8b6e35000c83dd8b91fe7;Fri Nov 25 20:00:31 EST 2011;Committer;nobu;2;6;1;7;0
aa23f6b9fdecbf3be3e21b0f6b40e2b22f125090;Fri Nov 25 02:45:50 EST 2011;Committer;kosaki;3;47;1;48;0
0996ae361a62db5094eb3d8cc59c7d002170c285;Fri Nov 25 01:41:59 EST 2011;Committer;kosaki;3;13;1;14;0
98975ba9dc6781083275e26aac4fbe29d689a7f6;Thu Nov 24 23:50:00 EST 2011;Committer;kosaki;2;10;0;10;0
b2eae7891b8a808f7f737833fbaf84b0d467377c;Thu Nov 24 23:06:26 EST 2011;Committer;kosaki;2;6;0;6;0
d0e615e25f839d32507bcccb593d5fc3c28db28c;Thu Nov 24 23:04:35 EST 2011;Committer;kosaki;2;9;0;9;0
b418bc9be47ac63da559cb4bbdf705d83d99cde2;Thu Nov 24 23:02:44 EST 2011;Committer;kosaki;2;17;6;23;0
450c2094be9ef5ddf0f5f91f1744e03dac93af31;Thu Nov 24 22:58:00 EST 2011;Committer;kosaki;2;5;37;42;0
746aa6f74b55b1783242b4f074200105dd7d90bc;Thu Nov 24 22:54:39 EST 2011;Committer;kosaki;2;5;19;24;0
1e79a33e2178202bbc7f08996bfd7cffe30f48f9;Thu Nov 24 22:49:54 EST 2011;Committer;svn;1;2;2;4;0
5817762f2bce7b4875075f61861d58e0410e2dad;Thu Nov 24 22:49:51 EST 2011;Committer;kosaki;2;5;1;6;0
d7b7f56c8c3017073bd8ff5917367bbfb8af206a;Thu Nov 24 11:07:50 EST 2011;Committer;akr;3;17;1;18;0
bee4e843ce20dd899eb86fd2f6947e6573b20465;Thu Nov 24 11:00:35 EST 2011;Committer;akr;2;13;0;13;0
7e35d6fcaa773afc4f492689471f5687cc41c814;Thu Nov 24 03:08:52 EST 2011;Committer;akr;1;35;0;35;0
d7166624bf70c2fe9f0b067065b9fd490de16d20;Thu Nov 24 02:57:57 EST 2011;Committer;kosaki;2;23;2;25;0
452b74c10682280912d14254795d2e76894fbdc9;Thu Nov 24 01:09:55 EST 2011;Committer;emboss;2;23;15;38;0
5c7e691e5de1fc0d9a8d7bc15cf45cb4a06d4452;Thu Nov 24 00:46:34 EST 2011;Committer;naruse;1;2;2;4;0
c8abe4a054e605dd6e73c0725c4f4d3c59440aa6;Wed Nov 23 23:17:59 EST 2011;Committer;emboss;1;1;1;2;0
6872b9e13b048812a1d75f3cf86c743965007225;Wed Nov 23 23:15:13 EST 2011;Committer;svn;1;2;2;4;0
29b0d9d932139aa38d7bb9656041a154dffc0649;Wed Nov 23 23:15:09 EST 2011;Committer;emboss;4;21;13;34;0
1eb0f880d2b569acdf7ee9b6166532371a7421ec;Wed Nov 23 11:24:54 EST 2011;Committer;svn;1;2;2;4;0
fd8d9d9dceb445099aacbe75eb08246925c98527;Wed Nov 23 11:24:49 EST 2011;Committer;naruse;3;20;2;22;0
6904c662574a4ac0968bb286f26436a4dbe0c9b3;Tue Nov 22 09:08:34 EST 2011;Committer;usa;2;6;0;6;0
083b923ea80ae15cb4b623bca71d92d083073da4;Tue Nov 22 08:49:47 EST 2011;Committer;nobu;2;12;1;13;0
a0ef626241b3438361f98ab7cc289150cc286d98;Tue Nov 22 05:38:55 EST 2011;Committer;naruse;1;1;1;2;0
cc56bdee405b6de918f60f9ac73433d84c04fde0;Tue Nov 22 04:54:42 EST 2011;Committer;naruse;3;6;2;8;0
18b520443cfdf145f3cd7fd22f192c04dc0da9fc;Tue Nov 22 02:34:00 EST 2011;Committer;nobu;2;8;2;10;0
30d762795cf3078764102d9921f875116d5d77a9;Tue Nov 22 02:27:53 EST 2011;Committer;naruse;3;15;5;20;0
033244c1b2b23c3f70a2a7c5cbdef570fdb9220e;Tue Nov 22 01:47:35 EST 2011;Committer;naruse;3;57;4;61;0
4e29a1a8fd69e8f13dbfacdbb897fc378ac0ad4b;Mon Nov 21 22:00:50 EST 2011;Committer;akr;2;6;1;7;0
daeaa65f088aa541fa6a9345208b6988fe22bf4d;Mon Nov 21 19:47:09 EST 2011;Committer;tenderlove;3;8;9;17;0
19bca2e6b203e4b25b5b14a6907177b1267d927d;Mon Nov 21 15:46:14 EST 2011;Committer;akr;2;6;1;7;0
15e793bad9ca2da2e6d6ab50b3469fcebf769f2c;Mon Nov 21 15:26:16 EST 2011;Committer;svn;1;2;2;4;0
08f8dfc20bdec42a08b6c062ec993f00f4b8775b;Mon Nov 21 15:26:12 EST 2011;Committer;akr;2;5;1;6;0
f49f6ff1d75d7cb456811f6fa15aa9a935236748;Mon Nov 21 14:40:09 EST 2011;Committer;akr;2;56;5;61;0
81bedc68ac9786004d304e2431897a07b8d26000;Sun Nov 20 21:17:57 EST 2011;Committer;naruse;3;19;0;19;0
ee98d19128d0c12fcc469490269efccfe80f0984;Sun Nov 20 15:19:33 EST 2011;Committer;svn;1;2;2;4;0
c82ff0aac895ee77065cb5d108a4ccd706e235a3;Sun Nov 20 15:19:28 EST 2011;Committer;nobu;1;1;1;2;0
c2c6687ddb5b8531ac71f816c3b769ea68cb154a;Sun Nov 20 14:22:44 EST 2011;Committer;nobu;3;17;3;20;0
aa347ba042d6a1adf27d9ef139be9436634b9ce8;Sun Nov 20 14:19:04 EST 2011;Committer;nobu;1;1;1;2;0
afea9046a99f5de0295da8455c09d4614ee2338a;Sun Nov 20 14:05:44 EST 2011;Committer;nobu;1;2;2;4;0
22dcc88584072526fc09bc4a68b51deb1e24d67b;Sun Nov 20 14:02:02 EST 2011;Committer;nobu;1;23;17;40;0
be276c140d26d7205e5f36922d08b0b9ebd24ccc;Sun Nov 20 13:44:11 EST 2011;Committer;naruse;2;6;1;7;0
901ed0b3187048dd064b4bfdaaecc94881ab5800;Sun Nov 20 02:02:14 EST 2011;Committer;akr;2;8;3;11;0
562c42a668ded49568e71d8af16576818babb97a;Sun Nov 20 01:21:01 EST 2011;Committer;akr;2;5;1;6;0
4dd0e267273be9f5703db1486c3a6865c00fe092;Sat Nov 19 19:02:02 EST 2011;Committer;svn;1;2;2;4;0
f6a635a91911df86a1464859db81d382156d93f8;Sat Nov 19 19:01:49 EST 2011;Committer;nobu;4;6;9;15;0
54f282c2c4102e6b2d3c641054b3c08808788224;Sat Nov 19 12:52:37 EST 2011;Committer;akr;4;20;0;20;0
62fed7c91a7a38e0469bbd454d1c4e8c373e91e5;Sat Nov 19 10:48:22 EST 2011;Committer;akr;1;3;1;4;0
6445aab4724529f511c5d2908b452e8145560f14;Sat Nov 19 10:47:03 EST 2011;Committer;akr;3;17;1;18;0
b0fe68867625cf252dd100afbc4a7776354035d7;Sat Nov 19 07:37:22 EST 2011;Committer;akr;2;8;2;10;0
6fde18fe1cb5f23270da971d15ab85d7588a06af;Fri Nov 18 23:19:30 EST 2011;Committer;svn;1;2;2;4;0
805a01cb9a723f3d9f2a53591a3c3fdd61046547;Fri Nov 18 23:19:26 EST 2011;Committer;akr;2;6;0;6;0
714ec98ec4015917337b3271c98f49a143e175d8;Fri Nov 18 08:18:18 EST 2011;Committer;nobu;2;70;26;96;0
3723ac22d23ad8675d9aad2f1df229b0c81e31cd;Fri Nov 18 07:12:14 EST 2011;Committer;nobu;3;76;2;78;0
7491541e1602d2cf9b29783abadf802f1f50251c;Fri Nov 18 04:21:23 EST 2011;Committer;usa;2;9;2;11;0
44cff77b95104cc99ea5625df6ebe8adfa3f4a22;Fri Nov 18 04:06:01 EST 2011;Committer;usa;3;12;1;13;0
d6c86e631d030202f23b096a1659a495c0263c5a;Thu Nov 17 23:02:16 EST 2011;Committer;ryan;9;118;64;182;0
6b43a55611a8139a288e2550e933f84f80155245;Thu Nov 17 22:38:21 EST 2011;Committer;svn;1;2;2;4;0
5a94b29c533f9e07be7c0d9ce60f02f8630d70c9;Thu Nov 17 22:38:18 EST 2011;Committer;ryan;1;1;1;2;0
09d2180d2d813e3f78a5c76b021943ceb36ddb8b;Thu Nov 17 11:45:32 EST 2011;Committer;akr;2;6;1;7;0
b37c003e2450d71dc97958e79660972701458cf3;Thu Nov 17 11:24:07 EST 2011;Committer;usa;3;15;2;17;0
b5907f7d46d74dda26479a4ed4f8b78a6d51dcf9;Thu Nov 17 01:42:54 EST 2011;Committer;tenderlove;1;1;3;4;0
9660bcfc4390dcf49b213877a6b1b58423c1dfdb;Thu Nov 17 01:38:20 EST 2011;Committer;svn;1;2;2;4;0
07636686da3b93120a1f56e79bdf5ab9ad1f6f8d;Thu Nov 17 01:38:16 EST 2011;Committer;tenderlove;2;6;1;7;0
1f86c08fdf8a4280eb321ad8732bc85f46f4ee6f;Wed Nov 16 09:13:56 EST 2011;Committer;nobu;2;7;0;7;0
4a997526e02554b48cf002a8dc20df8c4560f69a;Wed Nov 16 04:53:51 EST 2011;Committer;usa;2;8;2;10;0
2a445945081d71aec08ec0a9d67e4384821e0b3a;Wed Nov 16 03:06:05 EST 2011;Committer;usa;3;11;2;13;0
ff187b02670f2ae6e703b9f0125bed37206f899d;Wed Nov 16 02:43:03 EST 2011;Committer;naruse;1;1;1;2;0
bbe004c1e461a5769663ddc0b24d0b517fe3c118;Wed Nov 16 02:36:08 EST 2011;Committer;usa;2;8;3;11;0
b4664c781ba08aac8ae085c57c078aae6081f142;Wed Nov 16 02:12:37 EST 2011;Committer;naruse;1;1;1;2;0
ce03ef024295f247ecf4a4e476691d1497974d90;Wed Nov 16 01:46:43 EST 2011;Committer;usa;2;5;2;7;0
5db50ed02d97de08c47f4abe1edf47e87b500314;Wed Nov 16 01:27:15 EST 2011;Committer;usa;2;5;1;6;0
12bde2dfabc3492d490e6c53628cf8cdf04495ff;Wed Nov 16 00:59:56 EST 2011;Committer;naruse;2;11;3;14;0
efdcaeaf32b6455e2ff97ae09fb46f7a5b831455;Tue Nov 15 21:35:14 EST 2011;Committer;svn;1;2;2;4;0
737907b24abacfe6ebed79b33f9a8ba8ca3d4b15;Tue Nov 15 21:35:09 EST 2011;Committer;akr;2;7;1;8;0
dbb03fdc96e45c46ada208991a2e4d04306cb740;Tue Nov 15 13:55:38 EST 2011;Committer;nobu;1;11;11;22;0
498a6e8a05e77f3d85f45945293f46054565903c;Tue Nov 15 12:58:37 EST 2011;Committer;akr;2;7;1;8;0
3d25acdccc6c6afec0649655859590892b561c9d;Tue Nov 15 11:09:47 EST 2011;Committer;akr;5;11;6;17;0
fd5a7ee75cb372aaf15c8a3c95517ce228b94f04;Tue Nov 15 05:57:34 EST 2011;Committer;kosaki;2;30;14;44;0
3d85b0ff5a0ebe583235c99dfe17791d9d5d6587;Tue Nov 15 05:05:35 EST 2011;Committer;ngoto;2;2;2;4;0
fa00b6516c96ffc888c194caf9bf964255c6ec54;Tue Nov 15 04:42:31 EST 2011;Committer;ngoto;4;42;16;58;0
9cdd62bd19f7872bab25912ed0485c098ea141d2;Tue Nov 15 04:18:43 EST 2011;Committer;kosaki;2;55;68;123;0
d020fb15254c13e458bb9603479edbb7b3fb347f;Tue Nov 15 01:41:58 EST 2011;Committer;kosaki;2;7;2;9;0
16b663db574f4793060e0d7276c03ef1b203dee9;Tue Nov 15 00:51:46 EST 2011;Committer;naruse;2;5;1;6;0
66f8e8bbcec5fa1d3c4e61f948a6e895b368a89f;Mon Nov 14 17:02:10 EST 2011;Committer;ayumin;2;5;6;11;0
40ca7a2265556e28399666d471f1390f01adc2cf;Mon Nov 14 16:10:17 EST 2011;Committer;ayumin;2;7;1;8;0
e1440769f3d8d5dbc5fbf97bf77ac88acb65583e;Mon Nov 14 16:00:33 EST 2011;Committer;svn;1;2;2;4;0
61fe9d5c4132ece0762cc2e6ab05ac49951ae82e;Mon Nov 14 16:00:29 EST 2011;Committer;kosaki;1;2;0;2;0
b848d4f9c8859ad2d37c9523759366d9b24f0464;Mon Nov 14 13:06:51 EST 2011;Committer;akr;3;9;0;9;0
158a828c97ac00799533d942f90a31f712b9290a;Mon Nov 14 11:22:15 EST 2011;Committer;akr;1;2;2;4;0
958caf186ff462fcbadea7dc386eaca7a46a166d;Mon Nov 14 08:17:49 EST 2011;Committer;nobu;1;8;0;8;0
ed681d3a82591db3f4dd6e77c568f98b7d1d6216;Mon Nov 14 05:56:09 EST 2011;Committer;kosaki;3;13;8;21;0
302220a8a53cb09713d2cfb05ac2decfc098030b;Mon Nov 14 05:53:59 EST 2011;Committer;kosaki;2;6;1;7;0
9debadd9489f76f7f211bf11027dbea907c19252;Mon Nov 14 03:55:40 EST 2011;Committer;kosaki;2;6;2;8;0
b2a2ba119104b0ff2b6c20611d76de924596ca5b;Mon Nov 14 03:54:34 EST 2011;Committer;kosaki;5;166;0;166;0
d3437b7c1a496143c2bff2698082af143f5e1dc0;Mon Nov 14 03:51:56 EST 2011;Committer;kosaki;3;17;14;31;0
11137bed53cc5a3431e2db80e27d31629cca4f0e;Mon Nov 14 03:47:21 EST 2011;Committer;kosaki;2;58;0;58;0
15102dacfc2663b94d45a4819ca2a7db62dea8fb;Mon Nov 14 03:45:54 EST 2011;Committer;svn;1;2;2;4;0
74a13c76349b3b463514f60beb9f02c2ba301ad6;Mon Nov 14 03:45:47 EST 2011;Committer;kosaki;7;249;4;253;0
416778c5d80230183ef06a49bb58145a7480ed48;Sun Nov 13 14:47:31 EST 2011;Committer;nobu;3;7;10;17;0
a0146d1e8708eb372e415ac733066bee34e3ef36;Sun Nov 13 14:46:01 EST 2011;Committer;nobu;3;56;20;76;0
4b01d611dbd7911f3f68f1a8b4666125bceaf25b;Sun Nov 13 14:22:17 EST 2011;Committer;akr;2;6;0;6;0
abe61eb0d136581d031fd8694ec8682820bba722;Sun Nov 13 12:32:15 EST 2011;Committer;akr;2;2;2;4;0
bfed16a21f057a1b0fed51936ff11a64ac7c4ea3;Sun Nov 13 10:58:18 EST 2011;Committer;akr;2;9;7;16;0
e8ca9cc343dcdf11641bd8a9d73bf7aa291b5572;Sun Nov 13 07:25:40 EST 2011;Committer;akr;2;9;2;11;0
3e5bff7ec18cb834f7e05ed5f973edd35f990617;Sun Nov 13 06:41:19 EST 2011;Committer;akr;2;6;2;8;0
2b2ef5cfced1c06ceb9920afd6b24255510d4242;Sun Nov 13 03:47:07 EST 2011;Committer;akr;2;17;0;17;0
d3fc4ae7cb4ace087eef327bd19fa5fe957c745a;Sat Nov 12 18:03:37 EST 2011;Committer;kosaki;3;8;0;8;0
d956e6dba2c07a1deb1d51cbbcbd240729eb8021;Sat Nov 12 17:43:01 EST 2011;Committer;svn;1;2;2;4;0
3aaf92b5a119885aba0b1c41946b498426880399;Sat Nov 12 17:42:57 EST 2011;Committer;kosaki;2;6;1;7;0
80c32b2330a2d25111b54982f942f23641463ce3;Sat Nov 12 08:26:13 EST 2011;Committer;nobu;2;10;5;15;0
521f420a772c37cd4a90b51da7c18c18084c47ac;Sat Nov 12 08:01:51 EST 2011;Committer;nobu;2;6;2;8;0
0eb08aa068abc9101d1452ce868126575782b471;Sat Nov 12 07:50:12 EST 2011;Committer;akr;1;2;2;4;0
9998578951df328ae16da51bebca1ee3b6811dd4;Sat Nov 12 07:49:48 EST 2011;Committer;nobu;2;8;8;16;0
df2e1f85d2192be61eb5a8f8cb9663f47769101b;Sat Nov 12 07:06:09 EST 2011;Committer;akr;3;11;7;18;0
5c29d116c2d1dac5c6953bb60a3bda35df51d713;Sat Nov 12 04:37:54 EST 2011;Committer;kosaki;2;9;1;10;0
33817fbc29943b5b26254626d8721a0ce391b1cf;Sat Nov 12 02:33:58 EST 2011;Committer;kosaki;2;142;1;143;0
632652a2442d364d38b72cc3bf7ebc4cc2fb9b12;Sat Nov 12 02:32:16 EST 2011;Committer;kosaki;2;15;0;15;0
f2708ce30f0bf7c7a0ace010a7f8461de1e41f8b;Sat Nov 12 02:31:15 EST 2011;Committer;kosaki;2;41;1;42;0
791f5449c170467ebe7f43d06047ec3d61d141eb;Sat Nov 12 02:29:37 EST 2011;Committer;kosaki;2;7;0;7;0
b3027d5929945a7d08b89af3bb514c9b687b41d0;Sat Nov 12 02:27:51 EST 2011;Committer;kosaki;2;15;4;19;0
7e2f0491ce16d7f15660b0b01be9f23526aa07b9;Sat Nov 12 02:24:51 EST 2011;Committer;kosaki;3;32;2;34;0
fc7bb927a24ffe60c89f70a00bcc9bbab73ecff6;Sat Nov 12 02:17:41 EST 2011;Committer;kosaki;2;89;44;133;0
f13d10a0afeec1c6e66b4717fd9f12faeda515ff;Sat Nov 12 02:12:19 EST 2011;Committer;kosaki;2;8;5;13;0
eec252e2e520ed1297df6ca8deb089f29e384e2c;Sat Nov 12 02:09:56 EST 2011;Committer;kosaki;2;27;11;38;0
6ed2a4dfb3ffcb2191314a23e45f39075eb4bf6a;Sat Nov 12 02:06:28 EST 2011;Committer;svn;1;2;2;4;0
9d16ad639f49513b720e3afa6809eb98c0a6d609;Sat Nov 12 02:06:23 EST 2011;Committer;kosaki;2;30;10;40;0
db48bbdf0b4b8400d4ad0c1df5190d898fd9ed75;Fri Nov 11 14:01:25 EST 2011;Committer;akr;2;8;7;15;0
268f6c3680ca5895630f92025a66ba67c2a0c7e2;Fri Nov 11 12:14:23 EST 2011;Committer;akr;2;9;0;9;0
266d09839b436b2ecc1d95456db4771b5a8119db;Fri Nov 11 12:03:51 EST 2011;Committer;akr;2;10;3;13;0
6cedbce87d273b7fc8c6d4099434da370c063fb7;Fri Nov 11 09:42:02 EST 2011;Committer;nobu;2;24;19;43;0
214fd6ce775ea0f9b69d8dc8ea947fe785197953;Fri Nov 11 08:21:17 EST 2011;Committer;nobu;2;22;7;29;0
05e73548645fecf95494fee4f75f7f7713bf870c;Fri Nov 11 08:09:48 EST 2011;Committer;nobu;2;40;8;48;0
0d746627af624e1fca683b726ee2de86127fa16c;Fri Nov 11 03:41:13 EST 2011;Committer;kosaki;2;6;1;7;0
688e1b34a6877b7f4aeea9cd1dbf6698ce3652b3;Fri Nov 11 03:35:49 EST 2011;Committer;akr;1;1;1;2;0
da7cefb0f8ae4bb2a7e246cb9a71948236bab823;Thu Nov 10 23:35:39 EST 2011;Committer;svn;1;2;2;4;0
661a936e64449a4bdd2fd979e433cd93f66dd34e;Thu Nov 10 23:35:35 EST 2011;Committer;drbrain;2;19;4;23;0
e68f4ac7dc5a55c16e560fa7796bb9981ec6833d;Thu Nov 10 11:39:16 EST 2011;Committer;akr;1;2;0;2;0
6c9a235938ff60b6958e4cf2d4c066e99f010228;Thu Nov 10 06:43:46 EST 2011;Committer;nobu;1;9;4;13;0
fb1836ab4854d5da9f4600ef9053cae95f7ca577;Thu Nov 10 06:43:44 EST 2011;Committer;nobu;1;6;4;10;0
fc5f37f0e1cda9afc108e2bed5676714cb7d7028;Thu Nov 10 06:13:37 EST 2011;Committer;nobu;1;5;2;7;0
cfe220d8f390691f6c8e17f5c6554efbd450eb0a;Thu Nov 10 06:02:40 EST 2011;Committer;nobu;2;28;16;44;0
a5fc87bd5ba21f1704e566344653f6d9d381fa8f;Wed Nov 09 23:45:39 EST 2011;Committer;drbrain;2;13;0;13;0
b5167b481953b3057e6774c24dad829a70d67f10;Wed Nov 09 17:10:54 EST 2011;Committer;svn;1;2;2;4;0
871c6923dc32630e93f3483d9db1e547ac62a478;Wed Nov 09 17:10:48 EST 2011;Committer;kosaki;2;10;9;19;0
c88d35619b79eda6f56fd912af4ddee762db10f5;Wed Nov 09 14:23:04 EST 2011;Committer;nobu;1;1;1;2;0
1393e55d094b05ce688a5d2477980cf941e685f4;Wed Nov 09 14:20:27 EST 2011;Committer;nobu;2;6;2;8;0
42b4255d087ec64ae2ed48d51dd6fe103ce397f6;Wed Nov 09 13:54:33 EST 2011;Committer;nobu;2;5;1;6;0
3f289d9237dc9be556f3f5ca2606b9589f509379;Wed Nov 09 13:26:06 EST 2011;Committer;akr;1;2;1;3;0
7df246bd795c2c56dd976420bac0e7a94cf88a40;Wed Nov 09 13:15:12 EST 2011;Committer;usa;2;7;1;8;0
54cb63091d0fa0f4216b4a3b3312f1a062ecf26e;Wed Nov 09 11:08:15 EST 2011;Committer;usa;2;18;0;18;0
0c215e34dfc51e0757322c8ef17d421c6dfb07e4;Wed Nov 09 10:02:22 EST 2011;Committer;ko1;2;28;1;29;0
572e4807e6400e1f319d01ef88b1123d4c99efce;Wed Nov 09 07:43:08 EST 2011;Committer;usa;2;9;0;9;0
9cd8b76e6df560d1da61138e99eab76b7c3e1f6b;Wed Nov 09 04:26:39 EST 2011;Committer;ko1;3;27;2;29;0
b2c44e7af5b2eb17dc492dc2a2431cfe29b02d89;Wed Nov 09 02:40:39 EST 2011;Committer;nobu;2;11;6;17;0
b10c3136b0163536a679b10fecbc2992f3b5fa64;Wed Nov 09 02:06:49 EST 2011;Committer;naruse;2;5;1;6;0
e120e375774f9cb3f45e3275f03bfdf06c6b2a6e;Wed Nov 09 01:32:25 EST 2011;Committer;nobu;2;6;1;7;0
4c63e0274000d41e07cc11fdfa2bfe416ecda8db;Tue Nov 08 19:54:44 EST 2011;Committer;tenderlove;5;103;20;123;0
7bb2da2e2bf3526bbc7bcbde3a630c1215f76bd6;Tue Nov 08 17:13:07 EST 2011;Committer;svn;1;2;2;4;0
3d855def9e721d38976fe4c5707eb48b30740600;Tue Nov 08 17:13:03 EST 2011;Committer;naruse;1;3;0;3;0
0e4c2ce84111e538318e67ceb45c3a34e8394ed3;Tue Nov 08 14:34:39 EST 2011;Committer;nobu;4;95;24;119;0
4342469e8c5a32bc45b7748f5745b92b101901a1;Tue Nov 08 14:31:56 EST 2011;Committer;naruse;2;7;0;7;0
ebe0280253dd02965f8a33227ee8b7b8745de9b0;Tue Nov 08 14:26:51 EST 2011;Committer;nobu;2;77;55;132;0
ddb9acd9f83d28185a0e43fd7a4a3598157b99cf;Tue Nov 08 11:51:28 EST 2011;Committer;akr;3;66;24;90;0
c2c0707949d8b09441a46f7011cd4ed6bb5f9e86;Tue Nov 08 10:04:32 EST 2011;Committer;akr;2;68;64;132;0
4d36509054e578020de975e01167a8a041b2cf27;Tue Nov 08 09:02:59 EST 2011;Committer;nobu;1;3;0;3;0
6bb4ddcba58fa225d092223c33403a78441be5cc;Tue Nov 08 08:59:28 EST 2011;Committer;nobu;2;7;1;8;0
7c7514b206a0ac94f107395eef991d2eea4072a7;Tue Nov 08 08:30:53 EST 2011;Committer;nobu;2;8;0;8;0
452bf3b9c954d770ccb704cb9f5470f515e00584;Tue Nov 08 08:26:00 EST 2011;Committer;naruse;2;7;6;13;0
53881a8c6dc2ca658244d8f12952b732f98dd737;Tue Nov 08 05:52:32 EST 2011;Committer;usa;2;10;2;12;0
1b79efbb3945e59fb784a0ca23587e8ec5644777;Tue Nov 08 05:50:43 EST 2011;Committer;usa;1;20;0;20;0
ce19ae0ef0f830ad1781568abd097b9fb7ec0169;Tue Nov 08 02:03:57 EST 2011;Committer;naruse;2;8;2;10;0
bd3b3c1b51a7d6ca50d9391d77c5ef618166caa3;Mon Nov 07 21:01:40 EST 2011;Committer;akr;1;4;1;5;0
cb230eee021b07fa5bbf413f1ae944bd5e366e94;Mon Nov 07 17:48:17 EST 2011;Committer;svn;1;2;2;4;0
add77a592bee645aa6787130db384afc11482a04;Mon Nov 07 17:48:11 EST 2011;Committer;usa;3;94;16;110;0
4764756497ace72f8578ab886ae1e8b45c2def7c;Mon Nov 07 13:05:43 EST 2011;Committer;akr;2;8;0;8;0
733a57b878e1ac5f3639300947ee0c46cc0c690e;Mon Nov 07 12:16:10 EST 2011;Committer;akr;1;1;0;1;0
e115627a1846d2c15d1319e6399fa5f8d6e5cb61;Mon Nov 07 11:33:39 EST 2011;Committer;tenderlove;3;13;1;14;0
8ff37e390195f401d82cc8cfb607a3b2ddcba1ed;Mon Nov 07 11:27:27 EST 2011;Committer;tenderlove;2;8;4;12;0
a27349a4cb97f6db907388d5013100493f5dec73;Mon Nov 07 11:22:22 EST 2011;Committer;tenderlove;2;10;4;14;0
e4e5b7df4cca2cedba1ec2b52f75c450a0c618ce;Mon Nov 07 11:17:17 EST 2011;Committer;akr;3;35;0;35;0
66595f389473a4040e318fdfcc4b5d81cf8c2698;Mon Nov 07 11:08:39 EST 2011;Committer;usa;2;20;5;25;0
987c03a387fd0cb9cc4880bfffee51e5d18209e8;Mon Nov 07 10:44:02 EST 2011;Committer;akr;2;12;0;12;0
8c492668a7b31820918fe4f9768ee56d891bd96e;Mon Nov 07 10:27:19 EST 2011;Committer;usa;2;26;0;26;0
2522df965526dcbcdb632b66cc899570c2609e6c;Sun Nov 06 16:18:31 EST 2011;Committer;svn;1;2;2;4;0
ae1943bee9339e5f2c9a47cb7ac6c29de0f57bd8;Sun Nov 06 16:18:26 EST 2011;Committer;ayumin;2;7;0;7;0
5cb63654873fb7e6673a544f0cfba35378319f7f;Sun Nov 06 05:51:43 EST 2011;Committer;akr;4;23;10;33;0
600fcacc7551d9957feac8a32f7639dcc3fc49cd;Sat Nov 05 18:33:37 EDT 2011;Committer;emboss;2;27;0;27;0
273c900be84bea453a07b96896c426041180790c;Sat Nov 05 15:14:37 EDT 2011;Committer;svn;1;2;2;4;0
df334f5277548bb71877224f26531dba388b9805;Sat Nov 05 15:14:33 EDT 2011;Committer;akr;2;8;1;9;0
642562c707d3e53104f4088417761b783c744db5;Sat Nov 05 11:30:51 EDT 2011;Committer;duerst;2;22;18;40;0
333c847f19a0e9d53ab3021fed7517a5604d2bf4;Sat Nov 05 10:13:00 EDT 2011;Committer;akr;2;8;1;9;0
a3521e0261d229f8402cc84a018d2bc1a64fcc5a;Sat Nov 05 09:06:05 EDT 2011;Committer;akr;2;12;10;22;0
385a7d4594da0168c7e9cf031f1e4a9c6ff46e8c;Sat Nov 05 08:56:50 EDT 2011;Committer;akr;2;21;20;41;0
c3749b6a6da86243ca16ed058216114e71c184f3;Sat Nov 05 07:37:47 EDT 2011;Committer;ktsj;23;48;36;84;0
0e68c46e2dc4ae6603f9dd53a2048c6d8bddea10;Sat Nov 05 06:46:02 EDT 2011;Committer;akr;2;32;18;50;0
d05202a5969404e24ff83a99a23ab5e19a54b374;Sat Nov 05 02:19:52 EDT 2011;Committer;svn;1;2;2;4;0
df390d82f9c53ba2a3404dc09997bc8a46d716f9;Sat Nov 05 02:19:48 EDT 2011;Committer;akr;2;27;18;45;0
413f24d3b01ee6ceaf8b025cf64e05155689fdbe;Fri Nov 04 07:19:23 EDT 2011;Committer;nobu;14;34;34;68;0
ab682d95e077b43db7dfd293744aa546888d7e35;Fri Nov 04 05:12:31 EDT 2011;Committer;nahi;3;26;1;27;0
3463615a69288dd066df0579eea087737a6c6bf8;Fri Nov 04 00:33:11 EDT 2011;Committer;emboss;2;43;4;47;0
00bfe1940e10abdf646096aeb4e489f978c91411;Thu Nov 03 23:45:23 EDT 2011;Committer;emboss;3;43;11;54;0
3e6ea9306c2ef0dbab4f5284c51bb528d9ffee60;Thu Nov 03 19:55:43 EDT 2011;Committer;usa;2;7;0;7;0
a3ce319639f8ddae4e328fdd99f6a1f851c8a0f5;Thu Nov 03 19:06:43 EDT 2011;Committer;usa;1;2;1;3;0
102ec1171d94df9def66214dee1387a5f266dee9;Thu Nov 03 18:45:41 EDT 2011;Committer;usa;2;6;2;8;0
932d63efe08fc0d2a69ea81676508a62a2c981b2;Thu Nov 03 16:59:53 EDT 2011;Committer;usa;2;11;1;12;0
b2f90f4d511082c219ba446afce59d55d26d8280;Thu Nov 03 16:23:58 EDT 2011;Committer;naruse;2;17;2;19;0
21ab6bc3fa7f586a4605778e30730df21ce0b691;Thu Nov 03 15:54:19 EDT 2011;Committer;naruse;2;5;1;6;0
a3ace91f3e233a3f7b9db27e20d4496a9e0cfd24;Thu Nov 03 15:54:16 EDT 2011;Committer;naruse;2;6;4;10;0
dae4acbedd77ea7eb19127a43c6f66079fdbd0df;Thu Nov 03 15:19:28 EDT 2011;Committer;svn;1;2;2;4;0
5a2758ed1e59fcb6e2f2c75a2e7412485f34927e;Thu Nov 03 15:19:24 EDT 2011;Committer;usa;2;10;2;12;0
ac46d76ce83e8ccf5ec20ea0b671175dbeb0cdee;Thu Nov 03 13:50:55 EDT 2011;Committer;nobu;2;5;5;10;0
b45c882aec9d5d97261b11704c931c03f8d69639;Thu Nov 03 13:46:41 EDT 2011;Committer;akr;2;27;6;33;0
a0b22b1a39ec127d12689de200faf4addc2b5300;Thu Nov 03 13:14:48 EDT 2011;Committer;nagachika;2;14;1;15;0
8731a38bfff493437f831ad86c07266ae615aad4;Thu Nov 03 12:50:57 EDT 2011;Committer;nagachika;1;1;1;2;0
88f1b8cf0c286d5a499d0832cde5ff6be4105d89;Thu Nov 03 11:15:15 EDT 2011;Committer;akr;5;94;0;94;0
df6a0fe8bb0d41634689af8dcbee2c3e5eed4818;Thu Nov 03 10:55:26 EDT 2011;Committer;akr;1;6;2;8;0
cead180d3f97cc8e519e338d15899d00b1d439a7;Wed Nov 02 23:42:31 EDT 2011;Committer;svn;1;2;2;4;0
576454a432559b43840f4827841d3c82d37e3458;Wed Nov 02 23:42:10 EDT 2011;Committer;emboss;2;7;0;7;0
292b3e4113eb1258119c0afe5834c8fc8a7f018c;Wed Nov 02 12:36:06 EDT 2011;Committer;nobu;3;7;1;8;0
c852d76f46a68e28200f0c3f68c8c67879e79c86;Tue Nov 01 23:17:53 EDT 2011;Committer;akr;3;8;2;10;0
aea9c733e83800909730871bdf6b1bf48016846d;Tue Nov 01 15:52:48 EDT 2011;Committer;ayumin;3;14;8;22;0
ebbd0df5ece8a597caa5630620fc6a089a06c5ea;Tue Nov 01 15:21:54 EDT 2011;Committer;svn;1;2;2;4;0
8188057b58c738989a39a98fe8030a05d82dea65;Tue Nov 01 15:21:50 EDT 2011;Committer;shugo;2;7;2;9;0
b9a7f8b44c26b2d978bbcf33e67ecc1337573944;Tue Nov 01 13:08:30 EDT 2011;Committer;nobu;2;9;0;9;0
f0bd6396933c38a59167180c03b1ee6c86692932;Tue Nov 01 12:43:47 EDT 2011;Committer;naruse;2;6;6;12;0
809006f407147d6788d785e86590a79603110a38;Tue Nov 01 10:49:40 EDT 2011;Committer;akr;2;6;1;7;0
89a1258110b72b700016ea09cbd7b73c3a875dea;Tue Nov 01 10:01:01 EDT 2011;Committer;akr;2;5;0;5;0
c882b8e84d4a3398671b0387c1294d9807a89b0b;Tue Nov 01 08:17:59 EDT 2011;Committer;naruse;2;5;0;5;0
f9269809027806f3b41ad73207721bd8adb35650;Tue Nov 01 05:56:51 EDT 2011;Committer;naruse;3;8;2;10;0
cd3445ca6e9dde2603d5a6787274b5baac487bdb;Tue Nov 01 04:31:52 EDT 2011;Committer;naruse;2;31;9;40;0
b7d397348e6bf508bf337ec9c1c2d88d1cbfa84a;Tue Nov 01 03:37:01 EDT 2011;Committer;akr;2;8;1;9;0
1bbae2431ff1746cbc8fee66df69131f0e2d7294;Tue Nov 01 03:04:53 EDT 2011;Committer;akr;1;5;0;5;0
c16f98ab0a4976998d7ff35ffbbb4f3ca110439b;Tue Nov 01 03:04:03 EDT 2011;Committer;akr;4;32;14;46;0
632f448827347626d0c8d1ceef234b00984ce7a4;Tue Nov 01 00:42:41 EDT 2011;Committer;naruse;1;1;1;2;0
5dbc3d1e7919f1ee2058baec9555684ee0babed0;Mon Oct 31 23:26:19 EDT 2011;Committer;akr;3;37;2;39;0
24176a8d5d98ea7d1eb3971ffb7fad7f9ccd2adb;Mon Oct 31 23:24:25 EDT 2011;Committer;akr;1;2;2;4;0
7ae60a6b0d529ba04b8b59d3e5a58320a54b5878;Mon Oct 31 22:32:49 EDT 2011;Committer;akr;3;19;2;21;0
ee5ae134dd1c0037a36b2e0c78cd4e326d002c3a;Mon Oct 31 21:01:18 EDT 2011;Committer;akr;2;31;5;36;0
17f068b6a676892082b0e8defefbbb8c8297902c;Mon Oct 31 18:05:07 EDT 2011;Committer;svn;1;3;3;6;0
9b8aca6ae56e7b164c919e11adb3c035375a794e;Mon Oct 31 18:05:03 EDT 2011;Committer;usa;2;23;7;30;0
8ce4a284e438bf1b5a652a7d27db84f24fb742ff;Mon Oct 31 14:49:57 EDT 2011;Committer;akr;2;21;5;26;0
1a8fbff3dbbddf3c0d4e58d0f7da9ad1eb0e2025;Mon Oct 31 14:38:50 EDT 2011;Committer;akr;2;26;3;29;0
6a96646de2bbbe24f8d6c0bd3c31374012ae419e;Mon Oct 31 13:50:32 EDT 2011;Committer;naruse;1;1;1;2;0
ca6311b0b50341f55993e47f2323af55be4d0ebb;Mon Oct 31 13:21:03 EDT 2011;Committer;naruse;2;11;0;11;0
a16c2745fe843d41bf2046e8362e6963c604e5a8;Mon Oct 31 13:07:26 EDT 2011;Committer;akr;2;11;4;15;0
1a70dfe6f4750a577b889a568527a07ed540d43c;Mon Oct 31 12:49:16 EDT 2011;Committer;akr;8;35;18;53;0
6533f070ba616662b7ab7504f7bc2a0827394a89;Mon Oct 31 12:03:49 EDT 2011;Committer;akr;3;14;5;19;0
687c41dc4d03ba77cd5c286ab721ce56100120e7;Mon Oct 31 11:17:15 EDT 2011;Committer;akr;2;39;40;79;0
c4dd8ca7b36056a2aa08eaa454a8dbd0d8420a55;Mon Oct 31 10:15:27 EDT 2011;Committer;akr;2;8;2;10;0
b2a1af15474219c75d2447b0213e20f1e60b3dc1;Mon Oct 31 04:16:11 EDT 2011;Committer;usa;3;98;18;116;0
92a8bfacd9e22062bf30ca4cb996af8f5e25b7b5;Mon Oct 31 03:39:01 EDT 2011;Committer;akr;2;15;1;16;0
da5ae5544d4abd95b94df303018684847e1d88f8;Mon Oct 31 03:07:26 EDT 2011;Committer;akr;2;26;14;40;0
bdc85361e48340b4f9d6b1039a8c338a2cb64138;Mon Oct 31 01:52:21 EDT 2011;Committer;usa;2;13;0;13;0
0bbb8e8975ad9f00d467218098dd2d6ad8895974;Sun Oct 30 15:51:33 EDT 2011;Committer;luislavena;2;11;0;11;0
64d4f3a45add6734793f19599c5eae4c0080ba56;Sun Oct 30 15:17:32 EDT 2011;Committer;svn;1;2;2;4;0
5c19f077008f6e6633e15a8d15fceb4b17d37208;Sun Oct 30 15:17:27 EDT 2011;Committer;akr;4;27;4;31;0
e7f8c03818873b7cd64cb5080fe329098352af6c;Sun Oct 30 13:48:35 EDT 2011;Committer;akr;3;25;1;26;0
a3efca16a12044b46f0e305ddcacfe6d412afcca;Sun Oct 30 13:34:04 EDT 2011;Committer;akr;2;9;3;12;0
0d2a92e0b327bd69781dd51f34278e843d5f0b74;Sun Oct 30 12:13:05 EDT 2011;Committer;akr;4;37;21;58;0
6e0ed044b6d7e8247a49e85d622eab9f128dbdba;Sun Oct 30 11:07:09 EDT 2011;Committer;akr;2;11;8;19;0
7c43d8523cadf8cd0483581fb8a50138b7fc4d9f;Sun Oct 30 09:46:56 EDT 2011;Committer;akr;2;36;0;36;0
d67ac15c86e14eec076acfc03a2224714a642ea7;Sun Oct 30 01:50:38 EDT 2011;Committer;nobu;2;7;2;9;0
54816d10eb5decfaec4155646f7aecc4f96311eb;Sun Oct 30 01:47:23 EDT 2011;Committer;nobu;2;11;0;11;0
f0b021c0cef7adbbca2574ceba4be6abacbdaf90;Sun Oct 30 01:02:46 EDT 2011;Committer;akr;2;11;2;13;0
e745a03cfa60074b6d9569491f5932a74ee20e1b;Sat Oct 29 23:30:34 EDT 2011;Committer;akr;2;6;1;7;0
503e5c975011ef9ad6f30431920c91e1e9f384e0;Sat Oct 29 22:48:45 EDT 2011;Committer;svn;1;2;2;4;0
cb9f3040d7020fcac74f292eba810081b73b195e;Sat Oct 29 22:48:41 EDT 2011;Committer;akr;3;23;1;24;0
71804183a368342b45e288bb2d6f7da8d69fd75f;Sat Oct 29 14:56:13 EDT 2011;Committer;ktsj;1;1;1;2;0
0a9cb21e6215e50cb1d81f9f984a09b2b09176c1;Sat Oct 29 13:11:01 EDT 2011;Committer;akr;3;23;4;27;0
195fbd18d61c336b510f63ea83dbf6483523aee2;Sat Oct 29 12:08:47 EDT 2011;Committer;arton;2;28;19;47;0
54d7e82613237819c0a5c484d94c097ff068c259;Sat Oct 29 11:59:46 EDT 2011;Committer;akr;2;20;0;20;0
a9648d1e58260d35438d759dccf81cc45be9b45e;Sat Oct 29 11:58:30 EDT 2011;Committer;akr;1;1;0;1;0
4ae2b92576e8e9fc43906e9483c79eff9d0522f7;Sat Oct 29 11:02:32 EDT 2011;Committer;akr;5;28;7;35;0
3bffb5f3064b129941a2cf6f459aeb85e8469ea7;Sat Oct 29 07:12:09 EDT 2011;Committer;akr;2;7;0;7;0
baa2d74daea424a7e28cf659e9d3a1fd05a7ff3e;Sat Oct 29 05:27:32 EDT 2011;Committer;akr;2;7;0;7;0
da74bc75523ef4054030e5f3cf4aac3e9bfe8715;Sat Oct 29 04:01:54 EDT 2011;Committer;akr;7;50;33;83;0
3ae3cd741d4ac85e2cd53c588318afb582412fd9;Sat Oct 29 02:33:28 EDT 2011;Committer;akr;3;33;3;36;0
d498620a7b70ea8adbc6d6ba0f1ab29943638b72;Sat Oct 29 00:06:05 EDT 2011;Committer;nobu;1;1;1;2;0
b9c3a33b4062ec130759f82db090bc0095141be4;Sat Oct 29 00:05:15 EDT 2011;Committer;svn;1;2;2;4;0
2fd8753bde9c7c190cbd91adfb331da4f13e932d;Sat Oct 29 00:05:11 EDT 2011;Committer;nobu;2;10;0;10;0
27295f104a348d914815566f08bf9a57f72cf77c;Fri Oct 28 13:25:05 EDT 2011;Committer;akr;1;1;1;2;0
769fcd704800aa37380e711559c04e366afcc7ef;Fri Oct 28 13:06:16 EDT 2011;Committer;akr;2;4;8;12;0
96031a6d4ebb395b3581d812cf98d5db8a36fee1;Fri Oct 28 03:11:06 EDT 2011;Committer;naruse;1;4;0;4;0
615d5068d29ec07464c8057e15556d0c1df70187;Fri Oct 28 02:30:22 EDT 2011;Committer;naruse;2;5;0;5;0
509ed0d94fea08f9e08767ddfa8564b9f9237c88;Thu Oct 27 21:07:23 EDT 2011;Committer;akr;2;31;0;31;0
a5a7e2cd91173f12eb0007f8a55f36b84a3fab13;Thu Oct 27 18:02:42 EDT 2011;Committer;tenderlove;2;9;0;9;0
344191d18ef6bf7369122c58b9836f4ab3571e9a;Thu Oct 27 15:11:13 EDT 2011;Committer;svn;1;2;2;4;0
f8751046b8b0a37b6257efcbb2f5aa082346719d;Thu Oct 27 15:11:06 EDT 2011;Committer;akr;2;25;17;42;0
c1de5660711505d9f381d562596b3b06407766e1;Thu Oct 27 09:28:21 EDT 2011;Committer;nobu;2;14;2;16;0
723038b0ba1a6fac881ceacdfc0ff01375eedc10;Thu Oct 27 07:10:53 EDT 2011;Committer;nobu;3;11;1;12;0
e344d8a48388a213e4dd404b128769c5dccbf11a;Thu Oct 27 07:10:49 EDT 2011;Committer;nobu;1;28;12;40;0
1b4e1375374c37d092d069b887fca61e53701ad8;Thu Oct 27 05:56:24 EDT 2011;Committer;nobu;2;11;14;25;0
9598856e868be10661ac5aff827ef39f14e2aa2d;Thu Oct 27 05:55:29 EDT 2011;Committer;nobu;2;12;4;16;0
bafe8376581b62e7ce9a87455d376809b7607fdd;Thu Oct 27 00:59:46 EDT 2011;Committer;naruse;2;21;0;21;0
2b7bbe18b3528e30ed13339e1808536ad1196805;Wed Oct 26 23:49:49 EDT 2011;Committer;emboss;2;4;1;5;0
ca05a2afbfd9a6372b093d784a6f31fae7e7c236;Wed Oct 26 23:43:09 EDT 2011;Committer;svn;1;2;2;4;0
4fe2dacee7657a381a5ff6fc3b0bffa658b08731;Wed Oct 26 23:43:04 EDT 2011;Committer;emboss;2;12;4;16;0
e15e5251c3efb9e54b6dc9571672a0c8d7984c59;Wed Oct 26 06:24:33 EDT 2011;Committer;svn;1;2;2;4;0
cba2e89cdc2e48f865f0a3a68f8d0ebd2ae1d69c;Wed Oct 26 06:24:29 EDT 2011;Committer;nobu;3;18;1;19;0
49f6242b34f1daf9591b262c48723b7f2e7883d3;Tue Oct 25 12:54:21 EDT 2011;Committer;akr;3;15;6;21;0
06a8e95fb414a4142cab8f04172b80da8baec98d;Mon Oct 24 21:35:10 EDT 2011;Committer;svn;1;2;2;4;0
430f4da042f9c49840d4607fdc20ebccd348676a;Mon Oct 24 21:35:05 EDT 2011;Committer;drbrain;2;11;5;16;0
2bb5441808b95926697799de2ab2d2675c89084e;Mon Oct 24 14:57:08 EDT 2011;Committer;akr;6;20;6;26;0
b317a4cd28f575b60cdff0da86afef5c1bde9a06;Mon Oct 24 13:49:58 EDT 2011;Committer;akr;5;24;12;36;0
5153fd2a5e930b70ebae087e2f6e254cf4a30929;Mon Oct 24 13:40:13 EDT 2011;Committer;akr;2;23;0;23;0
be561cbebedeb3a5c8cf164a488c56ffd412d894;Mon Oct 24 11:08:52 EDT 2011;Committer;akr;1;1;1;2;0
9a82672ce294d85571f5ec470bef76f765bc32f4;Mon Oct 24 06:41:57 EDT 2011;Committer;naruse;1;2;2;4;0
530160d6059bd882d026fa0d503c1fae6a5fd5b6;Sun Oct 23 23:19:21 EDT 2011;Committer;svn;1;2;2;4;0
a28fe36c89cca3ae402f657f6bb8ebf038c23175;Sun Oct 23 23:19:14 EDT 2011;Committer;akr;3;31;1;32;0
b062e60805c9be8c6267d3ad17bd5fbd0c0c8a83;Sun Oct 23 09:22:59 EDT 2011;Committer;ktsj;2;5;1;6;0
bb98e0ecec27318f376e487f8c7e2e8852802967;Sun Oct 23 09:03:33 EDT 2011;Committer;nobu;2;9;4;13;0
d332891fddbcf9d319369968b5898b294742343b;Sun Oct 23 07:51:10 EDT 2011;Committer;ngoto;2;7;0;7;0
965dba4faaeadb4e3fa8bfbf3e7895cb6246dc49;Sun Oct 23 07:39:56 EDT 2011;Committer;ayumin;2;6;1;7;0
fc024f1919bbf232bb1ada8e2090aadeff1fc13a;Sat Oct 22 23:03:13 EDT 2011;Committer;svn;1;2;2;4;0
e7ff29581b10da03be7b83f5e99e31e380573fd7;Sat Oct 22 23:03:02 EDT 2011;Committer;akr;2;8;0;8;0
df8126f9e3728771fa7d0dc319a14d9d33d505c5;Sat Oct 22 11:35:58 EDT 2011;Committer;akr;2;17;14;31;0
b574a4d4a1f1d77fa0224b02774456107cdbc932;Sat Oct 22 09:58:15 EDT 2011;Committer;akr;18;133;46;179;0
00715f4c5aa12eec0dd88fb08bc7f46d23de8d40;Sat Oct 22 08:50:50 EDT 2011;Committer;akr;1;5;0;5;0
931226061b8fc437f8c706b67343ae7a6e25f26a;Sat Oct 22 08:47:13 EDT 2011;Committer;akr;2;5;1;6;0
16f4ecbc8cb83f0cadf02eb254623c27ea1946f1;Sat Oct 22 08:46:12 EDT 2011;Committer;akr;3;59;1;60;0
f600a558e03976679a9b8e5c24e14bb9c7d70916;Fri Oct 21 17:35:05 EDT 2011;Committer;svn;1;2;2;4;0
971769cd7632cd13be53c9c2e777b7f6810bfd4b;Fri Oct 21 17:34:58 EDT 2011;Committer;ngoto;3;22;8;30;0
cb2a69d883469d8929892facb6c48059bdfac3dd;Fri Oct 21 13:02:19 EDT 2011;Committer;nobu;2;22;5;27;0
fd807aa2ea743a8bc95f08fa8eb7fd137f21f14a;Fri Oct 21 13:01:37 EDT 2011;Committer;nobu;2;7;7;14;0
b073b5347bc90a6786f1cdea32bcfce69430ea1b;Fri Oct 21 03:26:11 EDT 2011;Committer;ngoto;2;6;1;7;0
9c223dd57301fc28ab5a42db429f27f3cebda80c;Thu Oct 20 17:22:14 EDT 2011;Committer;svn;1;2;2;4;0
b878cfa971870065e5a47cbe54758fe641a1cbf4;Thu Oct 20 17:22:09 EDT 2011;Committer;emboss;3;128;3;131;0
402c8cf9d1f67e326f41dc003f3d9ca6924810ec;Thu Oct 20 13:55:31 EDT 2011;Committer;usa;2;84;32;116;0
98490d1f71a6d7072c8bf439a88e08c3762b27dd;Thu Oct 20 13:48:21 EDT 2011;Committer;emboss;2;100;7;107;0
67db3f817712f26fd812b8b159a1642761b71ecc;Thu Oct 20 12:35:23 EDT 2011;Committer;ngoto;1;1;0;1;0
a1d308456d5506c809c8fcabfb41e1861d832999;Thu Oct 20 12:30:13 EDT 2011;Committer;ngoto;2;9;1;10;0
9c49753182f2fc5e8d8e26c93c3e47ccfe85dba7;Thu Oct 20 04:09:37 EDT 2011;Committer;nobu;2;6;1;7;0
359e7979d5815626bf13f5ce1ca5e194170d990b;Thu Oct 20 03:32:36 EDT 2011;Committer;emboss;2;102;0;102;0
72cbec3f6d5335d0119c859df53c459e16bc9df9;Thu Oct 20 02:42:26 EDT 2011;Committer;nobu;4;140;23;163;0
2e32ad816398bba5557e4e5bbd7fa50b5d96aced;Wed Oct 19 21:05:05 EDT 2011;Committer;drbrain;2;20;2;22;0
9bec8ef50ce1858ee2070a1637447eb12ce89990;Wed Oct 19 20:34:21 EDT 2011;Committer;ryan;8;119;24;143;0
9cfc7a658f1e6f97fd88ee69310f4ccc5f20d73c;Wed Oct 19 20:05:25 EDT 2011;Committer;svn;1;2;2;4;0
65ca601ba6de9b63b6d0507788ffa411d4d85908;Wed Oct 19 20:05:21 EDT 2011;Committer;emboss;3;42;1;43;0
1a2f635761680408dceadcb79787e17b73680e94;Wed Oct 19 11:20:41 EDT 2011;Committer;nagachika;1;2;2;4;0
6b8d4ab840b2d76d356ba30dbccfef4f5fd10767;Wed Oct 19 08:07:34 EDT 2011;Committer;matz;2;5;1;6;0
34fb36422d4eb024d9c55095bffe2f19b248c893;Wed Oct 19 02:52:38 EDT 2011;Committer;drbrain;2;43;8;51;0
62bd3dd4af5ac017a05e250293abe9e5c87a1193;Wed Oct 19 02:32:39 EDT 2011;Committer;drbrain;2;37;0;37;0
2a4ce0757d691199ea65ca36d59803280ff1b42a;Wed Oct 19 02:07:50 EDT 2011;Committer;drbrain;2;182;177;359;0
e4af86d6315e377b47aa50c3b8b27d0d35c1d980;Wed Oct 19 01:15:41 EDT 2011;Committer;svn;1;2;2;4;0
c35204f7bdd821feb2d73782e3a56a3c822d6150;Wed Oct 19 01:15:35 EDT 2011;Committer;emboss;6;24;11;35;0
12c497dcf68ea7e1f75b2ba100e09b9f133eafe2;Tue Oct 18 14:28:58 EDT 2011;Committer;nobu;3;10;5;15;0
eb21db77c06f82f9b0e6c878fad5e2e3a591886e;Tue Oct 18 14:07:32 EDT 2011;Committer;nobu;2;6;1;7;0
560a6c6ffa187f764cb5d81a7d27cb7a84a13c02;Tue Oct 18 14:05:51 EDT 2011;Committer;nobu;4;30;16;46;0
1a3f365c504650ed51f5c5f284b60fe94fafeca4;Mon Oct 17 17:34:01 EDT 2011;Committer;svn;1;2;2;4;0
673448c27d46e84a49dacc2ce2a7f10a041f39b9;Mon Oct 17 17:33:57 EDT 2011;Committer;xibbar;1;1;1;2;0
4db3466357f3a6d89aac94a24c31de6aa99e89a8;Sun Oct 16 10:47:25 EDT 2011;Committer;svn;1;2;2;4;0
e6ce15c68a35f53b26a4b86a74e6857bad1adad7;Sun Oct 16 10:46:30 EDT 2011;Committer;nobu;3;12;2;14;0
6d7df91c24dea505d1003d06a213ce886f6e575d;Fri Oct 14 13:54:30 EDT 2011;Committer;nagachika;1;1;1;2;0
039f12b5bb7bec277706f76183a91632c3f1105c;Fri Oct 14 03:14:00 EDT 2011;Committer;nobu;3;38;1;39;0
3a0e582e1fbeef0ab7ef7af8c94e4b711331259a;Fri Oct 14 02:19:39 EDT 2011;Committer;nobu;2;5;0;5;0
4f731db7b783337ad3f1a6e05e8ae21a8eaa1231;Thu Oct 13 21:16:46 EDT 2011;Committer;nobu;1;3;3;6;0
f3a62db7a4f550aff38b2a968c79a0204de71dd5;Thu Oct 13 20:58:12 EDT 2011;Committer;svn;1;2;2;4;0
c96c193e1d8d6ec45749c8ab49e5be99771fab7c;Thu Oct 13 20:58:08 EDT 2011;Committer;nobu;3;12;3;15;0
5558de40b6344f5bdba783b170a54df80f4b4e6d;Thu Oct 13 10:39:58 EDT 2011;Committer;ngoto;2;15;0;15;0
123645aab61c07fb3c64e3f2ea771cb74f53ff64;Thu Oct 13 09:19:10 EDT 2011;Committer;kosaki;2;7;2;9;0
09d18bec58d7a3359e09bb14b34e6410fdb49ddd;Thu Oct 13 09:04:33 EDT 2011;Committer;svn;1;2;2;4;0
c180eabf8f0c818ca1f8fcdca424588b8daf5bb3;Thu Oct 13 09:04:29 EDT 2011;Committer;nobu;2;8;2;10;0
9f3f24e22a8c4916b23fe17d8b7f5f0caa2ced75;Wed Oct 12 14:41:23 EDT 2011;Committer;svn;1;2;2;4;0
a31495b1700e828b9fb9cd7d5ce3b6c8dbe9e8c4;Wed Oct 12 14:41:19 EDT 2011;Committer;nahi;3;42;50;92;0
48cbe2025fd062081d3528f2c06e94b580298b15;Mon Oct 10 23:50:02 EDT 2011;Committer;drbrain;2;78;42;120;0
06e3f3495a9d7b0b9152fcd4611cbdc4eca0c126;Mon Oct 10 22:55:54 EDT 2011;Committer;drbrain;2;248;16;264;0
627c179a99856b6aab653586849145eec3c7b8e6;Mon Oct 10 21:10:02 EDT 2011;Committer;drbrain;2;26;22;48;0
ccec5b49ca8dee413c0e6cd205c21b44eb30c015;Mon Oct 10 21:06:39 EDT 2011;Committer;drbrain;2;13;5;18;0
55b3a88bb5aa2bc9fe2907f69d0ffd9cec12b87b;Mon Oct 10 20:54:49 EDT 2011;Committer;svn;1;2;2;4;0
ee8fd5f1972735020f42b3ef74880540347721cc;Mon Oct 10 20:54:45 EDT 2011;Committer;drbrain;2;25;7;32;0
91e013c70957cbbac6bc60c7f7072cfb68e5bf5f;Sun Oct 09 02:18:22 EDT 2011;Committer;svn;1;2;2;4;0
a30fd3b6604237ef112412928a9c077886415854;Sun Oct 09 02:18:18 EDT 2011;Committer;ktsj;3;25;10;35;0
82f1f640ec4a59bd77cde7fee509080828406835;Fri Oct 07 23:55:41 EDT 2011;Committer;drbrain;2;8;3;11;0
ee1acd6a83d1802c272802c69db5e9965ea9ead6;Fri Oct 07 18:21:06 EDT 2011;Committer;svn;1;2;2;4;0
92af97c6074aa7d20776bfc68d5bccfc2222de4b;Fri Oct 07 18:21:01 EDT 2011;Committer;drbrain;2;29;0;29;0
d5e7b3972c8a9aec4ad828abf4f7a1a7e3024d9b;Fri Oct 07 11:29:37 EDT 2011;Committer;nobu;1;2;2;4;0
881891fb2f2762c321ba128f50d1717ce5b1fc48;Fri Oct 07 08:57:42 EDT 2011;Committer;nobu;3;125;91;216;0
e50c05f7f623404aaa1772c4421f4983527e239f;Fri Oct 07 08:54:30 EDT 2011;Committer;nobu;2;7;2;9;0
291bf9add0affcb2adfc439a5f309d9ebdfab890;Thu Oct 06 21:36:22 EDT 2011;Committer;svn;1;2;2;4;0
06336140a449ea88be28173e0a6d81d16f4d11d9;Thu Oct 06 21:36:17 EDT 2011;Committer;drbrain;2;97;96;193;0
171c708b0c862ee92d6a46ac9def97193954638b;Thu Oct 06 11:51:55 EDT 2011;Committer;kazu;4;12;6;18;0
89fef02f1305887d97ddcf96cc4df9109ce414e2;Thu Oct 06 07:29:33 EDT 2011;Committer;nobu;8;138;22;160;0
60d83c5da49aade87ee4a45ca777637000f60cfb;Thu Oct 06 05:59:35 EDT 2011;Committer;drbrain;2;76;58;134;0
8f6cb4b4738027a20228f4731e8731b7bc29fef4;Thu Oct 06 01:01:22 EDT 2011;Committer;drbrain;2;9;5;14;0
e2974b1a4b3263c8c66581f6e3943c193b1e2d3b;Thu Oct 06 00:57:06 EDT 2011;Committer;drbrain;2;20;19;39;0
9edfa89744eae3aa286f6bb746fe16fdc6dd42af;Thu Oct 06 00:17:41 EDT 2011;Committer;drbrain;2;12;8;20;0
0d900cecdfdaa833ab436863bbf2c3dac464d608;Thu Oct 06 00:14:55 EDT 2011;Committer;drbrain;3;206;48;254;0
f365f19054cefe6b95041d3111edc37117f3e2cb;Wed Oct 05 23:54:33 EDT 2011;Committer;drbrain;2;134;72;206;0
2e35340cf6b5013d1804d7ec1f09efca3283dcee;Wed Oct 05 16:49:34 EDT 2011;Committer;nagachika;1;1;1;2;0
c9d81ed7b37d59c346e456f692a1d0c970aea72b;Wed Oct 05 16:47:39 EDT 2011;Committer;svn;1;2;2;4;0
257d0ac80cabb8a940effee08fb0426dd533be46;Wed Oct 05 16:47:33 EDT 2011;Committer;nagachika;2;6;0;6;0
0a5ac6a44809ec32ae6e836086708a64112bcfd0;Wed Oct 05 07:36:28 EDT 2011;Committer;naruse;3;4;63;67;0
6340d6336a41c00577f4c5c1060a779220681ca1;Wed Oct 05 07:35:31 EDT 2011;Committer;naruse;2;4;4;8;0
a635de7dcbc14a1f59fbcf07122c6bce1fb21673;Wed Oct 05 07:35:27 EDT 2011;Committer;naruse;3;63;4;67;0
6f8f555d2f8d46a4358d3aecdc6914022c20c5cb;Tue Oct 04 20:57:07 EDT 2011;Committer;drbrain;2;67;6;73;0
9654a4c9855d2dff19dbc2e446949b43e31dcd3d;Tue Oct 04 20:48:34 EDT 2011;Committer;drbrain;2;12;0;12;0
137c547c3ef8167630170275ba2ae5a14fa0af95;Tue Oct 04 17:53:41 EDT 2011;Committer;tenderlove;4;62;6;68;0
77e58a3398cde8a0e9b0cb07ffe20e6137efe41c;Tue Oct 04 16:53:14 EDT 2011;Committer;tenderlove;2;7;2;9;0
fccfc4f7de195db7b690cb17673c8942a8175fce;Tue Oct 04 16:25:02 EDT 2011;Committer;svn;1;2;2;4;0
b7c66e31de87dc6f4b1b8666f44b2487b1c0b3b8;Tue Oct 04 16:24:58 EDT 2011;Committer;tenderlove;2;14;2;16;0
92a05ea2cf375e415ddd420243d0e38801708f8a;Tue Oct 04 12:10:09 EDT 2011;Committer;nobu;3;10;2;12;0
0688c81a89e506f426df8b58cb57a706477bf95c;Tue Oct 04 09:44:08 EDT 2011;Committer;naruse;2;2;6;8;0
4eb497d90b0d439458e7f34046bbe41d38e4c06a;Tue Oct 04 07:37:11 EDT 2011;Committer;naruse;3;13;3;16;0
bf8168cf334e45ce6e93fa5aedc74ab7ca4069f3;Tue Oct 04 06:04:46 EDT 2011;Committer;nobu;2;6;2;8;0
e6c2da74e6e6aea10035df83ac77fbb21a75b4f4;Tue Oct 04 05:17:45 EDT 2011;Committer;kazu;1;4;4;8;0
356c7cbfb64bc3b7bf5c49c0537065f6ac8bb1c2;Tue Oct 04 02:44:55 EDT 2011;Committer;naruse;3;9;3;12;0
f65cdf797f514a7b7897ae5e5dc8aeafa42df96b;Tue Oct 04 01:25:04 EDT 2011;Committer;naruse;1;1;0;1;0
14f878aed60a62b24535983c136a8eb5e59030b8;Mon Oct 03 23:33:57 EDT 2011;Committer;drbrain;2;27;4;31;0
6be866e2621c543b710da3ece25d32ce861ece02;Mon Oct 03 23:23:24 EDT 2011;Committer;drbrain;2;20;9;29;0
983476fbab9a769532f38da5692e7c5e4390f1c7;Mon Oct 03 23:16:11 EDT 2011;Committer;drbrain;2;14;8;22;0
b7ea625bd6f04457ffb15e2f423e58539dd56a13;Mon Oct 03 22:59:45 EDT 2011;Committer;drbrain;2;19;12;31;0
b4d3400ed64aa5b6fe1be522a254c22206f755c5;Mon Oct 03 22:43:59 EDT 2011;Committer;drbrain;2;8;3;11;0
cb014763c6c38e282f6f4528f8104ed9048fe4b8;Mon Oct 03 22:35:49 EDT 2011;Committer;drbrain;2;16;10;26;0
aec0f808bc79c6964632cf1385bf8c61888b66fd;Mon Oct 03 22:31:25 EDT 2011;Committer;drbrain;2;11;7;18;0
90dfc8f99e774e5ed71b4ed09a14bb75febca936;Mon Oct 03 22:15:47 EDT 2011;Committer;drbrain;21;107;100;207;0
9167328359b472b7aacd1afda2118cff702d3d3a;Mon Oct 03 21:44:38 EDT 2011;Committer;tenderlove;3;21;19;40;0
1c60db55ac07b238d9d4e1443f5b6f8dd1fa9da0;Mon Oct 03 21:31:43 EDT 2011;Committer;tenderlove;6;27;17;44;0
bd3b0d470c12fbdb48efcdb310d00eaa0fea84e5;Mon Oct 03 21:21:31 EDT 2011;Committer;tenderlove;3;31;1;32;0
1721fca3ada1c19211b01d7c8b18dac5e509fc0e;Mon Oct 03 21:00:50 EDT 2011;Committer;tenderlove;3;12;5;17;0
bdadd499402bc12749758ded92588f3f36d04dda;Mon Oct 03 20:49:19 EDT 2011;Committer;tenderlove;3;32;5;37;0
aee487367ae52afe43b145e4ce645af21640dea6;Mon Oct 03 15:03:04 EDT 2011;Committer;svn;1;2;2;4;0
3973e70d92aa2148edf05180f347c188fa9f0642;Mon Oct 03 15:02:58 EDT 2011;Committer;nagachika;3;23;4;27;0
3e6a5b27f02ca51ae3502f64575937aa6c34dcdc;Sun Oct 02 12:08:40 EDT 2011;Committer;ktsj;2;6;1;7;0
051aa44240da6b563ed89410e054b0d5e7900bdf;Sun Oct 02 03:18:39 EDT 2011;Committer;ayumin;3;63;0;63;0
9bb327f1329dbb875868b8a58fde516fcc7db5ef;Sun Oct 02 02:29:27 EDT 2011;Committer;tenderlove;2;10;10;20;0
02e4428ec537211c28ae053ceac2e3442437f463;Sun Oct 02 01:56:51 EDT 2011;Committer;ktsj;2;6;2;8;0
5e7ff0511e4e631af771cf67534ce1dec5ff047a;Sun Oct 02 01:27:00 EDT 2011;Committer;nobu;1;9;0;9;0
49cc468ad4393872b5407ca89991b49a7b82bcea;Sun Oct 02 01:03:30 EDT 2011;Committer;nobu;2;6;1;7;0
bc07265ceb9ca1c2d9329e614240b6ada4ff2b5c;Sat Oct 01 23:48:48 EDT 2011;Committer;ktsj;3;7;2;9;0
a9dae873234dd4a4f71c32dd638dae95ceda017b;Sat Oct 01 15:47:46 EDT 2011;Committer;svn;1;2;2;4;0
91e190dbc26e68ccee57bb8a1847385cd019255a;Sat Oct 01 15:47:42 EDT 2011;Committer;ktsj;2;6;0;6;0
3d2451d99651a0f0a3c1ecd2c12b5a1264b4b6b9;Sat Oct 01 01:00:40 EDT 2011;Committer;nagachika;4;29;2;31;0
0003d051dd161d26e4df67313de912e89479c2d5;Fri Sep 30 19:50:38 EDT 2011;Committer;nobu;1;16;16;32;0
817980fb4ccb443b60d1a2d880273b16dba49fb1;Fri Sep 30 19:50:30 EDT 2011;Committer;svn;1;3;3;6;0
f212df564a4e1025f9fb019ce727022a97bfff53;Fri Sep 30 19:50:25 EDT 2011;Committer;nobu;1;6;4;10;0
7fe9a24a0d649bada6d58ceb7ed9368daf2dce43;Fri Sep 30 00:18:18 EDT 2011;Committer;naruse;1;2;1;3;0
813f3585690a4dcdb87f3e4e031ef4b284762dbb;Thu Sep 29 18:18:03 EDT 2011;Committer;nobu;3;8;0;8;0
8ce9cb8f3185a12d13dce3c994f4aaf05f37a703;Thu Sep 29 16:54:19 EDT 2011;Committer;svn;1;2;2;4;0
a73b88ae43f1726b0b5219937efab53f8c8e934f;Thu Sep 29 16:54:14 EDT 2011;Committer;nobu;2;17;3;20;0
ce515f5c8fbf5a06dc9e0ff8706e913a2ff9154b;Thu Sep 29 11:37:47 EDT 2011;Committer;nobu;2;5;1;6;0
71d110252507b2f720743b930628c971c3201198;Thu Sep 29 11:10:46 EDT 2011;Committer;nobu;2;23;5;28;0
b2658a7604bf7dc9602b9ed4182247d0ef6cfe8f;Thu Sep 29 11:09:48 EDT 2011;Committer;nobu;2;13;7;20;0
8e6e8e628888aa251f771ce8b3fe30a6b41a7a0e;Thu Sep 29 11:07:45 EDT 2011;Committer;nobu;37;164;159;323;0
68f97d7851481e11ce90bb349345dc4caed00cf7;Thu Sep 29 11:06:47 EDT 2011;Committer;svn;1;2;2;4;0
4737e1d8c9debaf36cebb4e682da7f3abfb7d1f4;Thu Sep 29 11:06:42 EDT 2011;Committer;nobu;1;1;1;2;0
839b4b512578705e1ea3fbcfbb67257abcca4cc2;Wed Sep 28 10:17:26 EDT 2011;Committer;ayumin;1;1;1;2;0
63633f8f61d683d5c1b5b1244b93c32381ee4e11;Wed Sep 28 00:21:15 EDT 2011;Committer;nobu;1;1;1;2;0
682177e1691b61ec24928e7793336e8b8df60428;Wed Sep 28 00:14:19 EDT 2011;Committer;nobu;2;7;1;8;0
2865b450e05f7e9e80f4af6c0c29d0bd4014840d;Tue Sep 27 19:44:02 EDT 2011;Committer;ayumin;3;25;4;29;0
fcb2bb8bd696ee8c455a7874b657453286a4d6d9;Tue Sep 27 19:15:51 EDT 2011;Committer;ayumin;2;7;3;10;0
19099f372c6333bd0e63bc18fe2d36454cece69e;Tue Sep 27 19:06:56 EDT 2011;Committer;svn;1;2;2;4;0
0e18153140724ad3efc8d0515f1cfffb78cbb2ed;Tue Sep 27 19:06:52 EDT 2011;Committer;mrkn;3;7;1591;1598;0
1bdf1a5c6f53fa834c10704bd9b60f6c0c375328;Tue Sep 27 00:59:04 EDT 2011;Committer;kosaki;3;14;12;26;0
2cc5eeaf6c377a7b55e2bbaf6661929c17139aa6;Tue Sep 27 00:50:29 EDT 2011;Committer;kosaki;2;7;73;80;0
38fe7da8417b6682325e88fc152b15dae1687626;Mon Sep 26 19:01:48 EDT 2011;Committer;ayumin;1;1;1;2;0
379d519f0b5d06e54d262f56131b64d3ef25ef68;Mon Sep 26 18:52:10 EDT 2011;Committer;ayumin;2;5;0;5;0
81ed2fda7b8c4c03abc18ba2e2e9ff6e74966a62;Mon Sep 26 18:52:08 EDT 2011;Committer;ayumin;1;2;2;4;0
23b4b59a4e366dac865059e0a76d1a3e0f3810b0;Mon Sep 26 18:37:32 EDT 2011;Committer;svn;1;2;2;4;0
375d9f9112f9ebb352536fed9cb263bfcc9ebbcd;Mon Sep 26 18:37:26 EDT 2011;Committer;ayumin;3;29;5;34;0
7b6677f1e60d6a4c4e8927550ba775321a389ce6;Mon Sep 26 02:28:54 EDT 2011;Committer;naruse;2;7;0;7;0
36a1e76053e0f80d9c8239c134a0bd3574eb087d;Mon Sep 26 00:21:54 EDT 2011;Committer;kosaki;2;6;13;19;0
20ae79b0c26e2b9ee9441728353f27c571507a4d;Mon Sep 26 00:19:03 EDT 2011;Committer;kosaki;6;15;135;150;0
6823334c214d9b83ea71de67ab6c5ce1c4fbdfab;Mon Sep 26 00:05:45 EDT 2011;Committer;kosaki;2;6;55;61;0
69bebb053177db260f60f3310976e74476c2d066;Sun Sep 25 15:10:23 EDT 2011;Committer;svn;1;2;2;4;0
9643aa94c24eab358992f60c8bcc387b6969dee9;Sun Sep 25 15:10:18 EDT 2011;Committer;kazu;1;2;2;4;0
8b7e10879ea7e78584e4d37ecf535fb2ddc57206;Sun Sep 25 14:51:20 EDT 2011;Committer;emboss;3;51;4;55;0
b4bc086a1feb6b099115926f4639e20b6c7d3da2;Sun Sep 25 13:40:25 EDT 2011;Committer;nobu;2;15;15;30;0
3255adcd0cb07c5bf4279ecbff1f2aeebdefeae4;Sun Sep 25 12:05:06 EDT 2011;Committer;ayumin;4;389;0;389;0
73bd9e566b081941e9e7f158cbf4f5fd1c2461a8;Sun Sep 25 12:05:02 EDT 2011;Committer;ayumin;2;17;2;19;0
fecda0d9f72f52f9777fb32f63eb2471353221ec;Sun Sep 25 07:54:35 EDT 2011;Committer;nobu;4;12;3;15;0
256f355af5cc3efb543608193da615d5a9fcd340;Sun Sep 25 07:45:08 EDT 2011;Committer;nobu;2;6;1;7;0
62dfc45bb28ae99927ad2ae91f5d6293ff13d5c6;Sun Sep 25 07:42:38 EDT 2011;Committer;nobu;3;3;3;6;0
9e3a3be87011e4337d9d6a8adb1f4f7ec8b9694f;Sat Sep 24 18:43:36 EDT 2011;Committer;svn;1;2;2;4;0
73220a234e978fe92b20287a1d4cd1c540ffe103;Sat Sep 24 18:43:32 EDT 2011;Committer;naruse;3;22;1;23;0
48ddab1e7d3338a6827b2311099e1a28dd5ab8f1;Sat Sep 24 05:20:32 EDT 2011;Committer;svn;1;2;2;4;0
76822e873914b36b43696e05153445d5cdc8bae1;Sat Sep 24 05:20:28 EDT 2011;Committer;kazu;1;2;2;4;0
3a16362371a431127d6a7cc7884bff102ede6b55;Fri Sep 23 05:21:54 EDT 2011;Committer;emboss;2;4;4;8;0
e2694c597d5dd309dba2a7b5d8b0ea6963fe7f2e;Fri Sep 23 04:51:19 EDT 2011;Committer;emboss;2;8;3;11;0
4c3f08caeac0fe7436208b723a0bd6d45eeab964;Fri Sep 23 03:14:30 EDT 2011;Committer;svn;1;2;2;4;0
e3af0655e21a1f6e1fcf3d50c6ac8a5486d8b57b;Fri Sep 23 03:14:24 EDT 2011;Committer;emboss;2;7;0;7;0
64b7b548e0f5d143a6c18c1d295ed274fac48761;Wed Sep 21 17:53:23 EDT 2011;Committer;nobu;2;6;1;7;0
7f4c92c4782751b4411522f7d38fb4aa0c59a345;Wed Sep 21 17:02:32 EDT 2011;Committer;svn;1;2;2;4;0
f80896c2192746c3d3c5d6300c6412e69a3e3d7d;Wed Sep 21 17:02:21 EDT 2011;Committer;nagachika;2;10;0;10;0
bf8826c510adee31805b41df2713df54379c61e9;Wed Sep 21 08:02:07 EDT 2011;Committer;svn;1;2;2;4;0
f48ef8bb9e9b35309ddf52fc959a8605a17f78e1;Wed Sep 21 08:02:03 EDT 2011;Committer;usa;2;6;1;7;0
192292af762eac6c082b96fe18d29c90ab3f33dd;Tue Sep 20 12:16:08 EDT 2011;Committer;naruse;1;5;1;6;0
f9576738263a1ce2bdd24ae356e749331120182e;Tue Sep 20 09:09:00 EDT 2011;Committer;nobu;2;13;5;18;0
3a902c4dbd366ddfe696ae0565f0c0174996f9cd;Tue Sep 20 07:18:37 EDT 2011;Committer;naruse;1;1;0;1;0
c7b58831a3dd9982fcc718515ca0306200acda30;Tue Sep 20 01:23:33 EDT 2011;Committer;naruse;1;1;0;1;0
35c065ae0e02052a8335d2f305f7cf80e716bb57;Mon Sep 19 18:30:26 EDT 2011;Committer;svn;1;2;2;4;0
fbf4c1d2779df506b3936c0296db246bb0dbc3f0;Mon Sep 19 18:30:23 EDT 2011;Committer;naruse;1;1;1;2;0
6ec841b2df3bcf95180c7d8f6b73d80d7f44d4e6;Mon Sep 19 10:34:30 EDT 2011;Committer;ayumin;2;13;10;23;0
d4db53a0e00f06e44b583156359258aa213fda52;Mon Sep 19 09:47:27 EDT 2011;Committer;kosaki;2;22;7;29;0
7c371d465868986e3ac301ad99a1d3b7c3704a49;Mon Sep 19 00:28:41 EDT 2011;Committer;drbrain;2;54;0;54;0
3b17a1d0cf0097f9f9382cb2214f5af523bc11ed;Sun Sep 18 22:54:29 EDT 2011;Committer;svn;1;2;2;4;0
125b62e76d97fd9483c9e15313f80c43a8c1a213;Sun Sep 18 22:54:25 EDT 2011;Committer;nobu;3;20;1;21;0
c4d77cb4adaae2bab9aa015c9a0528f0abf07bbd;Sat Sep 17 14:34:13 EDT 2011;Committer;nobu;3;70;2;72;0
19c312afee311fe4a753e9440e01eb614c9fbf0e;Sat Sep 17 03:51:41 EDT 2011;Committer;svn;1;2;2;4;0
d52be39fb75529ae996a751c76027ce7f05440f8;Sat Sep 17 03:49:20 EDT 2011;Committer;ktsj;2;7;0;7;0
8ccd05c958fcf75d0e547d3c7786e4f27c737051;Fri Sep 16 07:09:24 EDT 2011;Committer;naruse;2;1;8;9;0
fd47fed2699a53cdeb26d204a6fb6a4b75db42ac;Fri Sep 16 06:44:59 EDT 2011;Committer;marcandre;2;8;1;9;0
23d472165f401e28bc2128f74a964c438cf3ced4;Fri Sep 16 01:12:46 EDT 2011;Committer;naruse;2;1;8;9;0
f6b16290174a77ff43243709820d087ceca7bf76;Thu Sep 15 17:13:56 EDT 2011;Committer;svn;1;2;2;4;0
22420b14536c02697b37149bd27b8f6a3d07e8a8;Thu Sep 15 17:13:51 EDT 2011;Committer;marcandre;2;8;1;9;0
6ca73ab90c863aac6a690d340ffd37ef0fd45162;Thu Sep 15 05:24:42 EDT 2011;Committer;nobu;1;7;7;14;0
7db23668b0fd02069fcacf275488ee812cc15bd8;Thu Sep 15 02:40:39 EDT 2011;Committer;nobu;1;1;1;2;0
89e490f1de040450e8356176c0cf252a5ae035e9;Thu Sep 15 02:39:49 EDT 2011;Committer;nobu;2;12;7;19;0
762e4c0c5fef33688155117c7ffec55f6ad49d0e;Wed Sep 14 17:25:48 EDT 2011;Committer;svn;1;2;2;4;0
2fecb27eb47333fda1e0049584d6b56dd336197f;Wed Sep 14 17:25:37 EDT 2011;Committer;ayumin;87;2397;2393;4790;0
9da539cce9e823ab78699a8784eacfe789e67f6d;Wed Sep 14 02:45:02 EDT 2011;Committer;svn;1;2;2;4;0
d24e1dac2b66afc3265065209686970481fb5367;Wed Sep 14 02:44:57 EDT 2011;Committer;kosaki;2;8;1;9;0
4e7c8bbe034e7f96b4d2880f99cf1bc75d4c6097;Tue Sep 13 11:21:52 EDT 2011;Committer;nobu;3;5;4;9;0
f7081431f2c645b198db8ca00ab195c6b8c3d189;Tue Sep 13 06:02:59 EDT 2011;Committer;nobu;3;26;4;30;0
faa2bef46da2dd219e8eaecbd9e21821e3aa0ea9;Mon Sep 12 20:38:23 EDT 2011;Committer;svn;1;2;2;4;0
1796817e46b96e70d0e2e1dd9884429c82982ebd;Mon Sep 12 20:38:17 EDT 2011;Committer;matz;2;6;1;7;0
53fd35c30467468c72acd881d99a17d1fba6b1dd;Mon Sep 12 13:24:19 EDT 2011;Committer;nobu;1;1;1;2;0
2c9375ba69c5bfba56e8cc1ab4ac7c2ff01d24f3;Mon Sep 12 11:36:06 EDT 2011;Committer;kosaki;4;84;3;87;0
4705fcc3c0df0d4f389aff690852356b8d2fd317;Mon Sep 12 04:38:15 EDT 2011;Committer;nobu;4;32;0;32;0
821ae88259f349909ae2e956b09c4d8bf35e1792;Mon Sep 12 03:54:53 EDT 2011;Committer;usa;2;7;1;8;0
a458e72e7c70fa7e3208cf31c115c42317116c06;Mon Sep 12 03:42:39 EDT 2011;Committer;nobu;2;18;3;21;0
704830be3d793a827e42d20e7f4687bfe94423bf;Mon Sep 12 03:40:54 EDT 2011;Committer;svn;1;2;2;4;0
1161616768dba3ba8470cd8877b01a2c3ce80a3d;Mon Sep 12 03:40:49 EDT 2011;Committer;nobu;2;57;0;57;0
776227cbcfde1e583a1b12014fdb7dc1f569724a;Sun Sep 11 09:36:20 EDT 2011;Committer;nagachika;1;1;1;2;0
1b2780150686f0346ea59920bedf376f04498b9e;Sat Sep 10 20:23:40 EDT 2011;Committer;svn;1;2;2;4;0
506b25385694e063a4786c9a3861baec4fd2d263;Sat Sep 10 20:23:36 EDT 2011;Committer;marcandre;2;27;23;50;0
39ec2f686402fa4419cf2cafef57ebdcda569785;Sat Sep 10 10:34:15 EDT 2011;Committer;naruse;2;2;7;9;0
35551be6028626c44f90050be5937a48dbf7731b;Sat Sep 10 04:43:12 EDT 2011;Committer;ayumin;2;8;2;10;0
49042ae821cb15986ab92d030960ee84154ae8a7;Fri Sep 09 23:34:05 EDT 2011;Committer;ko1;2;11;0;11;0
6126c50add54b22325b2312cb50d9a69d441a85e;Fri Sep 09 23:32:56 EDT 2011;Committer;matz;2;7;1;8;0
cf7d76f0bccdec8dac0bb4a8b67955fe2c6cea2e;Fri Sep 09 23:14:00 EDT 2011;Committer;akr;1;2;2;4;0
8ecf99f23585fdc8b6f1b50c76100f93585a4d17;Fri Sep 09 16:44:42 EDT 2011;Committer;svn;1;2;2;4;0
69a4efaf66fa3750dd2e7ddb2dfa31ed67faaacc;Fri Sep 09 16:44:38 EDT 2011;Committer;kazu;3;9;2;11;0
0abbe4c1e61f7010a8efc663fc420bc797572f80;Fri Sep 09 13:06:51 EDT 2011;Committer;ayumin;2;7;1;8;0
702d25f5eb43fa375b553a5eea1d1904899df81c;Fri Sep 09 07:48:00 EDT 2011;Committer;shugo;1;8;0;8;0
cf8626a0826ab96430f4819c17c78dc11bd108e1;Fri Sep 09 06:29:36 EDT 2011;Committer;naruse;1;4;2;6;0
6199181b092e98bffe52452b12ce28e32cddd523;Fri Sep 09 02:26:31 EDT 2011;Committer;naruse;1;2;2;4;0
dcea3a0fb26ea7a1837ba456eca6fa1ef0047a17;Fri Sep 09 02:26:28 EDT 2011;Committer;naruse;1;5;2;7;0
73a1e841d6c829a13c9b6ade7332b62905f727c6;Fri Sep 09 02:08:44 EDT 2011;Committer;sorah;2;9;0;9;0
61b062ba6dac3d7583096bf25158d187413c2029;Fri Sep 09 01:22:06 EDT 2011;Committer;nobu;3;19;3;22;0
fa5446f14e0c57037432911745944da11f570945;Thu Sep 08 17:09:30 EDT 2011;Committer;ayumin;2;207;202;409;0
b81c4967f71d015d2af98521aaabaccb7942638d;Thu Sep 08 16:26:22 EDT 2011;Committer;ayumin;1;1;1;2;0
ce7a3174b86a4270185c37ee3dbc95169ad3e23c;Thu Sep 08 16:24:47 EDT 2011;Committer;svn;1;2;2;4;0
d53e9c1e8403edd9855cbb323e7ed3ef84564e8a;Thu Sep 08 16:24:43 EDT 2011;Committer;ayumin;4;54;47;101;0
05558e04b824272aea1b351d3e12ad9348ea26f1;Thu Sep 08 12:17:06 EDT 2011;Committer;naruse;2;9;4;13;0
599071b700aa7176a2bb762c2d9781d02013f27c;Thu Sep 08 03:57:41 EDT 2011;Committer;nari;2;33;0;33;0
ac6ad66d0b6a023357245dbe7d605e793b9448ce;Thu Sep 08 00:02:55 EDT 2011;Committer;nobu;2;24;5;29;0
6572bd3ce9bce5199bbebfe78b2b61290b0308a7;Wed Sep 07 22:44:27 EDT 2011;Committer;nobu;2;12;13;25;0
7dc427f7ed18574470dea3c6c28c27d4134ec395;Wed Sep 07 22:37:34 EDT 2011;Committer;naruse;2;13;8;21;0
4fe51cb33042375a11356900d8e618ce3b15cc3f;Wed Sep 07 22:33:14 EDT 2011;Committer;nobu;2;10;1;11;0
e3532c8bde441bb6a0430188d9e36f69515bd086;Wed Sep 07 22:17:55 EDT 2011;Committer;naruse;1;23;23;46;0
776a2d9ddf60558858cf1f8254b1333083b8f3f1;Wed Sep 07 18:51:10 EDT 2011;Committer;ayumin;2;177;172;349;0
5aa34ef56241a4a177468eb3383e490296b6049b;Wed Sep 07 18:15:33 EDT 2011;Committer;ayumin;1;1;1;2;0
32b81702d7d2a7805d7bc19f898bab3d60fbc5fd;Wed Sep 07 18:03:23 EDT 2011;Committer;ayumin;2;6;0;6;0
a33ae8a87e1a937e8d3b557fda4da85c772e443b;Wed Sep 07 17:56:28 EDT 2011;Committer;svn;1;2;2;4;0
9f4dd65e890a465c40d71f97df38e117f28d7bed;Wed Sep 07 17:56:24 EDT 2011;Committer;ayumin;2;28;23;51;0
7b30cb6122f2e4d2b2461c49ea67c294f4aff5e6;Wed Sep 07 14:46:53 EDT 2011;Committer;kou;1;1;1;2;0
2bb6fcb6fd216cb32c4997f0a5793e51e75360bd;Wed Sep 07 14:42:44 EDT 2011;Committer;kou;3;32;1;33;0
6b3feab965578e1cc06e8b64f55902d43da8bce6;Wed Sep 07 10:36:11 EDT 2011;Committer;naruse;1;1;8;9;0
f2bd0ce9933be0d7a9c94a5f1b41f85f75eff6a6;Wed Sep 07 08:28:42 EDT 2011;Committer;naruse;3;7;1;8;0
5a883a2cf45d582e407fce9931d6c954a3786c3f;Tue Sep 06 22:50:23 EDT 2011;Committer;svn;1;2;2;4;0
7e04b19d22f5b284782f9f1265d888ecbe339dd0;Tue Sep 06 12:20:17 EDT 2011;Committer;sorah;4;52;0;52;0
e2b7469698fa75ac8849287d91724c266fb4d404;Tue Sep 06 12:16:44 EDT 2011;Committer;tarui;2;8;1;9;0
90c33c21985f445c7a60cddfd3718cc8f073de82;Tue Sep 06 08:11:21 EDT 2011;Committer;naruse;1;3;3;6;0
e240f49073d7f04eb513d4665b118ed8cdfdb864;Tue Sep 06 06:55:30 EDT 2011;Committer;nobu;2;9;4;13;0
3a6c3a672feeafb46f682b68295dd9a13f5b4725;Tue Sep 06 04:15:49 EDT 2011;Committer;nobu;4;18;1;19;0
a1c5ebe7875cd1b59865fe6c2b88c7981a25939d;Tue Sep 06 03:07:16 EDT 2011;Committer;nobu;3;60;0;60;0
80f54e68108a11447168d299f46abce461565f27;Mon Sep 05 21:45:25 EDT 2011;Committer;marcandre;2;6;1;7;0
3dc28710c98502db74dc103bcdc58b65564e83ab;Mon Sep 05 21:44:42 EDT 2011;Committer;marcandre;2;10;5;15;0
73bb2a29f9b345785af7d456135e8ecd7e13a174;Mon Sep 05 20:39:57 EDT 2011;Committer;svn;1;2;2;4;0
319531524b0be46b216e40eaa43086b86d30eae3;Mon Sep 05 20:39:54 EDT 2011;Committer;seki;2;25;55;80;0
4117048c4097301007ba48563c27ec13fa3a828c;Mon Sep 05 12:02:30 EDT 2011;Committer;nagachika;2;5;1;6;0
1cd56023d3e5eacca7d6a5f9b36e9c1528fb62bf;Mon Sep 05 10:36:24 EDT 2011;Committer;nagachika;2;7;1;8;0
bc17dba00f667520e8af3b1bd72ff59882f81751;Mon Sep 05 09:10:58 EDT 2011;Committer;nobu;2;18;11;29;0
179cf473c203826e65d401cfdf17d56133ed0164;Mon Sep 05 09:05:13 EDT 2011;Committer;naruse;1;1;1;2;0
ff2c5c161c1cbb18923521ad15817255013fdd4a;Mon Sep 05 08:46:44 EDT 2011;Committer;nobu;1;5;4;9;0
522c16e84cff784ad631d83e8db8075ba16667a1;Mon Sep 05 06:06:31 EDT 2011;Committer;naruse;2;7;0;7;0
818ebcc54b7281b465428d1ccc84cc17592bd3cf;Mon Sep 05 06:05:31 EDT 2011;Committer;nobu;1;1;1;2;0
48cd6cb153c6b14b5843934cd403103ff369f648;Mon Sep 05 01:06:25 EDT 2011;Committer;shyouhei;3;4;155;159;0
75c42535c9e49a3afae910d533874933558857ed;Sun Sep 04 20:14:29 EDT 2011;Committer;marcandre;2;21;34;55;0
269de36cd06e58726d33bc85429419ede7c3c9d6;Sun Sep 04 20:14:00 EDT 2011;Committer;marcandre;1;41;32;73;0
dc20068d98394b5dd289ebcbb86563fdd40bc58a;Sun Sep 04 19:28:58 EDT 2011;Committer;svn;1;2;2;4;0
9d2f5dff62b8bbaa9a67f38bb310ee9e3694f025;Sun Sep 04 19:28:54 EDT 2011;Committer;marcandre;2;18;4;22;0
26f73a5117cd4ddba5121203f91f9d853f4dea4d;Sun Sep 04 13:33:14 EDT 2011;Committer;shugo;3;31;0;31;0
60c8455253682cbda20a90950be3777f2d819ead;Sun Sep 04 12:22:46 EDT 2011;Committer;shyouhei;13;1577;1418;2995;0
a17fd731c9cab021f3e40f63f10ac13c0e0ca516;Sun Sep 04 06:18:06 EDT 2011;Committer;ktsj;1;2;2;4;0
7c9b9977b0f3ff367e96f9901761f97b9e3c8b97;Sat Sep 03 15:54:44 EDT 2011;Committer;ktsj;2;18;0;18;0
aa6ebbe3298cd11e24a7726c9fc8ad57879975ac;Sat Sep 03 15:11:57 EDT 2011;Committer;svn;1;2;2;4;0
bc2a1f2a98b04f040ea485cedd3283f2f3906e4c;Sat Sep 03 15:11:53 EDT 2011;Committer;nobu;7;40;1;41;0
3e0819c66a0908be61fbb769e96c1accb1d67f26;Sat Sep 03 14:56:26 EDT 2011;Committer;nobu;2;36;10;46;0
90a10297d685b12e691ddf0c04439d19f8592feb;Sat Sep 03 14:55:20 EDT 2011;Committer;nobu;2;9;2;11;0
4ac511266dea82881bcf79ff29b7815a2d5e46ef;Sat Sep 03 14:54:14 EDT 2011;Committer;nobu;1;2;0;2;0
74f724de1acf9773a4220dedb544b80d4a7311a5;Sat Sep 03 14:52:18 EDT 2011;Committer;nobu;3;28;5;33;0
a46d29bb4e232064b68f54e46be8a44216570563;Sat Sep 03 09:46:51 EDT 2011;Committer;nagachika;3;28;0;28;0
b31c817782531fa0f3657af692e4a83b5f30f068;Sat Sep 03 04:49:43 EDT 2011;Committer;nobu;1;1;1;2;0
a1b8cacd0f1dec9bfb77c33aa84dc9a1e3a2a66e;Fri Sep 02 21:23:26 EDT 2011;Committer;svn;1;2;2;4;0
69dff899a06d501fc091821f29d7dc697c247e64;Fri Sep 02 21:23:22 EDT 2011;Committer;nobu;1;2;2;4;0
7dc7da3d86bed37d1c9ec7331b45b418746ce65d;Fri Sep 02 12:11:17 EDT 2011;Committer;nobu;3;12;3;15;0
45fffaeac83cff2e5e09fbf34d39033f65c0784d;Fri Sep 02 08:09:04 EDT 2011;Committer;kazu;1;5;5;10;0
7dddaf680710795bba628db7ca02f4d3f1a57b1c;Fri Sep 02 05:36:49 EDT 2011;Committer;nobu;4;38;22;60;0
5e14b979476566916d2ff0dd255a6d1694ac7166;Fri Sep 02 00:58:10 EDT 2011;Committer;nobu;3;34;2;36;0
8659de2e0f2ee5401d0486d7efaeb7c831564ac1;Thu Sep 01 19:07:44 EDT 2011;Committer;tenderlove;3;22;1;23;0
6e6feaf8da3a0d1f3179aba199221aa375ee9269;Thu Sep 01 16:07:21 EDT 2011;Committer;svn;1;2;2;4;0
c4eb2983bac76f60e0d3fe958b74237e2aac90d6;Thu Sep 01 16:07:16 EDT 2011;Committer;nobu;3;23;5;28;0
43284b6bf8324a762808537d5cd2c0774b662a84;Thu Sep 01 08:31:24 EDT 2011;Committer;nobu;5;39;5;44;0
d3507e3ea697be7aab4e9344c379d6b277cf81cf;Thu Sep 01 07:42:29 EDT 2011;Committer;nahi;10;284;10;294;0
ca3b4133fd011b0077ea99b92bbd92c4e5cb7797;Thu Sep 01 05:09:29 EDT 2011;Committer;usa;2;8;0;8;0
9cdc7f9db0ed33bc1ab3aafe299c9403190dda18;Thu Sep 01 01:22:58 EDT 2011;Committer;usa;2;13;6;19;0
d163179c3e442557537ab6f24357a15af225dc4a;Thu Sep 01 00:31:18 EDT 2011;Committer;naruse;2;17;12;29;0
6240b52cb9a8f7bbdab0f9bae6b7979d54f51df5;Thu Sep 01 00:23:24 EDT 2011;Committer;svn;1;3;3;6;0
91e4b4f6d8ca1813df814d74e2675df196a64ff0;Thu Sep 01 00:23:20 EDT 2011;Committer;naruse;1;0;5;5;0
0d475da8056ec4731872a5290cdabe94b53d4f64;Wed Aug 31 08:35:27 EDT 2011;Committer;nahi;2;24;6;30;0
cfe8ed5cbc763a3abcfc19ce10619836aeff7682;Wed Aug 31 08:28:19 EDT 2011;Committer;nahi;4;279;32;311;0
f653519cbbf9344102502830f6e478ae3d293810;Wed Aug 31 07:55:15 EDT 2011;Committer;usa;1;1;1;2;0
8b74d0c3fb195058c18a939af1faa96fda9f4860;Wed Aug 31 07:29:57 EDT 2011;Committer;usa;2;33;1;34;0
c06658feba7ae82e175bac72f241029276e715a0;Wed Aug 31 06:56:16 EDT 2011;Committer;naruse;7;54;37;91;0
64e0cae2741c501e8558966096b4b139d945ca82;Wed Aug 31 04:13:00 EDT 2011;Committer;marcandre;2;33;6;39;0
800081d0c82fa24483d6485d7f0b067a3820151f;Tue Aug 30 15:51:13 EDT 2011;Committer;usa;2;6;1;7;0
a34f81561d2f7d6437d577fee3247e62c07838b7;Tue Aug 30 15:49:55 EDT 2011;Committer;usa;2;5;1;6;0
13a77870de58b6b8fe96f5e188c7f7201ed640a3;Tue Aug 30 15:34:54 EDT 2011;Committer;usa;2;8;1;9;0
34e65bee79acae81a97222205630513277a3289b;Tue Aug 30 15:07:21 EDT 2011;Committer;usa;3;16;6;22;0
790e8b583696493d5cf4cd3829441ef4ad85aaec;Tue Aug 30 15:04:16 EDT 2011;Committer;svn;1;2;2;4;0
ee7d523631de5755a1b4d8ee1fe8ab8a15edfcde;Tue Aug 30 15:04:11 EDT 2011;Committer;usa;4;33;1;34;0
527be1b25a3192fffa143ef4bb520c9812e8324d;Tue Aug 30 13:39:31 EDT 2011;Committer;nagachika;2;10;2;12;0
13d3a16ada7e154647d9abdc203e3b19ee328ccd;Tue Aug 30 13:28:58 EDT 2011;Committer;usa;2;7;2;9;0
28bba481f952a96024a76f976d1cd4343d78706c;Tue Aug 30 05:21:27 EDT 2011;Committer;naruse;1;0;2;2;0
b14c060ddabfad99deff3e56d847034f7d0946be;Tue Aug 30 02:23:12 EDT 2011;Committer;naruse;13;715;275;990;0
2dd9d721ed6820a584654c82f4ae1d6331f78a9e;Tue Aug 30 00:59:52 EDT 2011;Committer;kosaki;2;9;1;10;0
3ffa44622db2386727a8e11bb3aeb0385621f9fa;Tue Aug 30 00:51:46 EDT 2011;Committer;kosaki;2;9;1;10;0
0cebfad20ab9eb694eeb95f083635127cfbf35f9;Tue Aug 30 00:33:05 EDT 2011;Committer;kosaki;6;166;19;185;0
f3ef9346d1da0a4fdc1162e6c0832a38a7ea9f81;Tue Aug 30 00:13:59 EDT 2011;Committer;svn;1;2;2;4;0
3596d49edfc61126cc2d3cd8634516d10fbcbe42;Tue Aug 30 00:13:56 EDT 2011;Committer;kosaki;2;11;0;11;0
9742dec279e8be6081a60a5a9bc6c0384e8f98b6;Mon Aug 29 14:24:31 EDT 2011;Committer;mrkn;2;6;1;7;0
8ca1e6a0eeb96526b6fb7a719d05651d12c9f0d3;Mon Aug 29 06:51:48 EDT 2011;Committer;naruse;1;2;1;3;0
733e371c2a50208f43350456baf93107e627d0a1;Mon Aug 29 05:54:03 EDT 2011;Committer;naruse;1;1;1;2;0
442e8a238cfdf24a79af882139190e939612c321;Mon Aug 29 03:54:35 EDT 2011;Committer;naruse;1;3;3;6;0
c89b18dfd126850d4e9a0824c2a4b8218a7fa308;Mon Aug 29 01:07:19 EDT 2011;Committer;svn;1;2;2;4;0
640420f7044405cec4b1e6486caca4def5f80a45;Mon Aug 29 01:07:15 EDT 2011;Committer;mrkn;5;104;7;111;0
0d530b2392585cc535fb905f9ba4467257ef289c;Sun Aug 28 06:53:47 EDT 2011;Committer;nagachika;2;14;3;17;0
650c122fd71ef2beb3a7465d453ced925bb4ca88;Sat Aug 27 20:31:01 EDT 2011;Committer;svn;1;2;2;4;0
4c66fc089080a63f58d95877130a0a0920a409c6;Sat Aug 27 20:30:57 EDT 2011;Committer;ryan;4;69;6;75;0
0971109e3dcc8f30df79fba1ac6db174e7c7ecdc;Sat Aug 27 11:51:02 EDT 2011;Committer;ktsj;3;9;2;11;0
6bc83a18b74844acff9e664ff2983f00181d577b;Sat Aug 27 10:06:25 EDT 2011;Committer;naruse;3;15;7;22;0
a09e7139a3916c832f42d54191fc69439ecc603e;Sat Aug 27 09:59:48 EDT 2011;Committer;ktsj;5;52;16;68;0
7412263eba30c0c65ae72f4e9dc0d139f37f4d00;Sat Aug 27 09:45:15 EDT 2011;Committer;naruse;3;8;5;13;0
23b280869314c59be4e4fb01d68ebacf753475a9;Sat Aug 27 09:18:18 EDT 2011;Committer;naruse;5;90;49;139;0
4d033a11c5bd778f124febb30e419bd91d372076;Sat Aug 27 02:19:42 EDT 2011;Committer;nahi;4;39;275;314;0
80d6bf2291380b5860b2fa588404d7721bf34c30;Fri Aug 26 23:45:41 EDT 2011;Committer;drbrain;4;22;18;40;0
164c7dc57445c43a559dfcb39a48614ea23f067a;Fri Aug 26 23:11:38 EDT 2011;Committer;drbrain;2;40;27;67;0
ca9654114920982b7603e28d6e8d808df77f1795;Fri Aug 26 22:22:37 EDT 2011;Committer;drbrain;11;71;58;129;0
18e342e80dfe96b865e3b80a27687ccf4b09d781;Fri Aug 26 21:47:28 EDT 2011;Committer;ryan;1;1;0;1;0
ee34216a8cd7b568d4e79bdde02603329d8982ae;Fri Aug 26 21:45:02 EDT 2011;Committer;ryan;1;6;0;6;0
45248e74e424715c51c0d14e958fd3a9995ba572;Fri Aug 26 19:04:39 EDT 2011;Committer;ko1;2;7;1;8;0
e0fcbac6074700b84ae8032f741a36245cdd526e;Fri Aug 26 19:03:25 EDT 2011;Committer;svn;1;2;2;4;0
5d486bec613a2b420a19a03f67e6253ae22b7ca7;Fri Aug 26 19:03:21 EDT 2011;Committer;ko1;2;6;0;6;0
1e7f99dddf1877f5fb7a4dd5759dddff8ba17154;Fri Aug 26 10:27:20 EDT 2011;Committer;nahi;4;331;32;363;0
e93d882d96cc536857e6c181b5f0194f15316b7d;Fri Aug 26 01:10:50 EDT 2011;Committer;drbrain;12;205;76;281;0
4544b3824c8ce74e0a92c58a3167f900904f506b;Thu Aug 25 23:24:33 EDT 2011;Committer;tenderlove;4;29;0;29;0
a6e30a87140512445892d464b841a8ef60e0d012;Thu Aug 25 21:00:03 EDT 2011;Committer;kazu;4;42;42;84;0
5f55548738a1bb1dd334efba4245dcca00cc1554;Thu Aug 25 16:39:41 EDT 2011;Committer;svn;1;2;2;4;0
2fa6ebc64d04c455318ccd04e50a64986d72c4c5;Thu Aug 25 16:39:37 EDT 2011;Committer;akr;1;12;1;13;0
965f51b348aa9f5906cd83361a0774e3853c7d35;Thu Aug 25 00:43:45 EDT 2011;Committer;drbrain;5;83;60;143;0
b0fb4fb689062826730d0712a685787daf796b9a;Thu Aug 25 00:29:02 EDT 2011;Committer;drbrain;3;29;0;29;0
ef039de5604582fbf87aea2dbc9a28697423aa51;Wed Aug 24 23:37:56 EDT 2011;Committer;ko1;3;44;0;44;0
85e24491a6f2df6c764a743940651448e8d487b0;Wed Aug 24 22:57:55 EDT 2011;Committer;marcandre;2;7;1;8;0
ee0d942ed9af59cefd7717ae456d76ebc5d2f6ee;Wed Aug 24 22:57:42 EDT 2011;Committer;marcandre;1;2;3;5;0
beb26e1b491f8d9fd20a2d944f036100cd1abac3;Wed Aug 24 22:02:03 EDT 2011;Committer;ko1;6;84;51;135;0
72107daf0e9b35d28ae75c728134b64d2383cb65;Wed Aug 24 21:54:27 EDT 2011;Committer;tenderlove;3;17;95;112;0
34f6671d68a3fc6d94a7ed6954b71615735fa83b;Wed Aug 24 21:14:44 EDT 2011;Committer;tenderlove;3;23;1;24;0
8b8c7fd386022f30f846ce7fd4c8224d61118b57;Wed Aug 24 16:41:12 EDT 2011;Committer;ngoto;2;7;2;9;0
830125d8195a6ac7eaa5e50cb406015db3f0f6b3;Wed Aug 24 16:23:27 EDT 2011;Committer;svn;1;2;2;4;0
073f94e24f17ee2786df6f5d54624482ba95284f;Wed Aug 24 16:23:23 EDT 2011;Committer;ngoto;2;8;2;10;0
32618ba7438a2247042bba9b5d85b5d49070f5e5;Wed Aug 24 07:28:12 EDT 2011;Committer;naruse;1;1;1;2;0
7049d9c80d1ba859beb5d68c7a9de37d5c11b8e8;Wed Aug 24 06:31:15 EDT 2011;Committer;ko1;9;110;84;194;0
4f03f0cb67b0bf6497ffd4051e872905e3b49ead;Wed Aug 24 00:52:04 EDT 2011;Committer;ko1;3;16;1;17;0
61920a128a2593f6fb968cfd4928499f0a3e2ed3;Tue Aug 23 23:53:49 EDT 2011;Committer;drbrain;11;97;4;101;0
cede48fd403ddb0631fafc49392350bb889c38ab;Tue Aug 23 22:58:06 EDT 2011;Committer;drbrain;4;42;2;44;0
d1919daa4282b29d22240c7fee977afbcbc7ea58;Tue Aug 23 22:34:13 EDT 2011;Committer;ryan;1;8;4;12;0
2c43b9664b29f76c73ac8bae5400b79d0a5313e0;Tue Aug 23 21:47:25 EDT 2011;Committer;ryan;9;1024;187;1211;0
885f5fa2b0c1ba20a26759e65fefeece48cb56db;Tue Aug 23 15:44:30 EDT 2011;Committer;svn;1;2;2;4;0
54163e2b52559d8c996607c0df635743d47af81b;Tue Aug 23 15:44:26 EDT 2011;Committer;mame;3;32;3;35;0
a14e13b23bea72ed78181f752eb6e9454b10eb9a;Tue Aug 23 06:26:11 EDT 2011;Committer;drbrain;2;30;16;46;0
a5cb0fb0c298146e3dbb85772bd5a9fd4b4ff8c3;Tue Aug 23 02:36:18 EDT 2011;Committer;svn;1;2;2;4;0
e3e985064a6b9d338edc86cf3e807345a26b64af;Tue Aug 23 02:36:13 EDT 2011;Committer;nahi;3;27;0;27;0
4ed4711361e771516e0088fc86c822bd4dd1ac76;Mon Aug 22 14:48:15 EDT 2011;Committer;svn;1;2;2;4;0
9c038691e1aaf184066f0c355835d9e87a4e57b4;Mon Aug 22 14:48:10 EDT 2011;Committer;nagachika;2;11;2;13;0
729ad0b0abc42e77515b86463abc8500506d12c9;Sun Aug 21 08:55:10 EDT 2011;Committer;ktsj;2;5;1;6;0
6d36527c9a264c31f50a4824544b0dc46af8b29e;Sun Aug 21 05:34:55 EDT 2011;Committer;svn;1;2;2;4;0
b28715b2fb177d3040ddef19df58f72d77c43d29;Sun Aug 21 05:34:51 EDT 2011;Committer;ngoto;2;7;0;7;0
5cb16a55f56220eb8a0e0bfa69c5427023a12975;Sat Aug 20 04:26:20 EDT 2011;Committer;ktsj;3;10;3;13;0
4536f22a69d719d04eb7e597a10c48732e80607d;Sat Aug 20 01:43:34 EDT 2011;Committer;svn;1;2;2;4;0
dcb7cc1a8b76b1691b59192474cb7f193acd75cd;Sat Aug 20 01:43:26 EDT 2011;Committer;nobu;3;26;10;36;0
e9930a4b56c874a73d9400a5568e3fa52a139138;Fri Aug 19 05:25:52 EDT 2011;Committer;nobu;3;31;10;41;0
2bd37c71839858341cf2534657a60261e05f275f;Fri Aug 19 05:16:20 EDT 2011;Committer;shugo;3;74;3;77;0
5852b97e4eb18560b911848095025404926904da;Fri Aug 19 04:20:10 EDT 2011;Committer;mrkn;2;6;1;7;0
248d589b554331ed1cee9dfc29f1d6f79bff9312;Fri Aug 19 04:17:04 EDT 2011;Committer;mrkn;2;9;0;9;0
61f830bf7d184d5ee6423c152d9be4454f1769fa;Fri Aug 19 02:33:02 EDT 2011;Committer;svn;1;2;2;4;0
28b5db007f531a95917a07ed02146fc8360ae104;Fri Aug 19 02:32:59 EDT 2011;Committer;shugo;3;23;1;24;0
29cbd3392343b91ef4269416d5f4ed3406d2ce26;Thu Aug 18 12:48:28 EDT 2011;Committer;svn;1;2;2;4;0
224d0eeb3de343d0dc1f912101d30d6fad2b9426;Thu Aug 18 12:48:25 EDT 2011;Committer;nagachika;1;2;2;4;0
52c7bbd44460bc8e0c1142204c6740782c36c45e;Wed Aug 17 14:04:22 EDT 2011;Committer;mrkn;2;8;4;12;0
4e8d6c105c22c40f1abf1aab357419e8f4ef2f5b;Wed Aug 17 06:35:21 EDT 2011;Committer;mrkn;4;91;7;98;0
b30d203fed8c29fd05d010631ca8e4750ce34849;Wed Aug 17 01:24:22 EDT 2011;Committer;mrkn;3;21;0;21;0
783fb0881f91d59dca1430657628c4d50bd1a2be;Tue Aug 16 21:41:25 EDT 2011;Committer;emboss;1;7;7;14;0
515d546d7614cefbad79b8c33d063ee8b33ffff0;Tue Aug 16 21:37:46 EDT 2011;Committer;emboss;2;103;0;103;0
734a62a4feb977cad8a80665e3376c16dbbe4d57;Tue Aug 16 19:59:42 EDT 2011;Committer;svn;1;2;2;4;0
a517fe05186e1ca3ee9460ada40b15e0d2ec544a;Tue Aug 16 19:59:38 EDT 2011;Committer;emboss;2;7;2;9;0
0dee7247a734b15fb653ea31d9a7bb3f7d8a33cf;Tue Aug 16 09:56:56 EDT 2011;Committer;nobu;3;9;4;13;0
cb40b39a2f20d10f9b3b8f62487b3fb1e413f1b1;Tue Aug 16 09:52:10 EDT 2011;Committer;nobu;2;7;1;8;0
5afbff7bc27fc2a937ed15429e0ade9d98460907;Tue Aug 16 01:36:28 EDT 2011;Committer;akr;1;0;1;1;0
de6d4f7e7bdb78e5cb443a2e327265b52cde0d44;Tue Aug 16 00:34:51 EDT 2011;Committer;drbrain;8;398;7;405;0
87ff4b24ae4911bda46a5426024959c278da69b2;Mon Aug 15 23:48:59 EDT 2011;Committer;drbrain;8;208;1;209;0
8977d3e30c225ba17e6ed542875b320d3d8bd3e1;Mon Aug 15 23:08:43 EDT 2011;Committer;svn;1;2;2;4;0
12979424515344460afb12002ce07b670bf7cd6f;Mon Aug 15 23:08:39 EDT 2011;Committer;drbrain;16;251;103;354;0
39e112f89a4e7471bb95ec516b05c75ac6df5aa9;Mon Aug 15 01:10:29 EDT 2011;Committer;svn;1;2;2;4;0
1be5789eed8de583662e47e2bf580bf14a9e296c;Mon Aug 15 01:10:26 EDT 2011;Committer;emboss;3;19;0;19;0
63ad065026a60caf5b032712a269b427ad6ae15a;Sat Aug 13 20:58:16 EDT 2011;Committer;svn;1;2;2;4;0
4db0c519f51a891cadda08981e9e0f7f2b3f3f81;Sat Aug 13 20:58:11 EDT 2011;Committer;akr;2;33;0;33;0
31e1fce2a3a4ba971aed17cf6544d04649ba4dc9;Sat Aug 13 13:17:30 EDT 2011;Committer;nobu;2;22;2;24;0
75de442dd0b7eb7325f61610f096e2a469c2eff5;Sat Aug 13 08:05:43 EDT 2011;Committer;tadf;2;32;11;43;0
a49ad9a639fc6b6e5643966791cc9a1c80f23cb3;Sat Aug 13 00:46:18 EDT 2011;Committer;nagachika;1;1;1;2;0
c67712ef6359707e32ebf2c6bcc27b9bbe3c532b;Sat Aug 13 00:41:10 EDT 2011;Committer;tadf;4;25;0;25;0
14b57772ece1fa9c9f597d8fe39496f8a4d9088a;Sat Aug 13 00:40:06 EDT 2011;Committer;nagachika;2;6;1;7;0
5339bbe2dc3130f7e7534b0d72dd1f1d42b7f8d5;Sat Aug 13 00:27:44 EDT 2011;Committer;tenderlove;3;14;0;14;0
0acaab201a821bc6591598775ffc6b6c4980ba9d;Sat Aug 13 00:12:05 EDT 2011;Committer;tadf;3;14;4;18;0
b5f05971f5349753966067e9af2555801a32c1ac;Sat Aug 13 00:00:26 EDT 2011;Committer;tenderlove;2;10;2;12;0
e8b3d0decfa58776fab3492ae6406e58ad60a05c;Fri Aug 12 23:48:18 EDT 2011;Committer;tadf;2;10;0;10;0
ee13ed7e84410683a37834e5674a096a0e82d2ec;Fri Aug 12 18:41:57 EDT 2011;Committer;drbrain;2;11;6;17;0
c233d6592d6ce0cca9149f09cc87c5799d33382a;Fri Aug 12 17:23:11 EDT 2011;Committer;drbrain;2;52;0;52;0
26b384e6a584cbd142327d1b1fb67f861cfc862d;Fri Aug 12 16:56:52 EDT 2011;Committer;svn;1;2;2;4;0
5caef67a6f19e5c03cc4684532d738e02a694015;Fri Aug 12 16:56:48 EDT 2011;Committer;drbrain;7;18;6;24;0
da6eec340eb13d0c50431a0661528a7fe300ffda;Fri Aug 12 04:42:13 EDT 2011;Committer;kosaki;1;1;1;2;0
33c7e324e50ef3053449ddd0719e95e3182098b4;Fri Aug 12 02:42:51 EDT 2011;Committer;kosaki;2;7;2;9;0
5e4de2a2656607feaa38aedfbaf705d1a9a8c6a6;Fri Aug 12 00:15:42 EDT 2011;Committer;drbrain;3;13;3;16;0
65bfe20244dad2fc582ee1b5d20137f8083ae5e0;Thu Aug 11 23:31:05 EDT 2011;Committer;akr;1;2;0;2;0
562257497691b7ddc8032a872693b23918aa5726;Thu Aug 11 23:20:15 EDT 2011;Committer;akr;5;17;5;22;0
9536568d3e46da2a028fcc5e15a79589f5187942;Thu Aug 11 18:31:53 EDT 2011;Committer;svn;1;2;2;4;0
73f0448e983659f863dcacc25beb054ea676e0fb;Thu Aug 11 18:31:49 EDT 2011;Committer;drbrain;4;12;2;14;0
8f97a2c53745f97055c38f41dd1e3dd96e64b300;Thu Aug 11 06:51:42 EDT 2011;Committer;nahi;2;9;3;12;0
7b05ac78e18740d107af133c410069375855dea1;Thu Aug 11 06:10:11 EDT 2011;Committer;kazu;1;2;2;4;0
c77924a9146af179bcedfb3f7e44fef4917075f6;Thu Aug 11 06:07:46 EDT 2011;Committer;svn;1;2;2;4;0
0eb903aa984b70c942e89b49de6035b948a239a8;Thu Aug 11 06:07:37 EDT 2011;Committer;nobu;2;12;2;14;0
6c0e64dee5cb5273f90b9ee51b49ca035689483d;Wed Aug 10 14:04:23 EDT 2011;Committer;akr;2;5;3;8;0
e7320dbe32788d113fb7c18f4ef91a46a131c4f0;Wed Aug 10 13:14:51 EDT 2011;Committer;akr;1;1;0;1;0
5515afbf8f5b7e9f3c611691a9dd8326f7bd6f9c;Wed Aug 10 13:13:57 EDT 2011;Committer;akr;2;90;12;102;0
184f041fb8de3398a859a20763f2a30ba1486065;Wed Aug 10 12:28:19 EDT 2011;Committer;akr;4;12;4;16;0
2e2fabc4335763199c69379502f8033d50f157a0;Wed Aug 10 10:35:08 EDT 2011;Committer;mrkn;3;30;4;34;0
6bf7dd725bf57dc6d52a7fe3353f70d061193d94;Wed Aug 10 05:11:10 EDT 2011;Committer;nobu;2;6;4;10;0
72596937af869b2a3e3f8db0a46971fe208044de;Tue Aug 09 17:56:43 EDT 2011;Committer;svn;1;2;2;4;0
a967390d04a26a134bfb7b1945d4dcec3d7355bc;Tue Aug 09 17:56:40 EDT 2011;Committer;naruse;2;7;6;13;0
0bd01d00585400b11649072a1d72cb3c740abf91;Tue Aug 09 14:00:49 EDT 2011;Committer;nagachika;2;11;0;11;0
4d71d348555f75ea705f8a0e4782e0e5935a7094;Tue Aug 09 05:31:47 EDT 2011;Committer;ngoto;4;28;5;33;0
e26cead1e99e10ab3e672e0894ebdc8c277c833c;Tue Aug 09 04:26:15 EDT 2011;Committer;nari;2;16;0;16;0
75a84097adf38474b20e6f4f3b2fa2ef35e4bd60;Tue Aug 09 03:56:14 EDT 2011;Committer;ngoto;1;1;0;1;0
321be14fe7418356073a6bddc1fcb8ce841d3a46;Tue Aug 09 03:36:18 EDT 2011;Committer;ngoto;3;21;2;23;0
23aef380e045d6e81f053f254233d0f299a5e82a;Tue Aug 09 00:18:23 EDT 2011;Committer;svn;1;2;2;4;0
88cff367f4ce29937fbf41f4a27cc869c5dd2a8d;Tue Aug 09 00:18:18 EDT 2011;Committer;drbrain;2;33;14;47;0
f2f14f572d6fb92394955953352e6edb688cc986;Sun Aug 07 14:38:17 EDT 2011;Committer;kosaki;3;16;1;17;0
9c760d0aad3fac021dcfa7d7c80609cd4178d9c9;Sun Aug 07 13:52:36 EDT 2011;Committer;kosaki;3;8;3;11;0
b6c6ce116e9bd09e20ac8fb3991439e0a1e45940;Sun Aug 07 13:43:37 EDT 2011;Committer;kosaki;2;6;0;6;0
937ff7bdeb84361431651fbbe9158152efc2f6c1;Sun Aug 07 06:38:36 EDT 2011;Committer;naruse;2;6;0;6;0
bc647cbdfbc6a16afa04df82930896490162d128;Sun Aug 07 05:13:02 EDT 2011;Committer;ktsj;2;7;3;10;0
f9260247d2442baf381c9158c21bde69f035ef84;Sat Aug 06 22:18:45 EDT 2011;Committer;naruse;2;6;1;7;0
2878632eff7de18f4f2c52305be04cea9f754e21;Sat Aug 06 15:44:21 EDT 2011;Committer;svn;1;2;2;4;0
dd6911a8c878439165501450029b55b87323dd52;Sat Aug 06 15:44:06 EDT 2011;Committer;naruse;2;9;3;12;0
1b8e472727a4dfd22a4faf4f63e84dd371910a55;Fri Aug 05 22:16:12 EDT 2011;Committer;svn;1;2;2;4;0
cb0f9d5fafd6cb1ad138b28d9e69566ff29f923f;Fri Aug 05 22:14:05 EDT 2011;Committer;drbrain;2;6;1;7;0
9fb5dca9c95460200d04766f769afb1fd02928c4;Fri Aug 05 13:28:50 EDT 2011;Committer;ngoto;2;7;2;9;0
543ecd95d506c5b85d82fe4d5a8a1860a71620dd;Fri Aug 05 13:20:26 EDT 2011;Committer;nobu;1;2;2;4;0
1adf7962be7f1403a4df8a850d2156a21d6f8aa8;Fri Aug 05 11:31:52 EDT 2011;Committer;usa;1;229;219;448;0
c3d8ff4e84f650ad96e9944f4abebfafc99c6211;Fri Aug 05 08:28:00 EDT 2011;Committer;knu;1;0;4;4;0
39eea54cfe59d69282271e75703fd053b377a2f0;Fri Aug 05 08:26:42 EDT 2011;Committer;knu;2;23;2;25;0
700aeee754648204314b644f24a75aaebe438ca7;Fri Aug 05 07:03:21 EDT 2011;Committer;ngoto;3;13;4;17;0
1ded4dbd110868891d1255bc11845c1130a0ca3e;Fri Aug 05 06:55:36 EDT 2011;Committer;nobu;3;20;2;22;0
c3a750ebee3960f5ee47bcba4e60d8c3585eb843;Fri Aug 05 04:35:28 EDT 2011;Committer;shugo;4;22;12;34;0
55148a250101b662fde32919f14afcf2dcdc801d;Fri Aug 05 03:18:25 EDT 2011;Committer;nobu;4;44;5;49;0
2205687ccf6caf2d7b9998478751508afba707c6;Fri Aug 05 01:11:12 EDT 2011;Committer;mrkn;1;1;1;2;0
3434676e9e3c87c39fe4a8c411a041449efc7446;Fri Aug 05 01:00:01 EDT 2011;Committer;drbrain;13;143;14;157;0
d24997cce12d27cec767ca7091a076df1b2319db;Fri Aug 05 00:48:17 EDT 2011;Committer;nobu;1;5;2;7;0
5fd10124aa7adb1b3e8aa0299909b6522397799e;Thu Aug 04 22:00:36 EDT 2011;Committer;nobu;2;21;8;29;0
1d69f7ccf10618d34fcf363c323217e475c16b12;Thu Aug 04 15:06:27 EDT 2011;Committer;svn;1;2;2;4;0
6a7081bb18d84d39a0d7d46f0197158eb600dced;Thu Aug 04 15:06:20 EDT 2011;Committer;mrkn;2;40;7;47;0
3fb456953417cd85514968587c819b428b75b6b5;Thu Aug 04 11:36:50 EDT 2011;Committer;ngoto;2;5;1;6;0
3abbda4f6ef4e2c314bb288b2a2b5cc0762ee652;Thu Aug 04 11:23:16 EDT 2011;Committer;kosaki;2;11;2;13;0
1c647cc203485dad91b8e34b0ea07354c8c3578f;Thu Aug 04 07:09:58 EDT 2011;Committer;nobu;1;83;83;166;0
5f3a8912f770d0a629a744364217c8478cab96bd;Thu Aug 04 07:08:48 EDT 2011;Committer;nobu;3;15;10;25;0
f555a533d05b48ff3f6062ffa4a559613d12408d;Thu Aug 04 06:44:13 EDT 2011;Committer;nobu;2;26;0;26;0
11667b9c9ac0b3fb835508cfdb3ecc863e3b6935;Thu Aug 04 02:54:22 EDT 2011;Committer;nobu;1;1;1;2;0
d04697df8814b6161f87e597a615e7773f6f1f78;Thu Aug 04 02:32:19 EDT 2011;Committer;naruse;2;6;2;8;0
e9ddb1a1f965d830ec26c808be9fcacacedf6844;Wed Aug 03 18:08:57 EDT 2011;Committer;tenderlove;2;61;16;77;0
92f39045346c665b84761a031de4965f3fe9d270;Wed Aug 03 18:08:48 EDT 2011;Committer;tenderlove;1;1;1;2;0
03418c4e5f551ec6d899580c9a5e86bbc37c649d;Wed Aug 03 17:49:22 EDT 2011;Committer;mrkn;2;14;0;14;0
ae51324199bf96cbb7439583900bd20bd51186b8;Wed Aug 03 17:21:12 EDT 2011;Committer;nobu;2;7;1;8;0
55d68f1160b64b1d857128a36b47fd05b51fab8f;Wed Aug 03 17:02:44 EDT 2011;Committer;tenderlove;3;113;0;113;0
d7c026d05806f706d43a8d86694dd957d04c7a61;Wed Aug 03 15:40:03 EDT 2011;Committer;naruse;2;221;1;222;0
9dd559a73a467697aaf08f3e5cb54e0488abd587;Wed Aug 03 15:38:49 EDT 2011;Committer;svn;1;2;2;4;0
c8c02c9cc39444ad89b4ceba09d2ed06f4cff9dc;Wed Aug 03 15:38:44 EDT 2011;Committer;nahi;2;2;2;4;0
454de1d5eb178ae71397702702fbda4996196f65;Wed Aug 03 12:18:50 EDT 2011;Committer;akr;1;9;0;9;0
f9e9eee677e8196da7288f4ab7754ebe345d7ed9;Wed Aug 03 07:10:56 EDT 2011;Committer;usa;10;29;277;306;0
f0fbf6c976b3bb5494c9740b1c6235306946f696;Wed Aug 03 03:47:10 EDT 2011;Committer;nobu;1;1;1;2;0
deb0024af1c73dd3c40dc908b3b728d812763849;Wed Aug 03 00:22:08 EDT 2011;Committer;shyouhei;2;6;0;6;0
a0b9f48674f104d79b374b104635ab4d88d32ec8;Tue Aug 02 22:46:34 EDT 2011;Committer;nobu;3;8;1;9;0
73407963382f4a7a899732fcd3f4d8b5d343211a;Tue Aug 02 22:39:28 EDT 2011;Committer;naruse;1;1;1;2;0
ae1bccf7a49225fdc8a58f9f83926e3d675dc0c2;Tue Aug 02 15:39:10 EDT 2011;Committer;naruse;1;3;2;5;0
2392f452897ae36b568321a03b7261e787638840;Tue Aug 02 15:26:04 EDT 2011;Committer;svn;1;2;2;4;0
642458fd77476ac3a364a914ab02097014c8f6b8;Tue Aug 02 15:25:59 EDT 2011;Committer;akr;2;12;1;13;0
048202f4467a1cf16040318b759d43fa961eb0a2;Tue Aug 02 14:50:54 EDT 2011;Committer;nobu;1;1;1;2;0
48bc63fa7aadb25f3c0fdaad9c116e9171a8cfad;Tue Aug 02 14:27:56 EDT 2011;Committer;naruse;1;6;1;7;0
027a15e9582d62fbd2df7efcdd2e8475be758583;Tue Aug 02 13:08:45 EDT 2011;Committer;naruse;3;20;2;22;0
2cf05e587951f189db69278f7ee3a8ba4b8d64fe;Tue Aug 02 12:19:27 EDT 2011;Committer;naruse;1;0;124;124;0
9864da84f6c385265b4c4caeb3cf52787535e270;Tue Aug 02 11:18:58 EDT 2011;Committer;sorah;2;8;0;8;0
faf295f1e1467b6f4e088877db258be03c7be4f4;Tue Aug 02 07:35:21 EDT 2011;Committer;naruse;2;32;8;40;0
86bbfdadf3d9f2da5febeb02a3dcf81f3f2478ef;Tue Aug 02 03:03:18 EDT 2011;Committer;nobu;3;9;0;9;0
48fd404ffe789d592597640842f17360e6d0fac4;Tue Aug 02 02:42:17 EDT 2011;Committer;nobu;2;15;7;22;0
fa25f26095cf3d2de410ec509265379246ea5414;Mon Aug 01 22:35:05 EDT 2011;Committer;shyouhei;3;10;2;12;0
35186277d14806bc88843701a570f9ab73d91b8a;Mon Aug 01 21:22:17 EDT 2011;Committer;svn;1;2;2;4;0
9e49d29e0801e9d6543339cedfc373dadae7773a;Mon Aug 01 21:22:13 EDT 2011;Committer;luislavena;3;9;1;10;0
4d9c0998cfa9acb8a1751b6ed6c6e47b9c1fe45e;Mon Aug 01 13:18:16 EDT 2011;Committer;nagachika;1;1;1;2;0
b8d546db6445742f511110f09cf3f33dc87d310e;Mon Aug 01 11:23:44 EDT 2011;Committer;usa;2;33;30;63;0
f209dc7242130144399e85d1dea1a5a0c8c5efe7;Mon Aug 01 06:45:43 EDT 2011;Committer;drbrain;3;20;14;34;0
6851f29bb77592e9908bb61ab117ed382bddcb66;Mon Aug 01 06:36:09 EDT 2011;Committer;shyouhei;2;8;0;8;0
3237f7dc9a436a44c068e9bd8572d6e4812df772;Mon Aug 01 06:22:05 EDT 2011;Committer;shyouhei;2;13;0;13;0
a429cafc4d95c0543e3fb234f1762067ee0b5304;Mon Aug 01 05:25:13 EDT 2011;Committer;drbrain;7;62;8;70;0
7d2efc1fdaa0251ae8ceb8e437ade37e8b2a28fa;Mon Aug 01 03:21:43 EDT 2011;Committer;kazu;1;0;2;2;0
d18f05af854596f3baca66aa21e83d12d92f0821;Mon Aug 01 03:10:06 EDT 2011;Committer;svn;1;3;3;6;0
db42bd0448f01a79ddcc522be13b49651118fc82;Mon Aug 01 03:10:02 EDT 2011;Committer;naruse;2;7;2;9;0
6280ce3b686c846c17713237e11f12fe182f2e87;Sun Jul 31 14:17:45 EDT 2011;Committer;yugui;1;3;3;6;0
ddeccd20f12f82d17bbf572e1ac54bac1409bc5c;Sun Jul 31 14:17:42 EDT 2011;Committer;yugui;2;9;1;10;0
4270dbe629600ac7ab72da3fecd13ba7af234a51;Sun Jul 31 14:17:40 EDT 2011;Committer;yugui;3;14;0;14;0
05ec839244c807c1b6f6f701abd01f5eac41a37e;Sun Jul 31 14:17:37 EDT 2011;Committer;yugui;3;10;2;12;0
2dafa21892b5e75ef64031811d0b6138acf85aa1;Sun Jul 31 14:17:34 EDT 2011;Committer;yugui;2;11;1;12;0
f037909aed0e554b8c53fe7cde258f8ff95047b1;Sun Jul 31 14:17:31 EDT 2011;Committer;yugui;2;7;1;8;0
3441301d7dbb103478abf575251c59c18958e530;Sun Jul 31 14:11:37 EDT 2011;Committer;ktsj;2;12;7;19;0
172ac007f82ab70e215f236185760d6cc06b8379;Sun Jul 31 14:00:57 EDT 2011;Committer;ktsj;2;12;11;23;0
53d3b13233b96b965c84ed628142b1292422319e;Sun Jul 31 11:31:55 EDT 2011;Committer;yugui;5;36;2;38;0
f46cff647e8999b09e72fb8353de6fcd0c007cc1;Sun Jul 31 09:59:01 EDT 2011;Committer;nobu;2;13;0;13;0
70189a8cfd0e06230984b1033635d532c543e39d;Sun Jul 31 02:32:48 EDT 2011;Committer;ktsj;3;27;0;27;0
89b601d176a64f1293a3d3b5195b6735cbf880af;Sun Jul 31 00:19:00 EDT 2011;Committer;drbrain;33;1295;566;1861;0
4ac69a57b5e8587a321b052212ae5b9bedeafe55;Sat Jul 30 16:31:36 EDT 2011;Committer;naruse;2;6;3;9;0
7f958b79961e33bef589aaef8c8596761e845044;Sat Jul 30 16:24:38 EDT 2011;Committer;svn;1;2;2;4;0
8a74797f1399361890b6a2a9255834cd6724763b;Sat Jul 30 16:24:35 EDT 2011;Committer;mrkn;2;4;4;8;0
6466df87a6e94663c0e2ea4f745bcf14f3335635;Sat Jul 30 14:19:11 EDT 2011;Committer;nobu;3;21;10;31;0
321346cfa5fca9da246d83588fbaae2f79fc6069;Sat Jul 30 14:14:46 EDT 2011;Committer;nobu;3;18;6;24;0
cf310f97416686e93841e202462c8bb60fb332e6;Sat Jul 30 13:41:45 EDT 2011;Committer;ngoto;2;6;1;7;0
3761e00f87802b7eea43f037991dfe826e3575ab;Sat Jul 30 08:36:47 EDT 2011;Committer;suke;3;15;15;30;0
5edd7f07d822d45b55737efdf2fa24aea928e7d8;Sat Jul 30 05:31:45 EDT 2011;Committer;mrkn;4;41;1;42;0
cef42f3058b1b9e135f995801f4fe3e2aefee09f;Sat Jul 30 02:23:43 EDT 2011;Committer;kosaki;1;1;0;1;0
ac397a9eeeb2b4a0716cea77ff2de1ace1203dd9;Sat Jul 30 02:22:51 EDT 2011;Committer;kosaki;2;6;2;8;0
18bc6c31a1a0831ae6dda645a13b2df13d761fe8;Sat Jul 30 01:57:06 EDT 2011;Committer;kosaki;4;25;12;37;0
1054b79609f3f468470ae022cea5445e58ed831b;Fri Jul 29 22:40:41 EDT 2011;Committer;akr;2;6;2;8;0
72276eb06b7d16501bd32821befe9b7803a51302;Fri Jul 29 15:49:36 EDT 2011;Committer;nobu;2;2;2;4;0
07cbc8bce8e4798ff7a356d816f43f5bf115615e;Fri Jul 29 15:21:48 EDT 2011;Committer;nobu;1;6;6;12;0
2401971e2d2ed29f15fcbeb556aaf3ace0fb37cf;Fri Jul 29 15:01:27 EDT 2011;Committer;svn;1;2;2;4;0
31eb19bbb66480f65defe1d00df42abe52f109dd;Fri Jul 29 15:01:20 EDT 2011;Committer;akr;2;7;1;8;0
d93746490d15deb4bdf35a47348106a41338002c;Fri Jul 29 14:53:51 EDT 2011;Committer;nobu;4;23;1;24;0
0d6329343aaa02234b89af0ae2a3129470bda760;Fri Jul 29 14:53:47 EDT 2011;Committer;nobu;2;13;1;14;0
d6ec67523643bb0e76f8bacc78116c2ab0a22c35;Fri Jul 29 13:14:59 EDT 2011;Committer;nagachika;1;2;2;4;0
14871a378676977bf343464b32cefb5c3fb1796e;Fri Jul 29 11:52:28 EDT 2011;Committer;akr;2;21;17;38;0
b6ee29c9c0e86a083f3b11fde8d54ffec9f8d27f;Fri Jul 29 11:29:49 EDT 2011;Committer;akr;2;5;1;6;0
8ef6a221443e432a94fb287157eda6f6b95d060b;Fri Jul 29 10:03:25 EDT 2011;Committer;akr;2;359;348;707;0
18f03623a3f9fda3e8b6404ebe7464df2756835b;Fri Jul 29 08:01:45 EDT 2011;Committer;naruse;1;2;2;4;0
b7c350d9639ea981c6acbd5f30361d2803209f63;Fri Jul 29 07:17:37 EDT 2011;Committer;naruse;1;0;1;1;0
012d59029566764d4bca642708cf378a5d79435c;Fri Jul 29 07:17:36 EDT 2011;Committer;svn;1;2;2;4;0
0a4a5b20db3db69fd62804030f3f1008c83d89a6;Fri Jul 29 07:17:35 EDT 2011;Committer;naruse;1;3;1;4;0
63bbbdb6fb1b40b76547c777c3a50bb5d628105b;Fri Jul 29 07:17:32 EDT 2011;Committer;naruse;2;8;1;9;0
60053a0a506440f773da92b09204bde854f4f471;Thu Jul 28 14:47:51 EDT 2011;Committer;nagachika;2;19;11;30;0
e7e87b3c4e5979ab81e924c3f1d26b7a28edbf74;Thu Jul 28 13:48:05 EDT 2011;Committer;nahi;3;33;1;34;0
46247fb35a262b71d193b76ec594c644d6efeabe;Thu Jul 28 05:26:20 EDT 2011;Committer;usa;2;5;1;6;0
d3d44cd9287e47fd84f6a6c7dd9cadb99870e36a;Thu Jul 28 03:32:56 EDT 2011;Committer;nobu;2;6;12;18;0
eda13c7ee2e3946790edad7e84740359367c90fa;Thu Jul 28 03:32:52 EDT 2011;Committer;nobu;3;21;6;27;0
ad8ab9c0132fd5b90187b1ba2825d1fd9eaebe14;Thu Jul 28 03:32:48 EDT 2011;Committer;nobu;2;5;4;9;0
79d8d7439a84782f4c7155fcc8f9da4471a38823;Thu Jul 28 03:32:45 EDT 2011;Committer;nobu;2;5;4;9;0
e2b800113cae1e3b5b28e24f520fe694bd27506b;Thu Jul 28 03:25:55 EDT 2011;Committer;seki;2;29;62;91;0
da6c57aa54182447491d2650269e3ba98437ef86;Thu Jul 28 00:23:28 EDT 2011;Committer;naruse;1;1;1;2;0
cfb37052cb1194d1b972cb7f07975846d1144f12;Wed Jul 27 19:53:44 EDT 2011;Committer;drbrain;2;81;95;176;0
9f3914aba6fe3df5a1c4382b655fb0a7df0cdbfa;Wed Jul 27 17:15:09 EDT 2011;Committer;nobu;5;68;27;95;0
5c815b733d90a82d0d708d836c9a98c9704d8ad4;Wed Jul 27 16:18:54 EDT 2011;Committer;nobu;1;7;2;9;0
a99ef204009aed23aac183076c7724bd95a1e8a3;Wed Jul 27 15:52:23 EDT 2011;Committer;nobu;1;39;35;74;0
9261088ec10c2672bf2a944982a199f857bb1926;Wed Jul 27 15:30:15 EDT 2011;Committer;svn;1;2;2;4;0
d7138d72db03b51d2404b52fe532735d6f3c1b52;Wed Jul 27 15:30:11 EDT 2011;Committer;naruse;3;13;4;17;0
969ae329ee2eddc5099f7212ffd0159bff7fbac5;Wed Jul 27 14:55:40 EDT 2011;Committer;nobu;1;1;1;2;0
dddc9485da5e96d9406f7c4e942aa253d21a12c0;Wed Jul 27 13:49:43 EDT 2011;Committer;nagachika;2;12;2;14;0
9f2b8eafdd89d351ff86b461ba0e8f1061ae210c;Wed Jul 27 08:58:38 EDT 2011;Committer;naruse;2;11;0;11;0
3eb7d2b33e3f8555d81db5369eb6fb7100a91e63;Wed Jul 27 06:44:39 EDT 2011;Committer;drbrain;2;52;0;52;0
e29d58970b9b4814634de55e4d3eb1e77ffdd703;Wed Jul 27 05:21:33 EDT 2011;Committer;naruse;1;1;1;2;0
55b81eb9e659f641edd0c73aa504c7d35970ad8a;Wed Jul 27 03:33:45 EDT 2011;Committer;drbrain;4;30;21;51;0
355076660142581517b794650613f718a1eee30a;Wed Jul 27 02:04:51 EDT 2011;Committer;nobu;1;5;0;5;0
c553ee2db807083a609b728c449956bf5b9f8727;Wed Jul 27 02:04:39 EDT 2011;Committer;nobu;1;1;1;2;0
035ef0a3475943d92f813a6449a33dc07b6d4e4c;Wed Jul 27 01:40:07 EDT 2011;Committer;drbrain;172;175;1060;1235;0
b9c485aa0d6f13303e7e9ab05c6d2b2496610a35;Wed Jul 27 00:31:43 EDT 2011;Committer;emboss;2;89;24;113;0
34fcd4406abd99db3d59b6b58aea52016c66e0fc;Tue Jul 26 16:17:24 EDT 2011;Committer;nobu;1;1;1;2;0
8603c5934a4e613cdb07b04a1ce86fb1f21fdbd5;Tue Jul 26 16:05:35 EDT 2011;Committer;nobu;10;121;10;131;0
298349d03bcdb6c25420d9a92265816d59892a1f;Tue Jul 26 16:05:30 EDT 2011;Committer;nobu;3;26;2;28;0
3fbc65d47fe8d446dde8fe77d3b76fb81f8ffba1;Tue Jul 26 16:05:27 EDT 2011;Committer;nobu;7;26;19;45;0
dca0b4177706c2cd9cda0d38af1b82752982e158;Tue Jul 26 15:49:47 EDT 2011;Committer;mrkn;3;29;5;34;0
079fb8d4c369cfc7d450d6e4d02b112596dcb5ee;Tue Jul 26 15:48:25 EDT 2011;Committer;mrkn;3;23;2;25;0
2fcb91c74c18680fed4c4067bda6aab60abb5de2;Tue Jul 26 15:46:42 EDT 2011;Committer;mrkn;3;31;0;31;0
5ba05758fe549404a5b64fba6418278d16be8cec;Tue Jul 26 15:40:27 EDT 2011;Committer;mrkn;3;25;0;25;0
a987000bbc62348e49f43e2a4fc5128f9345bb59;Tue Jul 26 15:40:27 EDT 2011;Committer;svn;1;2;2;4;0
a238140726b6ce044e89b80b465a9ce0deda8757;Tue Jul 26 15:40:23 EDT 2011;Committer;mrkn;3;73;2;75;0
710dc1afc0ffe7ec031a54e6794af142a35b773c;Tue Jul 26 14:37:09 EDT 2011;Committer;shyouhei;2;5;1;6;0
a18b03c96c0fd74a1008dde2e730a39bf2783e22;Mon Jul 25 15:18:01 EDT 2011;Committer;svn;1;2;2;4;0
da5b7f9229f985a39cd855e92fd5dd3895fd05a2;Mon Jul 25 15:17:56 EDT 2011;Committer;mame;2;15;1;16;0
71ff558ed04ba8fb6019355299aaa3df236897fb;Mon Jul 25 14:40:19 EDT 2011;Committer;usa;2;7;1;8;0
9a27239558d384b197c650e5d12be1d12c33631f;Mon Jul 25 14:29:28 EDT 2011;Committer;mame;5;58;28;86;0
f23ad92a959ba0a09a9c5c4d4ebbd4aef4b676fe;Mon Jul 25 13:23:45 EDT 2011;Committer;nahi;1;2;0;2;0
2fff0f4f71452e161825f079de9f7c65b088b260;Mon Jul 25 13:21:49 EDT 2011;Committer;nahi;3;42;4;46;0
0a9b952c6f314665af1a58f6f411f752343e9691;Mon Jul 25 06:30:07 EDT 2011;Committer;nahi;6;346;340;686;0
8c30497aaefac8e4b11fd1f564509c75bb6a249b;Mon Jul 25 04:49:26 EDT 2011;Committer;nahi;3;12;9;21;0
e80d1f8faf82e66769a47c31671734aff890fdf1;Mon Jul 25 04:30:06 EDT 2011;Committer;svn;1;2;2;4;0
6c8a2fe247a93403257fe2af76b67180055069b4;Mon Jul 25 04:30:02 EDT 2011;Committer;nahi;2;13;1;14;0
29f354df6350f960a9ecf8a5e363208ead010a6c;Sun Jul 24 11:35:56 EDT 2011;Committer;akr;2;42;12;54;0
0283c3d0bba4f4fca5da128bb0544e5745778cb3;Sun Jul 24 11:04:11 EDT 2011;Committer;akr;2;17;3;20;0
f5b9de7502139b6c4013476e89b207fe39a5c104;Sat Jul 23 23:57:50 EDT 2011;Committer;akr;3;101;5;106;0
6b3ec75c7f31fbfa72d7fb17626744f40b2a6b73;Sat Jul 23 16:05:19 EDT 2011;Committer;drbrain;3;21;3;24;0
1e52e560374c5cb5f435327f042ecff43697a2ad;Sat Jul 23 15:57:21 EDT 2011;Committer;kosaki;2;1;12;13;0
e39294cac530389e983a57c59b7daa8a2a77d2f6;Sat Jul 23 15:18:32 EDT 2011;Committer;kosaki;2;12;1;13;0
9eba5f65e230bfc308161194c09288b34118ea54;Sat Jul 23 15:05:07 EDT 2011;Committer;svn;1;2;2;4;0
4dc1a2180946ab793adee5eb235fc4ee8fa4cefe;Sat Jul 23 15:05:03 EDT 2011;Committer;nobu;7;167;14;181;0
a7c15b2617620b79ea734faf31dacc8e72ed5ad1;Sat Jul 23 12:49:06 EDT 2011;Committer;tadf;1;1;1;2;0
f0fa1d7a5a650206daac14f2093fd248d4267f9d;Sat Jul 23 12:14:43 EDT 2011;Committer;tadf;2;5;1;6;0
fe4ceb25b907b5cc5af46cc0d32ca67b10d7d7d5;Sat Jul 23 11:21:55 EDT 2011;Committer;naruse;4;16;4;20;0
f99bed93302a0485b615dd651915d1262c1d1bcb;Sat Jul 23 11:17:00 EDT 2011;Committer;tadf;3;18;13;31;0
e845e35fa31766f347abdb86bf69793d584537fc;Sat Jul 23 10:13:53 EDT 2011;Committer;suke;2;15;0;15;0
65658ea0d4f17b90bb09003405a7560d6df0b58e;Sat Jul 23 10:03:30 EDT 2011;Committer;naruse;3;20;0;20;0
2bcd502a71bc0a140f3b78ed0d148745fb648555;Sat Jul 23 08:13:37 EDT 2011;Committer;akr;5;42;19;61;0
c93ed570a2991f5ec059526941f442eadacc3cb1;Sat Jul 23 05:38:50 EDT 2011;Committer;drbrain;11;238;182;420;0
12d9be6b727bdfe605fc65f18659c4cb4d4b283c;Sat Jul 23 03:19:07 EDT 2011;Committer;nobu;2;31;4;35;0
d9242d596658382cfc69c0a617ad167630d20687;Sat Jul 23 03:12:28 EDT 2011;Committer;nobu;3;8;1;9;0
a3f5a5952f78827b4982f3d6e6f19a424926b26e;Fri Jul 22 21:16:54 EDT 2011;Committer;svn;1;2;2;4;0
93177c1e5c3906abf14472ae0b905d8b5c72ce1b;Fri Jul 22 21:16:50 EDT 2011;Committer;naruse;1;1;1;2;0
201179fc2ad9c31395addd929989bcce0fd43c07;Fri Jul 22 13:01:12 EDT 2011;Committer;kosaki;1;1;1;2;0
5975e9e008111d82885946b104fbe3f8fb800160;Fri Jul 22 12:52:25 EDT 2011;Committer;kosaki;2;8;1;9;0
b5f91deee04aa6ccbe07c23c8222b937c22a799b;Fri Jul 22 12:29:13 EDT 2011;Committer;naruse;2;8;2;10;0
34918aa83260246e545911efe6e1672507c3e699;Fri Jul 22 12:06:42 EDT 2011;Committer;nobu;8;178;26;204;0
c276b7380499eb5b181eca838ec86fc480d4ac94;Fri Jul 22 11:44:53 EDT 2011;Committer;nobu;3;19;0;19;0
b8a1e15ef120f824a7ab7d1fa793dc2da8154ac9;Fri Jul 22 11:37:06 EDT 2011;Committer;kazu;2;7;2;9;0
e0060732f13f1f930feeb390e883f307dd0f89d4;Fri Jul 22 10:05:49 EDT 2011;Committer;nobu;2;7;2;9;0
256eae162c094584146c52e77f2f36cb1628cbfc;Fri Jul 22 09:33:41 EDT 2011;Committer;nobu;1;1;1;2;0
fba1063c5f6f4a1b2b10d6bebfc443eb94a36943;Fri Jul 22 07:12:22 EDT 2011;Committer;nobu;1;7;8;15;0
a58c76cc204b4e0824b5701f1b4ef3b7cf2f86e4;Fri Jul 22 04:58:10 EDT 2011;Committer;drbrain;2;6;1;7;0
c1fa17c13897f4c1343da1cc3ef7c67f34e98634;Fri Jul 22 04:52:22 EDT 2011;Committer;drbrain;2;67;6;73;0
af017841509b5cce4b82466f564186ea53774688;Fri Jul 22 04:11:38 EDT 2011;Committer;emboss;2;8;7;15;0
afd3a18fc3662ebc717a183b718ad2dae89bc0c4;Fri Jul 22 03:16:48 EDT 2011;Committer;drbrain;2;28;8;36;0
00a006511b4b46298ac6cdebbeabb48d65d94ae8;Fri Jul 22 02:21:26 EDT 2011;Committer;emboss;3;23;6;29;0
84e835fe4a68586fcb17adc2a6140c737c83dd62;Fri Jul 22 00:13:07 EDT 2011;Committer;emboss;3;27;1;28;0
480c0f69bd7aa81eda0f5b269427442a8a45f6b3;Thu Jul 21 21:37:46 EDT 2011;Committer;svn;1;2;2;4;0
616cae109036d3abf786b7f2db68a78714d740e5;Thu Jul 21 21:37:43 EDT 2011;Committer;marcandre;3;20;1;21;0
272322bedeecfc0ef908e4746df4fea9b5cf90a3;Thu Jul 21 12:02:45 EDT 2011;Committer;akr;2;14;2;16;0
9752864b888a368188afaaf103e44f6da054c7dc;Thu Jul 21 11:09:52 EDT 2011;Committer;mame;3;55;0;55;0
e98c84519f117825017769825e6303ffb9dd4f7f;Thu Jul 21 10:35:52 EDT 2011;Committer;mame;2;14;0;14;0
579f2a0aa84664382ddbab1e4aef1a6ed8fa6455;Thu Jul 21 09:12:36 EDT 2011;Committer;naruse;2;6;1;7;0
35f2f9bf13a48d5fa6f8c6213f454303e687e861;Thu Jul 21 08:31:44 EDT 2011;Committer;naruse;2;6;1;7;0
2dfc9e162615a326eb639bd51ce0ae9ec3d439e4;Thu Jul 21 08:27:08 EDT 2011;Committer;naruse;3;21;4;25;0
4aa9e1ace0c240a99bd41b59a3df736948198480;Wed Jul 20 15:20:14 EDT 2011;Committer;naruse;1;11;0;11;0
4c58bed876c2c3646d031a2f7e8facee8b50c2be;Wed Jul 20 15:00:06 EDT 2011;Committer;svn;1;2;2;4;0
55b0c9fb6caf4e578982ac7354a943d2d6cc4289;Wed Jul 20 15:00:00 EDT 2011;Committer;kazu;2;6;1;7;0
b41ccc4a9c4d4900e79642bb98ad87b2ba63e766;Wed Jul 20 13:26:10 EDT 2011;Committer;akr;15;80;2;82;0
13f62a384b48a5e8ade2319e102a6aa31a0321c9;Wed Jul 20 06:50:54 EDT 2011;Committer;naruse;2;8;0;8;0
7e0907ceddbd939ea3d04c9630ad509ade7a4d60;Tue Jul 19 22:17:13 EDT 2011;Committer;kazu;2;8;0;8;0
0c65c82860c47f0a9d3a65254d6edc26b4e2b155;Tue Jul 19 15:00:03 EDT 2011;Committer;svn;1;2;2;4;0
1278d514320b568e49e5f3478d7215ca90e404c6;Tue Jul 19 15:00:00 EDT 2011;Committer;kazu;1;1;1;2;0
8ea395f546b3f56bcb70aee7dbcf79dae4393aca;Tue Jul 19 07:39:54 EDT 2011;Committer;takano32;2;6;2;8;0
b1c03685bc8cb5eda9681e10d099764941a2da38;Tue Jul 19 07:27:26 EDT 2011;Committer;akr;2;11;11;22;0
bd793165aec8d9404e0e9d82ce9333d7f3208e3b;Tue Jul 19 07:10:23 EDT 2011;Committer;svn;1;2;2;4;0
2c7576a0214aab975bc6b7ac6e04eaa5aaf07d55;Tue Jul 19 07:10:19 EDT 2011;Committer;akr;4;17;0;17;0
dc22968239d57dddbfb5ef33ff07d013e7518611;Mon Jul 18 04:38:37 EDT 2011;Committer;tenderlove;4;22;1;23;0
d95cb162340c4b769397569b1e0760d226c054f6;Sun Jul 17 15:10:09 EDT 2011;Committer;svn;1;2;2;4;0
e5f8aa95a3a41ce3543e61f64c6f2f6c183add0b;Sun Jul 17 15:10:06 EDT 2011;Committer;shugo;3;164;1;165;0
e4324d714fa5925b68d7aeb9f5699de9b4b9a723;Sun Jul 17 14:09:44 EDT 2011;Committer;nagachika;1;0;8;8;0
e2fd80b3d3b7f8ca7ffc2e7286fdb59e0c44bc79;Sun Jul 17 07:26:45 EDT 2011;Committer;nobu;8;79;5;84;0
18f0a65018dd357a1815941618d3cf9f274e6239;Sun Jul 17 06:30:10 EDT 2011;Committer;nobu;3;37;8;45;0
1297cc615c5ddbe70451e94568798dbd40dbd414;Sun Jul 17 03:17:17 EDT 2011;Committer;nobu;1;58;0;58;0
6349c7bf4dcbd33e92f8b187d83b8fad22cd8fb0;Sat Jul 16 23:02:46 EDT 2011;Committer;svn;1;2;2;4;0
f8a538495e01aaa6c6fe0de1f09052d971bd064b;Sat Jul 16 23:02:42 EDT 2011;Committer;emboss;2;38;2;40;0
2915c155e825d5e012b2b4489ac11fc20759ed44;Sat Jul 16 08:29:21 EDT 2011;Committer;nobu;2;11;3;14;0
c2dfaa7d40531aef3706bcc16f38178b0c6633ee;Fri Jul 15 21:28:10 EDT 2011;Committer;marcandre;3;26;6;32;0
e05e9928430f94ef14dbf4c4adee7e24e18ec79f;Fri Jul 15 18:24:55 EDT 2011;Committer;usa;1;1;0;1;0
5a7a4ce48df6390fcc96a7a6030ce2b0095ad141;Fri Jul 15 18:22:42 EDT 2011;Committer;usa;2;8;0;8;0
6125467117b48c99f9ad688bb6547ca597027009;Fri Jul 15 16:06:58 EDT 2011;Committer;svn;1;2;2;4;0
6270ce85ed36d2844166facb937c2a9f63fb022f;Fri Jul 15 16:06:53 EDT 2011;Committer;kosaki;3;23;1;24;0
4b29cccf57c44f112c4ee06f30962060a16ae0aa;Fri Jul 15 10:16:41 EDT 2011;Committer;mrkn;2;10;0;10;0
ade91aca9fd5902e33496a1a3fd1994ca66259fe;Fri Jul 15 05:37:50 EDT 2011;Committer;usa;1;11;0;11;0
f15d0deaaf1ae0b92c539bd823dd2b00afbaf502;Fri Jul 15 05:33:45 EDT 2011;Committer;usa;3;8;8;16;0
e56f2abe4b775dcee4690ef43cbac71bbce2a5af;Fri Jul 15 03:03:31 EDT 2011;Committer;nahi;3;23;2;25;0
0419cfc2ede2b62e38e6fd2baeee06a248477ccd;Thu Jul 14 16:51:32 EDT 2011;Committer;svn;1;2;2;4;0
e8ab94ede0609bb02cea9960e685fd3752dbe762;Thu Jul 14 16:51:29 EDT 2011;Committer;nobu;3;11;2;13;0
301a11b24b728aa15b811c50f68396a81cf15b85;Thu Jul 14 07:56:22 EDT 2011;Committer;kazu;1;1;1;2;0
ab86f1cffb204ab2c51c39926b9c34c4e608c5ad;Thu Jul 14 05:41:05 EDT 2011;Committer;nahi;5;39;3;42;0
f10ef64f1b969cb7a4af50c6a898bc81d1467b23;Thu Jul 14 01:54:13 EDT 2011;Committer;svn;1;2;2;4;0
dc08ed037f3ada1640697c0b9c52a27fdf2a5fc8;Wed Jul 13 13:55:57 EDT 2011;Committer;kazu;1;1;1;2;0
a289ef416221e7a6d18675c57f19939978207a02;Wed Jul 13 13:11:48 EDT 2011;Committer;svn;1;2;2;4;0
145b721829919dd082ced363ea7fae141b688492;Wed Jul 13 13:11:41 EDT 2011;Committer;nagachika;2;3;3;6;0
8cf76cae70190cd533d6f9a114281ea01da9cd90;Tue Jul 12 14:42:48 EDT 2011;Committer;kosaki;2;15;1;16;0
55b3bfbc4cf890cb2ebd6b7853189edd442bdad9;Tue Jul 12 11:04:58 EDT 2011;Committer;kosaki;3;7;16;23;0
ba5d78581af66d6bb821f6dce40fcadc6727d929;Tue Jul 12 08:15:47 EDT 2011;Committer;matz;2;8;1;9;0
1d4da24e2148a81ccbcb6bbc4aebf875fa4c2e34;Tue Jul 12 08:09:15 EDT 2011;Committer;sorah;2;19;21;40;0
7fd8266516393afb6e9fdedd028e01daccc46c75;Tue Jul 12 05:12:29 EDT 2011;Committer;kosaki;1;2;18;20;0
c307523565e0a8815bfd0d7deeed8b9ae7796e16;Tue Jul 12 05:08:28 EDT 2011;Committer;kosaki;2;6;0;6;0
89e2951bde9b7f4e04a8f068bfde6756aebf74af;Tue Jul 12 04:55:50 EDT 2011;Committer;kosaki;3;78;0;78;0
888d8e93e1149991e2edaa5ddb78c11f803b4063;Tue Jul 12 02:59:17 EDT 2011;Committer;svn;1;2;2;4;0
edeba4dbe6fac8e5693b8e5bff12f09a93d22999;Tue Jul 12 02:59:11 EDT 2011;Committer;usa;2;14;0;14;0
2a5aa8cdaa3343b8b9af17c3cdb827d6bae59dcc;Mon Jul 11 14:29:45 EDT 2011;Committer;kanemoto;2;9;0;9;0
f078ced91f188f992931b0f0c30c0ef2e0c2f952;Mon Jul 11 09:56:55 EDT 2011;Committer;ryan;1;4;0;4;0
abf99e80bf11fefd3a8dfdce879e0b6ee66cf136;Mon Jul 11 06:56:06 EDT 2011;Committer;kosaki;2;4;4;8;0
9826b8203856ab799b52bc28a559f5679525a9f5;Mon Jul 11 06:16:39 EDT 2011;Committer;usa;1;2;1;3;0
12adf25a80227737ee09c50ae156cf2dd451b19a;Mon Jul 11 06:03:41 EDT 2011;Committer;usa;2;6;1;7;0
e4c452daf8030575f83c3bae49cb0fe9a76c7e89;Sun Jul 10 20:39:35 EDT 2011;Committer;kanemoto;2;6;0;6;0
74b339e9385181844ee44d155ac59c8544e5016c;Sun Jul 10 17:04:40 EDT 2011;Committer;kosaki;8;33;71;104;0
0b6c9402c77692b290537a66517e12bda8f6a6bb;Sun Jul 10 15:40:10 EDT 2011;Committer;svn;1;2;2;4;0
0b2db1ab4c92be307305821a5392b5ac2c75ba46;Sun Jul 10 15:40:07 EDT 2011;Committer;mrkn;1;2;0;2;0
a4f423f18bd60312c7e6e503c60e368c064abbd1;Sun Jul 10 14:54:03 EDT 2011;Committer;yugui;4;12457;12429;24886;0
431812bd62be5f204f7ad8acbf6d61981ab47ee4;Sun Jul 10 14:31:10 EDT 2011;Committer;yugui;2;5;1;6;0
99f8f14d89308c17d8e9e53e03dd5ead6984e7fc;Sun Jul 10 14:05:07 EDT 2011;Committer;mrkn;3;35;7;42;0
819c2418b11d911f9ff0c81ad13a82f43b1092ee;Sun Jul 10 13:59:00 EDT 2011;Committer;nobu;1;1;1;2;0
577c03c7130e5776e0958d870e1aaf545d59e40e;Sun Jul 10 13:38:17 EDT 2011;Committer;nobu;3;87;21;108;0
ce698d4c0d4eb9c48650466b7f1566c869eb2e01;Sun Jul 10 12:52:03 EDT 2011;Committer;ko1;2;10;1;11;0
7506a580fefcf89365d0480abfe47c6894117c0c;Sun Jul 10 12:19:16 EDT 2011;Committer;sorah;13;99;106;205;0
9cf9d5eaf7923498a3ece7f6757c9010aaa55e71;Sun Jul 10 09:04:44 EDT 2011;Committer;ko1;3;43;0;43;0
b9a13f4962333f08338b9839d1bd9151665ac8aa;Sun Jul 10 08:29:46 EDT 2011;Committer;kosaki;4;13;5;18;0
a2e497d5ede45bd4f4a57f494027020d7bd1733b;Sun Jul 10 08:01:04 EDT 2011;Committer;naruse;20;537;191;728;0
a119b9d146fea877acc1e9ba5df0702163ce917a;Sun Jul 10 07:46:00 EDT 2011;Committer;kosaki;4;23;0;23;0
04b182a4f8a2ab719e56b5d311422c46bb3a9ba6;Sun Jul 10 07:17:50 EDT 2011;Committer;kosaki;1;1;0;1;0
2acd61551bbc2f0bb00cbe5de74d731edd9f404b;Sun Jul 10 07:12:02 EDT 2011;Committer;kosaki;2;6;1;7;0
564fb6a795b8a9692664f3c541d5aec4fd1f69c7;Sun Jul 10 06:32:06 EDT 2011;Committer;mrkn;3;40;1;41;0
8c812c9a03027617b3681205544a26f297d4d641;Sun Jul 10 06:11:49 EDT 2011;Committer;sorah;2;111;3;114;0
32af4ed47f18839d3d783c3d2ab6f8895a81d6be;Sun Jul 10 05:59:12 EDT 2011;Committer;tadf;2;21;6;27;0
919978a8d9e25d52697c0677c1f2c0ccb50b4492;Sun Jul 10 05:19:47 EDT 2011;Committer;ko1;2;14;2;16;0
ebd61e5f289958fbba5f54d9ff6bf916de524819;Sun Jul 10 03:19:49 EDT 2011;Committer;mrkn;3;548;35;583;0
b88daae7ecd3853f4c56d9bb74e0e06ea2a0a939;Sun Jul 10 03:11:52 EDT 2011;Committer;mame;2;14;1;15;0
b0f115da1a8952e2328e3ef872bb2903c45ed96f;Sun Jul 10 02:42:07 EDT 2011;Committer;mame;2;10;0;10;0
d22e08f9375dbc0d0a962751d1c57f17b22f01b6;Sun Jul 10 00:47:31 EDT 2011;Committer;tarui;3;10;0;10;0
b1d647c809a86b8068a327ce2398c89c3823dc61;Sun Jul 10 00:13:37 EDT 2011;Committer;drbrain;2;6;2;8;0
19065fe3f507445a82d0c8ed29a471d81e96ad79;Sat Jul 09 19:11:10 EDT 2011;Committer;svn;1;2;2;4;0
53e667a9ebcb5c234b0df850121561e09e9fc4d9;Sat Jul 09 19:11:06 EDT 2011;Committer;naruse;1;0;9;9;0
aef7007477fe6c2ca1a798ff85884a9a3d9b9d97;Sat Jul 09 11:06:43 EDT 2011;Committer;tadf;2;5;1;6;0
bc11aa72d322c910bf898324f6f64f7b49cc92df;Sat Jul 09 10:50:51 EDT 2011;Committer;tadf;3;13;2;15;0
88b6d5050bfaa9f0677cc8db2ad98dc155d067b1;Sat Jul 09 08:25:35 EDT 2011;Committer;tadf;2;12;8;20;0
057e0a373cee4f033e95c2d4a83e75587dade91a;Sat Jul 09 08:18:57 EDT 2011;Committer;tadf;2;259;175;434;0
2a8a9d1def49b2673814e2307520fd02f9d536dd;Sat Jul 09 07:56:04 EDT 2011;Committer;nobu;2;17;2;19;0
03c618daf0f7a0e668e1f4eb25e5aa139bfb5175;Sat Jul 09 07:54:38 EDT 2011;Committer;nobu;2;7;0;7;0
63ab1901516e3e0afd987a79c07fae261b4045c3;Sat Jul 09 06:59:23 EDT 2011;Committer;nobu;3;9;4;13;0
7fd78fad3e9d650f7dcdfdd40b3045e3a5443f20;Sat Jul 09 05:32:19 EDT 2011;Committer;xibbar;3;18;2;20;0
57da3d94aa649614958d5ceef989f3fd758c2bb7;Sat Jul 09 04:18:09 EDT 2011;Committer;kosaki;1;3;3;6;0
1e696acc7e86a6d57fe6afa91c7478420c62bc2b;Sat Jul 09 02:41:14 EDT 2011;Committer;marcandre;3;33;1;34;0
d137810d3a79e42b8ea7a52b04df0d3d1bc03ab9;Sat Jul 09 00:25:27 EDT 2011;Committer;drbrain;2;8;3;11;0
0c3833ec5ab485175edefe78b307af0f2acdd973;Sat Jul 09 00:21:44 EDT 2011;Committer;drbrain;2;13;5;18;0
dd2dfc71e7c887b054c0eef930ff1a708fc2de52;Fri Jul 08 23:39:42 EDT 2011;Committer;nobu;5;9;2;11;0
01d18fe0168ba6ba71a6652cd3ebf5a1ea478496;Fri Jul 08 23:37:12 EDT 2011;Committer;svn;1;2;2;4;0
dc3697f62f4eb78093be3c95a8f8f265d3f184f5;Fri Jul 08 23:37:08 EDT 2011;Committer;nobu;2;11;0;11;0
e33183acca3d11bbfae6f4551bca890cf7d4280a;Fri Jul 08 12:23:10 EDT 2011;Committer;naruse;4;15;5;20;0
29e497d231b91237ca4a1b6d6eaaf7ace869508e;Fri Jul 08 09:00:54 EDT 2011;Committer;nobu;3;24;24;48;0
bc1fd9458d6e168ab49f0b648a5fb1ba41702367;Fri Jul 08 09:00:51 EDT 2011;Committer;nobu;2;2;2;4;0
4902ef7d591fb01f6c9f70ec194e147c47935541;Fri Jul 08 07:40:41 EDT 2011;Committer;nobu;4;24;6;30;0
b16fd08622a5b79259c7af22ef2ce8b06652d79e;Fri Jul 08 07:39:09 EDT 2011;Committer;nobu;3;20;35;55;0
b0f8bda2dad36c25b5dfaccb4eec9c876b1fb6c2;Fri Jul 08 07:39:07 EDT 2011;Committer;nobu;1;2;2;4;0
c23dea553ed97146e4652fb1bf4e66ac652e7d28;Fri Jul 08 07:01:16 EDT 2011;Committer;nobu;1;1;0;1;0
837e73ab6dbc15ca1cbf726eb34a9535c009c4bf;Fri Jul 08 07:01:12 EDT 2011;Committer;nobu;1;2;2;4;0
9878d2199c8d5c20253d765d7837f17973b14498;Fri Jul 08 06:53:33 EDT 2011;Committer;nobu;2;13;1;14;0
8de18f9cda17997c4831c15e74574c44a6100ff5;Fri Jul 08 06:03:17 EDT 2011;Committer;usa;2;6;0;6;0
fc22563658a795e5bbd316245caabae6ae0f4252;Fri Jul 08 05:41:52 EDT 2011;Committer;usa;2;6;6;12;0
c3e05262697f64218259b63acfd6933958c62eae;Fri Jul 08 05:39:50 EDT 2011;Committer;nari;2;9;5;14;0
b4582e79d7bab19789bbe26bbfab6f363a6e477c;Fri Jul 08 05:36:57 EDT 2011;Committer;usa;2;7;0;7;0
8739bb305daac9fdf134e5cf16d46b89619b484e;Fri Jul 08 04:57:27 EDT 2011;Committer;kosaki;1;6;0;6;0
554a33d838a12e92d112d1bba6dac322d4d8160e;Fri Jul 08 04:50:25 EDT 2011;Committer;kosaki;2;25;29;54;0
874127452910c0e8ef2f92923b00d0d318520f7f;Fri Jul 08 04:40:01 EDT 2011;Committer;kosaki;4;17;3;20;0
4ad2d02a49b0ec009599c3a2c8683bd45119792b;Fri Jul 08 04:09:00 EDT 2011;Committer;kosaki;2;7;2;9;0
b43b6cf71f4ce482d46fd60364b457afe2963078;Fri Jul 08 02:39:15 EDT 2011;Committer;nobu;3;7;1;8;0
4837d6d5b5a84fbf4f52a2c96defd06876fb3138;Fri Jul 08 02:08:29 EDT 2011;Committer;nobu;1;1;0;1;0
affa47ae4db231c37b9da85f66e2ed50182b86f5;Fri Jul 08 01:40:54 EDT 2011;Committer;kosaki;2;7;0;7;0
50b64ee7dea249c1324b27742ce55cf6f9eef2a8;Fri Jul 08 00:18:39 EDT 2011;Committer;drbrain;2;56;25;81;0
ba64040e9a531ea4b6013fda066593248178f792;Thu Jul 07 15:23:47 EDT 2011;Committer;svn;1;2;2;4;0
f90739e22bf43c27d62e4144499340b00f182a38;Thu Jul 07 15:23:39 EDT 2011;Committer;kazu;1;3;3;6;0
17bb77fd776ab39b7fb6b90c45feb6a7899a62ef;Thu Jul 07 14:59:09 EDT 2011;Committer;nari;3;76;8;84;0
68a0d412dd36b0caf1551089d8e6c64819854b6f;Thu Jul 07 09:09:44 EDT 2011;Committer;kosaki;1;4;0;4;0
1a1c95404f8842b7327e76e945ef747554e37709;Thu Jul 07 08:56:12 EDT 2011;Committer;usa;2;10;2;12;0
cfa0035962f7c373ca612be5bee749803368fd5b;Thu Jul 07 06:44:46 EDT 2011;Committer;nobu;6;49;7;56;0
f4ca906d5c3267c0f84db4c5780829783c71a8b6;Thu Jul 07 06:40:33 EDT 2011;Committer;nobu;2;14;8;22;0
136c117fc1c5e396f71d2db0a192fb195bb5f37e;Thu Jul 07 06:23:40 EDT 2011;Committer;naruse;2;40;2;42;0
a259db72b72c9cdf1059c15f6c99fdab3fbfc1a7;Wed Jul 06 21:57:16 EDT 2011;Committer;naruse;2;5;1;6;0
789b288d10f287055c657dc78d1826f5dba6dd0c;Wed Jul 06 21:47:56 EDT 2011;Committer;drbrain;2;25;1;26;0
0e7da28c98711f807b86900f37bd5bed22922dd5;Wed Jul 06 21:19:59 EDT 2011;Committer;drbrain;3;13;5;18;0
c1d84bfcdb113364f9fcdef94a07961613743ff3;Wed Jul 06 19:31:33 EDT 2011;Committer;nobu;3;13;3;16;0
ca252765bcfd1b05189a73e366d361d4eefbd988;Wed Jul 06 16:12:51 EDT 2011;Committer;usa;1;2;2;4;0
b76263fa09f778179e277b234b0057aadbcba6f9;Wed Jul 06 15:43:38 EDT 2011;Committer;usa;2;34;4;38;0
1fc2d3e4a9d4374df91976a83ce4bd0969222612;Wed Jul 06 15:39:32 EDT 2011;Committer;svn;1;2;2;4;0
aab018f8febefe2171d97d40c11a85a4c7b3fbf1;Wed Jul 06 15:39:27 EDT 2011;Committer;matz;2;13;0;13;0
2ab094ba4dc078747bf2393693aca88cbeb99735;Wed Jul 06 13:13:09 EDT 2011;Committer;sorah;2;10;1;11;0
0242fe816ca736a927d551f64e9ba5d2263fed32;Wed Jul 06 12:31:53 EDT 2011;Committer;kosaki;2;12;6;18;0
032e56fbd66d3dd1aa144a86f4a90b667dcff649;Wed Jul 06 12:29:09 EDT 2011;Committer;kosaki;2;14;3;17;0
c454ee6c9fdce8fb558fee0198aea307157ccb23;Wed Jul 06 12:24:25 EDT 2011;Committer;kosaki;2;12;1;13;0
302fcb568d817bed348f554f1be28951ad924449;Wed Jul 06 12:22:56 EDT 2011;Committer;kosaki;2;5;1;6;0
a737fc8ace0d56354f618c6657d7042a7423e851;Wed Jul 06 12:21:50 EDT 2011;Committer;kosaki;2;5;1;6;0
5738ab331eaa73794fb3ece9f9779b00f2288765;Wed Jul 06 09:12:33 EDT 2011;Committer;sorah;2;11;4;15;0
eb983e86e720dbeac771c2d6a37e85383e8e0596;Wed Jul 06 05:54:06 EDT 2011;Committer;svn;1;2;2;4;0
453726f26a0a909357cbb757b648fc5fcb2b181b;Wed Jul 06 05:54:01 EDT 2011;Committer;sorah;2;11;1;12;0
c9730974686070bc180c016d126930d3b3ca0ada;Tue Jul 05 10:09:04 EDT 2011;Committer;naruse;1;1;1;2;0
2ac460af94948caa8af7c13648a0d3a7e46eb446;Tue Jul 05 06:28:07 EDT 2011;Committer;nobu;3;30;6;36;0
eb78d224e3bb0747d4ae671e3aa4068d94398d00;Tue Jul 05 05:08:23 EDT 2011;Committer;mame;2;9;1;10;0
8fb2058d825f1e795153255ea99ecc4aa70ed414;Tue Jul 05 05:06:05 EDT 2011;Committer;naruse;3;98;5;103;0
fed26e916bdc9f03f1c27b2bbc47fda6b2236c74;Mon Jul 04 16:32:21 EDT 2011;Committer;mame;2;21;0;21;0
d6a5698d8a14efa0479347fee7c7a40f4966b823;Mon Jul 04 16:32:12 EDT 2011;Committer;mame;2;7;1;8;0
a5305216bbc85595558e6dc50741a516b88ad5d2;Mon Jul 04 16:32:05 EDT 2011;Committer;mame;2;5;0;5;0
917df93b0dd37f1bf69fc8633f47d1a0fdcaeaa2;Mon Jul 04 16:14:02 EDT 2011;Committer;nagachika;1;4;4;8;0
f413992431cd03937c8326e54c3ba5d14aa54d80;Mon Jul 04 15:55:10 EDT 2011;Committer;svn;1;2;2;4;0
ea8b916307b739798a1710c4443677c5e0bf314a;Mon Jul 04 15:55:06 EDT 2011;Committer;nagachika;3;51;9;60;0
e6d42f34e2cbd2c6a9133d4e972ceda58af43bc0;Mon Jul 04 13:27:31 EDT 2011;Committer;kosaki;2;12;1;13;0
1e8adda1fc192247a09c29c5806eb647e427028a;Mon Jul 04 12:58:07 EDT 2011;Committer;kosaki;1;1;1;2;0
74454f5796fda5c7ec2d47a95acccb7d742a0974;Mon Jul 04 12:21:02 EDT 2011;Committer;mame;3;18;42;60;0
276033220d75692dd1f6a6c3823748202f3eb125;Mon Jul 04 10:22:44 EDT 2011;Committer;mrkn;1;2;2;4;0
49c0b143e420d51f4e6da9e73eb229bda738828d;Mon Jul 04 06:52:39 EDT 2011;Committer;nobu;1;1;1;2;0
6dad6f5c4c2c71021c8b80790d9a72f31aba6905;Mon Jul 04 06:52:35 EDT 2011;Committer;nobu;1;2;0;2;0
cc30e4031993de270e1105a7549f34fdf93002c5;Mon Jul 04 06:49:53 EDT 2011;Committer;nobu;1;5;5;10;0
d55560d551082a081d8fac85f30f029af99bdec3;Mon Jul 04 06:49:15 EDT 2011;Committer;nobu;1;1;5;6;0
948f01a865a0dec8e7edf3e71eb72f055ea3ebba;Sun Jul 03 22:16:02 EDT 2011;Committer;naruse;2;14;3;17;0
eb35bb0b351f55459fdfce7198e8756e37141dff;Sun Jul 03 21:56:59 EDT 2011;Committer;ko1;5;41;0;41;0
4937a6dec45f33f7158565cfc65e24dc5b00dded;Sun Jul 03 21:09:54 EDT 2011;Committer;svn;1;2;2;4;0
05117a4917152cb4f0dfa216c19314a902d57922;Sun Jul 03 21:09:50 EDT 2011;Committer;kosaki;1;2;0;2;0
3b63aee19353db475bde05c2be2c4a371b618a1e;Sun Jul 03 14:44:59 EDT 2011;Committer;yugui;2;21;2;23;0
6343e30c147dc00e34e9d45ea3f74f94873b9709;Sun Jul 03 04:44:53 EDT 2011;Committer;nobu;3;20;23;43;0
b582f2a1233b1ca59e707b489bb0187349f500b7;Sun Jul 03 01:07:12 EDT 2011;Committer;nobu;1;1;1;2;0
70dd402cd8357097d1090972585fe23bc940ae41;Sat Jul 02 21:18:16 EDT 2011;Committer;kosaki;2;23;8;31;0
560c1aeba991f0c0276f786e242d7bceed5fdf83;Sat Jul 02 19:59:14 EDT 2011;Committer;svn;1;2;2;4;0
5a73c71dcf4b32c9c30f2cb68bac1d274839488f;Sat Jul 02 19:59:05 EDT 2011;Committer;kosaki;3;36;11;47;0
5a31811f411d5baebe94072f779523a139a4ee59;Sat Jul 02 01:02:39 EDT 2011;Committer;mrkn;1;1;1;2;0
a5615faba16106e17a66d225bf7ad7782615af94;Sat Jul 02 00:03:29 EDT 2011;Committer;emboss;3;9;2;11;0
5ce01ed12fd1b74db5238c13c9d4428574a61c7b;Fri Jul 01 22:27:48 EDT 2011;Committer;marcandre;1;1;3;4;0
d1999f393faf98610125403dd01e11b532011ed7;Fri Jul 01 22:25:32 EDT 2011;Committer;marcandre;1;0;1;1;0
e7047b8a373f12ee8debb9f13e2940e17aa5f10e;Fri Jul 01 22:17:46 EDT 2011;Committer;nobu;3;64;20;84;0
a943788fb748d7d99e6f9500da1e9cf02854cdd5;Fri Jul 01 16:59:58 EDT 2011;Committer;mrkn;2;5;1;6;0
a108a97f9816acbc3cc9286c7aee6dee8246a12e;Fri Jul 01 16:00:49 EDT 2011;Committer;svn;1;2;2;4;0
2a1b73ee40ccf923edce4ecc2eae715f368d8515;Fri Jul 01 16:00:45 EDT 2011;Committer;mrkn;2;9;0;9;0
f44446c45d8875d5e5d6e556da8d1ff3d4452cab;Fri Jul 01 10:39:12 EDT 2011;Committer;kosaki;42;94;44;138;0
0fe64693a7d018dde9b9a5d88dd7a9eac60ea14d;Fri Jul 01 09:48:34 EDT 2011;Committer;nobu;1;3;3;6;0
22412ceda46b551047afc7e0724ffd67ce8d0bdc;Fri Jul 01 06:33:14 EDT 2011;Committer;marcandre;1;1;1;2;0
c8e23882574a7cf14c5800369ca1e838eea7fe88;Fri Jul 01 06:23:12 EDT 2011;Committer;marcandre;4;243;0;243;0
59a3d59496607ebeb618fd781d3af9a6bc8c647e;Fri Jul 01 06:21:24 EDT 2011;Committer;marcandre;3;11;3;14;0
004c34f9de58067e627eb714083ca99b17e3fcfd;Fri Jul 01 06:13:35 EDT 2011;Committer;marcandre;4;916;0;916;0
376b8251271da10ff3571b9a15c25333bb4492bc;Fri Jul 01 06:10:40 EDT 2011;Committer;marcandre;3;12;0;12;0
f4dda52025433e232f931ffa1cb0473684128a5a;Fri Jul 01 05:28:48 EDT 2011;Committer;naruse;2;8;0;8;0
c05fd75befe5b6021e7926452d6813c3472f540f;Fri Jul 01 02:08:48 EDT 2011;Committer;kosaki;2;13;0;13;0
2e4fb84f7c78d7d9cd24d1802ef97fda6d2466d0;Thu Jun 30 23:23:32 EDT 2011;Committer;ko1;2;14;2;16;0
8ad06e2604f9563f21e0b7e107aedde82f40adf8;Thu Jun 30 23:03:23 EDT 2011;Committer;nobu;3;14;7;21;0
fa4514e4fedc1e1390200e3901e2add22a4a27b4;Thu Jun 30 22:29:34 EDT 2011;Committer;ko1;5;58;22;80;0
198c2570e740280bf7f00a38d311ade19c27fef7;Thu Jun 30 20:20:32 EDT 2011;Committer;nobu;8;19;19;38;0
72be91b5c0fab9e2c65adf957bafa8cb7a1783b9;Thu Jun 30 18:49:04 EDT 2011;Committer;tadf;1;8;8;16;0
8fca66d7ebb50f8b3d7af8a5550dbcaf12138a3a;Thu Jun 30 18:34:09 EDT 2011;Committer;matz;3;10;1;11;0
bd26a9d656fcf617dd51ab1594cac9fd970bf9d7;Thu Jun 30 18:32:21 EDT 2011;Committer;tadf;1;1;1;2;0
1d259b64ed730736ce51ccfe2cf4de01b52d74bb;Thu Jun 30 18:24:55 EDT 2011;Committer;svn;1;3;3;6;0
6c1e759c3f62b6dcf80186a1401dcf4bc7956978;Thu Jun 30 18:24:50 EDT 2011;Committer;tadf;2;41;12;53;0
be5e17704c73f5e285986955013edfc19bbfd2b0;Thu Jun 30 14:54:11 EDT 2011;Committer;mrkn;2;6;1;7;0
1dcd4b325ee9074952461d1748d881ea27da05d5;Thu Jun 30 14:48:52 EDT 2011;Committer;emboss;5;108;41;149;0
c4becf8aaf8b1dc27ca274457548117d703c65e5;Thu Jun 30 13:39:50 EDT 2011;Committer;ko1;2;14;0;14;0
3bd05662883a14ce0ffe63666317d80faeb7afef;Thu Jun 30 13:35:43 EDT 2011;Committer;ko1;1;1;1;2;0
065fe8b7a4dadd41760131cb3778abd4aef26e90;Thu Jun 30 13:34:53 EDT 2011;Committer;ko1;4;42;3;45;0
c6ef31c9331a364851e805ab35372cd7a9ecbc71;Thu Jun 30 12:31:53 EDT 2011;Committer;kanemoto;2;8;0;8;0
1a876fb61ea9c64553a80f4d4683c8b675eca054;Thu Jun 30 12:17:52 EDT 2011;Committer;tadf;2;7;1;8;0
3b8f9dc0b073170bd71fa42e018194afe0f99ea6;Thu Jun 30 11:54:27 EDT 2011;Committer;nobu;3;20;0;20;0
1b10d8c327e2aff121cfbe537c3617d3714daab8;Thu Jun 30 11:38:33 EDT 2011;Committer;tadf;2;14;12;26;0
00d0d6eab02a7102d7e720b4cfd105210a27a85d;Thu Jun 30 11:35:04 EDT 2011;Committer;nobu;1;6;2;8;0
5700a8601ae53096334272cda3a072980c44c78f;Thu Jun 30 11:12:38 EDT 2011;Committer;nobu;2;42;7;49;0
97772985f0900057bfcbb79978eaa5f7855523d3;Thu Jun 30 11:05:24 EDT 2011;Committer;tadf;2;74;59;133;0
fa2c1c75a9ef0c9a9b35a56108ef6d2ea84717e5;Thu Jun 30 10:11:45 EDT 2011;Committer;ko1;2;15;6;21;0
9942e92ca6693bf0b6f795fed11f1ff7acef8b8a;Thu Jun 30 08:38:10 EDT 2011;Committer;ko1;1;1;1;2;0
3b32735546e989557a8992063f9f1bbdcd999beb;Thu Jun 30 08:37:06 EDT 2011;Committer;ko1;3;35;4;39;0
d49a61e68f1d6ffe448ec3244c63d48adc101cea;Thu Jun 30 08:27:13 EDT 2011;Committer;ko1;2;15;4;19;0
0c22e9a001dde8bc662b003578ee63b01fcb0d6b;Thu Jun 30 07:31:41 EDT 2011;Committer;kazu;1;3;3;6;0
51646778414daf9546aff748e6bf0561b050aa5c;Thu Jun 30 03:34:16 EDT 2011;Committer;ko1;2;19;2;21;0
f680230589fc3645ba91d0d99e5f453cc1b3e191;Thu Jun 30 03:31:01 EDT 2011;Committer;naruse;1;1;1;2;0
ae56a2ec03e09106830f897db2613b54fd03a2b2;Thu Jun 30 03:27:08 EDT 2011;Committer;naruse;1;1;3;4;0
5b2300bd6b8ce870b959025da52ca3d25081f909;Thu Jun 30 03:18:12 EDT 2011;Committer;naruse;1;3;1;4;0
b3205aaa70a2464ae68f9997348d2e2865aefe44;Thu Jun 30 03:13:18 EDT 2011;Committer;nagachika;1;3;3;6;0
25513543ffe6308352f3724f0be2332dda4cde62;Thu Jun 30 00:37:00 EDT 2011;Committer;drbrain;2;25;6;31;0
8670d553685433ebfaefa2e19a19e41114a4e5bb;Thu Jun 30 00:30:46 EDT 2011;Committer;drbrain;2;23;0;23;0
9802a3e7dec322e396783f7585dc76d6538a44a8;Thu Jun 30 00:22:32 EDT 2011;Committer;drbrain;3;24;1;25;0
b57a0d44f9edf90c02cf2e6dbf574cf9c6eb2d5a;Thu Jun 30 00:20:15 EDT 2011;Committer;drbrain;2;271;1;272;0
65c2fec50cc2da8200489ab95362d3a971cdd64b;Wed Jun 29 21:37:48 EDT 2011;Committer;nobu;2;10;0;10;0
7ed1803137a8e7757fdb6851e27642c9ceeeffed;Wed Jun 29 21:37:45 EDT 2011;Committer;nobu;1;14;14;28;0
7c30ffb92d5bba73edf2557b5935d3211722daa3;Wed Jun 29 21:33:36 EDT 2011;Committer;drbrain;2;5;0;5;0
eaa572e57d1a21892e57f7e451cb991fab32b2d2;Wed Jun 29 21:25:03 EDT 2011;Committer;naruse;3;9;1;10;0
be9d096cc9f6b7ca277123ba351f84f10be3458e;Wed Jun 29 21:23:36 EDT 2011;Committer;drbrain;2;8;4;12;0
e75e7fcc9f90d41ae14019c0f3b5d5048badbb5a;Wed Jun 29 21:17:31 EDT 2011;Committer;drbrain;13;501;47;548;0
6f1ce28d624007f1d7688865a782c3ba4ad376a0;Wed Jun 29 17:55:03 EDT 2011;Committer;kosaki;2;5;4;9;0
c90ff68d3271b9b7e981152f11db6ea5f4f6061d;Wed Jun 29 17:43:58 EDT 2011;Committer;kosaki;2;11;8;19;0
5e15194561c45b4a123d0945b4de33f0bf2f2fe6;Wed Jun 29 17:36:00 EDT 2011;Committer;kosaki;2;29;13;42;0
ed0876f66d98c3c2a6247a626d1889eba5d7cb2f;Wed Jun 29 16:34:51 EDT 2011;Committer;kosaki;2;8;14;22;0
3a9117011fdbcfd75e84cf5c0006bf357a20f959;Wed Jun 29 15:55:44 EDT 2011;Committer;kosaki;2;8;1;9;0
b3ad7b9ea14bd28606e871a6be9a7dba6201cb3d;Wed Jun 29 15:51:54 EDT 2011;Committer;kosaki;2;9;0;9;0
b07b51f7fc03630e073ebd39006e0727e379ff71;Wed Jun 29 15:47:24 EDT 2011;Committer;kosaki;2;7;1;8;0
09dee51be3de0d3849c98e600238ef6944a2786a;Wed Jun 29 15:31:37 EDT 2011;Committer;keiju;2;180;96;276;0
549d4feecd84bdfbb03aedd0987a15e6c04ab294;Wed Jun 29 15:08:44 EDT 2011;Committer;svn;1;2;2;4;0
f1ce1f1dbfb39637c0e3e2c50304fed03c582f6e;Wed Jun 29 15:08:41 EDT 2011;Committer;keiju;2;15;1;16;0
23658b355c1c62771945cfa86e098ba8dd618779;Wed Jun 29 14:47:04 EDT 2011;Committer;tadf;5;79;26;105;0
64263ddeb6b925866bc4ad2d5c74300af178b896;Wed Jun 29 14:40:44 EDT 2011;Committer;eban;1;3;1;4;0
2a9819b7475c503e6b4ed5056dffae0dd3e0fc1d;Wed Jun 29 14:22:02 EDT 2011;Committer;eban;2;6;1;7;0
d7ccf5e1ccf93d6e71246d0eb1ab66ce5b170a70;Wed Jun 29 14:11:19 EDT 2011;Committer;eban;2;7;0;7;0
4f4f09d009298e0a35cff6d42338643146c2af0c;Wed Jun 29 13:51:30 EDT 2011;Committer;keiju;2;5;1;6;0
e31caff00eaef9237e5825a7e9ccdae80a6fecf0;Wed Jun 29 13:19:59 EDT 2011;Committer;nagachika;3;59;5;64;0
d073f1d53c9b72ab4fd1a02494999648c41b0868;Wed Jun 29 12:38:41 EDT 2011;Committer;nagachika;1;6;6;12;0
e6540a035efb692f66ceead14a301f92b560bdd4;Wed Jun 29 05:20:37 EDT 2011;Committer;matz;2;7;1;8;0
3cd9a01e6f82620f6a9af425fc345c3c4e38b536;Wed Jun 29 03:35:48 EDT 2011;Committer;nobu;1;1;1;2;0
926301969f7970b5a59a065dabb234cddc590e6c;Wed Jun 29 03:09:34 EDT 2011;Committer;drbrain;14;144;14;158;0
54bbc098fa1e05570e960750bf2c86d45017e575;Wed Jun 29 01:13:22 EDT 2011;Committer;marcandre;3;13;4;17;0
de97e946f04dd0374d6f2580c97591bc1fdc1f3f;Wed Jun 29 01:11:19 EDT 2011;Committer;marcandre;3;155;0;155;0
22ffae4009c90eabf5a4e1f73caeaf3256f4e16c;Wed Jun 29 01:09:46 EDT 2011;Committer;marcandre;3;38;0;38;0
dfc6bf9da8a16b639a472f29ee72816d18263d6c;Wed Jun 29 01:08:02 EDT 2011;Committer;marcandre;3;119;19;138;0
87dadf3b8cd9b8bd2d5a5ba1a5009e289447f08a;Tue Jun 28 21:23:40 EDT 2011;Committer;ko1;2;12;3;15;0
e9c1783bbd3d1acbc53bd20bcb6cfe62dc4af5ba;Tue Jun 28 21:17:34 EDT 2011;Committer;svn;1;2;2;4;0
c22126755cd89f2b8aa309df8908d839e588a3bd;Tue Jun 28 21:17:29 EDT 2011;Committer;ko1;4;64;13;77;0
58018f1f2d41ec28203439496537106e6b08c377;Tue Jun 28 14:46:57 EDT 2011;Committer;keiju;2;6;1;7;0
e36395dce6fa7658e91e1f86d5f4f72c148b6a8c;Tue Jun 28 12:52:21 EDT 2011;Committer;keiju;2;5;1;6;0
2102559f8c15c8b8ba5db2a7d31548555ac0ae48;Tue Jun 28 11:45:50 EDT 2011;Committer;nahi;2;8;1;9;0
0148d41a13f0ce7ec5a83f93984fe7aaf9c0e2d2;Tue Jun 28 10:42:25 EDT 2011;Committer;kosaki;3;7;21;28;0
4870feb31a6625dcbf8817ccf16294bb3f3737e1;Tue Jun 28 06:09:46 EDT 2011;Committer;naruse;3;75;45;120;0
565336acca867889a43b8a2f8331a253d97dee0c;Tue Jun 28 04:45:05 EDT 2011;Committer;usa;2;6;1;7;0
9ca26b50d7117726f821735e1fd7eff4b93d34d0;Tue Jun 28 02:57:02 EDT 2011;Committer;ko1;1;2;0;2;0
014a5f31789856f9ed7a59f19fb3c3e544655a7d;Tue Jun 28 02:53:15 EDT 2011;Committer;ko1;2;13;7;20;0
2619f216fef06c9fca948ca729a0e23b62996f09;Tue Jun 28 02:45:29 EDT 2011;Committer;drbrain;19;164;78;242;0
84ece951630c61eddab8be47b80fc1a7f774175f;Tue Jun 28 02:28:25 EDT 2011;Committer;drbrain;10;201;111;312;0
41ab31e67a747e5db91a7ef4502a54cdf0525163;Tue Jun 28 01:20:23 EDT 2011;Committer;naruse;2;5;1;6;0
1f2478a7e6dadc4085e631c9203a50f9f0389f4c;Mon Jun 27 23:38:31 EDT 2011;Committer;marcandre;1;2;1;3;0
0de3c24ea2b82d1ae8114da19e1075a2e4ea1be7;Mon Jun 27 22:51:42 EDT 2011;Committer;drbrain;2;27;13;40;0
4a42dda48262ef31125f76a0a642736281724c33;Mon Jun 27 20:09:59 EDT 2011;Committer;nahi;2;16;8;24;0
801bac0977abdb810d0c932c1fe82eb34ae66df3;Mon Jun 27 18:36:55 EDT 2011;Committer;naruse;1;4;0;4;0
bb6384761e6c32acd169faa337d77d7e8d1efe5e;Mon Jun 27 16:26:09 EDT 2011;Committer;mrkn;5;288;44;332;0
576b44165a8f0d61f16fcc42dde4901fb0421257;Mon Jun 27 16:20:56 EDT 2011;Committer;keiju;2;5;1;6;0
bad9f40714202b8dd4d5c7f5485a550f00768eb4;Mon Jun 27 15:42:50 EDT 2011;Committer;marcandre;1;6;0;6;0
3f5e567a475e05c9922ad343dde3cbfb85fa153d;Mon Jun 27 15:42:37 EDT 2011;Committer;marcandre;1;1;1;2;0
190bc7ae0e7346cc572129eea314c06c1c51cfe8;Mon Jun 27 15:18:22 EDT 2011;Committer;seki;5;68;2;70;0
eda3f1be206aa86cb2fb4f795fd33b1df1909cb0;Mon Jun 27 15:10:32 EDT 2011;Committer;svn;1;2;2;4;0
f3eed6a7d5cdc692cce70446b071ff55ace08ecf;Mon Jun 27 15:10:28 EDT 2011;Committer;keiju;2;5;1;6;0
3639736d5d4ae60dad6e2221d2b95bb73d6b3576;Mon Jun 27 13:10:26 EDT 2011;Committer;kosaki;2;6;1;7;0
f8cc7796801c48be0a31c892ec7e39b79b4f08ed;Mon Jun 27 13:05:22 EDT 2011;Committer;kosaki;2;7;3;10;0
d647b5358ed5c7f07b3aa500b40297568a882975;Mon Jun 27 12:59:08 EDT 2011;Committer;kosaki;2;6;1;7;0
ea3da57e1234b47f6c851d1760637fe627e9579d;Mon Jun 27 12:18:00 EDT 2011;Committer;kosaki;2;11;6;17;0
c32869dfeb9ce2958759639755419dd80afb8101;Mon Jun 27 02:45:30 EDT 2011;Committer;naruse;1;2;3;5;0
657e9e2879939338b7e8a57db0917016fa4edc08;Mon Jun 27 02:43:03 EDT 2011;Committer;naruse;2;8;3;11;0
f18cf4f023448fc25078303c12d1cec15ed3edf9;Mon Jun 27 00:59:07 EDT 2011;Committer;ko1;2;6;0;6;0
d1d5d5e79845c292c6118884fa66729954daad01;Mon Jun 27 00:30:41 EDT 2011;Committer;ko1;8;222;45;267;0
8ce62003a0046374bc696cbf4b3c46e9283a85b1;Sun Jun 26 23:01:56 EDT 2011;Committer;tadf;2;11;7;18;0
61a34d625e163412824ae37257b043a002236b90;Sun Jun 26 16:34:20 EDT 2011;Committer;nobu;2;11;2;13;0
e8e7ad8192c09c8c0f0bc35336347dcc65d5793f;Sun Jun 26 15:55:29 EDT 2011;Committer;naruse;1;4;0;4;0
19ef07bb3400172e16358f6ffb6e2f4aded1ad0b;Sun Jun 26 15:45:50 EDT 2011;Committer;svn;1;2;2;4;0
8d00a7c2748a8207aa16903ca595a3ba11eb3e3c;Sun Jun 26 15:45:49 EDT 2011;Committer;naruse;2;6;2;8;0
145fccbd42babfcdab7a0401cda78e7945152f6f;Sun Jun 26 15:45:47 EDT 2011;Committer;naruse;2;7;0;7;0
a252c17e15b20480c54960e027b49ca9e9999543;Sun Jun 26 14:50:09 EDT 2011;Committer;tadf;2;38;0;38;0
51a0501a3966debbaf89a6ce54eba47930a9a43a;Sun Jun 26 13:23:00 EDT 2011;Committer;tadf;2;99;34;133;0
d6e89e0c4ea7722b7fc59e198f21a03ccaf5a2a6;Sun Jun 26 09:09:49 EDT 2011;Committer;shyouhei;2;18;4;22;0
230be2a7715c55e1b0ff889bb2c77442ff2f0e8c;Sun Jun 26 04:49:33 EDT 2011;Committer;kosaki;2;22;6;28;0
93e1583d735bac916ac815ee2737a9596dccad0f;Sun Jun 26 01:32:03 EDT 2011;Committer;emboss;5;51;10;61;0
3380f2ff6ed3ced7965be7f2242c95580f0a45af;Sat Jun 25 16:03:11 EDT 2011;Committer;tadf;2;46;43;89;0
64fd7d878593f1ae226a5d041c495587b4d4ff33;Sat Jun 25 15:05:41 EDT 2011;Committer;svn;1;2;2;4;0
9c931b853b99f67964ff7948770031713ad21940;Sat Jun 25 15:05:37 EDT 2011;Committer;nagachika;3;27;0;27;0
fb72e453f9e141f182a542dc03b6d95267a3737f;Sat Jun 25 14:28:56 EDT 2011;Committer;nagachika;2;8;2;10;0
1a196574c4bd7867cd30f48d057680e5a1ab3364;Sat Jun 25 14:21:16 EDT 2011;Committer;nagachika;2;7;4;11;0
eae5081790fc71df5c72fb743e7b8ae914e85c16;Sat Jun 25 09:20:20 EDT 2011;Committer;svn;1;2;2;4;0
d5448b8e9143667ed181e7c6cb5a5ea6618b7b54;Sat Jun 25 09:20:16 EDT 2011;Committer;nagachika;1;2;2;4;0
635d13a8b7eb17f65462ea44c9911755a45ab8c7;Fri Jun 24 11:05:59 EDT 2011;Committer;nahi;3;42;1;43;0
706335aa0beaf1477acc41e15543e412c760474e;Fri Jun 24 08:06:38 EDT 2011;Committer;nobu;3;68;9;77;0
dd91beb3e1e39fdee5588419fc0da8b09fd70a06;Fri Jun 24 07:06:13 EDT 2011;Committer;nahi;1;1;1;2;0
369b095015d0efb40e0833c94ab0b0837c7f48f4;Fri Jun 24 07:01:52 EDT 2011;Committer;nahi;2;21;1;22;0
ea9c30bec1856e1a1c8c856d1f752258c70c15db;Thu Jun 23 22:24:44 EDT 2011;Committer;drbrain;4;16;10;26;0
d001539a0538cba0e48be2ebdafe29e67b006a4e;Thu Jun 23 22:11:55 EDT 2011;Committer;drbrain;139;8738;6735;15473;0
3fbc9440feb66cf762834b6d66e6f3a893bab5b7;Thu Jun 23 15:45:58 EDT 2011;Committer;tadf;2;11;8;19;0
838af29cb12d05b45d75c84b73d2a4154935b6a2;Thu Jun 23 15:15:40 EDT 2011;Committer;svn;1;2;2;4;0
2e83b82323eeba9d97abc15cca9f0f76da82d657;Thu Jun 23 15:15:37 EDT 2011;Committer;tadf;2;15;12;27;0
bf2e60cda7ad9e08f03d1eed99f77cc9c6cc1496;Thu Jun 23 13:51:55 EDT 2011;Committer;nahi;5;58;0;58;0
3e01a8d58e4095e77a7ecf6658fc7a825e8ed6c0;Thu Jun 23 13:03:02 EDT 2011;Committer;nahi;1;4;4;8;0
544daf1f7abc19fd1577b1aafd7abebef4ee19d7;Thu Jun 23 10:36:09 EDT 2011;Committer;nahi;3;104;24;128;0
a02504ba843f476edfe6cb41b93fefe01c9594c8;Thu Jun 23 09:20:21 EDT 2011;Committer;sorah;1;1;1;2;0
45f164eaebc52b6f7c8b18f929916df52e0d72a3;Thu Jun 23 07:22:37 EDT 2011;Committer;nahi;1;1;1;2;0
b9cbe522ed328641f737028915f9fcb738602d20;Thu Jun 23 04:33:18 EDT 2011;Committer;svn;1;2;2;4;0
e6f4c92f6def7977e03fa6ce8c7b4f25f19fc2b7;Thu Jun 23 04:33:13 EDT 2011;Committer;sorah;2;6;1;7;0
dea3113ab324ee47fba127ba7745f5213d931536;Wed Jun 22 13:39:56 EDT 2011;Committer;nahi;3;82;3;85;0
8d836a15e46baacfb136b883e9efa5e08cc4727b;Wed Jun 22 13:28:18 EDT 2011;Committer;emboss;2;7;1;8;0
dc8f58f6e82c933ff3f8c68be29f6bccc8f31ca1;Wed Jun 22 12:30:22 EDT 2011;Committer;kosaki;2;6;1;7;0
be953b4d1ce3f0dfc7f24c84ec7a51e027102557;Wed Jun 22 11:00:24 EDT 2011;Committer;naruse;4;21;6;27;0
d8af9c854d4c6723afb4a3295b8a21bdce8cc06e;Wed Jun 22 09:24:31 EDT 2011;Committer;nahi;3;39;3;42;0
26cb830df918614b4d734d187b7b65aba39f4d8e;Wed Jun 22 08:41:08 EDT 2011;Committer;emboss;18;121;70;191;0
41c517d13230dd3edd302a87231ac467babf2f3c;Wed Jun 22 06:04:27 EDT 2011;Committer;emboss;2;12;1;13;0
914a4a025a493c17bba8262d1a13d6da2cef662f;Wed Jun 22 05:48:44 EDT 2011;Committer;emboss;3;8;3;11;0
bda678dc5b8533d7161b1021230b9732acaab0c5;Wed Jun 22 03:43:38 EDT 2011;Committer;nahi;3;46;9;55;0
02ab6d95beca6a23401da882e36123428367960d;Wed Jun 22 03:40:08 EDT 2011;Committer;nahi;4;277;268;545;0
40508ede731122cdf2d13d39477317a529d4d4fd;Tue Jun 21 18:22:54 EDT 2011;Committer;tenderlove;3;24;1;25;0
7c5fdec05da5a6ba0a77224e241639d49a205a6c;Tue Jun 21 18:04:41 EDT 2011;Committer;tenderlove;1;2;2;4;0
800c313bde129b5e54d41abd478e1be6dab63016;Tue Jun 21 17:44:44 EDT 2011;Committer;nahi;4;20;4;24;0
7d112260586c99168bc51df274784bcc01db6692;Tue Jun 21 16:34:16 EDT 2011;Committer;nahi;1;2;1;3;0
0fd4653236c75408d0430acf0ee35955d15788eb;Tue Jun 21 16:33:11 EDT 2011;Committer;svn;1;2;2;4;0
5e8aa0a1d2f0ceeefbdf00414c8c0921d910fcac;Tue Jun 21 16:33:06 EDT 2011;Committer;nahi;2;17;3;20;0
4ce158147502304af431c820c227134628578e74;Tue Jun 21 12:58:37 EDT 2011;Committer;nahi;3;40;0;40;0
908baefe7da367539092994fdbc718a43772e956;Tue Jun 21 12:31:17 EDT 2011;Committer;kosaki;6;23;2;25;0
b9d9ea62b4c8479c95e29ac478d3a39f9008ea5d;Tue Jun 21 11:52:24 EDT 2011;Committer;kosaki;3;1;8;9;0
5b16ddf5047aa508316e7687fafd1e4870f2d687;Tue Jun 21 11:42:50 EDT 2011;Committer;tadf;3;34;3;37;0
c9aef84c7a3c075b05a89c8f9737369f7f6c2303;Tue Jun 21 11:29:54 EDT 2011;Committer;kosaki;1;1;1;2;0
97beed076f258ebe0835cbe496a7604e196db288;Tue Jun 21 10:57:53 EDT 2011;Committer;kosaki;3;8;1;9;0
cb138bbaa6fdec9e9e8f6821e23130d6397677cd;Tue Jun 21 10:47:07 EDT 2011;Committer;kosaki;2;7;1;8;0
e49f890906507b49ac81328e1e7b68d2fea59226;Tue Jun 21 04:30:14 EDT 2011;Committer;kouji;2;33;0;33;0
d2e61d2205e50abe3f834c28618b4db708c5f303;Tue Jun 21 04:20:40 EDT 2011;Committer;svn;1;2;2;4;0
1daac53ce7f4fa0d8637e48a198cc5a1d896881e;Tue Jun 21 04:20:33 EDT 2011;Committer;kouji;2;10;1;11;0
1d110a14a44dce8a34be74821490a0ce303a64dd;Mon Jun 20 13:55:04 EDT 2011;Committer;kosaki;2;13;1;14;0
2552e428f3f89adbec3a548cf7b943b6b1318c24;Mon Jun 20 12:32:35 EDT 2011;Committer;kosaki;2;10;5;15;0
c102821291a31a729a3aa49d3f7be0900b3cb03c;Mon Jun 20 09:48:05 EDT 2011;Committer;nahi;3;9;4;13;0
15e7e472e65fd6110a42674f9e4ef73fd1f8bbdc;Mon Jun 20 06:48:40 EDT 2011;Committer;nahi;3;32;15;47;0
3fc0e0c18155adc610761d419576c3bae3150f13;Mon Jun 20 01:00:47 EDT 2011;Committer;svn;1;2;2;4;0
2190c953816ea5ea5562c9b31fcb97722a080a3b;Mon Jun 20 01:00:43 EDT 2011;Committer;naruse;1;1;1;2;0
ee80993690dadc8d3e649e8ab5dea8eab67d9e35;Sun Jun 19 04:32:41 EDT 2011;Committer;sorah;2;6;0;6;0
4c438fd0febce6557ebd38b363451eeab0914d58;Sun Jun 19 01:12:02 EDT 2011;Committer;sorah;2;21;7;28;0
12efda14eb54ab382f521515179e3939ccf77839;Sat Jun 18 15:00:18 EDT 2011;Committer;svn;1;2;2;4;0
6effaa9a139eadf99a606af293e4d39ce6dc1182;Sat Jun 18 15:00:00 EDT 2011;Committer;nobu;3;30;0;30;0
e623ceb9f9092616be590b1f5e1a71ddbb18c0b3;Sat Jun 18 12:39:01 EDT 2011;Committer;kosaki;2;4;7;11;0
ef86308a2c892d37a8961e531466c00b475275fe;Sat Jun 18 12:32:57 EDT 2011;Committer;kosaki;3;7;2;9;0
436810414630dd00c9881e06f0007f8f16973ca6;Sat Jun 18 09:56:01 EDT 2011;Committer;ko1;3;6;2;8;0
5ed8c08aa0277b30e00cb27cc2da1d785c145170;Sat Jun 18 08:26:19 EDT 2011;Committer;akr;12;23;11;34;0
bc46292caa9ce7114856c0e035ad3bec3114ba32;Sat Jun 18 04:41:53 EDT 2011;Committer;akr;2;5;15;20;0
7da3ea811e71bcf2445fe63608b15645ef205240;Sat Jun 18 03:49:33 EDT 2011;Committer;akr;16;39;23;62;0
19f386674eb5cfbf9c8fd6041114829f37888d17;Sat Jun 18 03:05:11 EDT 2011;Committer;nobu;6;42;5;47;0
3b59f6c56278b1314f5b01a192ed03966aa3d0db;Sat Jun 18 02:32:44 EDT 2011;Committer;akr;1;2;1;3;0
8a5330110b69b6a130417640284dde26191a8489;Sat Jun 18 02:12:40 EDT 2011;Committer;akr;1;4;0;4;0
8192693ccfc161a57a09b2f1f2b2f275182b66ac;Sat Jun 18 02:10:09 EDT 2011;Committer;akr;2;8;2;10;0
afd7e4668f8195a98eb45fd82132d3d11eada77f;Sat Jun 18 01:54:57 EDT 2011;Committer;akr;16;32;29;61;0
c6575865aa2186058b92c976257bb78b1edf4ca6;Fri Jun 17 23:15:47 EDT 2011;Committer;akr;3;213;51;264;0
e7996eb3cc1687d1f70ea8f78befddf821ad3ff0;Fri Jun 17 22:43:38 EDT 2011;Committer;akr;40;172;126;298;0
aba879a3f08cebd78ddd76aefceb6bafb8dbf907;Fri Jun 17 22:34:07 EDT 2011;Committer;nobu;1;2;0;2;0
610b2f96e38bf8eb72891a096515a7ace3ddb3bc;Fri Jun 17 22:34:03 EDT 2011;Committer;nobu;1;3;5;8;0
0d5ed3d2ad67e8c50f23f509af8a66a744258dfb;Fri Jun 17 22:33:59 EDT 2011;Committer;nobu;2;1;2;3;0
7191ea10498be703a60d995b450accdba74c75a3;Fri Jun 17 22:33:54 EDT 2011;Committer;nobu;2;18;18;36;0
b7a693da8e0d0e514d630d45cb1644d91bd3ba07;Fri Jun 17 17:38:18 EDT 2011;Committer;mrkn;3;9;2;11;0
f107d1e7066fdfa6360bf4aa9986f519dcd3f175;Fri Jun 17 17:38:14 EDT 2011;Committer;mrkn;5;200;58;258;0
a489109884de316893e3e716130be3a48bb965f0;Fri Jun 17 15:22:15 EDT 2011;Committer;svn;1;2;2;4;0
64f6ddb31d2f51b0e320d91d3df2867c351baa78;Fri Jun 17 15:22:10 EDT 2011;Committer;tadf;2;10;2;12;0
94b65c9d3fc54460c2e7a0ceffaafdf9089704e4;Fri Jun 17 14:53:56 EDT 2011;Committer;akr;1;1;0;1;0
021f166509dfead5f1de67651af60de43242365c;Fri Jun 17 10:18:39 EDT 2011;Committer;naruse;3;19;0;19;0
becd789625323ef37c16829b8f87153f832a7fa4;Fri Jun 17 04:10:37 EDT 2011;Committer;drbrain;2;43;30;73;0
630ba53d29654886845f549d7054ac4588d4c78c;Fri Jun 17 00:25:43 EDT 2011;Committer;drbrain;2;590;98;688;0
ca25e7962c906d9136912de4e5ab5c3788636b2b;Fri Jun 17 00:11:20 EDT 2011;Committer;drbrain;2;53;0;53;0
2adddf4c2b614f9271ef8c8628a9149f3a3a002a;Thu Jun 16 23:50:30 EDT 2011;Committer;drbrain;2;76;67;143;0
517c3385b121680d9db40a841deb6d57fc815821;Thu Jun 16 22:54:53 EDT 2011;Committer;drbrain;2;9;0;9;0
105a9e036c7f73913f2910858c1e6afce23378e8;Thu Jun 16 22:47:28 EDT 2011;Committer;drbrain;2;16;4;20;0
463df2ceb97bd79e7e7105f30839c12f4327a177;Thu Jun 16 22:38:48 EDT 2011;Committer;drbrain;2;17;1;18;0
8bfb41ba7e8b92c38fc129aacf67191aaa42d947;Thu Jun 16 22:23:25 EDT 2011;Committer;drbrain;2;7;2;9;0
be3911733043df19c9f57609a055f1a826d496f0;Thu Jun 16 21:12:00 EDT 2011;Committer;drbrain;3;101;7;108;0
772a2811923e1634ff7c157abdc9b41740659af6;Thu Jun 16 19:52:54 EDT 2011;Committer;ko1;3;5;4;9;0
f45d127ada4fd0f3d64788c13d5f3e0b27ba7062;Thu Jun 16 19:46:08 EDT 2011;Committer;naruse;2;25;1;26;0
98d45ef140dcc53f4dd7c0dbdd25433d5c378ff7;Thu Jun 16 18:09:03 EDT 2011;Committer;ko1;9;74;68;142;0
b3e68b1d12e605fa2770c04c5212be595cc7e92a;Thu Jun 16 17:28:58 EDT 2011;Committer;svn;1;2;2;4;0
1ac74a11c2594f1cc4284c941ccf5ca91fc8e146;Thu Jun 16 17:28:54 EDT 2011;Committer;ko1;2;6;1;7;0
3c23284734b60dac99339c300dff6c4bd2c226f4;Thu Jun 16 14:42:02 EDT 2011;Committer;kosaki;4;10;4;14;0
e80b506ed9798ed9fc8af520cf9243e7de1cdab9;Thu Jun 16 14:23:05 EDT 2011;Committer;kosaki;1;1;1;2;0
e290d7d98b07b132592227883753ce5a4088a259;Thu Jun 16 14:21:49 EDT 2011;Committer;kosaki;1;1;1;2;0
65ecadfaf2a70dcf62c1a1ea67b04de95792d00d;Thu Jun 16 14:12:29 EDT 2011;Committer;nagachika;1;1;1;2;0
288c18cdd8895d007458b6440d24b8949b4689e8;Thu Jun 16 11:24:23 EDT 2011;Committer;sorah;5;27;4;31;0
a15dfa6b4a0c8afc0fd47a5d1b6c7d12191e38fa;Thu Jun 16 10:32:51 EDT 2011;Committer;nahi;2;182;0;182;0
513e0ee53b684625f82ad1ef9862b089106fa3ea;Thu Jun 16 08:56:47 EDT 2011;Committer;kosaki;2;7;2;9;0
52607877c68f2c405dac50a13d5b73d35825c585;Thu Jun 16 06:17:59 EDT 2011;Committer;drbrain;2;33;20;53;0
14d0f7aa48430fdd3b8b94960c420e90c617a8c5;Thu Jun 16 06:09:57 EDT 2011;Committer;drbrain;2;100;72;172;0
09b830c4b2589828893bd987de091e72702f8271;Thu Jun 16 05:55:31 EDT 2011;Committer;drbrain;2;72;1;73;0
35bb53430c634361ba84a48326a236a53a2fd680;Thu Jun 16 05:37:31 EDT 2011;Committer;drbrain;2;6;1;7;0
dbf9baeddf8679c0dfeb905d720a64e657861675;Thu Jun 16 05:24:12 EDT 2011;Committer;drbrain;3;14;5;19;0
b7528b5edb1f9148ea00ebb6151720e5943b3f0b;Thu Jun 16 04:59:24 EDT 2011;Committer;drbrain;58;2634;274;2908;0
97ac172d58d695305c39d555155318edb99f1ea7;Thu Jun 16 02:41:03 EDT 2011;Committer;shugo;3;35;2;37;0
685444569cb747b399e0ab087e5876fad08a71bb;Thu Jun 16 00:12:55 EDT 2011;Committer;nobu;7;45;32;77;0
ef38cb7a05e1b45b074959f12999136518cadcbd;Thu Jun 16 00:10:10 EDT 2011;Committer;nobu;1;1;1;2;0
bc46dfd281a7c5f8ae41517e9bd571e4a4b1d3a0;Thu Jun 16 00:08:56 EDT 2011;Committer;nobu;2;16;3;19;0
ea11cf5d7f902609912652ad74586334638b4945;Wed Jun 15 23:06:00 EDT 2011;Committer;sorah;3;18;3;21;0
6e125382d7af727f70063a8f5e5959744865c193;Wed Jun 15 22:27:11 EDT 2011;Committer;sorah;2;10;0;10;0
72e8077957c252ff3f97afb1229c0553f1a82d0b;Wed Jun 15 18:09:47 EDT 2011;Committer;usa;2;8;10;18;0
a8bdd28d10c2c5981e944e945eed95f6c4ad44bc;Wed Jun 15 18:04:13 EDT 2011;Committer;usa;4;72;5;77;0
3eb1b472e26d65664b96ca261891cebada6fa03f;Wed Jun 15 16:04:35 EDT 2011;Committer;svn;1;2;2;4;0
24acc9017ac3fee7391d73e6fba6f03b79c60185;Wed Jun 15 16:04:32 EDT 2011;Committer;emboss;1;1;1;2;0
e33efe60a9410f014f21a894e2f4382be0f43e93;Wed Jun 15 14:45:09 EDT 2011;Committer;kazu;1;6;5;11;0
8923ba1ec9f7b8ebe6de729d5a54f2e2ccb202ff;Wed Jun 15 14:35:46 EDT 2011;Committer;kosaki;2;18;5;23;0
2ebd80d1157fcab65d2d854a8a094aec9a849968;Wed Jun 15 14:13:01 EDT 2011;Committer;kosaki;2;5;7;12;0
16cac0b722bfc334ca9ebcb40a2b86c47b263fe5;Wed Jun 15 12:04:15 EDT 2011;Committer;emboss;1;1;1;2;0
562e35bce5b8e475ae83e10f0a2d2d0e5ac25250;Wed Jun 15 12:03:22 EDT 2011;Committer;emboss;1;5;0;5;0
19853fc49b20626052d6cc92dbd7b08ecce03039;Wed Jun 15 03:36:57 EDT 2011;Committer;akr;3;43;26;69;0
071b8d76f0e920e510ffcb3dc6028ee863112b13;Wed Jun 15 03:28:47 EDT 2011;Committer;naruse;1;3;1;4;0
c75c838e1682a636ec7b4220b2a684194842d2b4;Wed Jun 15 01:58:13 EDT 2011;Committer;naruse;2;11;5;16;0
dfcc89576d958472e026e88f9c0e862e32fda349;Tue Jun 14 20:20:59 EDT 2011;Committer;nagai;2;10;4;14;0
ef3fb5d1e89c6494f1223da46ed8c7a74dff7d2d;Tue Jun 14 19:45:08 EDT 2011;Committer;ko1;9;73;68;141;0
c1bbb616d8be3f9f1231611b2576a6cea89033ae;Tue Jun 14 19:30:12 EDT 2011;Committer;kosaki;9;54;46;100;0
7f6e8625bbb71d4cf0826b56e152509fda00bab1;Tue Jun 14 18:54:30 EDT 2011;Committer;kosaki;3;19;0;19;0
556cd0de071dcddd85c3d56b35d208250863f5b5;Tue Jun 14 16:36:40 EDT 2011;Committer;kosaki;1;3;1;4;0
82e6d95edc047cf39ac3e3c5f388c5624a35d77a;Tue Jun 14 16:31:23 EDT 2011;Committer;kosaki;3;27;7;34;0
2e248ad5aa32cabb657fe214927b848d183f6d84;Tue Jun 14 15:49:16 EDT 2011;Committer;svn;1;2;2;4;0
179ab8927846f35cbaa614e3703404de7a4f8658;Tue Jun 14 15:49:12 EDT 2011;Committer;naruse;1;1;0;1;0
7d6fe4e604f05fda58a2af4f32a16e87f0c99d01;Tue Jun 14 14:17:42 EDT 2011;Committer;akr;2;12;1;13;0
92c04380496c7ea6a1adca625ba12418eba4ed8b;Tue Jun 14 14:07:02 EDT 2011;Committer;akr;2;84;88;172;0
614ec73fc8b5d949161c5b277e27719883d62981;Tue Jun 14 13:52:25 EDT 2011;Committer;tadf;3;58;2;60;0
f2dbf38606ebd91fa9e1a31243a44b36fbf871ce;Tue Jun 14 13:11:01 EDT 2011;Committer;tadf;2;115;97;212;0
300c837d5f40aee70b7e9fa62480383ea7ab7656;Tue Jun 14 13:00:53 EDT 2011;Committer;nagachika;1;1;1;2;0
3ec2b843c8d393d26a6248788199f2daa7bbdcb0;Tue Jun 14 12:57:50 EDT 2011;Committer;nagachika;2;25;11;36;0
68c3b15398ca7aaedfac1bbe74981d3c3a21f5ea;Tue Jun 14 10:54:34 EDT 2011;Committer;akr;1;5;5;10;0
cb728a297b3dd26e84d40456a4eddb6164bebaff;Tue Jun 14 10:51:25 EDT 2011;Committer;akr;2;17;12;29;0
8fc86b0d34af4f0b266682351c1478d1c70a3f98;Tue Jun 14 04:09:43 EDT 2011;Committer;nobu;1;4;1;5;0
7905fc1e54cda03594f050a76586780cd6968de3;Tue Jun 14 04:07:03 EDT 2011;Committer;nobu;1;11;7;18;0
b6135f1cd7eede03d43d8fe21c1923c68fd8749e;Tue Jun 14 02:13:52 EDT 2011;Committer;nari;2;6;1;7;0
8c79b8b6b86f9c5a9dff46c0e6c99cf935b7f399;Tue Jun 14 02:13:51 EDT 2011;Committer;nari;2;10;14;24;0
bfa6c6b41b230277c4f264da117eca222b591efc;Tue Jun 14 01:38:56 EDT 2011;Committer;naruse;1;1;0;1;0
5174425678a68c4c18ecd9d0007e494f49ab1520;Tue Jun 14 01:06:41 EDT 2011;Committer;naruse;1;1;1;2;0
cedc12ce9c085ccebc9bde2508a6e6f448afed48;Tue Jun 14 00:48:19 EDT 2011;Committer;naruse;1;4;1;5;0
d4eae546c87569d93908a4358f0ae85f630b8608;Mon Jun 13 17:23:18 EDT 2011;Committer;nobu;1;17;5;22;0
1d147fb24ca9c76c93c9bc449909364ac9a13b30;Mon Jun 13 16:12:52 EDT 2011;Committer;mame;2;31;0;31;0
7023a64d802487c2fa0c2de574d6093d2fe0be25;Mon Jun 13 16:06:26 EDT 2011;Committer;mame;2;21;9;30;0
8dddc12ad7a13220d83af86a836812172f3ee906;Mon Jun 13 15:06:34 EDT 2011;Committer;svn;1;2;2;4;0
afd1a64cd6ee73e69744a09242cc079b3f1f5170;Mon Jun 13 15:06:30 EDT 2011;Committer;kosaki;4;18;13;31;0
57ed1e9d75360713c3d5d75c4cbb05ea48c8b025;Mon Jun 13 14:51:25 EDT 2011;Committer;usa;2;5;1;6;0
ce90fcdbbd53f002e86a50be3b61a72df3588ca0;Mon Jun 13 14:38:26 EDT 2011;Committer;nobu;3;36;2;38;0
73c6b9d453e2e83482b928c1447f42d35013d565;Mon Jun 13 14:33:36 EDT 2011;Committer;nobu;3;10;1;11;0
a7b0b52f09b63e8ffe28b0040b54ae71a4a829e4;Mon Jun 13 14:28:53 EDT 2011;Committer;nobu;3;32;8;40;0
bcfc22b10e30771e692f7716a1fec7577373963e;Mon Jun 13 14:14:53 EDT 2011;Committer;kosaki;6;102;92;194;0
e504a81ff11c8611f06d54a23b355fed90b356ab;Mon Jun 13 14:12:23 EDT 2011;Committer;akr;2;6;4;10;0
9778737d7b2a870ff195f318cceb48b93e661f03;Mon Jun 13 14:11:23 EDT 2011;Committer;akr;3;53;6;59;0
3254c1bf24207b0c155e8e0b9427cf9709c8c8ca;Mon Jun 13 14:06:35 EDT 2011;Committer;nobu;1;12;12;24;0
a72f0334472ab7f51d62d7eff6b13dc4c7f7002f;Mon Jun 13 14:05:56 EDT 2011;Committer;nobu;4;70;70;140;0
e3672626bf0de4d7b65e539caf575a5dfac7a048;Mon Jun 13 12:49:53 EDT 2011;Committer;kosaki;2;5;3;8;0
839614309de62f761c9c53418356cf8f310745bd;Mon Jun 13 11:56:04 EDT 2011;Committer;emboss;4;134;136;270;0
56aca9fc00611bc7775ef3ff19fa61d88fc1d480;Mon Jun 13 11:32:43 EDT 2011;Committer;emboss;2;6;1;7;0
038ef3f05cbddb484c181a8614b088d99014917b;Mon Jun 13 11:25:44 EDT 2011;Committer;ko1;5;54;6;60;0
0f6794cb2329d9abca759a2db2717ea55ba3addf;Mon Jun 13 10:48:12 EDT 2011;Committer;keiju;2;10;0;10;0
2ba3909c0a55672f541d8be94168ba41e7211ecb;Mon Jun 13 10:21:07 EDT 2011;Committer;naruse;1;7;6;13;0
5112c6d1d9021a920a04e914449a81e9ede9a75e;Mon Jun 13 09:51:52 EDT 2011;Committer;mrkn;2;13;2;15;0
3bd8b390de64b002329729aecc370218035ee655;Mon Jun 13 09:51:48 EDT 2011;Committer;mrkn;3;93;21;114;0
58bae71a7b023b5bb5fdcfefb46232f3f14bc519;Mon Jun 13 09:36:48 EDT 2011;Committer;akr;2;15;0;15;0
df366010177157228cb11d2cd6050bc32044df8f;Mon Jun 13 08:03:22 EDT 2011;Committer;naruse;2;9;2;11;0
1afe9dbdfd18052c4882b7ba3312945aaf3ae64c;Mon Jun 13 07:41:20 EDT 2011;Committer;naruse;1;1;1;2;0
e6bea8978c9ec6b69a546f68416dd87dacac8b2a;Mon Jun 13 05:36:59 EDT 2011;Committer;mrkn;3;14;6;20;0
da923d2b1f6de3ba2947c83cf89c6affd85cc0d9;Mon Jun 13 05:22:40 EDT 2011;Committer;mrkn;2;5;1;6;0
1c629eff858830131539a5abab1717d93e029439;Mon Jun 13 04:09:04 EDT 2011;Committer;emboss;3;24;3;27;0
60947ded03b815692e23c61361c213f35a653e6b;Mon Jun 13 03:55:00 EDT 2011;Committer;naruse;2;20;9;29;0
8318a14cc4f818e0a461b06c718724246f1c5708;Mon Jun 13 03:54:57 EDT 2011;Committer;naruse;2;5;0;5;0
4e8fed8f4bf414c2667535c2fc324a43250deeca;Mon Jun 13 03:54:55 EDT 2011;Committer;naruse;1;9;0;9;0
69cb0ca3e4893cbe90f610c2f39ea309ce05e1b5;Mon Jun 13 03:54:53 EDT 2011;Committer;naruse;2;6;0;6;0
4247bfd60a15438e6adbabff682e96a235e2d241;Mon Jun 13 02:37:35 EDT 2011;Committer;emboss;3;38;4;42;0
a27b63d3fc1c491eda62a8a48527df53301f45ce;Mon Jun 13 01:58:09 EDT 2011;Committer;emboss;4;96;8;104;0
149f35fc6ee42eb006300378daf002d998a9a07f;Mon Jun 13 01:15:20 EDT 2011;Committer;emboss;2;59;18;77;0
bec36af2d12c0c1187ea4528c3b2fc03ec97395e;Sun Jun 12 20:52:25 EDT 2011;Committer;emboss;2;7;0;7;0
bbb3cfb12b16c7681a58e9a16cec49c37edab1ab;Sun Jun 12 20:39:38 EDT 2011;Committer;emboss;7;251;15;266;0
7b614a53dd50508410c48113dce87abfc003df6b;Sun Jun 12 19:44:48 EDT 2011;Committer;ko1;2;17;2;19;0
a7198a3c739f7c09f21f69df8611ae47780e3a68;Sun Jun 12 18:20:25 EDT 2011;Committer;naruse;1;4;1;5;0
e445f1c6843f6b9bca47084fefd8ef751a70cc98;Sun Jun 12 18:13:06 EDT 2011;Committer;naruse;2;8;1;9;0
f2c7a874a76dd113e088496220f2498e6223e721;Sun Jun 12 17:43:38 EDT 2011;Committer;emboss;2;12;0;12;0
48a399d6202a94e7bfd007f51d0de1780884593f;Sun Jun 12 17:03:26 EDT 2011;Committer;emboss;3;75;31;106;0
eac922547112bb3e5c0dae80506075510a45df53;Sun Jun 12 15:48:31 EDT 2011;Committer;svn;1;2;2;4;0
d6b4cf46ad5f355059bb90d5a93d6ac39e752059;Sun Jun 12 15:48:28 EDT 2011;Committer;emboss;2;92;18;110;0
c6a506d04d41ae614678a023771884ed72c5c061;Sun Jun 12 14:40:15 EDT 2011;Committer;seki;2;4;15;19;0
1afbc783d4c1b4c21c6dca9e39978a1259f74500;Sun Jun 12 12:09:22 EDT 2011;Committer;tadf;2;5;1;6;0
ef9fe8219c7a95a05c2ccd4fd8551208657aa16e;Sun Jun 12 11:38:00 EDT 2011;Committer;tadf;2;167;24;191;0
d5abe72ccac9705a68868e6642a42c0425b121bc;Sun Jun 12 09:12:38 EDT 2011;Committer;ko1;2;12;0;12;0
8c09664a94ed4e1bf043847b28e4567da845292b;Sun Jun 12 08:53:15 EDT 2011;Committer;ko1;2;14;55;69;0
483efa1fda9b3701ca72842d28bd8b17a36a8ccd;Sun Jun 12 07:22:41 EDT 2011;Committer;nagai;2;13;9;22;0
f0041fa0fddd9b5297c1840e7504bb0b04991c87;Sun Jun 12 06:58:15 EDT 2011;Committer;kosaki;3;14;16;30;0
614fcdf66c816b491527c760acb2fbef5c6b8650;Sun Jun 12 06:55:12 EDT 2011;Committer;kosaki;2;29;29;58;0
3c9187a2ad892d0c7c4b905104bb71c3c34a999e;Sun Jun 12 04:38:50 EDT 2011;Committer;ko1;5;73;18;91;0
60e078c860eed4ed92aa7be556623a52bf218f1b;Sun Jun 12 02:18:51 EDT 2011;Committer;akr;2;21;17;38;0
df3e3768e98b6bc60e8f0297c80ad7d8696e6a1e;Sun Jun 12 00:32:32 EDT 2011;Committer;nobu;4;21;1;22;0
465b0d49d637850a7a22732e541b06295f430cee;Sat Jun 11 16:07:41 EDT 2011;Committer;svn;1;2;2;4;0
67345bfa8222fe4d9b15d1d6ebf8cab31a9b1f6e;Sat Jun 11 16:07:37 EDT 2011;Committer;tadf;2;31;23;54;0
29f7ea1b50209cbdb6be1e3f637ef1c7262c18be;Sat Jun 11 14:47:41 EDT 2011;Committer;kosaki;1;1;1;2;0
9d4e471cf974d99ab01fc243b5419c6711888540;Sat Jun 11 14:27:08 EDT 2011;Committer;kosaki;6;71;38;109;0
8df20d6b169ed6b8e76927b5ce5db9acb0208a8b;Sat Jun 11 14:24:29 EDT 2011;Committer;tadf;2;211;9;220;0
47f89c982ccd616245d8c4f15d0d0d5067773ef7;Sat Jun 11 14:07:42 EDT 2011;Committer;nahi;3;40;9;49;0
35c16fe35fd7420ce7d0cd4059a02650ad8d4eb2;Sat Jun 11 13:42:35 EDT 2011;Committer;tadf;2;5;1;6;0
aab8224360e6ee11162b682115d664ac40eeedc0;Sat Jun 11 13:32:43 EDT 2011;Committer;tadf;2;173;1;174;0
87eeed5103da8cfa3f0d225fe2a5d82001cadbe8;Sat Jun 11 13:10:04 EDT 2011;Committer;tadf;2;17;24;41;0
4a400e5372579d9d41d5e39fc27e44c069c1480b;Sat Jun 11 12:59:21 EDT 2011;Committer;tadf;2;266;3;269;0
11c43f7ae9b9264171c9e5394772f155aa18afa4;Sat Jun 11 10:51:51 EDT 2011;Committer;nari;2;67;41;108;0
f53a117c7b8ad99a6af73a20c7c6840f30fce361;Sat Jun 11 10:44:51 EDT 2011;Committer;eban;1;5;1;6;0
004bd2590b5be59a291f5dd436ca413bb89ed3e9;Sat Jun 11 10:39:47 EDT 2011;Committer;nahi;2;8;1;9;0
a6567f2b999b0e14c1d18668ecbfab874e407545;Sat Jun 11 10:36:19 EDT 2011;Committer;tadf;3;18;1;19;0
4dbc9af8afb78687a0f8854d816e4753a032a32e;Sat Jun 11 10:25:25 EDT 2011;Committer;tadf;2;578;765;1343;0
95e42dc1526405e7c7310e39d0c369e9d436a7b9;Sat Jun 11 10:04:19 EDT 2011;Committer;nobu;2;6;1;7;0
10bf738beeba506565c0486a29fc063c421c1d36;Sat Jun 11 09:07:26 EDT 2011;Committer;eban;2;5;0;5;0
34b19050b3894d3e6e072f68c112711696dc1c41;Sat Jun 11 09:02:11 EDT 2011;Committer;nobu;3;14;1;15;0
6f58118e4c6b688aa8c78b5310c4e2c12c444537;Sat Jun 11 07:52:34 EDT 2011;Committer;nobu;3;9;1;10;0
0347b17b27af6ed50e270e52539424748f1cceac;Sat Jun 11 07:32:49 EDT 2011;Committer;kou;1;1;1;2;0
da672779e241c043133fbd549121cdecc2fc986a;Sat Jun 11 07:29:48 EDT 2011;Committer;kou;3;71;1;72;0
962956e8a128bfcc03e694e41316d67ba98122ef;Sat Jun 11 07:12:12 EDT 2011;Committer;kou;2;8;4;12;0
80cb3351ddcfabf7ba470a098f692c378456854d;Sat Jun 11 07:05:42 EDT 2011;Committer;kou;3;20;1;21;0
8aecece69326b14c8797203e692f7a6d354c5fa8;Sat Jun 11 06:53:59 EDT 2011;Committer;kou;2;15;10;25;0
0dfbb49a8350957c6af6f8fb43b297422df81095;Sat Jun 11 06:37:25 EDT 2011;Committer;duerst;2;4;1;5;0
1485f3c168d984d02af6530bbe2202b55d24f212;Sat Jun 11 05:21:30 EDT 2011;Committer;kosaki;2;5;1;6;0
ac0ab1f67511487d5afbc0d24aa37709b504d8d8;Sat Jun 11 01:32:49 EDT 2011;Committer;nobu;2;10;5;15;0
fe244c77b0ac09fedbb000eb80c8c0ac599e1a00;Sat Jun 11 01:21:10 EDT 2011;Committer;nobu;2;8;1;9;0
71fdb43e6ecab9d48c24c6e422685c86406a5dda;Sat Jun 11 01:17:11 EDT 2011;Committer;akr;2;10;2;12;0
2e29d255d369c5c0ba9321dd56fc54be9d75d2ab;Sat Jun 11 01:01:12 EDT 2011;Committer;svn;1;2;2;4;0
1482fccef5e971f1d899ae84d2ae3adac02e9873;Sat Jun 11 01:01:09 EDT 2011;Committer;nobu;2;5;1;6;0
7eed90933c657e7cf5de50ae39ee0672dbb3d58e;Fri Jun 10 14:24:02 EDT 2011;Committer;kosaki;2;6;1;7;0
c479bde4fe6486f2067c8a519714ee35e0411646;Fri Jun 10 07:42:24 EDT 2011;Committer;naruse;2;11;1;12;0
09c8651387bed889bd3f4763962d8ce73bd348b3;Fri Jun 10 06:45:21 EDT 2011;Committer;naruse;2;1;9;10;0
5a363fbb50570063019fd1dfd13490f053cbb29f;Fri Jun 10 05:47:38 EDT 2011;Committer;ko1;2;6;1;7;0
3bc5b309bed998e2a8d59f0ecae9b1e342763802;Fri Jun 10 04:04:41 EDT 2011;Committer;nobu;2;9;1;10;0
c95cbe809e229dc6778746e275462b8e058b25b1;Fri Jun 10 04:03:36 EDT 2011;Committer;nobu;2;2;2;4;0
be4623525f70198984338d0c4e4620e0c5e114ba;Fri Jun 10 04:02:11 EDT 2011;Committer;nobu;1;1;1;2;0
b5d59da9f69c201620f576824074d6fb45e06278;Fri Jun 10 04:01:26 EDT 2011;Committer;nobu;2;9;3;12;0
58b14e789273e3f9b05a54c9aa245d00f197d1ae;Fri Jun 10 00:52:54 EDT 2011;Committer;drbrain;2;16;5;21;0
132161da6911b51f6c5807d696f59d16d1ce1d23;Thu Jun 09 17:26:29 EDT 2011;Committer;tenderlove;2;5;1;6;0
c2f9e1b1007c1d498fed23bc749305b3c47afea1;Thu Jun 09 16:08:38 EDT 2011;Committer;tadf;2;13;4;17;0
14c504b3cc974e31fd0cdca8bfb654ddba4906be;Thu Jun 09 15:36:13 EDT 2011;Committer;tadf;3;21;28;49;0
5aee85cef11daf8ad7f4f62ab3d4065875397cb0;Thu Jun 09 15:31:02 EDT 2011;Committer;nagachika;2;4;1;5;0
aca87391e9e21395d4597ec32c135e922f92c860;Thu Jun 09 15:25:12 EDT 2011;Committer;tadf;2;11;3;14;0
27f4e2182438c9690a0bfc48e19911ca03f8bf5c;Thu Jun 09 15:02:50 EDT 2011;Committer;svn;1;2;2;4;0
87f025da25e2ce7f75f99cc71bd5396ecbf4ae1c;Thu Jun 09 15:02:46 EDT 2011;Committer;akr;6;137;23;160;0
1fdbe0f437de59f87527818918b55d794a5fb92d;Thu Jun 09 14:45:56 EDT 2011;Committer;nagachika;5;34;1;35;0
50a058b6beb55998b6d06b912bb8ffeb9131e6af;Thu Jun 09 13:58:09 EDT 2011;Committer;nagachika;2;16;0;16;0
d7a3261d28371d80ded8d308110ee46364fcc1f7;Thu Jun 09 13:38:27 EDT 2011;Committer;nagachika;2;13;0;13;0
30a87f353550aa112cdcb598641de22587ae0c68;Thu Jun 09 09:39:47 EDT 2011;Committer;mrkn;2;8;1;9;0
8cd2bf072180a9f733ac06dbaa96f071ca8e8303;Thu Jun 09 01:58:07 EDT 2011;Committer;tenderlove;4;56;23;79;0
aaa52bf088d9f78d8e578ead12695a73639fc95a;Thu Jun 09 00:22:33 EDT 2011;Committer;tenderlove;4;31;1;32;0
a8cc42d1ff3f3599a22d14a82fd046c71f719c2f;Thu Jun 09 00:06:34 EDT 2011;Committer;svn;1;2;2;4;0
c641e4b23e674e784258b1b3a86df5fb1091753a;Thu Jun 09 00:06:29 EDT 2011;Committer;tenderlove;4;19;6;25;0
c84bb5df6dff60d17ff692306aa94fd53bed9638;Wed Jun 08 12:57:29 EDT 2011;Committer;nagachika;1;2;2;4;0
5cf9a75c88fffd238e0f294bfca13ab6e8c039bc;Wed Jun 08 12:52:31 EDT 2011;Committer;nagachika;1;1;1;2;0
3621b2de3fd7fa603a7af4ad0bd7705add983492;Wed Jun 08 12:50:07 EDT 2011;Committer;svn;1;2;2;4;0
6d9e64d37c5eb24c670165a5c78b3b9eb076e2cf;Wed Jun 08 12:50:03 EDT 2011;Committer;nagachika;2;8;1;9;0
58aa09cb146cffcc258420d63fbf40b349afdb3a;Tue Jun 07 11:52:41 EDT 2011;Committer;kosaki;4;10;3;13;0
733be259071adba092ff9a2163cfed39392b2ad9;Tue Jun 07 09:56:30 EDT 2011;Committer;usa;3;9;18;27;0
04b81ae7992b8eb06fc89b6874be11c046dfad76;Tue Jun 07 09:38:51 EDT 2011;Committer;usa;2;8;4;12;0
01fd0228114ccc08a3e7c937b920695a6d2b21ca;Tue Jun 07 09:16:02 EDT 2011;Committer;usa;2;6;1;7;0
b59179c8732e7442c219abf585a2f59137de34b3;Tue Jun 07 05:00:04 EDT 2011;Committer;nobu;2;9;2;11;0
8137c55558d8b4dfa419907cc5a5e7262a720e3b;Tue Jun 07 04:50:34 EDT 2011;Committer;nobu;1;12;12;24;0
5b3bf854f7415d9ace826232e648668405c8a9c0;Tue Jun 07 04:37:08 EDT 2011;Committer;nobu;2;9;5;14;0
8189483161009fccab36541c974f20c8825ed9ba;Mon Jun 06 18:35:11 EDT 2011;Committer;svn;1;2;2;4;0
e301f4c18e58e72d29980e4193ad2efae6b636f9;Mon Jun 06 18:35:06 EDT 2011;Committer;kazu;2;55;52;107;0
4d85a0df206abc08fe0c7a0f20c2f2f6293c65f2;Mon Jun 06 14:06:59 EDT 2011;Committer;nagachika;2;21;14;35;0
dc62f1b651fe5fe079ed8c543700f22aeee571c2;Mon Jun 06 13:00:38 EDT 2011;Committer;tadf;2;31;0;31;0
0ac1621a20f44dd4e56cb7891324161430713374;Mon Jun 06 12:41:06 EDT 2011;Committer;nagachika;1;1;1;2;0
8676852786fe54a2c0e4db99fc1a986a71787111;Mon Jun 06 12:38:15 EDT 2011;Committer;tadf;2;11;2;13;0
961143f659a3832696c874eae31a2fa353acc58b;Mon Jun 06 12:31:51 EDT 2011;Committer;nagachika;1;2;2;4;0
2cdd0a87efe67c3a6a3ba48d6532ffa2e11bba5c;Mon Jun 06 12:05:12 EDT 2011;Committer;tadf;3;18;9;27;0
5574d874fb0ead39ad34000cdae4b55327465af6;Mon Jun 06 06:11:37 EDT 2011;Committer;usa;3;23;18;41;0
f4e499de6cf0708e5982e905fac24f33f4e1b58e;Mon Jun 06 05:38:11 EDT 2011;Committer;usa;2;7;10;17;0
3c9e6c7abb6c4029f9e610321f49f1b4ddcd80b9;Mon Jun 06 05:12:17 EDT 2011;Committer;usa;2;10;2;12;0
f0bd1c21740c062a94a8cd734646a922717cdc89;Mon Jun 06 05:09:58 EDT 2011;Committer;usa;2;6;2;8;0
55ddfceed3bae80f1f9f0452cbcc7565ad77f679;Mon Jun 06 03:47:04 EDT 2011;Committer;sorah;2;28;0;28;0
80651edad291d40efc2cd7d3fd92d1e1e188956e;Mon Jun 06 01:53:41 EDT 2011;Committer;naruse;2;11;3;14;0
55ea66cb11e7b4181bd51a3bd176a73a32d7ace3;Mon Jun 06 00:41:27 EDT 2011;Committer;svn;1;2;2;4;0
6c56c40b4422a89776f0128ca274e36e6784d896;Mon Jun 06 00:41:24 EDT 2011;Committer;tenderlove;2;6;0;6;0
ecaf7975cdca4cca1d93c822091747dbd3900101;Sun Jun 05 14:35:09 EDT 2011;Committer;kosaki;3;7;7;14;0
4010bc1e84e4ddc563926072686c2fcb894f0e0a;Sun Jun 05 12:48:23 EDT 2011;Committer;kosaki;2;22;9;31;0
64097bd7332f55d7b7af941388cf55076449439a;Sun Jun 05 08:53:56 EDT 2011;Committer;tadf;3;89;56;145;0
f6554c200b63382bd23814b54cb299dfe3b6a214;Sun Jun 05 08:23:43 EDT 2011;Committer;nagai;2;9;1;10;0
a975bf245f30d1ea1f48dc6087148a7cee52af04;Sun Jun 05 01:13:19 EDT 2011;Committer;tadf;4;352;321;673;0
2473b2ceafb95a1240369cc6b951343d623cfd5a;Sat Jun 04 21:25:20 EDT 2011;Committer;svn;1;2;2;4;0
fab22d5d299de40e48da528915374dc42d46ff00;Sat Jun 04 21:25:11 EDT 2011;Committer;tadf;2;45;0;45;0
6dc8503fa5c09aaff653c243bb1bd36f16a38a84;Sat Jun 04 08:02:37 EDT 2011;Committer;tadf;2;1131;825;1956;0
83ef8ee73e80e1b34ef95db844b8a0958f24eb39;Sat Jun 04 03:49:50 EDT 2011;Committer;nobu;1;24;16;40;0
bf1a04b191f80ecbe65ea0e45630f77630a25aa9;Sat Jun 04 02:32:39 EDT 2011;Committer;nobu;1;16;1;17;0
40930b71445a08d0d9a16681ba20cb8a68a7e3a0;Sat Jun 04 02:30:59 EDT 2011;Committer;nobu;3;22;0;22;0
a8009c20d94aef6ee73b9b3b9ba2877d46987012;Fri Jun 03 19:10:04 EDT 2011;Committer;svn;1;2;2;4;0
1de2e1fdc242924f619c214953ed12864068d1a7;Fri Jun 03 19:09:59 EDT 2011;Committer;naruse;2;9;4;13;0
7ad690313b3b274b2c527ab26d341f69fb09dbd5;Fri Jun 03 13:07:57 EDT 2011;Committer;naruse;2;8;2;10;0
259f84169874b627431e70131e1ce6c478dd2504;Fri Jun 03 12:05:52 EDT 2011;Committer;sorah;1;6;0;6;0
7bc3e95205b1711c0896f48bd0dbe60645061c26;Fri Jun 03 11:59:30 EDT 2011;Committer;usa;2;7;3;10;0
799fafc03b2a654de82d4bd0375dce5537edb88c;Fri Jun 03 11:58:11 EDT 2011;Committer;usa;3;10;2;12;0
d1a7670bafb97ea31e16c2055ca846425d2bad69;Fri Jun 03 11:48:47 EDT 2011;Committer;sorah;1;8;2;10;0
19c78f9b9bb86db1eb176181e4f444eaa781f348;Fri Jun 03 10:59:37 EDT 2011;Committer;usa;2;10;1;11;0
3862d95f0e805bc0cb56926b86c4f19f25c4bdc7;Fri Jun 03 00:32:29 EDT 2011;Committer;svn;1;2;2;4;0
a83f125c3141af17f0426d01e264d684fd60e317;Fri Jun 03 00:32:25 EDT 2011;Committer;naruse;3;11;5;16;0
fe8002b17bb232b443a1dd6469318527db5b690e;Thu Jun 02 14:52:11 EDT 2011;Committer;jeg2;2;29;10;39;0
fd8010fc0ae51c711d61652516afbd1a80f435a5;Thu Jun 02 11:06:40 EDT 2011;Committer;usa;2;6;2;8;0
7b3948f0552b09ee51b885595fe495fd50000bdb;Thu Jun 02 07:30:11 EDT 2011;Committer;sorah;4;197;1;198;0
2b0363df5d523434c0f197e9649713ff4bb1291b;Thu Jun 02 03:35:40 EDT 2011;Committer;usa;2;8;3;11;0
358624d5823b100010e72ff4f6edda0c5fb6232b;Wed Jun 01 22:57:35 EDT 2011;Committer;nagai;2;34;6;40;0
9b3e7967abe5efd6e5853e135b0f7c83ddce57da;Wed Jun 01 22:34:09 EDT 2011;Committer;ryan;4;42;21;63;0
172af01255da17cd53f235b330bb8bd8fd24ec29;Wed Jun 01 22:29:09 EDT 2011;Committer;ryan;1;12;9;21;0
ffe4aff8b3780c33a83a7591892b4d901e416911;Wed Jun 01 21:16:05 EDT 2011;Committer;ryan;1;2;2;4;0
3e95b6386a0727b10e5be2e240f3a0defda01133;Wed Jun 01 16:32:15 EDT 2011;Committer;akr;2;6;1;7;0
e93a9cfae7142dd7048637f6c230c1a7791082d9;Wed Jun 01 15:46:35 EDT 2011;Committer;svn;1;2;2;4;0
eeccb5935b3b60732e5ee0c02e54ac55dc7f53cb;Wed Jun 01 15:46:31 EDT 2011;Committer;nagai;2;52;39;91;0
859da834551657478bec39e55058e987780fcc54;Wed Jun 01 13:03:25 EDT 2011;Committer;kosaki;2;6;1;7;0
dcc1f64cb0372de4a05ecc3989f07a3460d6ba6a;Wed Jun 01 08:20:16 EDT 2011;Committer;kosaki;2;4;2;6;0
402cbc870dc9a5646e60c4a0e3b3f1a1aa8c4fbf;Wed Jun 01 06:42:23 EDT 2011;Committer;nobu;2;11;5;16;0
d441e3b959721be536978d37bc492b444a4a1d7b;Wed Jun 01 06:41:33 EDT 2011;Committer;nobu;1;1;1;2;0
19a8b5cbdc71383e4143d69c9fdb8e97928023d5;Wed Jun 01 06:40:55 EDT 2011;Committer;nobu;2;8;8;16;0
f964813967d3fe89b35996dfeeb868710062e513;Wed Jun 01 05:57:05 EDT 2011;Committer;kazu;1;5;5;10;0
e4b16eff50b01b396838a2229c540f752fc975bc;Wed Jun 01 05:12:55 EDT 2011;Committer;ryan;8;525;58;583;0
b204eabf0563bffc93d8a4b10e4a5e69c5eb2201;Wed Jun 01 04:05:03 EDT 2011;Committer;nobu;6;7;7;14;0
d22130922e7842226d38d59680e4bbb48a28a5f0;Wed Jun 01 03:45:05 EDT 2011;Committer;ryan;103;4722;3431;8153;0
4752539e3f3e563d559732c52424206bd6f12dbd;Wed Jun 01 03:37:02 EDT 2011;Committer;mrkn;2;16;3;19;0
38de163f1e24faf50cd4a09aa91ce271792d6bae;Wed Jun 01 00:48:09 EDT 2011;Committer;ryan;1;2;3;5;0
b8f3f2d62e62fa8ebfd4e59656173813ec96672a;Wed Jun 01 00:42:06 EDT 2011;Committer;drbrain;3;24;10;34;0
5dcb4fc18b38591d111e8c71667e65021b51cbdd;Wed Jun 01 00:26:27 EDT 2011;Committer;drbrain;2;28;21;49;0
b6dd727b86a9107dfb6f00164151fc59d50e8605;Wed Jun 01 00:21:46 EDT 2011;Committer;drbrain;2;37;18;55;0
f4273e88a8a6be5bb92aebb8a3fe4cf78829607a;Tue May 31 23:19:50 EDT 2011;Committer;ryan;1;18;14;32;0
f6809f61d64ebdb95297722f607b6faa97acab08;Tue May 31 22:35:59 EDT 2011;Committer;drbrain;2;7;1;8;0
161cdee26573e02dfc20076aedbebb0fb46cb80b;Tue May 31 22:27:35 EDT 2011;Committer;drbrain;2;6;1;7;0
290c4db6e6190ba049c965e9f9754c893428072d;Tue May 31 22:25:32 EDT 2011;Committer;drbrain;2;7;2;9;0
9ce69e7cef1272c86a93eeb9a1888fe6d2a94704;Tue May 31 21:56:01 EDT 2011;Committer;tarui;2;20;4;24;0
867fa454d81cf5fcbd10c96863e6ef9b8075985a;Tue May 31 16:23:00 EDT 2011;Committer;nobu;1;20;20;40;0
604fe33b4493271c6116733548c3cddb12d2ace1;Tue May 31 16:16:06 EDT 2011;Committer;nobu;5;243;24;267;0
fcc86b0f4c443b7ab28fb61831b81767a8798292;Tue May 31 16:15:15 EDT 2011;Committer;nobu;2;8;5;13;0
10c0604a347769ab23ac22aa83b495793ab543db;Tue May 31 15:36:55 EDT 2011;Committer;nagachika;2;5;1;6;0
678b6820f70d6bd09d6e5179755311f0774db22a;Tue May 31 15:33:42 EDT 2011;Committer;mrkn;3;41;0;41;0
8f9ff461cf1f8d7e8031f9f5b7755bf154655d74;Tue May 31 15:13:02 EDT 2011;Committer;nagachika;1;3;3;6;0
d7058e10dc730b101558d21c343d784aaaf98d3f;Tue May 31 15:09:38 EDT 2011;Committer;mrkn;3;26;2;28;0
8b709310284d8801b88faa74af1284ec367f56fb;Tue May 31 15:05:13 EDT 2011;Committer;svn;1;3;3;6;0
a010ea9a4507c9814c06d8f15f1f9f629bf8de47;Tue May 31 15:05:09 EDT 2011;Committer;nobu;1;8;8;16;0
6a158e05c880d420ddc66d991816b21026bc9f6f;Tue May 31 14:53:52 EDT 2011;Committer;tadf;2;22;12;34;0
100931ac2cc3b5c4e0c4dec9d91061de9e09f3da;Tue May 31 14:43:39 EDT 2011;Committer;mrkn;3;94;41;135;0
b54141bb1b4ae96ff6300177e5eb309b5fee738f;Tue May 31 13:45:31 EDT 2011;Committer;mrkn;3;65;33;98;0
899d2c14b055e180308396b5ef36397c0737f6f7;Tue May 31 13:28:48 EDT 2011;Committer;tadf;6;4145;5890;10035;0
3b3cf8753de031cdd109c5a7bd18ca6d18f95e01;Tue May 31 12:29:26 EDT 2011;Committer;akr;2;6;0;6;0
b219a56c07ad5d9fb1f6cddfb78e97eff1e89379;Tue May 31 08:10:42 EDT 2011;Committer;nahi;5;144;6;150;0
da1db8b454c6f8f0714d762c72815cf73efba4d8;Tue May 31 05:21:36 EDT 2011;Committer;usa;2;16;0;16;0
8fa30bbd48dd73d711961b226ef62780c21a96be;Tue May 31 03:59:36 EDT 2011;Committer;yugui;3;17;7;24;0
69dcd16351786a75982bbeeed6a4b468e702339d;Tue May 31 03:54:58 EDT 2011;Committer;usa;2;10;2;12;0
c5324d7ed6323fa86d083cf87847452c4aa4178a;Tue May 31 03:43:39 EDT 2011;Committer;usa;2;13;4;17;0
70c97ec80522630a184ae8f541d71165cbb68d22;Tue May 31 02:08:58 EDT 2011;Committer;naruse;2;9;4;13;0
b4bc82392d479d58da3fba053e55e06398102fec;Mon May 30 23:11:14 EDT 2011;Committer;nobu;1;1;1;2;0
c50a3040289ce5e8d6327d4fc61fdfcd3a5f7b19;Mon May 30 21:47:40 EDT 2011;Committer;svn;1;2;2;4;0
8b3e21b23d0b8e6dd545e8b97ae09ffbd0aeff53;Mon May 30 21:47:37 EDT 2011;Committer;emboss;1;16;0;16;0
34913093f9b66fa3d515e6f951b534dbc91a4b53;Mon May 30 13:30:18 EDT 2011;Committer;akr;2;6;1;7;0
36cad2f9a6564ebcde6c3375107c5688172837bc;Mon May 30 11:23:36 EDT 2011;Committer;usa;2;7;1;8;0
13e644cb2afb21862afeb2ef68ece2a5f82aabbb;Mon May 30 07:28:30 EDT 2011;Committer;naruse;1;2;1;3;0
1d5431374d286c5ce7f8bfc6033663a0fc051eec;Mon May 30 06:53:21 EDT 2011;Committer;naruse;4;13;4;17;0
4e4649e13cd4175aab75a0edc2fc5b082cf735d1;Mon May 30 01:28:37 EDT 2011;Committer;naruse;2;6;1;7;0
3b58e17d7bc1c2afe0d7b8190f1b113f3138063a;Sun May 29 22:06:54 EDT 2011;Committer;nobu;2;1;5;6;0
4de27b35b5f6ecfae588ece3127057a1dfb14d19;Sun May 29 17:01:27 EDT 2011;Committer;naruse;1;2;1;3;0
e524bb986a849ce4271285cccfd7fff286952353;Sun May 29 16:49:14 EDT 2011;Committer;naruse;1;7;3;10;0
818cb970b9083b2386ad47ba092b0cb8d2df0ba4;Sun May 29 15:49:10 EDT 2011;Committer;svn;1;2;2;4;0
0d6c59105543ed054afda3de2dc91e4d34858c83;Sun May 29 15:49:07 EDT 2011;Committer;nobu;1;1;1;2;0
7c99a7df8587d1b0683fb216dc3704d66332c957;Sun May 29 14:22:49 EDT 2011;Committer;nobu;2;5;1;6;0
f7b046987d0ffcaf9e70cc928dc55778cba10925;Sun May 29 14:18:34 EDT 2011;Committer;naruse;2;7;2;9;0
d5a775f5271e214273b7a2888a3a755040c6b50a;Sun May 29 14:14:38 EDT 2011;Committer;naruse;2;6;0;6;0
4173fb0cb542724d1e7493b361af0d22038335c9;Sun May 29 08:55:54 EDT 2011;Committer;nagachika;2;5;0;5;0
a3ffe9698b8a8dff25d94b3e7e490f0a01684bfe;Sun May 29 06:09:08 EDT 2011;Committer;nobu;5;16;3;19;0
e15b3c83b880aa2c2f07378095d1eba0214ca468;Sat May 28 17:17:36 EDT 2011;Committer;kosaki;2;9;3;12;0
25925517fec58ec217eef375461d40facf5e4f64;Sat May 28 15:24:22 EDT 2011;Committer;svn;1;2;2;4;0
bde7a62f9150d8a147c4e9b721ced4c2beb9600a;Sat May 28 15:24:18 EDT 2011;Committer;kosaki;2;31;13;44;0
ed02c4122a67f209c7c9c4ebdd09647d0ae88e6d;Sat May 28 13:52:03 EDT 2011;Committer;kosaki;3;54;7;61;0
e39b50d4b5531b84386862b47c3d3d273e6c32c7;Sat May 28 07:11:54 EDT 2011;Committer;kosaki;2;8;10;18;0
aede5b391193a2493594e4fcd49ffd685fbe41ca;Fri May 27 23:45:12 EDT 2011;Committer;akr;1;1;1;2;0
9efb5a9d6a14d140b5b2e958e84974da02a07324;Fri May 27 18:06:42 EDT 2011;Committer;naruse;2;7;0;7;0
412e9ba17447fc3460d8d1b2203cf53efa1b2ee7;Fri May 27 17:25:19 EDT 2011;Committer;kosaki;1;1;1;2;0
724b1c60dcacd476b8a3d5ecf8170b4cd8bfb1b4;Fri May 27 17:23:30 EDT 2011;Committer;kosaki;2;6;1;7;0
78271e8c72c72f42b4150b9456de2dbb36410b2f;Fri May 27 17:09:27 EDT 2011;Committer;kosaki;2;6;1;7;0
8858722dbd80a1a8e2244fd19e884678591e53dc;Fri May 27 15:59:06 EDT 2011;Committer;svn;1;2;2;4;0
a50bdcd6dfe4e7eec48bee5b40aebaaa5513e053;Fri May 27 15:59:02 EDT 2011;Committer;marcandre;3;19;3;22;0
40e7d793917c1c00fed590814d401ffd1d341991;Fri May 27 14:57:55 EDT 2011;Committer;kou;2;11;3;14;0
7bb29d4b320fd2e97bc2b879c96945ea472db2b0;Fri May 27 13:55:43 EDT 2011;Committer;marcandre;1;39;40;79;0
ffd86054f511f167bc268b8f1d4df1d63caf34e2;Fri May 27 13:55:21 EDT 2011;Committer;marcandre;1;13;8;21;0
c5719d9a756391ff365d92d62523222a7066d819;Fri May 27 13:46:25 EDT 2011;Committer;nobu;2;9;4;13;0
b5bc09d2347746eda0adf856ece5a3399d7d8839;Fri May 27 13:45:12 EDT 2011;Committer;nobu;2;6;1;7;0
9909c67583b2a538e23097759eb6be22a98ff044;Fri May 27 13:38:56 EDT 2011;Committer;nobu;2;5;0;5;0
faaf8ea8af1fc052a3234e7df7bee9cf156fdf86;Fri May 27 13:37:37 EDT 2011;Committer;nobu;2;5;5;10;0
83e216b6701e2582f59aeac5dd4bbc06c8b9da82;Fri May 27 02:34:25 EDT 2011;Committer;shyouhei;1;8;0;8;0
42f704a8faee3c60f2717430f1acbfbe97953491;Fri May 27 02:34:23 EDT 2011;Committer;shyouhei;2;4;1;5;0
e65e24bd2747203862e6773d7c74996d58e92f4e;Thu May 26 23:48:31 EDT 2011;Committer;nagai;2;6;2;8;0
542190ce584fe2f0923227e591bfe2b8880dad42;Thu May 26 23:36:33 EDT 2011;Committer;nagai;3;347;176;523;0
4aaea4c9b81dd70fe5255b44bdf6b3fef1354b53;Thu May 26 15:35:09 EDT 2011;Committer;svn;1;2;2;4;0
a9c056f1ed254c99152134235bd973ec503f64f2;Thu May 26 15:35:06 EDT 2011;Committer;jeg2;3;20;4;24;0
b74f5dee4a3a2b62753e42b87ec26837d508fa9a;Thu May 26 13:32:40 EDT 2011;Committer;jeg2;2;10;4;14;0
db0f21e906340b12cf1e20a3e560855aa80cdcb0;Thu May 26 06:46:32 EDT 2011;Committer;shyouhei;1;6;0;6;0
b1524728c556110a28d8cfc1a82f0f6ce97c6e1c;Thu May 26 06:44:52 EDT 2011;Committer;svn;1;2;2;4;0
c0f09a8a351a380f377ab3544ea859f4464d27e5;Thu May 26 06:44:48 EDT 2011;Committer;shyouhei;2;7;2;9;0
6e7544f132d2903cf88f7f41208913d940068be8;Wed May 25 14:46:08 EDT 2011;Committer;jeg2;3;36;18;54;0
ce9d84a9f05c2bc891826aa87cc38faac1a1c5b8;Wed May 25 02:54:48 EDT 2011;Committer;drbrain;2;16;26;42;0
eab122534dbff7f79f9b01a5e36aeb730ee24acf;Wed May 25 00:57:07 EDT 2011;Committer;drbrain;2;12;7;19;0
5bf1c145d4b3dbcc5936e0d950752fa6d4474366;Wed May 25 00:38:30 EDT 2011;Committer;drbrain;2;7;2;9;0
0441079b5863e186a08591350e479c56048614fc;Wed May 25 00:30:04 EDT 2011;Committer;drbrain;2;9;4;13;0
9c711c0be66ac8a3ce16d47a705dc85f30fc54d6;Wed May 25 00:26:51 EDT 2011;Committer;drbrain;2;44;34;78;0
9af99106c1b9e0c0d06ba7879d813834f0564881;Wed May 25 00:19:37 EDT 2011;Committer;drbrain;2;17;14;31;0
421875eeffe50cd08952a19e292c28fa2ba864e6;Tue May 24 23:24:32 EDT 2011;Committer;drbrain;1;2;2;4;0
373ea89e17894f33a0d6ba16a4b4d6f2ebd91ec6;Tue May 24 23:22:40 EDT 2011;Committer;drbrain;2;10;4;14;0
c5c245554df58577560571150189a592da7d0640;Tue May 24 22:58:18 EDT 2011;Committer;nobu;2;19;11;30;0
6cbe0e0fd6dd99520f0695f318a6a501570d578c;Tue May 24 22:13:14 EDT 2011;Committer;nobu;2;10;5;15;0
9a7e295255a22d3c99f6358a26d7b849a94cf7f3;Tue May 24 22:12:20 EDT 2011;Committer;nobu;2;14;7;21;0
18684395c6a05319f617f975f87c9b31b4a6d74a;Tue May 24 21:22:05 EDT 2011;Committer;svn;1;2;2;4;0
54bbfe811e70eb7a8536db7d4ab8482b04142cda;Tue May 24 21:22:00 EDT 2011;Committer;nobu;1;2;8;10;0
5c9c28b3a0efa1cc533df46ceafabc70ea37c3c4;Tue May 24 08:31:30 EDT 2011;Committer;naruse;2;7;2;9;0
3ca633b890706c4f5892a179389b8389b5022dc0;Mon May 23 22:37:44 EDT 2011;Committer;nagai;6;728;234;962;0
08f2c46ce177bbe5891c0f90fea0bfa9ee153a66;Mon May 23 19:05:51 EDT 2011;Committer;svn;1;2;2;4;0
4eaf3d4a511611f0a81d2da23ffb72b7641507f3;Mon May 23 19:05:47 EDT 2011;Committer;tenderlove;3;17;0;17;0
7d20942bf6dd54cf54d12d4c9f9dc86b9a813bb4;Mon May 23 01:04:07 EDT 2011;Committer;nahi;2;7;1;8;0
5b3dd70232ae9dc6b67001921374120ab168376e;Mon May 23 01:01:49 EDT 2011;Committer;emboss;3;44;9;53;0
1cb6879c824994df47fde9efcc3b542d5a349f70;Mon May 23 00:21:10 EDT 2011;Committer;drbrain;2;30;0;30;0
b452755c5c742f148f0e2373a3109d76c7443c00;Mon May 23 00:13:56 EDT 2011;Committer;sorah;1;1;1;2;0
6dc0488148c33fe3839e898e011178fa006fa87d;Mon May 23 00:10:49 EDT 2011;Committer;sorah;3;44;6;50;0
1e13786700925d11ac6aad5fbff1e8bc4826054a;Mon May 23 00:08:30 EDT 2011;Committer;drbrain;2;100;9;109;0
c651520c131685c89339096e32822ae4f41906aa;Sun May 22 23:46:08 EDT 2011;Committer;drbrain;2;118;18;136;0
317e2a50212b209d5972494b2ded191178d40bec;Sun May 22 23:37:03 EDT 2011;Committer;drbrain;2;9;2;11;0
6cfb4b614a5e1b59354a2cc33a9be8278f3142de;Sun May 22 23:33:21 EDT 2011;Committer;drbrain;2;197;142;339;0
b7576c3d7a4e776dbce6b80ad0d985bada9c3059;Sun May 22 22:22:16 EDT 2011;Committer;emboss;2;10;0;10;0
7d6529a415457ccfc912d6b8ddbac327516ee5d5;Sun May 22 22:00:24 EDT 2011;Committer;emboss;3;22;2;24;0
a65d506d83ee126d59576e483bdb6699ec73bbe7;Sun May 22 21:34:28 EDT 2011;Committer;emboss;3;23;0;23;0
e7d04f4b82a96bcda5224c75314e1dcf93f5f277;Sun May 22 21:01:13 EDT 2011;Committer;emboss;3;308;136;444;0
2cf8b26bf859fd0692d67ab84c341c858521aff4;Sun May 22 19:38:05 EDT 2011;Committer;emboss;2;16;7;23;0
efd99b781b711bdc32acef1ae3729f47cc69d86a;Sun May 22 19:08:45 EDT 2011;Committer;emboss;2;51;31;82;0
9253bd7797461488245b466eabf6c018a9d0c24c;Sun May 22 18:48:31 EDT 2011;Committer;emboss;1;3;4;7;0
00cfe4d26b1de5db60d0edc0e9619813834c2004;Sun May 22 15:37:03 EDT 2011;Committer;svn;1;2;2;4;0
4eb36541789358d7e17cf498fcc6c3b5dce91c20;Sun May 22 15:37:00 EDT 2011;Committer;mrkn;3;317;22;339;0
fbeca091ed738e4203c0f51bd1d3c68ba1edb4fe;Sun May 22 14:27:02 EDT 2011;Committer;emboss;2;26;13;39;0
4fc3431ba167008de37d4301e055c04de88a86e0;Sun May 22 12:58:23 EDT 2011;Committer;emboss;2;28;23;51;0
27ddbc597231c70467f2ced4f6e60f44bae6468a;Sun May 22 12:52:18 EDT 2011;Committer;nahi;3;16;33;49;0
75431b924cffd2731372c7ef06349b492faa601c;Sun May 22 10:17:46 EDT 2011;Committer;nahi;2;13;6;19;0
70b4b6dc8b54f7e4e5c48460ecd2843573c5a9a4;Sun May 22 09:26:46 EDT 2011;Committer;nobu;2;51;20;71;0
0d6d23b25db0e7d14969504eeba6ac31581a79a2;Sun May 22 09:26:02 EDT 2011;Committer;nobu;83;1033;1033;2066;0
87dbea7bbf97746de91388bd63180faddf0ed6f5;Sun May 22 02:45:12 EDT 2011;Committer;drbrain;2;77;29;106;0
883fb2bbfc1b2653cdb56346cd47b05550c85099;Sun May 22 02:27:09 EDT 2011;Committer;drbrain;2;32;20;52;0
95e1fc5b4e3125e866ec855dec7c2d888706dd00;Sun May 22 02:21:56 EDT 2011;Committer;drbrain;2;21;0;21;0
bb34bcbe470d62b6dccac38ef0a1e8ee435b8530;Sun May 22 02:14:57 EDT 2011;Committer;drbrain;2;25;1;26;0
55aa4dce3bc550617e16de91eba315a41baac2b9;Sun May 22 02:12:15 EDT 2011;Committer;drbrain;2;9;0;9;0
d235b822d254da92b0e9707a195744ab3e759500;Sun May 22 02:08:30 EDT 2011;Committer;drbrain;2;500;4;504;0
2a126b08a055ceacb6f540bd74e6d727f9d07883;Sun May 22 01:06:37 EDT 2011;Committer;kosaki;1;26;4;30;0
20f635d6b23332a5f3f4f6b0ffa1e2cf6d6b4089;Sun May 22 00:31:19 EDT 2011;Committer;kosaki;2;8;2;10;0
db874053457803ef694145c36249ad42aae5a49f;Sun May 22 00:01:06 EDT 2011;Committer;emboss;2;41;7;48;0
3c25546ba288ef859ded3f9737464de3331107a1;Sat May 21 22:55:48 EDT 2011;Committer;emboss;2;7;2;9;0
affb9cfbc877896201536cb9abcda6e9f11f0bb5;Sat May 21 22:13:27 EDT 2011;Committer;emboss;2;39;0;39;0
ee02506321aaef689c4e18fd07a16def30041782;Sat May 21 21:09:51 EDT 2011;Committer;emboss;2;39;0;39;0
e48e12ec095836a665ab91969747ead59df9f464;Sat May 21 19:12:10 EDT 2011;Committer;kosaki;2;6;0;6;0
be14985b0c1ac786b01e8b2aef8e78106a5f11d9;Sat May 21 16:36:40 EDT 2011;Committer;tadf;2;120;118;238;0
41ab05fa9f99ee1f88284fda7ac2c7ecb487fe6b;Sat May 21 15:27:32 EDT 2011;Committer;svn;1;2;2;4;0
c113796e403b7f61ac61ae8e066dc54953d7a51c;Sat May 21 15:27:28 EDT 2011;Committer;tadf;1;0;1;1;0
1f35d2485ce7375dda4190475bd3ac6690d3047f;Sat May 21 13:47:18 EDT 2011;Committer;tadf;3;6;2;8;0
67cf354b465604d820ea51d4afcc14d681640a19;Sat May 21 13:20:43 EDT 2011;Committer;kosaki;3;20;1;21;0
a04e4ae82b8d28b1fd40834bd12e4584f0695655;Sat May 21 13:07:46 EDT 2011;Committer;tadf;1;5;0;5;0
d39f52e87b3583a0bf2b565deaccec5634cf51db;Sat May 21 12:47:07 EDT 2011;Committer;tadf;2;279;0;279;0
559c025a22e7a1df0182c505017eec7cb3d2228e;Sat May 21 12:25:03 EDT 2011;Committer;tadf;8;7573;3048;10621;0
42cb637942628ab87119482e4bcf372cdc19f6d6;Fri May 20 18:00:26 EDT 2011;Committer;drbrain;3;983;61;1044;0
5bae5b4ae2bde5d61acdc6595f86559a0c3eddc3;Fri May 20 17:51:16 EDT 2011;Committer;drbrain;2;50;18;68;0
18d29d79a29617c5823bcc4d86fbc9e9e1064957;Fri May 20 17:44:27 EDT 2011;Committer;drbrain;2;7;2;9;0
c38c0537e054c5b7f61d6a11d2329b47bd878d83;Fri May 20 17:37:06 EDT 2011;Committer;svn;1;2;2;4;0
f8488a270f5ae97191a160be295d604c8e64919d;Fri May 20 17:37:02 EDT 2011;Committer;drbrain;2;29;0;29;0
78cd4749d8228790949dcc7d8b45895bdd52063c;Fri May 20 12:22:26 EDT 2011;Committer;nagachika;1;2;2;4;0
b0087a5817fc5ad0bcd2357eb744ef475b4c6ec9;Fri May 20 06:36:51 EDT 2011;Committer;usa;1;55;36;91;0
e6a51e8f8c475567acca22eb33ba26fcc7a1d7f3;Fri May 20 06:05:54 EDT 2011;Committer;iwamatsu;2;6;1;7;0
7e1e46b99da9d33b9aede74ea56f2cf62df41107;Thu May 19 19:24:13 EDT 2011;Committer;drbrain;2;381;326;707;0
e2283b873d84934c6415500801071dac059f8748;Thu May 19 15:58:13 EDT 2011;Committer;svn;1;2;2;4;0
2acc71b2d504be1b9593ae989bd415970528aef2;Thu May 19 15:58:09 EDT 2011;Committer;nobu;3;135;0;135;0
898374126e2c2632bc9bf0308407898af1f4ff82;Thu May 19 12:18:41 EDT 2011;Committer;kosaki;3;0;70;70;0
4ae55eb1c00889ccf923b2983229e556d7268484;Thu May 19 05:46:57 EDT 2011;Committer;usa;2;6;0;6;0
d371e3583e3b1e0692f92343017b62d2628190ff;Thu May 19 00:07:25 EDT 2011;Committer;nobu;59;1939;1935;3874;0
1fae66fca28167ca0e25625091c5df49405b8023;Wed May 18 22:50:35 EDT 2011;Committer;emboss;2;35;0;35;0
7f7fef1813b1022d0c11694515fb98929953a6b1;Wed May 18 22:22:34 EDT 2011;Committer;emboss;2;113;0;113;0
b205e559537f5a3cbd8cdb133378134e8c983615;Wed May 18 22:07:09 EDT 2011;Committer;drbrain;3;52;47;99;0
f535b33f8d7b1b46e6f94b836adca0bb89059cba;Wed May 18 21:41:01 EDT 2011;Committer;drbrain;3;8;3;11;0
8d906115636940fb3e71d610c8bb90bd826988b9;Wed May 18 21:31:13 EDT 2011;Committer;drbrain;2;6;2;8;0
7bbf2f308580f468802cd7d32c94fce1b9f1779e;Wed May 18 21:19:18 EDT 2011;Committer;drbrain;67;3836;3827;7663;0
34276148c4450faa77bb298cfbe005f7c263f802;Wed May 18 21:07:13 EDT 2011;Committer;drbrain;4;23;0;23;0
ebce1b4bd61c39030d93c01e7d080b8500be17ff;Wed May 18 21:02:36 EDT 2011;Committer;drbrain;2;14;0;14;0
d6581678cbeab9441cac49e5df41a1e0439df525;Wed May 18 20:58:23 EDT 2011;Committer;svn;1;2;2;4;0
40e6facf51085c5adccfc6818f2792bed1662b78;Wed May 18 20:58:19 EDT 2011;Committer;drbrain;2;65;6;71;0
7dd49ed5a78a2631f1a59635b1a0d6b9e18193cf;Wed May 18 14:09:38 EDT 2011;Committer;nobu;7;54;54;108;0
aef01ee7890bf6b2349c4c87548460ce9534dfb0;Wed May 18 13:45:29 EDT 2011;Committer;nobu;2;25;0;25;0
52f5f410e4ce1614793328d38d55f84f66371e6e;Wed May 18 13:41:54 EDT 2011;Committer;nobu;16;66;16;82;0
2082417a48d56295796e2bbfc2001ecf5008a88a;Wed May 18 13:36:46 EDT 2011;Committer;nobu;5;36;3;39;0
bfb8b125faa32e908c474dece5e3d83a4424d209;Wed May 18 13:35:13 EDT 2011;Committer;nobu;1;11;0;11;0
d2dd7416faf3d00c641d18a26ee67f25c9b26f5a;Wed May 18 13:33:31 EDT 2011;Committer;nobu;1;4;2;6;0
da3d9e99dd50f0f99741ca2f90b051d59b4f7f93;Wed May 18 11:31:58 EDT 2011;Committer;kosaki;2;22;15;37;0
73bb32d4dde058f4795b0e3b0869abc8054a7006;Wed May 18 02:14:01 EDT 2011;Committer;nobu;1;5;5;10;0
3cb36fadf2d52c7835354e8609220d88f96a7b16;Tue May 17 21:09:39 EDT 2011;Committer;drbrain;2;40;12;52;0
0d014df637974bdefaacbe89d8296a3be44465c7;Tue May 17 20:42:25 EDT 2011;Committer;drbrain;2;11;2;13;0
1ebfbd7c63de119363d444dd15dac88871528cb5;Tue May 17 20:29:58 EDT 2011;Committer;drbrain;2;25;0;25;0
747772bd430840b9133c1045a12e9564dedc76d3;Tue May 17 20:16:23 EDT 2011;Committer;drbrain;2;120;17;137;0
6e1b5723648423f55b46f7cf0a89476e5c61ac7c;Tue May 17 19:54:40 EDT 2011;Committer;drbrain;2;48;0;48;0
babda328c06e551e6d3f2d65ba21517f8cf0dba4;Tue May 17 19:52:26 EDT 2011;Committer;drbrain;1;5;0;5;0
af703059014aaec046b486c502b993ed84b8957c;Tue May 17 19:51:16 EDT 2011;Committer;drbrain;1;54;1;55;0
c0d9226f49556b9b39b4451f1d8b8c2271a177e1;Tue May 17 18:15:10 EDT 2011;Committer;drbrain;2;95;2;97;0
f4c41cf2d24be02a06179a1f84960e3741fcd568;Tue May 17 18:03:19 EDT 2011;Committer;drbrain;2;89;225;314;0
357213b077b124f97527ed57e6775614f26948c4;Tue May 17 16:04:21 EDT 2011;Committer;svn;1;2;2;4;0
b2d3995f4c8918bfd1ca5e9425242a64b9978291;Tue May 17 16:04:17 EDT 2011;Committer;kosaki;2;8;4;12;0
63d3eec7c4f2aacc8f78b0d10571b0d256e813d7;Tue May 17 12:25:48 EDT 2011;Committer;kosaki;2;6;1;7;0
30414014042210a895b5df3c3eaa86981e0b2e2f;Tue May 17 11:22:50 EDT 2011;Committer;kosaki;2;6;1;7;0
083ec6049e9f484486613d571a7b467d97652576;Tue May 17 11:11:57 EDT 2011;Committer;usa;2;55;12;67;0
b9f3cd5a0c53304cf2611864a5ef750bdb7694d6;Tue May 17 11:04:12 EDT 2011;Committer;kosaki;1;34;1;35;0
44606925ff5bdba121f66b65dc0603079bf3b118;Tue May 17 10:54:51 EDT 2011;Committer;kosaki;2;5;0;5;0
39b1198410c6183c73513eea43cdfbfae65b1c88;Tue May 17 10:36:29 EDT 2011;Committer;kosaki;2;8;1;9;0
60fdd0f0f56747b0bf0f91903636f9989e8fd577;Mon May 16 23:07:58 EDT 2011;Committer;emboss;2;163;3;166;0
13ae409e1ee96cb191d223e475cb563405dcec83;Mon May 16 22:15:32 EDT 2011;Committer;drbrain;2;17;4;21;0
a13b23973aeb23bfb78d6082fb6d66759f26efd2;Mon May 16 22:09:23 EDT 2011;Committer;drbrain;3;28;0;28;0
3257aa8f8f9745c1da1ec81c2f4eeeb723e6a56f;Mon May 16 22:00:48 EDT 2011;Committer;drbrain;2;6;2;8;0
ae4afa5a4e573d7b79a76bfea4bd27befc673acb;Mon May 16 21:57:22 EDT 2011;Committer;drbrain;2;7;1;8;0
1234af557bfe184fbdd5d40076c41f0feee737de;Mon May 16 21:53:12 EDT 2011;Committer;drbrain;2;46;32;78;0
61a5a6393d398a509352ffed49e662595d652d1f;Mon May 16 21:51:12 EDT 2011;Committer;emboss;1;156;150;306;0
532f1485d326edbcc72e64ce0e8f3aa9157f1946;Mon May 16 21:43:20 EDT 2011;Committer;drbrain;2;88;48;136;0
28c2fa2fdb56abb6960ee40b9364706059f0ea65;Mon May 16 21:31:06 EDT 2011;Committer;drbrain;2;74;13;87;0
e60f744e9a574630ebe1c14d023dc3d75ac6ae2b;Mon May 16 21:21:35 EDT 2011;Committer;drbrain;6;255;205;460;0
c648243c3d94076959d77a3af3c4b72ebd9268a0;Mon May 16 20:52:55 EDT 2011;Committer;drbrain;4;117;46;163;0
8638efb23d21484e384dc45f99de4d9c500f2428;Mon May 16 18:51:56 EDT 2011;Committer;drbrain;2;7;3;10;0
d764be79b10ce488207ec4f3e82d2e4139b2d501;Mon May 16 18:34:41 EDT 2011;Committer;drbrain;2;7;0;7;0
690a7b67ddcc3a57ebe68379d214a128e03429ae;Mon May 16 16:28:15 EDT 2011;Committer;svn;1;2;2;4;0
b18ebfab4aeb666e4bb843bf3f9be3b7e15218a9;Mon May 16 16:28:11 EDT 2011;Committer;nobu;1;2;2;4;0
91f386023975a186aa76ab790053df556cd1feec;Mon May 16 12:20:53 EDT 2011;Committer;nagachika;1;48;48;96;0
6df1b40282d7016f1aa14af955c0337800be3fad;Mon May 16 02:23:27 EDT 2011;Committer;usa;1;1;0;1;0
ac3a3c05c9cdf029fe05491eeb2d84e5a2d3a399;Mon May 16 02:22:27 EDT 2011;Committer;usa;3;11;0;11;0
f4b52722aad5a8d2e9fc858d2f1c4147ab584d21;Sun May 15 23:00:21 EDT 2011;Committer;drbrain;5;58;24;82;0
366f2c1120653be5e08f1cc7452d3dbbe1b85f2b;Sun May 15 20:50:49 EDT 2011;Committer;drbrain;2;110;2;112;0
a5eee54bbe01cef7f9b68ad323991feb9aeda0e0;Sun May 15 20:15:38 EDT 2011;Committer;emboss;2;500;1;501;0
9b710b827da8bbb9f932b4e8a2cee50ede442981;Sun May 15 15:33:27 EDT 2011;Committer;svn;1;2;2;4;0
9e9543acb5e739b4f584e6a681f22bb7b59e27df;Sun May 15 15:33:23 EDT 2011;Committer;kosaki;2;8;0;8;0
d734c9dea245305b31a3097387949bcf56351f71;Sun May 15 14:57:35 EDT 2011;Committer;kosaki;3;18;0;18;0
2b7996e83978097552b4a280ec9f9983401810e5;Sun May 15 14:51:09 EDT 2011;Committer;kosaki;4;20;13;33;0
29c2876d610275a42642ecb67ddc28906e484968;Sun May 15 13:37:47 EDT 2011;Committer;nagachika;3;27;11;38;0
980155686aa373e015f51e3e279403d2aa66d4b9;Sun May 15 12:41:40 EDT 2011;Committer;nagachika;3;19;0;19;0
f41dcd486e2004c042941b9d41400986d36f65dc;Sun May 15 12:04:32 EDT 2011;Committer;nobu;2;6;2;8;0
3a47cf3395dd4c4fe8bdd5df13aab698f2ca314b;Sun May 15 11:55:52 EDT 2011;Committer;nobu;212;846;846;1692;0
39da1b63699faf30c86e753e193c29b81b16136d;Sat May 14 18:39:53 EDT 2011;Committer;drbrain;2;474;36;510;0
6d198d2377972d5f9648df68e15cd104331ad18c;Sat May 14 18:24:11 EDT 2011;Committer;drbrain;2;96;6;102;0
4aefc2b3f03d89166492a7951d3673e683587677;Sat May 14 16:01:32 EDT 2011;Committer;svn;1;2;2;4;0
887063f44b21a9e7b2b1e7525de61d517474659f;Sat May 14 16:01:28 EDT 2011;Committer;kosaki;3;9;1;10;0
d19cda5fa6a0f5a1395c47603e21d8db219c8280;Sat May 14 13:45:58 EDT 2011;Committer;kosaki;2;5;0;5;0
4c79752cdfd315b2cb0e933bb4196ca04696b89a;Sat May 14 10:53:29 EDT 2011;Committer;kosaki;2;13;0;13;0
17807148446025ca1ad49a291edf0ea309a8e9d7;Sat May 14 10:51:16 EDT 2011;Committer;kosaki;2;6;5;11;0
3ad44e0aa18ff335cf110d8da11d92af82e2ad51;Sat May 14 10:49:47 EDT 2011;Committer;kosaki;5;197;97;294;0
537a29366961560f926416721cf32eb677a36ec8;Sat May 14 08:47:02 EDT 2011;Committer;nagachika;2;9;4;13;0
61341e050f61d44143ded6c13f94ad15905eb2a5;Sat May 14 06:45:39 EDT 2011;Committer;nagachika;1;1;1;2;0
4ccb387f3bc436a08fc6d72c4931994f5de95110;Sat May 14 03:14:33 EDT 2011;Committer;emboss;3;138;5;143;0
4bf8c87101217056257508d76e7787ded0d76849;Sat May 14 03:07:38 EDT 2011;Committer;drbrain;4;58;2;60;0
ad10cfeb526151300f0ab141d0b4b5c85576033d;Sat May 14 01:33:58 EDT 2011;Committer;emboss;2;118;0;118;0
61ebfd3a3496d619b18895b4c1f29c8c5d7c291d;Sat May 14 00:50:39 EDT 2011;Committer;drbrain;3;159;7;166;0
0b6da24a5e24ff9ce8e153d2f073c2363e94b28e;Sat May 14 00:39:16 EDT 2011;Committer;drbrain;28;594;98;692;0
fe89874540f5e95fbfd933a72fff2ad31b8e8d07;Fri May 13 22:31:15 EDT 2011;Committer;tenderlove;2;5;1;6;0
e16d6108c0420ebe4907b97f0419c9ed1eb4a579;Fri May 13 20:10:27 EDT 2011;Committer;emboss;5;23;91;114;0
10219ff6216c9d6459026e9e89ed788e2d440dc5;Fri May 13 20:03:21 EDT 2011;Committer;drbrain;10;115;13;128;0
cb57042beeac1f6acc424cc1339acfa198d5ac8b;Fri May 13 19:25:18 EDT 2011;Committer;emboss;6;103;15;118;0
f347a9212e20e437436405e097be828b63554c02;Fri May 13 17:59:35 EDT 2011;Committer;drbrain;2;8;0;8;0
8dca37990791a5572e7f7df7bbc9a0ab5aa5d8da;Fri May 13 17:54:22 EDT 2011;Committer;drbrain;2;12;0;12;0
172b1ba6155f5804a815a65f696355510c2a4cfc;Fri May 13 17:52:05 EDT 2011;Committer;svn;1;2;2;4;0
cc48da67d82edda1a6c201c0a90578cc63925146;Fri May 13 17:52:01 EDT 2011;Committer;drbrain;2;8;3;11;0
58355ea52a44ba8d66f1eb4dc10934e7b75efa7b;Fri May 13 12:54:57 EDT 2011;Committer;nagachika;4;11;8;19;0
a55d803ed3246ef68e83240feb19eeee9d605d69;Fri May 13 12:38:49 EDT 2011;Committer;nagachika;1;1;1;2;0
c2f8979729b1c698b48f5f727c0dd5ed3d1de5a3;Fri May 13 10:27:12 EDT 2011;Committer;shyouhei;1;6;0;6;0
eb5de217f190c70da870931a027b8b989171cc0d;Fri May 13 10:27:10 EDT 2011;Committer;shyouhei;1;9;1;10;0
79fdc67835ae7f15f31ef7f8c826ffe1969a5dc9;Fri May 13 09:59:16 EDT 2011;Committer;shyouhei;3;10;3;13;0
425b30bc7898f4fe8a65a5481bb5994eccdb59be;Fri May 13 06:24:36 EDT 2011;Committer;usa;2;48;21;69;0
7ed51785df6c4c3999cb9ef2d9893c5f4fac4672;Thu May 12 23:41:35 EDT 2011;Committer;drbrain;3;27;24;51;0
57580b76e8a20b266df05d1e099ae7af9bab4612;Thu May 12 22:49:40 EDT 2011;Committer;drbrain;2;10;5;15;0
d6e3bc4ce499fe5f439441c0c5117a6e0d54b5de;Thu May 12 22:37:01 EDT 2011;Committer;drbrain;2;37;0;37;0
8c47d5188338522f6eec459da460eb28348ee104;Thu May 12 22:04:59 EDT 2011;Committer;drbrain;2;55;47;102;0
6e10135d47a33975ee2c9d597caa968ce1045cb0;Thu May 12 21:51:41 EDT 2011;Committer;drbrain;2;34;6;40;0
f154226900b258f6f51b328fab98becd6c23f5f7;Thu May 12 20:45:45 EDT 2011;Committer;drbrain;2;22;0;22;0
e2b3183fc2c065f8aa9ae77f5ef7d0c8e29744af;Thu May 12 20:39:11 EDT 2011;Committer;drbrain;10;760;6;766;0
78e06ab19423518300a2ef9478cef69468e9d4a9;Thu May 12 20:17:29 EDT 2011;Committer;drbrain;3;45;0;45;0
73707bb42bc9d33f6baf9d82b01604284f3c1725;Thu May 12 17:16:25 EDT 2011;Committer;svn;1;2;2;4;0
836a8cf2149f214d86e31f07884530ed10d86653;Thu May 12 17:16:21 EDT 2011;Committer;kosaki;2;36;35;71;0
9fac3321a7207552f2717bed4193a8c3bdd31234;Thu May 12 12:18:47 EDT 2011;Committer;nagachika;1;7;6;13;0
4902517f9900c258ef74db55521edde1cb8d8684;Thu May 12 09:31:34 EDT 2011;Committer;kou;2;10;1;11;0
dd4dca8f064205412d4e3bbddaef46b93771357f;Thu May 12 05:51:55 EDT 2011;Committer;usa;2;6;1;7;0
9a7d41ae19d8c012113ca79b5a4f6637c9b60fdb;Thu May 12 05:48:41 EDT 2011;Committer;usa;2;6;1;7;0
baf2eff25e55bac63b4737865572fe2cb8f4d1af;Thu May 12 04:22:16 EDT 2011;Committer;iwamatsu;2;9;0;9;0
6eaa5cb30cee1d1ef934429807e26e9bd996d6de;Wed May 11 23:17:52 EDT 2011;Committer;drbrain;2;8;3;11;0
f14d97e1c0ce23412c2612085feda5d92db44f20;Wed May 11 23:05:29 EDT 2011;Committer;emboss;2;39;34;73;0
615e7987ca619a9d8df01844b61d95796b95fd19;Wed May 11 22:56:13 EDT 2011;Committer;drbrain;7;58;5;63;0
83d7aca7f6c02a92d49be1490e72b50fe9643598;Wed May 11 22:31:17 EDT 2011;Committer;drbrain;9;56;135;191;0
bc75259b69e3ba6cddea7e8508b90ea7759a6923;Wed May 11 22:27:14 EDT 2011;Committer;emboss;2;11;5;16;0
8578b5907a044160462356596068118877411720;Wed May 11 21:51:56 EDT 2011;Committer;svn;1;2;2;4;0
1915a913ecee168610f17d6b9c9e2d20d2a219d8;Wed May 11 21:51:52 EDT 2011;Committer;emboss;2;13;7;20;0
fcd7300bf28ac8571b54dcf356e797a786946b6c;Wed May 11 11:12:40 EDT 2011;Committer;keiju;2;7;2;9;0
1111afbe5a7599f3aa536485fd12c61fafbffa62;Wed May 11 10:22:16 EDT 2011;Committer;nagachika;4;4;4;8;0
8c2a52937f3b71efa7bcb48e7b8b00bc6b616ab4;Tue May 10 23:37:43 EDT 2011;Committer;drbrain;10;285;17;302;0
6626b0a2c567669cceebd3bfd0195b0ffd8c97c3;Tue May 10 18:07:56 EDT 2011;Committer;svn;1;2;2;4;0
b30735567813b8f16b1b9761d0d77195c4cc3bd7;Tue May 10 18:07:51 EDT 2011;Committer;drbrain;2;81;4;85;0
64495a2f85e8c661af0b60e360eaafcc457c3183;Tue May 10 05:53:46 EDT 2011;Committer;sorah;4;40;0;40;0
f47ff4821dbed8c3b9fa8a545743d82989673ba5;Tue May 10 03:03:19 EDT 2011;Committer;drbrain;1;1;1;2;0
7f2a943c5d2a37a8dcb4a36e5ecd6c0d35394627;Tue May 10 01:54:34 EDT 2011;Committer;drbrain;2;8;0;8;0
071a678a156dde974d8e470b659c89cb02b07b3b;Tue May 10 00:13:58 EDT 2011;Committer;drbrain;12;591;18;609;0
7e3ec1db0da950bf77bc3aa8d9b24b161cb60654;Mon May 09 19:22:45 EDT 2011;Committer;svn;1;2;2;4;0
38b4876bb0eb2a90ef7e5b3aabfb0e28b9698f27;Mon May 09 19:22:41 EDT 2011;Committer;drbrain;9;19;8;27;0
c980b87d070d8fc5b87b415e83fab6502fcab3d4;Mon May 09 12:35:49 EDT 2011;Committer;tadf;1;2;2;4;0
c1f80caa54ab992f27cee6ad7cc72caa7c966fb7;Mon May 09 11:57:59 EDT 2011;Committer;tadf;3;54;0;54;0
6c81a8e44e3abe05ccffc7c26813308e7b347bcb;Mon May 09 11:31:26 EDT 2011;Committer;tadf;3;7;7;14;0
140e1f0b15bc995b45caff0ac62af960d52b4441;Mon May 09 09:35:27 EDT 2011;Committer;naruse;2;10;4;14;0
ca927d60f4e6b82c61afd1447112abc2157ff622;Mon May 09 04:52:57 EDT 2011;Committer;mrkn;3;13;2;15;0
d3e5a29361a75f46c471b404479693bd6359ff0f;Mon May 09 02:53:59 EDT 2011;Committer;svn;1;2;2;4;0
074818f3b005d177c4265d25d31eeb11abd1ce83;Mon May 09 02:53:55 EDT 2011;Committer;naruse;2;6;2;8;0
10c4a861ebcbf0190beaca91c015126b851e5023;Sun May 08 13:18:47 EDT 2011;Committer;tadf;7;34;56;90;0
e2ab17e8816fb3a13b5e47eb7842961b45672e0d;Sun May 08 12:03:50 EDT 2011;Committer;tadf;3;12;2;14;0
6b8bc66e4df5631b3ebe19cbdd7e6326e916bc49;Sun May 08 12:01:59 EDT 2011;Committer;tadf;1;1;1;2;0
a4ecf14d586f304d78dbbcdc113bf0bf2ec12d94;Sun May 08 11:56:32 EDT 2011;Committer;tadf;6;55;47;102;0
5518dc64cf740df0988b7c2bd3a57f5455b9cc41;Sun May 08 11:38:25 EDT 2011;Committer;tadf;5;30;26;56;0
dbe8aba7f921414f2e4a5ba83b1a852c433b8e2d;Sun May 08 11:33:41 EDT 2011;Committer;tadf;5;34;26;60;0
bf92aa8b16f938c888197edc70a5bd97a39581bc;Sun May 08 11:15:23 EDT 2011;Committer;naruse;5;26;30;56;0
19f52b87408263faba97f91404d84d4ef707bab6;Sun May 08 10:46:27 EDT 2011;Committer;kosaki;2;20;3;23;0
099933373211f74c00cc837fac26168b5d54ad2d;Sun May 08 10:08:12 EDT 2011;Committer;tadf;2;5;1;6;0
1348dd26b003665a8dc219ea8f5799834b40c941;Sun May 08 09:41:38 EDT 2011;Committer;tadf;3;17;10;27;0
1816a4a6a994f6437b6b741fa3a84bfb4c827c04;Sun May 08 08:52:25 EDT 2011;Committer;kosaki;2;2;9;11;0
847b46145229b083b8c7a09ef0f15b5fc1b32fd5;Sun May 08 08:18:10 EDT 2011;Committer;tadf;5;30;26;56;0
d54240d35e0ca6d090cbf325ee6d098b2cfd5af9;Sun May 08 08:06:40 EDT 2011;Committer;tadf;2;6;2;8;0
ca5401e481f9fbe5aa415882e96f3030b4253386;Sun May 08 07:58:11 EDT 2011;Committer;tadf;2;22;24;46;0
23f2285835c8fc0bb344abcb6ed21520a6c5216c;Sun May 08 04:27:55 EDT 2011;Committer;kazu;1;1;1;2;0
c878761f3b992366d4da92d6120d28070281081a;Sun May 08 01:54:58 EDT 2011;Committer;kosaki;2;9;2;11;0
a3fd4cf507a137e78366c6d1190ddd584bc48b4a;Sun May 08 01:50:36 EDT 2011;Committer;kosaki;2;52;42;94;0
f23fa4b01140758c8327bf2a8f0cf48a1de75cd5;Sat May 07 20:21:38 EDT 2011;Committer;kosaki;2;11;1;12;0
c9da3d68baffd4368d54f21f08d155049e9034ee;Sat May 07 15:17:25 EDT 2011;Committer;svn;1;2;2;4;0
16846eb90cda0d82a26d9c724d29672ae309fc6d;Sat May 07 15:17:22 EDT 2011;Committer;kosaki;2;5;11;16;0
70e9201610cf83408f5e408571a48b7eab8cc5fa;Sat May 07 14:57:38 EDT 2011;Committer;kosaki;2;12;0;12;0
21fcb1c3a19bf6b330aebf14f4c915c0d63925d6;Sat May 07 14:52:54 EDT 2011;Committer;nobu;1;2;2;4;0
76734388a22c1ffed89e18d916a4215034898b39;Sat May 07 13:44:27 EDT 2011;Committer;kosaki;2;5;3;8;0
9468e945c8877af9d33044e5813627282a7700f4;Sat May 07 13:40:56 EDT 2011;Committer;kosaki;3;8;4;12;0
156ccab7964ae35fa2bcdb0e0a9c5f11192aa848;Sat May 07 13:36:08 EDT 2011;Committer;kosaki;3;32;12;44;0
ddcd5c2939771129c779bad077bbacc59cd7679a;Sat May 07 13:22:12 EDT 2011;Committer;kosaki;2;8;8;16;0
68417aa5ce4e6608da1304dac49dda42503031bf;Sat May 07 10:47:23 EDT 2011;Committer;kazu;1;2;2;4;0
1bd2c78b05b05f7868cd3b5bfc1e02ae11fb9eaf;Sat May 07 09:28:43 EDT 2011;Committer;nobu;3;15;3;18;0
562a1a79297d00b9ac92498173ad1fcba9fc5f51;Sat May 07 06:22:39 EDT 2011;Committer;kosaki;1;0;1;1;0
fa319c5774ff479e0961f0710aff206f52231f86;Sat May 07 06:20:39 EDT 2011;Committer;kosaki;2;8;2;10;0
94e4d61bdaad74e0f31bb6d69521784303a0cb5e;Sat May 07 06:17:59 EDT 2011;Committer;kosaki;3;48;17;65;0
471fb33b1a140973a3e3f6168f16b67bee95b4cd;Sat May 07 03:43:27 EDT 2011;Committer;kosaki;2;7;1;8;0
7ac6b706b418db4311ce64219c6156ec628453de;Fri May 06 18:17:14 EDT 2011;Committer;kosaki;3;75;36;111;0
2d7a5f6553a14431741f1469d76b774e4d6ac4c3;Fri May 06 18:14:25 EDT 2011;Committer;akr;1;1;1;2;0
604a1e2e22b1e8a841a6d3f6d0c870eb504306f3;Fri May 06 17:50:23 EDT 2011;Committer;kosaki;3;11;1;12;0
b2ea836ae705cc690d1230476e6eb97e92e7ef52;Fri May 06 17:39:32 EDT 2011;Committer;kosaki;4;92;62;154;0
54b50fbb9c5a62a5dbefc40568985b23eb4d1238;Fri May 06 16:56:06 EDT 2011;Committer;kosaki;2;28;3;31;0
17707b2d487abdf1ad494b4e6c5fc539fc76817c;Fri May 06 16:47:44 EDT 2011;Committer;svn;1;2;2;4;0
a1cfaf4b1f199d078f5168dcbc37a83250666ed4;Fri May 06 16:47:38 EDT 2011;Committer;kosaki;6;79;37;116;0
4a9883e92f856bf7db773e0ddc72f17a8662b75a;Fri May 06 14:58:38 EDT 2011;Committer;kosaki;3;57;10;67;0
066eecf53a762521891c46199c2e8c11a35fb8dd;Fri May 06 14:18:06 EDT 2011;Committer;kosaki;2;6;7;13;0
54aa0b1232b9ed09bca30f9f32ec3626498d7ceb;Fri May 06 13:36:02 EDT 2011;Committer;nobu;3;37;9;46;0
957ec6fcc81d603216ace1e2366bb841efbf959e;Fri May 06 08:44:07 EDT 2011;Committer;naruse;3;7;2;9;0
1f6a7c18f59a0547bd11a9b355376d2d6fd6e406;Fri May 06 08:38:36 EDT 2011;Committer;naruse;2;8;2;10;0
534388dd1795b9122a70b4722fd0e3c9f73dc569;Fri May 06 06:19:20 EDT 2011;Committer;svn;1;2;2;4;0
e3a69233e6563e6c95ccdc1040afa00db7b795e9;Fri May 06 06:19:17 EDT 2011;Committer;shyouhei;2;14;6;20;0
be237a9d8fad158f7cd0fd58b25eaf5884ab1664;Fri May 06 06:19:14 EDT 2011;Committer;shyouhei;1;5;0;5;0
dbbfac20fc35270df87a41d07ba7a219ab8b2a0a;Fri May 06 06:19:12 EDT 2011;Committer;shyouhei;1;17;10;27;0
25d040780fcff44b3b03062d1d2c4540df7b33ef;Thu May 05 14:09:21 EDT 2011;Committer;kosaki;2;44;19;63;0
b5d612e0df4b77f7918323d25d7b46ccdd2756d9;Thu May 05 13:26:18 EDT 2011;Committer;kosaki;3;6;7;13;0
66fc78d20737cc78c244809395b1f185748763ef;Thu May 05 13:09:42 EDT 2011;Committer;nobu;2;13;2;15;0
6410a4ae27a8832d1aee4c370bbf036608a7e577;Thu May 05 08:39:22 EDT 2011;Committer;nagachika;2;6;0;6;0
5358a5c016de6162433baf80c127be27ce2ca11c;Thu May 05 06:32:37 EDT 2011;Committer;nagachika;3;56;2;58;0
09c2f41211709047eff6f8829ff7afc827ef288c;Wed May 04 23:08:03 EDT 2011;Committer;svn;1;2;2;4;0
d3802d719ce37f023cf5c076ca29c1ddde5c51b4;Wed May 04 23:07:58 EDT 2011;Committer;tenderlove;1;2;2;4;0
f5b0f04d2ae2fdbf94f0a061a40693d84a863e0e;Wed May 04 13:14:28 EDT 2011;Committer;kosaki;3;8;2;10;0
674a33edf51e5b5a47f78b2794500ad2e61c69c3;Wed May 04 13:10:06 EDT 2011;Committer;kosaki;2;26;22;48;0
512624b62839f5ffe0faebfceb49411b10ee38bf;Wed May 04 12:13:02 EDT 2011;Committer;kosaki;2;6;1;7;0
be62297f9230c4cf8d73321c5c9e28037b35fc1d;Wed May 04 11:29:24 EDT 2011;Committer;kosaki;3;41;0;41;0
c06da4735da0e2285c1e3e52202b7090b3f43b1b;Wed May 04 10:02:06 EDT 2011;Committer;kosaki;3;41;9;50;0
2a989121db8f80aceeadb5d403af79d4b30e1bb8;Wed May 04 09:50:27 EDT 2011;Committer;kosaki;5;73;0;73;0
8a98c57ff064ac8f1555be414e28df418685ca30;Wed May 04 06:26:13 EDT 2011;Committer;kazu;1;1;1;2;0
951b0901302d851bac96341f181c8f0a1ece54d1;Wed May 04 03:47:33 EDT 2011;Committer;kosaki;2;9;1;10;0
d7fa4d837eff72adae21f0504fa9ccacab7f7019;Wed May 04 02:54:34 EDT 2011;Committer;kosaki;2;4;8;12;0
9851b0ce2fbc5934ddd00434048be4273f41102d;Wed May 04 02:44:28 EDT 2011;Committer;kosaki;2;34;9;43;0
4da4cb0421fbdd5c7a825addcda9c8725e86c844;Wed May 04 01:13:02 EDT 2011;Committer;kosaki;2;6;5;11;0
82b2e8012048cdc6f6ee7659fdb25ffa53945d02;Wed May 04 01:12:04 EDT 2011;Committer;kosaki;2;20;60;80;0
cd796c609fec41b412a78bd742c723b1d8319c61;Wed May 04 01:09:08 EDT 2011;Committer;kosaki;2;10;29;39;0
249fe0e74252af65c3e2e47a5e9e27eb839ad7c0;Wed May 04 01:07:03 EDT 2011;Committer;kosaki;4;77;4;81;0
9be37ca7d51513658f5f84d98fa5e46026cc5a04;Wed May 04 00:59:57 EDT 2011;Committer;kosaki;4;101;52;153;0
d47073de04f706c9d044b0fad694e5936dabc207;Tue May 03 23:06:19 EDT 2011;Committer;tenderlove;5;14;3;17;0
fb58474627ed1df82d18536f218cf5417ddf5843;Tue May 03 22:37:12 EDT 2011;Committer;svn;1;2;2;4;0
f081eca1d7ca95a15989c2b59230430ff3dfe708;Tue May 03 22:37:07 EDT 2011;Committer;kosaki;2;6;1;7;0
50522eb35172c4887b5a35919ebe8c52f00bfe71;Tue May 03 11:31:20 EDT 2011;Committer;kosaki;2;17;4;21;0
7ad29955a6afbe8ce03eeee376be2bfa792cd198;Tue May 03 09:31:13 EDT 2011;Committer;yugui;2;26;0;26;0
227609ea96356debda538a6c6bb2cef3d3119602;Tue May 03 04:45:28 EDT 2011;Committer;kazu;1;5;6;11;0
55a1b1d97a090eec8987c4a9c8541c2d3efc1110;Mon May 02 19:27:59 EDT 2011;Committer;nobu;2;6;1;7;0
ab8e05cc451249202e32a4f8a901a9edf7101b14;Mon May 02 19:27:56 EDT 2011;Committer;nobu;1;1;1;2;0
7694c3415795fca12f214041baf7a75e25e9d97f;Mon May 02 19:05:03 EDT 2011;Committer;nobu;1;27;26;53;0
690072a1a5c169507b547473680d6196adfbee4d;Mon May 02 18:57:10 EDT 2011;Committer;svn;1;2;2;4;0
88559ce46ed1af86a57738cedccdc28ba1f0e549;Mon May 02 18:57:06 EDT 2011;Committer;nobu;2;6;0;6;0
0a1e7d1568584f22f743347c5e3b64dbf705dd83;Sun May 01 16:16:05 EDT 2011;Committer;kosaki;4;149;2;151;0
0468df6249fa9ec94217f87f4213a8e1032c67f5;Sun May 01 15:38:57 EDT 2011;Committer;svn;1;2;2;4;0
49b4510cd1ca220e9ec51ad269c6544ca9610ca3;Sun May 01 15:38:53 EDT 2011;Committer;kosaki;2;11;0;11;0
4d88169267a8614c36e9fbe389dd3fadba25cdc5;Sat Apr 30 16:08:20 EDT 2011;Committer;kosaki;2;15;1;16;0
3cea846e426bffab9fd22846b6464787359ee63d;Sat Apr 30 16:02:15 EDT 2011;Committer;svn;1;3;3;6;0
e140be695630daf179cd6ef1180a12409d9fc2e9;Sat Apr 30 16:02:11 EDT 2011;Committer;kosaki;1;64;0;64;0
04202dc83dde72db03d72227841c6dddbd41a925;Sat Apr 30 14:11:34 EDT 2011;Committer;kosaki;3;19;1;20;0
3c68095b8a0d665b9ae94ec3c48fa4f30b3fb86a;Sat Apr 30 11:23:08 EDT 2011;Committer;kosaki;2;48;27;75;0
225fa965bc5807a356b94944916af0573ab692a9;Sat Apr 30 11:18:14 EDT 2011;Committer;kosaki;3;14;6;20;0
2d2544c8e66ce6cc0973611145d442a165a9c663;Sat Apr 30 11:15:15 EDT 2011;Committer;kosaki;6;23;12;35;0
4c926e9f15c42ef789e0af5ca2f15dc6188d1b3c;Sat Apr 30 11:08:39 EDT 2011;Committer;kosaki;2;7;5;12;0
5201602c276115ae4be8442d73c567c95af22f7b;Sat Apr 30 07:49:29 EDT 2011;Committer;kosaki;3;22;1;23;0
98c7ca9b65be4bc102463d1c90142094e8d05c42;Sat Apr 30 07:30:45 EDT 2011;Committer;kosaki;2;7;1;8;0
568c934373ce149ac10afcc62d41e5f44eff56ac;Sat Apr 30 07:16:31 EDT 2011;Committer;kosaki;3;32;0;32;0
b48537cd269a9b150c4ebde2efe80a424ea0165e;Fri Apr 29 19:09:44 EDT 2011;Committer;kosaki;1;5;0;5;0
1bbab743982f1d7bf289f5d388ddba355143e3a8;Fri Apr 29 15:50:43 EDT 2011;Committer;kosaki;1;1;1;2;0
58e414b85e913e96f949d9c1502114e13cd9f453;Fri Apr 29 15:43:55 EDT 2011;Committer;kosaki;2;5;1;6;0
708034fedff1979373f8282050bc863eced7d059;Fri Apr 29 15:20:05 EDT 2011;Committer;svn;1;2;2;4;0
ada9870af9da1443fe7be51ee50c98cdbfb53c45;Fri Apr 29 15:20:00 EDT 2011;Committer;kosaki;2;6;1;7;0
5f131b648dfb8b5817ca4c9ad02e9e89da3055f5;Fri Apr 29 12:12:52 EDT 2011;Committer;nobu;2;5;0;5;0
b4c5fad4b1b435f081dd552ad29040a9edb1457f;Fri Apr 29 04:18:29 EDT 2011;Committer;kosaki;4;60;20;80;0
9d4ae4ab0c5b17e48939457bc9d4cf45ac412d26;Fri Apr 29 03:23:13 EDT 2011;Committer;kosaki;1;13;13;26;0
3c24bc37a00901427add4f96f7f37411a0eb8da5;Fri Apr 29 01:44:32 EDT 2011;Committer;kosaki;3;38;0;38;0
e4ba4b79b657f784ab52a339958c1ebb2320e906;Fri Apr 29 01:29:22 EDT 2011;Committer;kosaki;2;5;3;8;0
85c1d5d41d8c6d045fb74f3ee09f59d80175c614;Fri Apr 29 01:24:54 EDT 2011;Committer;nobu;2;7;1;8;0
7ff7a2b376478fe3377a9c2dfdea43e3dde326ff;Fri Apr 29 01:18:51 EDT 2011;Committer;kosaki;1;1;1;2;0
6998f013ab594d3f2499155b1076e45eedf70e34;Fri Apr 29 01:18:11 EDT 2011;Committer;kosaki;2;10;1;11;0
32ae0ae1c2d6b1d24a875e2846db11290907a11f;Fri Apr 29 01:11:31 EDT 2011;Committer;svn;1;2;2;4;0
74c5e807f7e5f8cd9a041fe2e12e960d47f9c651;Fri Apr 29 01:11:28 EDT 2011;Committer;kosaki;2;51;17;68;0
22d5cf92263998d59d524c706b21c054c8ac53d2;Thu Apr 28 07:22:18 EDT 2011;Committer;usa;4;68;30;98;0
e269a71eeb2e360c0882b6c8309b80425d90ddd5;Thu Apr 28 06:34:01 EDT 2011;Committer;usa;2;6;1;7;0
e858442f4f9ca8dead0413a8fa140be92240f189;Wed Apr 27 21:07:09 EDT 2011;Committer;nobu;3;31;5;36;0
2f348762fbcf97b1de3b91c0dd84ba8b8b430dfd;Wed Apr 27 21:07:04 EDT 2011;Committer;nobu;2;6;5;11;0
c612fc92ec46809655caed77df894ce9b4724f50;Wed Apr 27 21:07:03 EDT 2011;Committer;svn;1;2;2;4;0
9c48e5990720b575e1143a5a1ec5a88e53ba43c5;Wed Apr 27 21:06:59 EDT 2011;Committer;nobu;2;12;2;14;0
06911f90ce919479dc4242f4289abbe43703caa4;Wed Apr 27 02:45:36 EDT 2011;Committer;naruse;2;7;2;9;0
86ed9661b8ac2a1a01f87b72da11a75ad6d7aab7;Tue Apr 26 22:42:46 EDT 2011;Committer;nobu;2;8;4;12;0
dfb52b729b47b78bf326f82b393ae73dcef96f68;Tue Apr 26 16:30:27 EDT 2011;Committer;nobu;1;1;0;1;0
322bffd84b60e84452d7c0a828009a7f704053f2;Tue Apr 26 16:23:05 EDT 2011;Committer;tadf;4;20;13;33;0
21e6862cd5f507b6096e8f738794b18dcff37a8c;Tue Apr 26 16:17:01 EDT 2011;Committer;nobu;2;5;1;6;0
8fabd0c551b885f98e23c0d3be175cb317d9d3fd;Tue Apr 26 16:14:26 EDT 2011;Committer;nobu;1;8;6;14;0
2ad123c298f24d1ab02624bd73e25f51f283c2ea;Tue Apr 26 16:09:14 EDT 2011;Committer;tadf;2;3;3;6;0
184e9e9d885a7d83ac0797c466647462008a6f7d;Tue Apr 26 16:05:49 EDT 2011;Committer;tadf;1;1;3;4;0
9fe4a35e67e46b84049e6c3951f4720d550322cf;Tue Apr 26 16:02:25 EDT 2011;Committer;tadf;6;280;189;469;0
0b98b9a95dc3bdedd620ccaf015607a5a959a06e;Tue Apr 26 15:57:04 EDT 2011;Committer;nobu;4;38;38;76;0
c26ab1ef1c1129198695edf2212774a084147228;Tue Apr 26 15:55:58 EDT 2011;Committer;nobu;2;40;1;41;0
876146772787599c894369801034f1fed1d16b54;Tue Apr 26 15:55:21 EDT 2011;Committer;nobu;6;86;28;114;0
3b937bbdc4abc6ec1d3ec5d6b4e31714e0456e35;Tue Apr 26 15:54:14 EDT 2011;Committer;nobu;3;16;13;29;0
7140c8f0cddac4ffc3d06d49d5e571a046dee089;Tue Apr 26 15:52:35 EDT 2011;Committer;nobu;1;2;2;4;0
4c7106c679273b81f0645bf45f02bc5bc942c05a;Tue Apr 26 15:51:04 EDT 2011;Committer;nobu;2;4;2;6;0
fcfc113b04eabea56ae0df01b95b0a3f7b69dcda;Tue Apr 26 15:50:09 EDT 2011;Committer;nobu;3;36;7;43;0
7da3b09e0f13b61126149b9cdb2cef53e49b9698;Tue Apr 26 15:02:13 EDT 2011;Committer;svn;1;2;2;4;0
91ee7710129845f3625b558a5a5e03ed5159bd12;Tue Apr 26 15:02:10 EDT 2011;Committer;tadf;2;5;0;5;0
b3defabde2fbdc8cc9b42644d718bc4f70170a8e;Tue Apr 26 13:36:49 EDT 2011;Committer;tadf;3;105;63;168;0
82c771fe8f963be5eefc52b1fc6e77a654015925;Mon Apr 25 21:45:40 EDT 2011;Committer;svn;1;2;2;4;0
73868a547f60849833fde5de6a2b5d780a0845e0;Mon Apr 25 21:45:33 EDT 2011;Committer;iwamatsu;2;10;0;10;0
333e43e06be3db1beddac9096f02bfe2e0f34bd7;Mon Apr 25 12:11:44 EDT 2011;Committer;arton;2;5;1;6;0
83e071701b8fb1a5fb711a153a9f682a91d19143;Mon Apr 25 11:04:40 EDT 2011;Committer;arton;2;5;1;6;0
63f39fcb4045f98888b24494b77317d70a8398e0;Mon Apr 25 07:56:42 EDT 2011;Committer;naruse;7;25;22;47;0
7c885222ca1d038006819afda93758cf1425ec66;Mon Apr 25 02:28:49 EDT 2011;Committer;naruse;2;25;5;30;0
b5909efd1376231e8a820226506c999446730781;Sun Apr 24 23:25:11 EDT 2011;Committer;sorah;2;29;8;37;0
2aeb3b47ee47443fa5531bfce856aa1df269a740;Sun Apr 24 22:27:39 EDT 2011;Committer;mrkn;3;129;76;205;0
03697bc1f3112b7a57ab016c98cd745f5af6b0e9;Sun Apr 24 18:31:47 EDT 2011;Committer;tadf;3;6;3;9;0
fd93bad83fbd420e67a5b08e6ec175a9bb64ec06;Sun Apr 24 18:09:24 EDT 2011;Committer;tadf;2;6;1;7;0
9f103e659ea9bff380f05bd5a85b9ca647fd8f88;Sun Apr 24 18:07:24 EDT 2011;Committer;tadf;2;20;11;31;0
f3551c047645a381ae306d4592ca60a0ca602f66;Sun Apr 24 18:04:47 EDT 2011;Committer;naruse;2;7;0;7;0
b7133cc6c74b0d9fc2e12f6859c50ee6258c72ce;Sun Apr 24 17:48:33 EDT 2011;Committer;tadf;2;6;1;7;0
2115af3a46838221b49d217141067a3829f9faeb;Sun Apr 24 17:13:17 EDT 2011;Committer;tadf;2;7;3;10;0
60c7967e12dfb54fe817616ec117da80debd4782;Sun Apr 24 17:00:18 EDT 2011;Committer;tadf;2;257;58;315;0
0c1d2a0af4475d90f78bbae1ba1ee70b0b31dc70;Sun Apr 24 16:04:35 EDT 2011;Committer;svn;1;2;2;4;0
8ff8d6196141b72cc1f7197aad7f99e7579d944e;Sun Apr 24 16:04:31 EDT 2011;Committer;kosaki;2;5;2;7;0
14491f13d753f0dc420f0becf0bd10182ef67bf5;Sun Apr 24 13:24:02 EDT 2011;Committer;tadf;3;70;35;105;0
bedb18f28240e89c4b60618125f2c99d56aa0c9c;Sat Apr 23 17:59:38 EDT 2011;Committer;tadf;2;7;2;9;0
4116d8a3bd7d90aba6c2cc6a61a4968bba667d6f;Sat Apr 23 17:51:42 EDT 2011;Committer;tadf;2;9;5;14;0
60aa9c809b58b214cba304b28f5813c8a7399a92;Sat Apr 23 17:34:58 EDT 2011;Committer;naruse;3;10;4;14;0
c34db589139980914f0b05d27b2499ac5bec615a;Sat Apr 23 17:34:55 EDT 2011;Committer;naruse;4;20;12;32;0
5c0a69a6211c76d0e34be9adb24e89ee539f4cba;Sat Apr 23 15:35:45 EDT 2011;Committer;svn;1;2;2;4;0
05b3bd27d875c0bec404c7502603042573fb6c41;Sat Apr 23 15:35:42 EDT 2011;Committer;tadf;2;14;19;33;0
37cfdf9f0b219ca879e17ceb19adba5c494642c7;Sat Apr 23 12:31:19 EDT 2011;Committer;svn;1;2;2;4;0
448e0d6668d5df4f63a17db2063b31ed50c39d46;Sat Apr 23 12:31:15 EDT 2011;Committer;tadf;4;1459;594;2053;0
d5b4cf7f798cf82cb6f33f774690b72f2a12de69;Fri Apr 22 13:35:43 EDT 2011;Committer;naruse;1;1;2;3;0
4e047495165c909935041e8ab869963d6e2c852a;Fri Apr 22 03:05:32 EDT 2011;Committer;naruse;2;7;2;9;0
c853e2d86e4d074e773cf06b2d9ee6519fc95c15;Fri Apr 22 02:50:45 EDT 2011;Committer;naruse;3;29;5;34;0
33883ded8b9d9578c26bd3706acc185df8c1abc1;Thu Apr 21 19:17:49 EDT 2011;Committer;svn;1;2;2;4;0
8968bd14fa6425196b1e9b8af1e6ca2eb8b84146;Thu Apr 21 19:17:46 EDT 2011;Committer;tenderlove;3;149;0;149;0
0efb462a503e0a24cb99226acf357d2613827488;Wed Apr 20 16:31:25 EDT 2011;Committer;naruse;2;7;2;9;0
934c6b48708664ba53809c002407f654949a9bb4;Wed Apr 20 16:15:39 EDT 2011;Committer;svn;1;2;2;4;0
6825f77323fd140d8cf8d407eed2fccbfec5e298;Wed Apr 20 16:15:35 EDT 2011;Committer;tarui;2;11;0;11;0
e8d5304080fb4bdfbad6005089fcf14b6850aae8;Wed Apr 20 12:34:01 EDT 2011;Committer;tadf;2;6;0;6;0
88014987ad8e159594ac44dd4444078af75c1394;Wed Apr 20 05:43:27 EDT 2011;Committer;naruse;2;7;1;8;0
2cc02aeb500909616d3757f52f0e40d5380de79f;Tue Apr 19 15:02:20 EDT 2011;Committer;svn;1;2;2;4;0
d9e6b7d6a5e81afb588d79ef923b70890cdec4ba;Tue Apr 19 15:02:16 EDT 2011;Committer;nobu;3;22;2;24;0
86576c8f28cbb2fec257c7cc46307954c18e39ce;Mon Apr 18 16:08:11 EDT 2011;Committer;svn;1;2;2;4;0
580e2f35a84d841f2b85c2d1ee4e0d38a1c26356;Mon Apr 18 16:08:07 EDT 2011;Committer;arton;2;6;0;6;0
e16fb91966e8923b2c9748bdcf0216dee1bd67ff;Mon Apr 18 03:17:05 EDT 2011;Committer;svn;1;2;2;4;0
b5897263eb86433ba5288232e012799b18428995;Mon Apr 18 03:17:02 EDT 2011;Committer;usa;2;8;3;11;0
1891d8dd3b1651896ee7182cd34c0f66ee1b4f2c;Sat Apr 16 20:14:58 EDT 2011;Committer;tadf;1;19;0;19;0
8459dc63bff1c043af857e6aaeb65e5e0726a6db;Sat Apr 16 15:22:51 EDT 2011;Committer;svn;1;2;2;4;0
2b6ab9bf1e592e6820403d2e2a273219f1278b1c;Sat Apr 16 15:22:47 EDT 2011;Committer;tadf;5;141;142;283;0
531dfb40e0fa16f873b53dbef8694a26e10a7d6b;Sat Apr 16 13:43:15 EDT 2011;Committer;tadf;1;2;2;4;0
10ce57ea8d3328a815ad096cb5049242c0959b1a;Sat Apr 16 13:26:15 EDT 2011;Committer;tadf;2;12;59;71;0
4c6580f8f67883ee9c2c8f5fd339306cfea0a777;Sat Apr 16 13:08:41 EDT 2011;Committer;tadf;1;1;1;2;0
ec01a8813ffe941220a6c77ee6f57a29f391501b;Sat Apr 16 12:58:28 EDT 2011;Committer;tadf;4;788;219;1007;0
b1fd9e92152c6da896e3d7977ef730db2b1ad670;Sat Apr 16 01:23:39 EDT 2011;Committer;svn;1;2;2;4;0
44638b2721a4a4458de6219183fced6066171627;Sat Apr 16 01:23:37 EDT 2011;Committer;kazu;1;2;2;4;0
c0b0901c7d248627542dbda233d77a6e1a02659f;Sat Apr 16 01:23:34 EDT 2011;Committer;kazu;2;5;4;9;0
82fd7175b50998c72b9db1017573d93d39e83024;Fri Apr 15 14:42:36 EDT 2011;Committer;kazu;2;7;2;9;0
09bafe3cce2609b6f890ad59ceb6948b2939c1e0;Fri Apr 15 07:39:59 EDT 2011;Committer;svn;1;2;2;4;0
733d4294fc6843ce49a8a8b41ba464b40a7718e7;Fri Apr 15 06:21:56 EDT 2011;Committer;knu;1;9;3;12;0
835693dac5bd2d38cac972adbfd7980c305435a4;Fri Apr 15 06:13:08 EDT 2011;Committer;knu;3;22;15;37;0
6692ef3c54a6c2aaa01e122925f9fcc441bb3132;Fri Apr 15 06:05:25 EDT 2011;Committer;knu;2;7;1;8;0
9d5f651a9815bce2ff48010f50b591af722b7712;Thu Apr 14 14:50:46 EDT 2011;Committer;usa;3;18;1;19;0
716a99389c36e7e15c932f8ce4a0229b9756b185;Thu Apr 14 13:48:18 EDT 2011;Committer;nobu;2;8;4;12;0
80020d092e6416eb19046e905ebfdbc9b89c35bc;Thu Apr 14 13:48:14 EDT 2011;Committer;nobu;2;9;6;15;0
3d41f4df438e8073e29cf85543917e401a83322b;Thu Apr 14 13:48:09 EDT 2011;Committer;nobu;2;15;7;22;0
146bedd6c487aa0fd93d8af41900887ff6d500eb;Thu Apr 14 13:48:05 EDT 2011;Committer;nobu;2;8;5;13;0
ed1c3f56c09c12d6921ccbe5b206c2ce4522aab2;Thu Apr 14 13:48:00 EDT 2011;Committer;nobu;2;8;4;12;0
311b3b4ff8fe2e6878041ccf225a41cf74f70f71;Thu Apr 14 13:47:55 EDT 2011;Committer;nobu;2;6;2;8;0
af103c63dce907b2c08d95a2d50f75e21b16074c;Thu Apr 14 12:23:32 EDT 2011;Committer;nobu;3;27;1;28;0
d986500059e8cacbe179a883d114b29787ca6628;Thu Apr 14 12:21:09 EDT 2011;Committer;nobu;2;18;1;19;0
f777225e09bcee89197f3a69739103f230881e27;Thu Apr 14 12:21:04 EDT 2011;Committer;nobu;2;6;3;9;0
b8bcb6474c14cbe6ec3d9b8de34e8acec627370a;Thu Apr 14 12:20:59 EDT 2011;Committer;nobu;2;6;2;8;0
b4dc41d42ee969dcbe9da510073a06a627c9b2fd;Thu Apr 14 12:16:09 EDT 2011;Committer;nobu;1;4;4;8;0
f5c7d1074fd5f4836aeae851eab819565cdfc6f2;Thu Apr 14 11:01:53 EDT 2011;Committer;kosaki;1;2;1;3;0
8c5961f6f9b0387647e233be8652f23e609d68c2;Thu Apr 14 10:58:10 EDT 2011;Committer;kosaki;2;7;1;8;0
fb7f3bf37cff4d10092f631439c0995aa97d6662;Thu Apr 14 07:02:54 EDT 2011;Committer;kazu;2;5;1;6;0
b642a73820895c78d66ad9b949a07b7cf84886ff;Wed Apr 13 15:43:17 EDT 2011;Committer;svn;1;2;2;4;0
d4d13162c570ca80cd13ad3f030a5bddbc3751cc;Wed Apr 13 15:43:13 EDT 2011;Committer;nagachika;2;6;1;7;0
a52dce92f40cb0c5bfa83b5785a91e253ca8e1fd;Wed Apr 13 11:22:38 EDT 2011;Committer;svn;1;2;2;4;0
c5a284aa17166e5c2a8a163a7290468c05ae9a9a;Wed Apr 13 11:22:34 EDT 2011;Committer;kazu;2;4;1;5;0
77a12692eeb0a2204b740dfece9f3015975af3be;Tue Apr 12 11:54:28 EDT 2011;Committer;akr;2;5;1;6;0
8553b70a39bf4707cee6d667fc5903f09bf0a525;Tue Apr 12 10:20:50 EDT 2011;Committer;naruse;2;23;9;32;0
dd11a58be3d6eba910a8bcfdb888562fb64fde01;Tue Apr 12 09:08:08 EDT 2011;Committer;kouji;2;13;1;14;0
c3b81f63e76fee3c09e5881eff7c2d2d60d00bab;Tue Apr 12 01:39:39 EDT 2011;Committer;usa;2;9;3;12;0
ace092cb7a160141ee6df169aa52e88deb941e3b;Mon Apr 11 16:38:14 EDT 2011;Committer;svn;1;2;2;4;0
c2bfeaa2449671a4dcea16e09c6bc3e7c7095456;Mon Apr 11 16:38:10 EDT 2011;Committer;luislavena;4;27;9;36;0
0f771e33e2c3be4bc6316d6f4a930ba67ed0a9a3;Mon Apr 11 12:52:22 EDT 2011;Committer;kosaki;2;8;43;51;0
616f70fcf6c81ca70b46951ddf605008a2848a92;Mon Apr 11 12:50:55 EDT 2011;Committer;kosaki;2;45;0;45;0
3b011d1a00dcad0ae960800778070ec565fcef7e;Mon Apr 11 12:18:32 EDT 2011;Committer;kosaki;2;16;5;21;0
2934feb9fff0821516d66a45998021114defa210;Sun Apr 10 22:24:54 EDT 2011;Committer;svn;1;2;2;4;0
091ea0ed71c30874902c56e977ba7c9b241c9376;Sun Apr 10 22:24:51 EDT 2011;Committer;drbrain;2;14;2;16;0
4db93c3f41818261121d53214030aad6ec001ee7;Sun Apr 10 13:24:26 EDT 2011;Committer;akr;2;48;44;92;0
2350bd945760d4196a9373257f984379c0eb8f61;Sat Apr 09 15:10:07 EDT 2011;Committer;svn;1;2;2;4;0
6eb77404724eaca3c58c45d76cd5ab36fea2be4a;Sat Apr 09 15:10:03 EDT 2011;Committer;sorah;2;9;4;13;0
4e817b39b42fb1089ed0d4eb5f8c4d3e0e695960;Sat Apr 09 14:28:06 EDT 2011;Committer;sorah;3;14;4;18;0
0a69f2e39de67d3d9887673b5030adcc5f2d0b81;Sat Apr 09 13:01:23 EDT 2011;Committer;sorah;3;26;0;26;0
699c3de19016690c3901641ca3d0d40822558f05;Sat Apr 09 09:02:07 EDT 2011;Committer;svn;1;2;2;4;0
eb7d68819f7a1373cb8797691edc459ba9412878;Sat Apr 09 09:02:03 EDT 2011;Committer;akr;2;8;4;12;0
8999a9d41552a0dd0b5556c451265f3b1c6bdda3;Fri Apr 08 07:50:53 EDT 2011;Committer;svn;1;2;2;4;0
653b4248a306685e0cdd86bf46c27a0ef03f9c7c;Fri Apr 08 07:50:49 EDT 2011;Committer;naruse;3;22;12;34;0
4ca9e7d03a90b4a703564d1e5288f1b94c797e7a;Thu Apr 07 11:04:22 EDT 2011;Committer;svn;1;2;2;4;0
e6ef26ae4b727d5e92af27bd251208b0bed4611a;Thu Apr 07 11:04:18 EDT 2011;Committer;akr;2;29;25;54;0
d55cf83561fd32a05bf230aee65ebdab5c3367e7;Wed Apr 06 12:08:46 EDT 2011;Committer;akr;2;42;38;80;0
d5b1fde5c783bdf3a7e316760313d08d5a0c868e;Wed Apr 06 06:14:05 EDT 2011;Committer;naruse;5;33;2;35;0
6fc7c377bc818269926b777b5b767dd57efb0c27;Wed Apr 06 02:44:49 EDT 2011;Committer;svn;1;2;2;4;0
e61d269f343f748d5c5d576dc77d8a9279af421e;Wed Apr 06 02:44:46 EDT 2011;Committer;naruse;2;14;1;15;0
a63105a45fb7d9ee28edca9bac90ce2300b1c7c6;Tue Apr 05 11:34:15 EDT 2011;Committer;akr;2;23;19;42;0
42caa6ddd6fa3cd882c59144760b2b3f85b08491;Tue Apr 05 04:05:22 EDT 2011;Committer;svn;1;2;2;4;0
257f7859a996bd4a43bf65e0c007441211d3282c;Tue Apr 05 04:05:19 EDT 2011;Committer;kazu;1;1;1;2;0
78ea7afe97241b7a8a8176f680865430779e7d68;Mon Apr 04 13:11:14 EDT 2011;Committer;kosaki;2;16;2;18;0
3ba502d5f01a39b4adfd456ffc29f0f13c106267;Mon Apr 04 12:43:28 EDT 2011;Committer;kosaki;2;9;1;10;0
b36f8e6e13a27755b873e54aee721844b9640905;Mon Apr 04 02:51:20 EDT 2011;Committer;svn;1;2;2;4;0
8eb92a671d6d9fd12b5beebc945e949633e5be6a;Mon Apr 04 02:51:17 EDT 2011;Committer;usa;2;9;8;17;0
6a06e94046401e861ecb3f88b10b22d2c85aac14;Sun Apr 03 13:58:32 EDT 2011;Committer;nagachika;2;19;6;25;0
11b1f4ff92f4eb5ab5be8d7b9c4ee7b1f6111148;Sun Apr 03 13:10:29 EDT 2011;Committer;akr;2;6;2;8;0
f4755f214c91c726ba264d3053680da1ac59cbf7;Sun Apr 03 12:35:29 EDT 2011;Committer;kosaki;3;9;2;11;0
34c46a676680d26f11ea18f1b7f7ac2b582a60d0;Sun Apr 03 12:24:03 EDT 2011;Committer;svn;1;2;2;4;0
f35a7770cd9ceeb88411f23b3595c4bf6ec78d79;Sun Apr 03 12:23:59 EDT 2011;Committer;kosaki;2;57;4;61;0
8a6e9ec085ff08a106ec7e143df03fd46c1431f3;Fri Apr 01 13:26:26 EDT 2011;Committer;akr;2;5;1;6;0
cc8bc6b7b6cb429c6a0a4bebc180b70b564e4e99;Fri Apr 01 10:02:03 EDT 2011;Committer;nahi;3;31;1;32;0
9d0fbe23b6ed84657eccac5d657b58eef2855361;Fri Apr 01 04:19:37 EDT 2011;Committer;nobu;2;8;3;11;0
92b7d39ea12495d23046e51571703627e5a808ea;Thu Mar 31 15:12:30 EDT 2011;Committer;svn;1;3;3;6;0
0916f978c5a209a99637586010813b7cd22d1b72;Thu Mar 31 15:10:27 EDT 2011;Committer;arton;1;1;1;2;0
2cda63027d3acf3057cba6e7f4b77adaef5cbb20;Thu Mar 31 14:15:48 EDT 2011;Committer;nobu;2;10;2;12;0
eb239b43344665308eafc105b5a7318486f82410;Thu Mar 31 11:42:23 EDT 2011;Committer;akr;2;6;2;8;0
7487298584145058f2340dc7a6e4da8d21fe5248;Thu Mar 31 09:07:42 EDT 2011;Committer;shugo;3;30;1;31;0
4273aa8e722c88b04ff0828b6a3c9e6b25988231;Thu Mar 31 07:52:40 EDT 2011;Committer;shugo;4;52;19;71;0
3044423f9404af026305c18ef40a1460f1dd8308;Thu Mar 31 05:54:37 EDT 2011;Committer;svn;1;2;2;4;0
e3d7e34e7e34b97ede54b29a4492daaab321de2f;Thu Mar 31 05:54:34 EDT 2011;Committer;shugo;3;12;1;13;0
633cf770f0ec5aa3d44e46c6997c3939fec73eef;Wed Mar 30 13:55:50 EDT 2011;Committer;nobu;2;42;1;43;0
764c486b8459cb4426fb2be77b4cd93879853911;Wed Mar 30 13:54:26 EDT 2011;Committer;nobu;2;18;3;21;0
3e2a0184d0169131c0db735ffb5b61eb3f22d2fa;Wed Mar 30 13:48:32 EDT 2011;Committer;nobu;3;3;21;24;0
3b20c2188046d33a0d3b2c2f711193dd5e02a19c;Wed Mar 30 05:38:50 EDT 2011;Committer;shugo;4;44;14;58;0
089462f592b630110827fea6624f1890411627e0;Wed Mar 30 03:52:07 EDT 2011;Committer;tenderlove;1;1;1;2;0
9e448999a0b75c45bc3d02d7a3bd1077cae95b8d;Wed Mar 30 03:38:53 EDT 2011;Committer;tenderlove;38;38;38;76;0
66ead6f2f04a667d45c5cc1eeabdd1e25ee1d60c;Tue Mar 29 15:25:29 EDT 2011;Committer;svn;1;2;2;4;0
80fb9c7b4e94a57f72bd22bee41759e01ccbfbcf;Tue Mar 29 15:25:25 EDT 2011;Committer;akr;2;6;2;8;0
76cc9bf0cf6e4b8a3de762a7a49d77492dbc9424;Tue Mar 29 13:01:37 EDT 2011;Committer;nagachika;1;1;1;2;0
a64103fbfe0218dcd6f1997e80c60a887897a52d;Tue Mar 29 12:56:40 EDT 2011;Committer;nagachika;2;8;1;9;0
d084c4f43d975f1f9b3f7bf12a46506dbbea2a2d;Tue Mar 29 01:29:20 EDT 2011;Committer;usa;2;10;1;11;0
d8ac44fcfcf730535df82a402bd7c97267b56d61;Mon Mar 28 20:20:33 EDT 2011;Committer;akr;2;5;1;6;0
1c2b0f4f8f160154aa9a954ba59a4b308036e276;Mon Mar 28 16:52:23 EDT 2011;Committer;svn;1;2;2;4;0
5988d8cbd5be141ccb9e6516785dae6be80c724e;Mon Mar 28 16:52:20 EDT 2011;Committer;arton;2;12;2;14;0
f2b3d517871b2c6d5db610d2084afedc2e2e7cab;Mon Mar 28 08:11:31 EDT 2011;Committer;naruse;1;1;1;2;0
09a4ae1bbc8c611db9d87842a9ff249005599855;Mon Mar 28 02:41:31 EDT 2011;Committer;naruse;3;19;9;28;0
0dcb387abe9570711af5638eac474157eddbfef2;Mon Mar 28 02:08:18 EDT 2011;Committer;usa;2;5;0;5;0
96cf5ef0e41b4c6bf053f4c150134dac666e04e6;Mon Mar 28 02:07:34 EDT 2011;Committer;svn;1;2;2;4;0
8df705810d0a1cfc4e3e00c8c1edb2d8c9c8447a;Mon Mar 28 02:07:28 EDT 2011;Committer;usa;2;7;3;10;0
94a5335148c70aec998bb5d2d1da07627e7d0503;Sun Mar 27 14:16:50 EDT 2011;Committer;akr;2;5;1;6;0
1f1c31e355c133d475fc99c3e9bd712957798169;Sun Mar 27 07:55:43 EDT 2011;Committer;nobu;2;5;2;7;0
69a6b860efcce52a949576a186101eb599c22924;Sun Mar 27 06:45:56 EDT 2011;Committer;nobu;2;71;56;127;0
e4d29d975792f8eac283f2a56d6b3e051e04c1ea;Sun Mar 27 02:23:21 EDT 2011;Committer;svn;1;2;2;4;0
ea490ced1149f59180a64016ffc4752cec31ec20;Sun Mar 27 02:20:17 EDT 2011;Committer;tadf;2;4;4;8;0
c65953cd0303d6c3315376f228c2ac20a8ad0135;Sat Mar 26 06:16:42 EDT 2011;Committer;akr;2;6;2;8;0
5f969a9d17d6762598a2cff820808acf25012d6d;Fri Mar 25 20:29:56 EDT 2011;Committer;svn;1;2;2;4;0
4d09e8cd199129b372eeb56a84b84e1348537ec6;Fri Mar 25 20:29:55 EDT 2011;Committer;naruse;2;6;5;11;0
700b778cbb6b718069504cdfe2240c9c01176835;Fri Mar 25 20:29:53 EDT 2011;Committer;naruse;1;3;4;7;0
e358888d5e22344429ee7d5589b5053e0a817afd;Fri Mar 25 13:01:06 EDT 2011;Committer;tadf;3;18;13;31;0
96216554d2de68c90c53068a87d88e8f25207d74;Fri Mar 25 12:56:34 EDT 2011;Committer;akr;2;8;4;12;0
8c6a73ded362b2bc09d00c8e2e3f1cfd8c070e3c;Fri Mar 25 11:06:59 EDT 2011;Committer;shyouhei;1;19;0;19;0
bb41909d8b8c14045bcf08d75732337d6c972595;Fri Mar 25 11:06:57 EDT 2011;Committer;shyouhei;1;3;2;5;0
d711cde778c8fcfeb85371292e5306a0673b292a;Fri Mar 25 11:06:56 EDT 2011;Committer;shyouhei;1;3;2;5;0
6b1cf264a80f2efe6a4b42553b8bf2e16f51690a;Fri Mar 25 06:46:57 EDT 2011;Committer;naruse;10;56;34;90;0
e3c3733a30091958cb00bc1a2e4f0882fe6d59d6;Fri Mar 25 06:46:55 EDT 2011;Committer;naruse;2;7;3;10;0
d81591607172afe8c92e6de72f7fa515aaa3d0bf;Fri Mar 25 02:50:17 EDT 2011;Committer;usa;5;35;23;58;0
5f6bb0dc64832f36c32cc4c02e0c8a08cc68317c;Thu Mar 24 16:18:20 EDT 2011;Committer;svn;1;2;2;4;0
9395381561f40d668f23ac8676ad5b29e062a2ac;Thu Mar 24 16:18:16 EDT 2011;Committer;kazu;1;2;2;4;0
ab69aba3ecd8d5fda8bc9ae2998228147267df9b;Thu Mar 24 14:41:17 EDT 2011;Committer;nobu;1;5;0;5;0
d3326ddf1113a0b0788658e5ef6131f2722ab3c4;Thu Mar 24 14:06:31 EDT 2011;Committer;nobu;3;16;1;17;0
0e3822c1e2e81baa96793e881cbbdfc2db7aba3a;Thu Mar 24 14:05:45 EDT 2011;Committer;nobu;3;24;1;25;0
e6a4a8018d1fd070cae7db533840aaa0dbcbe8ec;Thu Mar 24 14:03:45 EDT 2011;Committer;nobu;1;3;3;6;0
9de5f281cdcddcdb9479a4418f8dc2c7d415625a;Thu Mar 24 13:49:26 EDT 2011;Committer;akr;2;9;5;14;0
3a16cc24e84704e5b3939f886ba036ea6c4c77c6;Thu Mar 24 07:29:21 EDT 2011;Committer;naruse;20;110;71;181;0
643f90d8db0a10c86ba5922fc48731d06edfcf6b;Thu Mar 24 04:49:18 EDT 2011;Committer;naruse;4;21;6;27;0
90d74620c2b0ad10f4510cefa90cd380393faa5c;Thu Mar 24 04:49:16 EDT 2011;Committer;naruse;2;5;1;6;0
3dbb97708b3295787a665d97b543862ee049e6c9;Thu Mar 24 01:25:19 EDT 2011;Committer;naruse;2;6;1;7;0
fea562417fa8589365aeb9b994ff36d952305f1a;Thu Mar 24 01:25:17 EDT 2011;Committer;naruse;2;9;2;11;0
72f79b9da468a90218e48863a7d1146175b2e070;Wed Mar 23 16:55:30 EDT 2011;Committer;svn;1;2;2;4;0
5db5e0af451bbef4a093f63c664c71d08543364e;Wed Mar 23 16:55:27 EDT 2011;Committer;kazu;1;6;6;12;0
a3f70766909a96eb7c43b12f78a1779fef544d5d;Wed Mar 23 12:09:57 EDT 2011;Committer;akr;2;5;1;6;0
9b66922d7f7a231724090de9a8037f4e944b1764;Tue Mar 22 23:07:36 EDT 2011;Committer;nobu;4;19;1;20;0
24055b89c8fdf7de36ae6d613d18a65ed446ce59;Tue Mar 22 23:05:53 EDT 2011;Committer;nobu;1;2;45;47;0
50b3370db80e9881b597e8a183cff31f9005f94e;Tue Mar 22 23:05:51 EDT 2011;Committer;nobu;1;0;3;3;0
e63f298f85f226fde1a2d4bd5e93f6e445689511;Tue Mar 22 23:05:49 EDT 2011;Committer;nobu;1;1;1;2;0
858a66d1ac96bfb7c4705b580bf26b13b79bb7dc;Tue Mar 22 15:18:09 EDT 2011;Committer;arton;1;0;1;1;0
e6eeeb7ce2637b5fff244e6aeeb1ad9ba8dc84f3;Tue Mar 22 15:05:43 EDT 2011;Committer;svn;1;2;2;4;0
50ff6ed8662699d28403bddd2edf0fc7db0a9b90;Tue Mar 22 15:05:39 EDT 2011;Committer;arton;2;12;1;13;0
f06ec31c54992da9eb1a69e34e69ec846aa25d2b;Tue Mar 22 12:20:52 EDT 2011;Committer;naruse;2;7;1;8;0
4520a3408afe2f30c4513ace4a00107c6a547ea3;Tue Mar 22 11:10:34 EDT 2011;Committer;akr;2;7;3;10;0
9c1a7bf74a78e9d888248fa67e4129f24a89803b;Tue Mar 22 11:09:43 EDT 2011;Committer;akr;2;9;5;14;0
cd9423097a0cbc5408a37d5e65f412bb6906ea8e;Tue Mar 22 04:39:04 EDT 2011;Committer;nahi;6;12;17;29;0
05184578d77e81c0e3e0940eb3f40d2a1ce99dcd;Tue Mar 22 01:59:18 EDT 2011;Committer;naruse;3;11;1;12;0
2c1936cf87184470308b6bf3f0fe70f1a99936af;Tue Mar 22 01:08:49 EDT 2011;Committer;naruse;2;7;5;12;0
12d17449532803979139cce212124f0e17a4728d;Tue Mar 22 00:22:46 EDT 2011;Committer;svn;1;2;2;4;0
f9819d0374ed3681542b4a33c4ea48f60eddc388;Mon Mar 21 21:49:00 EDT 2011;Committer;naruse;2;7;2;9;0
40bf1a5de175b09b9492a039679b5a54437fedfd;Mon Mar 21 21:45:11 EDT 2011;Committer;naruse;1;4;0;4;0
c85be4258933c5e0e9104e7b71772ff86509ec07;Mon Mar 21 21:42:23 EDT 2011;Committer;naruse;3;47;44;91;0
78df33a0c14bc330f983f4a27c334c2cfbec9c2e;Mon Mar 21 21:23:42 EDT 2011;Committer;naruse;5;36;25;61;0
80b64d145a30613a7d357f9f942e5846c064ea0e;Mon Mar 21 02:23:21 EDT 2011;Committer;sorah;2;5;8;13;0
580f7c95a522eec6b9ea12ba81a02c76731154ad;Sun Mar 20 16:28:50 EDT 2011;Committer;svn;1;2;2;4;0
d9dd52acbf99968010f7d5db3d7b4a0e9c30047b;Sun Mar 20 14:11:16 EDT 2011;Committer;tadf;2;6;0;6;0
7adef00759f3815cfe2509b5dac74e525079a145;Sun Mar 20 13:49:27 EDT 2011;Committer;tadf;1;3;3;6;0
e48047fe0cedc0fa859f7940ab504c34dc4ea6d5;Sun Mar 20 13:34:44 EDT 2011;Committer;tadf;2;12;45;57;0
434157444fed90d00d3919e604fbcc9319d97ed6;Sun Mar 20 12:44:47 EDT 2011;Committer;tadf;6;1509;210;1719;0
7bc47c026066831295b3fdf1ed8f7f8bfafef957;Sun Mar 20 03:43:40 EDT 2011;Committer;akr;2;16;12;28;0
099e7c190614eb4afff9f69de5ca2eafdf47dc88;Sat Mar 19 16:34:02 EDT 2011;Committer;svn;1;2;2;4;0
11e4052295ade5bfa68f9f4b1c4b99edcfbbedc7;Sat Mar 19 16:33:59 EDT 2011;Committer;arton;4;22;11;33;0
bdc8f4fca9f6dacf6abd16d4fcf829401adf5556;Sat Mar 19 10:00:51 EDT 2011;Committer;arton;1;3;7;10;0
5281610f919f96fd0ec1a14a53ad42b54bc8d373;Sat Mar 19 09:28:49 EDT 2011;Committer;arton;3;32;1;33;0
812550b977e2114d74212ee211e520baee8760f3;Sat Mar 19 08:10:08 EDT 2011;Committer;arton;2;12;1;13;0
b86e5f851744df466acdecd54a945dff11793715;Sat Mar 19 03:30:59 EDT 2011;Committer;akr;2;10;6;16;0
61f411312b50c65151d9a564be41674f17d471c9;Sat Mar 19 00:25:05 EDT 2011;Committer;svn;1;2;2;4;0
16493e4ec515d1a3dc24e881f776e20fd7136a75;Sat Mar 19 00:25:01 EDT 2011;Committer;kazu;1;2;5;7;0
e287d9de791674dbb0125e709c0f436ae5ef4298;Fri Mar 18 14:00:02 EDT 2011;Committer;nobu;1;4;5;9;0
022b3368dae3f2c9063451c7f2be67a4c4ce8040;Fri Mar 18 11:45:43 EDT 2011;Committer;akr;2;11;7;18;0
c7837ed8d3ec3a74382927df7c2fae19862b78ea;Thu Mar 17 23:48:13 EDT 2011;Committer;nobu;3;17;1;18;0
58e8b41eb18715949c8bca673427ddc90b548f7b;Thu Mar 17 16:07:58 EDT 2011;Committer;nobu;1;8;336;344;0
508d65a542a2fcdd7b591b5f12a89bd3d48249a6;Thu Mar 17 15:59:40 EDT 2011;Committer;nobu;4;7;16;23;0
3ae0dbccd2b56c0c0d0938a150344423265d4fa2;Thu Mar 17 15:54:25 EDT 2011;Committer;svn;1;2;2;4;0
247fdeedf89865ff218282e74c24c044817afc01;Thu Mar 17 15:54:22 EDT 2011;Committer;nobu;5;60;0;60;0
05529fa1cb4721570fd9595ffd46eba2015c4476;Wed Mar 16 21:23:31 EDT 2011;Committer;akr;2;11;7;18;0
2d5c21403c489f0b386a8a354f9d69b6de619fb4;Wed Mar 16 16:22:42 EDT 2011;Committer;svn;1;2;2;4;0
9f088185ca94d28cad8edd6491c6a32f0c539c44;Wed Mar 16 16:22:39 EDT 2011;Committer;kazu;1;3;3;6;0
bc843e4b7ddf11f80cea691033cbf8163c6272d3;Wed Mar 16 11:42:03 EDT 2011;Committer;akr;2;7;1;8;0
d6fb308078ce499092d75472b221ee8def9f42c1;Wed Mar 16 06:07:03 EDT 2011;Committer;drbrain;3;74;0;74;0
92946d44742ee9c48f418f6ff583b1bf35da9d1f;Wed Mar 16 04:47:18 EDT 2011;Committer;drbrain;2;179;63;242;0
0777480af252b112be8250dc682b51881f701540;Tue Mar 15 23:41:20 EDT 2011;Committer;svn;1;2;2;4;0
9b62c58a3a6f39eb4ed24c7b7f029e6a3b0d7232;Tue Mar 15 23:41:17 EDT 2011;Committer;akr;2;15;11;26;0
3b17a84e4a428f5dcfebb70cdb92107875027236;Tue Mar 15 09:34:51 EDT 2011;Committer;akr;2;10;6;16;0
627527d7185bc44cae5ea44ea6e4c805da24f553;Tue Mar 15 00:53:36 EDT 2011;Committer;svn;1;2;2;4;0
fae8bc73627eefa5e64cb2b62dcf1c01c5f6bbfe;Tue Mar 15 00:53:31 EDT 2011;Committer;sorah;2;5;0;5;0
dc5eb8970c109a82978468a1becfd90094f5df12;Mon Mar 14 12:27:31 EDT 2011;Committer;nagachika;2;12;3;15;0
f82f5216ac5eee518ee59fbdaa49de862c6a60fd;Mon Mar 14 10:55:09 EDT 2011;Committer;svn;1;2;2;4;0
675b3f337f831961b0dcaadaec2083244a2048d4;Mon Mar 14 10:55:05 EDT 2011;Committer;akr;2;10;6;16;0
fd641fbf953ccc878a29283c9511fd6289f9b766;Sun Mar 13 09:11:45 EDT 2011;Committer;akr;2;10;6;16;0
fe7425bb0cd2bf0cbb12d9bed564d4cdf9878408;Sun Mar 13 07:14:11 EDT 2011;Committer;svn;1;2;2;4;0
6ef956ab90315f63d103bed0c3a7d9d2c0028019;Sun Mar 13 07:14:07 EDT 2011;Committer;sorah;3;20;0;20;0
f085a0b034484a621220bbaa66b3e8f61f2f870f;Fri Mar 11 19:13:02 EST 2011;Committer;akr;2;8;4;12;0
ec40f71690faae6ba65ab86d9c5c35d3b2dc5b71;Fri Mar 11 17:28:44 EST 2011;Committer;tadf;2;28;8;36;0
af7a09a6874c0d6a6c37344c36da8e3bed782c9f;Fri Mar 11 16:27:25 EST 2011;Committer;tadf;3;9;5;14;0
e26e4b2cdf1c684b10f6620502b829390763f517;Fri Mar 11 16:21:56 EST 2011;Committer;tadf;4;679;192;871;0
2a2c9877ca688e75fdd38aceab24ceb6a491ddaa;Fri Mar 11 15:07:51 EST 2011;Committer;svn;1;2;2;4;0
f809440332cb82b7c933433a59a0eb1fbc092eb3;Fri Mar 11 15:07:47 EST 2011;Committer;tadf;8;3197;3197;6394;0
725e9ee966ad1d697a421c9300c44150e268e849;Fri Mar 11 14:33:52 EST 2011;Committer;tadf;4;4;818;822;0
906aaa9c0029f47f42b0c833d4c63f1795d97a01;Fri Mar 11 13:59:45 EST 2011;Committer;kazu;1;1;1;2;0
e77a9ad446dc1a7bb69ef706ce8c4ded28b86ced;Fri Mar 11 09:42:46 EST 2011;Committer;nobu;3;44;8;52;0
23f2460e820ad8ec99cf81ff39f3e9adce67b15d;Fri Mar 11 09:33:56 EST 2011;Committer;nobu;1;6;4;10;0
bd90dc80f29a09376e04f5f1b6adbe17806a67fa;Thu Mar 10 16:54:02 EST 2011;Committer;kosaki;4;21;2;23;0
2ff3ec5dbea979cc5d37abc8fc8c98c8edc14fd8;Thu Mar 10 16:26:05 EST 2011;Committer;svn;1;2;2;4;0
4a8cf2d92d85aa1fad8a388186d8a5025c694d47;Thu Mar 10 16:26:01 EST 2011;Committer;kosaki;2;6;1;7;0
d49f0d9576e9f770554cfc867f99c96c5b7afc22;Thu Mar 10 13:28:58 EST 2011;Committer;akr;2;8;4;12;0
f1b2fb67061ee2fa15a04e8777bcb55790a9dd5c;Thu Mar 10 13:07:03 EST 2011;Committer;naruse;2;10;1;11;0
eb778a7b6bfb16f4dd5f1a682ff0dc3dcb31e0f3;Thu Mar 10 08:07:56 EST 2011;Committer;naruse;2;6;1;7;0
2fc47aa06b99c529156f857f6669e3752f406015;Thu Mar 10 02:15:25 EST 2011;Committer;naruse;1;1;1;2;0
a9a0b5dfee155428530ae37bebe8709a053b6f85;Thu Mar 10 01:55:30 EST 2011;Committer;usa;2;9;3;12;0
9e53a0b142f06540ee886ccf107299bdfc2ca3d6;Thu Mar 10 01:35:56 EST 2011;Committer;naruse;2;7;1;8;0
6e5f49770c9b9be151e3142a575abe99a69b0d14;Wed Mar 09 22:32:29 EST 2011;Committer;ryan;24;196;64;260;0
08c07a215d3d4b5e26293d9d52bc06b486f15844;Wed Mar 09 18:01:11 EST 2011;Committer;akr;2;8;4;12;0
af1460d6701c530633b008e55bc2a81284a50744;Wed Mar 09 15:03:58 EST 2011;Committer;svn;1;2;2;4;0
292d9610f5af42aa710295555f274d88314301b4;Wed Mar 09 15:03:54 EST 2011;Committer;nagachika;2;6;1;7;0
6afaff752b6e5e88ebb745ca5a1e72d5c2bc10cf;Wed Mar 09 14:07:11 EST 2011;Committer;nagachika;1;1;0;1;0
862048e28d26112af1e67205cfd1c16564590bce;Wed Mar 09 14:06:15 EST 2011;Committer;nobu;3;22;1;23;0
4df71924e47bc0da8bbc3a08f814c48350131585;Wed Mar 09 03:51:39 EST 2011;Committer;tenderlove;3;37;12;49;0
095b27946454cec5237e1ce229623e98905a937e;Wed Mar 09 02:59:04 EST 2011;Committer;naruse;2;3;0;3;0
89c0d70e42ff2ed9007e484b4c69b26c6eb5c820;Wed Mar 09 02:54:40 EST 2011;Committer;naruse;2;23;1;24;0
d9e5dd3b0fbbb71e37fcee4a745673848555997e;Tue Mar 08 15:45:33 EST 2011;Committer;nobu;2;7;5;12;0
c74a962aab0c8af42a5e7ef37ac81d3a7e625def;Tue Mar 08 15:15:55 EST 2011;Committer;nobu;3;10;6;16;0
776156243cc7dc25a19bac50d6a06efa62016a4e;Tue Mar 08 14:52:05 EST 2011;Committer;kosaki;2;6;2;8;0
1f9ee467c88db366a57d7d6c08acb3b9782c2535;Tue Mar 08 14:40:33 EST 2011;Committer;nobu;2;140;0;140;0
6917c26a7a488d00961476f450f94f5a7163a854;Tue Mar 08 14:40:03 EST 2011;Committer;nobu;1;1;1;2;0
d558bb59c8d9c752babe1249cc1932126feebf7e;Tue Mar 08 14:29:22 EST 2011;Committer;kosaki;2;7;0;7;0
9652eae6e7f618bddb898d0c630a1983b1b77ac9;Tue Mar 08 14:12:48 EST 2011;Committer;nobu;1;11;6;17;0
6b0dc7fd81b25bc66681548b8b82f38258f7e08c;Tue Mar 08 14:10:19 EST 2011;Committer;nobu;2;6;1;7;0
a190741da4681820d38d977bf2f14f969f9ffca3;Tue Mar 08 12:45:20 EST 2011;Committer;akr;2;6;2;8;0
45f59656ae27864c2ffe4f932e413059e425fed4;Tue Mar 08 07:52:19 EST 2011;Committer;usa;2;8;0;8;0
d504a2458c14d25dee796a1e59b8c83bf8f3e186;Tue Mar 08 06:59:51 EST 2011;Committer;usa;2;9;1;10;0
85df40e9ab4559cd4ddde3f106ab56c76a808cc8;Tue Mar 08 03:30:23 EST 2011;Committer;nobu;2;19;5;24;0
bc650f27b4b700cc0c0702b7e77e23ffdc1015c2;Tue Mar 08 01:41:05 EST 2011;Committer;kazu;1;5;5;10;0
acd036bcdc2ce9d8750294e8932b0feb119e4917;Tue Mar 08 00:33:05 EST 2011;Committer;nobu;4;81;14;95;0
15f0e53a0698b5b7abd003f9cf305a456a98babc;Tue Mar 08 00:25:40 EST 2011;Committer;nobu;3;14;5;19;0
487185de671234a650f43b2de16c9253171a3388;Tue Mar 08 00:08:16 EST 2011;Committer;nobu;2;16;8;24;0
108eb9c68c00d43eb33b20341dee8506717d4a3d;Tue Mar 08 00:07:19 EST 2011;Committer;nobu;2;9;1;10;0
c57118f757619042261c65098a7001a05addf4de;Mon Mar 07 16:44:36 EST 2011;Committer;naruse;2;19;2;21;0
436d5dc6eb2661f55191286437714676694214ed;Mon Mar 07 16:17:27 EST 2011;Committer;naruse;2;5;1;6;0
fe8e2dd1e11c2e57b5305fcb63528b6d85f74e84;Mon Mar 07 16:13:57 EST 2011;Committer;naruse;2;11;3;14;0
30c06ec68aa01526c7ea0b03bd8ec9d31f620719;Mon Mar 07 15:03:22 EST 2011;Committer;svn;1;2;2;4;0
37e159f5475680dd7fdc9d5456212e2a8ae39ffe;Mon Mar 07 15:03:18 EST 2011;Committer;akr;2;6;2;8;0
e267617f3e359cf40a28ba3baa360b9cd7ca2bf2;Mon Mar 07 14:03:41 EST 2011;Committer;sorah;3;39;17;56;0
52b40be04b961a38379d559b3a10d8a6252ba43b;Mon Mar 07 12:54:27 EST 2011;Committer;kosaki;1;6;6;12;0
19a127d0cbb9a94b530add65f118252e94551bb9;Mon Mar 07 12:35:45 EST 2011;Committer;kosaki;2;21;5;26;0
1a8ee910f3f923f50e2b21cd55b8d3ae50eac85a;Mon Mar 07 11:58:12 EST 2011;Committer;kosaki;2;26;6;32;0
1df42597d15416357a20bd68700ce1a2d245e8bb;Mon Mar 07 08:44:45 EST 2011;Committer;matz;63;1828;711;2539;0
fc634cc092f486adfc911f614b7b4aa2c48c698d;Mon Mar 07 08:39:45 EST 2011;Committer;svn;1;3;3;6;0
eb807d42eca121df22f72b95465bba52a4e7fefa;Mon Mar 07 08:39:39 EST 2011;Committer;matz;67;770;1842;2612;0
c414d861c109ff546e2bc8c7264859907d6e0f76;Mon Mar 07 05:15:22 EST 2011;Committer;nagachika;1;0;1;1;0
7b3c2c28dc774759064a08c1dde816812a88e231;Mon Mar 07 00:06:08 EST 2011;Committer;nobu;2;11;6;17;0
489e05fcc9008e993cbbbc455b1d9be16974c163;Mon Mar 07 00:05:35 EST 2011;Committer;nobu;1;2;2;4;0
bb9a05528d8de071a1221386c32e108a6be401fc;Sun Mar 06 23:39:04 EST 2011;Committer;nobu;1;8;0;8;0
35c9d383a93ee0da0b009a4944e9359644901d2b;Sun Mar 06 23:38:31 EST 2011;Committer;nobu;2;17;29;46;0
29246c34eb9a5aa1b18a2ad459d095bd38e72a42;Sun Mar 06 15:26:04 EST 2011;Committer;svn;1;2;2;4;0
c6bb8beb5294ce1162ea0f088707a9fe167449a7;Sun Mar 06 15:25:58 EST 2011;Committer;kosaki;2;11;2;13;0
b1329e3b63193730837e189b927a97cb1d73f3ba;Sun Mar 06 14:47:27 EST 2011;Committer;kosaki;3;5;28;33;0
beed971728f8789d8e2daac0567d109bff21cb2d;Sun Mar 06 14:28:02 EST 2011;Committer;kosaki;2;10;1;11;0
aca674c2e7c0c99c9caf11e7fe46621b16d57bb5;Sun Mar 06 14:21:31 EST 2011;Committer;kosaki;2;29;3;32;0
dd9f5e87145f224bd3b95ced4374d9ca1a77c6e1;Sun Mar 06 13:21:31 EST 2011;Committer;akr;2;26;22;48;0
97f07f096843beec98c13063a2d561e017a4ce6b;Sun Mar 06 12:51:17 EST 2011;Committer;kosaki;2;9;0;9;0
18f4f0888513be990c164ecd5b3ea92e24570240;Sat Mar 05 20:25:08 EST 2011;Committer;naruse;7;43;27;70;0
7f1362a84e692ad84aa412d7b51490401b58efed;Sat Mar 05 18:23:59 EST 2011;Committer;svn;1;2;2;4;0
b2a8d109b65d4cf16d1c057b7bca8e25ac674630;Sat Mar 05 18:23:55 EST 2011;Committer;kosaki;2;6;1;7;0
eaf08203dd3357808945b2926c3696578452fc0b;Sat Mar 05 13:59:21 EST 2011;Committer;nagachika;2;6;1;7;0
a474b0e3f72533159f87a6efd52a4bc3028467fe;Sat Mar 05 10:45:01 EST 2011;Committer;kosaki;2;31;28;59;0
b110abbecbd4cc2a23a470d4f8def2d120d3b4cc;Fri Mar 04 16:38:38 EST 2011;Committer;svn;1;2;2;4;0
c0359f81764e30ad041b152aeea1a2c0a95c3ccb;Fri Mar 04 16:38:34 EST 2011;Committer;kosaki;3;75;13;88;0
1d6bd86acd77ad4dde428ca53878ae0b24b487ed;Fri Mar 04 14:28:05 EST 2011;Committer;nagachika;1;8;0;8;0
118a5bcf96801f326f2a40c473473a014e5a9634;Fri Mar 04 14:20:23 EST 2011;Committer;nagachika;2;7;0;7;0
ff077097774f94b7b69b8d0ebcdea2638e906ec0;Fri Mar 04 13:02:45 EST 2011;Committer;kosaki;2;9;3;12;0
62374161f1627843294f4f3836af085dd70eaa59;Fri Mar 04 12:16:45 EST 2011;Committer;kosaki;2;6;0;6;0
27bb573c06e3427357f390db653a3ce0328d30fb;Thu Mar 03 22:18:50 EST 2011;Committer;akr;2;6;2;8;0
d0403176fbbecf42e2de8d778c5a256537f25d99;Thu Mar 03 15:22:10 EST 2011;Committer;svn;1;2;2;4;0
2adbf720d5f5567369bd5b210580969bb751165f;Thu Mar 03 15:00:04 EST 2011;Committer;nobu;1;8;0;8;0
4f8f4a9ee4f03977aae81e41ced5b30f5607f939;Thu Mar 03 13:13:10 EST 2011;Committer;usa;3;21;7;28;0
0ebf520671e0a25768e06237a1fe6439c148c1f5;Thu Mar 03 12:23:44 EST 2011;Committer;usa;2;16;6;22;0
1890364e90a5934988c6c853965ebdc6768b16bc;Thu Mar 03 09:59:51 EST 2011;Committer;naruse;2;5;1;6;0
b49993b726a7986877dad7c8c566613bf801c516;Thu Mar 03 08:53:44 EST 2011;Committer;naruse;1;0;5;5;0
7bb73a0852c747478ff5ed030e2a857d201596b7;Thu Mar 03 05:28:00 EST 2011;Committer;naruse;2;9;0;9;0
6a288deabc6e718add4552111a6fd2434c723431;Wed Mar 02 16:14:32 EST 2011;Committer;naruse;2;13;1;14;0
613861d6c5dcf98f9b56112826adbf9f02d4f93a;Wed Mar 02 15:51:53 EST 2011;Committer;svn;1;2;2;4;0
f25ff846f6884e202d13ab28e3e10c917b9cdf31;Wed Mar 02 15:36:48 EST 2011;Committer;naruse;11;114;147;261;0
cddcffb8f9dd015650b2ac02235bfe39261989f9;Wed Mar 02 14:20:06 EST 2011;Committer;nobu;3;34;27;61;0
e1e8297a76cbe7918458cb37043ad498228c6139;Wed Mar 02 12:15:50 EST 2011;Committer;akr;2;6;2;8;0
31fcc22365059bdefede5ce343262436214ba2fa;Wed Mar 02 05:29:52 EST 2011;Committer;sorah;2;9;4;13;0
a991a12cbc63c803811673fa3b77c035fdf78558;Wed Mar 02 05:09:37 EST 2011;Committer;naruse;2;9;4;13;0
7fd10596b949be1d8c7615add9ba2de7b28642dc;Wed Mar 02 05:06:49 EST 2011;Committer;svn;1;2;2;4;0
888362cc851d6921ed930b09c0317a37a2d4046d;Wed Mar 02 05:06:43 EST 2011;Committer;sorah;3;8;5;13;0
66541b9a83357b58db25811e5a7b8e21159d2c52;Tue Mar 01 13:29:41 EST 2011;Committer;akr;2;12;8;20;0
39f90db9258437c04130b21951a63bb4a06fd74e;Tue Mar 01 13:05:17 EST 2011;Committer;sorah;2;5;1;6;0
0a9442983d5194f3975e93c6af6dd025be45ebc2;Tue Mar 01 12:54:39 EST 2011;Committer;sorah;3;31;41;72;0
af3e36158fd820634cfed1ad318c87152690d086;Tue Mar 01 11:56:06 EST 2011;Committer;kosaki;2;7;16;23;0
b8bc68113ac3a8c6b66bf5a11a7a75691851f455;Tue Mar 01 10:48:23 EST 2011;Committer;tadf;3;8;2;10;0
25a9b62d45ddd60a231272567c7dda9337da9b62;Tue Mar 01 09:41:32 EST 2011;Committer;ryan;73;2404;715;3119;0
86bb0af7ea3b50f72e6845a6f5f64cb1b23fd279;Tue Mar 01 07:23:37 EST 2011;Committer;usa;2;5;9;14;0
6016591e1cc54e48d58662180cc548c03334e1c5;Tue Mar 01 07:02:08 EST 2011;Committer;naruse;3;29;22;51;0
f83651ac30c7c776dee8a6a401c654757cb8d1c2;Tue Mar 01 04:40:49 EST 2011;Committer;mrkn;2;9;4;13;0
d301b4d80bfdab57a9e8250b124d1de0ea0d1b62;Tue Mar 01 04:28:58 EST 2011;Committer;naruse;1;2;1;3;0
b8b48f9d58619e55c33106f8dfa21fc70c63e7ad;Tue Mar 01 01:35:17 EST 2011;Committer;naruse;4;137;0;137;0
af4d75f9586b002e63bb36220bf98dabc0456c06;Mon Feb 28 15:15:37 EST 2011;Committer;svn;1;3;3;6;0
e59654c24b756beee29fe7b48a42f0ae22a7ba1e;Mon Feb 28 15:15:32 EST 2011;Committer;arton;2;8;0;8;0
667833711bc7784f4d7972bbf64332011863ad5b;Mon Feb 28 14:56:01 EST 2011;Committer;nagachika;2;11;1;12;0
4a57c5e7d961e457826ea5dabb758b249d8faeb0;Mon Feb 28 13:52:58 EST 2011;Committer;kosaki;3;25;5;30;0
2755f11fd5a682cc5bf3c57f2e2af139d75c5be4;Mon Feb 28 10:26:18 EST 2011;Committer;shugo;1;1;0;1;0
d4880792c142257fa63e4c424a455ba7185a7d23;Mon Feb 28 08:42:42 EST 2011;Committer;shugo;1;0;1;1;0
c1f400917ab2c00233013e5b61487bdbdf917999;Mon Feb 28 08:37:24 EST 2011;Committer;akr;2;23;19;42;0
92905e839fcb242a4ccb9aee38251c586bd33375;Mon Feb 28 08:34:35 EST 2011;Committer;shugo;1;1;0;1;0
32424ea251d21e1fbf5292ad833808e1e0aacc48;Mon Feb 28 08:29:29 EST 2011;Committer;eban;1;0;1;1;0
9eaa1e51d557f4d4d0d163080033c434e2b76558;Mon Feb 28 08:20:50 EST 2011;Committer;eban;1;1;0;1;0
a35e9a28016cfc9a62b02cf75ad6725f3b5a7da5;Mon Feb 28 08:17:52 EST 2011;Committer;eban;1;0;1;1;0
9ead317858a0d9b49a5e62628fa6819b6c38e7fb;Mon Feb 28 07:57:28 EST 2011;Committer;eban;1;1;0;1;0
c0c182bf880ee749ca43921bbb1bc1a95d66c3d5;Mon Feb 28 07:49:06 EST 2011;Committer;akr;2;10;6;16;0
4960e66ab64350c6a6cc89b3b40fcd842dfa65d9;Mon Feb 28 07:46:49 EST 2011;Committer;naruse;3;8;1;9;0
3fec2bee37ebbb54f5e7fc2fee3ba832a2994882;Mon Feb 28 07:46:16 EST 2011;Committer;akr;2;28;24;52;0
b38b83706653bf07cf9c24e91d6bf691abe4b8a6;Mon Feb 28 04:16:16 EST 2011;Committer;shyouhei;2;8;3;11;0
1c4c00a326f96cc27b9f0a459fdb3a98fd4bd4b9;Mon Feb 28 03:59:12 EST 2011;Committer;shyouhei;2;6;1;7;0
5d881f0fd44b6339f30e66239a6f0efd20e6d580;Mon Feb 28 03:28:24 EST 2011;Committer;usa;2;13;5;18;0
18c34c6c92659b4bd176143be0c5ee75c72f60d0;Mon Feb 28 02:58:35 EST 2011;Committer;sorah;2;22;6;28;0
1fa29a76a76c782ba04794cd5a14cd9072c94c58;Sun Feb 27 22:40:55 EST 2011;Committer;svn;1;2;2;4;0
04ccb2fee266d65c0a4fdf427d76fd0a18e7e69c;Sun Feb 27 22:40:53 EST 2011;Committer;sorah;2;13;6;19;0
f0f7079d48c2b154341e8bd8464b845ef992739d;Sun Feb 27 13:03:01 EST 2011;Committer;kosaki;2;17;0;17;0
c6598ffcaed5de0f936b62f3a29b725d6d5ca73d;Sun Feb 27 09:03:16 EST 2011;Committer;sorah;2;62;50;112;0
6725dff1a187443c29a1f308e6ea7726111091bd;Sun Feb 27 04:17:11 EST 2011;Committer;svn;1;2;2;4;0
92ba80cc4af30e035d12439f9dbfcf1091b2e5d7;Sun Feb 27 04:17:09 EST 2011;Committer;akr;2;8;4;12;0
715dc8355c3306ef2b61fe2dc84129b14c3fdb2e;Sat Feb 26 14:51:35 EST 2011;Committer;nobu;3;7;7;14;0
c2e491c43eeb47918540bb53a211840e58ed5572;Sat Feb 26 14:36:32 EST 2011;Committer;nobu;1;0;1;1;0
fe060e0e5c8d5521c1e8c8022af7d3217f48f8fa;Sat Feb 26 14:35:30 EST 2011;Committer;nobu;1;161;161;322;0
fdf361189c2f0f695cd1f91177281725e6753c7b;Sat Feb 26 08:10:03 EST 2011;Committer;tadf;4;3837;167;4004;0
b08efdee966ca5daf7d71cf183e6e653c64e7954;Sat Feb 26 08:03:36 EST 2011;Committer;nobu;1;2;1;3;0
86c7e68442b560e1c743d77d0783bc29a577790f;Sat Feb 26 07:17:59 EST 2011;Committer;sorah;4;246;217;463;0
10e2dbee16845d632ab81579db76d8356f33cca0;Fri Feb 25 22:12:47 EST 2011;Committer;svn;1;2;2;4;0
2695d032e3fe0a342e586a03bd7f0eaffe52c5c1;Fri Feb 25 22:12:46 EST 2011;Committer;tenderlove;3;19;13;32;0
ba1de001b19ee58a3dc6865dc6acfaa25c6506a1;Thu Feb 24 21:09:32 EST 2011;Committer;nobu;2;3;2;5;0
dbf889812b655ed6f5cf98795770e1154186df0e;Thu Feb 24 14:03:34 EST 2011;Committer;akr;2;9;5;14;0
18f39f4e57d1000e6b33b3ac58ec9494a0511fa9;Thu Feb 24 13:53:11 EST 2011;Committer;nobu;2;6;0;6;0
4acc61313fbe98a7249acd6eff264e3d0c4209c4;Thu Feb 24 13:51:59 EST 2011;Committer;nobu;3;19;10;29;0
d3b2d870bfbb60955d914aa0a288f69fa9614c10;Thu Feb 24 13:51:56 EST 2011;Committer;nobu;1;2;2;4;0
54168739bdd96f126bffe86974708fee33df5ef9;Thu Feb 24 05:43:17 EST 2011;Committer;sorah;1;24;9;33;0
0695a5aa253886a91830e33a6684c857f72dbea9;Thu Feb 24 04:47:48 EST 2011;Committer;sorah;4;14;6;20;0
cc61e92148b6fc6b981b476095e1d43d5c4335cf;Thu Feb 24 01:08:54 EST 2011;Committer;svn;1;2;2;4;0
e9c22a6f1a0b1f7afe2ca282209015e48fef5795;Thu Feb 24 01:08:51 EST 2011;Committer;sorah;4;43;21;64;0
48fa6ed529d531419b54c56993730b0e2ded928c;Wed Feb 23 14:08:25 EST 2011;Committer;sorah;10;283;3;286;0
92729ad4736ad34bdcf6eb98211010fa6a68dd2d;Wed Feb 23 13:05:32 EST 2011;Committer;akr;2;10;6;16;0
fb2f540ad77abf599d50058d5a85b3c3c059d04d;Wed Feb 23 00:04:55 EST 2011;Committer;naruse;1;15;6;21;0
0e8a6353c612af508f34bfe742bd7129d310a2ee;Wed Feb 23 00:04:54 EST 2011;Committer;svn;1;2;2;4;0
d78e45e08ddef8d7e5e58ea0fc97f28e59baf218;Wed Feb 23 00:04:51 EST 2011;Committer;naruse;1;1;1;2;0
8f1430d08b1cba4e2a255cb48e3fa46a84d4d2e3;Tue Feb 22 14:16:38 EST 2011;Committer;sorah;2;7;2;9;0
b7af3f6f0cf09846f90345aa134722f27714ca3f;Tue Feb 22 12:39:43 EST 2011;Committer;akr;2;8;4;12;0
06aeddaf926a38c6ff436988b6ed373a00fb23df;Tue Feb 22 05:35:05 EST 2011;Committer;sorah;2;8;1;9;0
a790bd0bd775927583ff5502b4ccd54e6cfb0706;Tue Feb 22 03:36:38 EST 2011;Committer;sorah;6;490;37;527;0
a6fcf3e5e266836b983e50242dc18ef438320e90;Mon Feb 21 21:13:04 EST 2011;Committer;drbrain;2;181;2;183;0
7b494b09a016c78933d0d707a32351d082392ef1;Mon Feb 21 18:09:47 EST 2011;Committer;tenderlove;2;6;1;7;0
4ed82ae5cb15646272947a33de7714bd852f80a3;Mon Feb 21 18:09:38 EST 2011;Committer;tenderlove;6;46;19;65;0
10ec858f40e75facef5b7344efee55e77c13e291;Mon Feb 21 18:09:27 EST 2011;Committer;tenderlove;1;2;2;4;0
88014ea8cfe0de60c7753a733e8ce694f17e5726;Mon Feb 21 17:42:53 EST 2011;Committer;svn;1;2;2;4;0
846b8118df73b63026903db7a99a4b7222ce5b2c;Mon Feb 21 17:42:50 EST 2011;Committer;tenderlove;2;12;3;15;0
8b5a3b7d39a8768cb0e7cc082c0c84c7ead92155;Mon Feb 21 02:00:43 EST 2011;Committer;tenderlove;4;43;42;85;0
6f37c467d47483aac7bf5336a72446452e7ae251;Mon Feb 21 01:56:10 EST 2011;Committer;tenderlove;5;43;3;46;0
816c7900fd084509583953d7b2739e8412b0834d;Mon Feb 21 01:49:41 EST 2011;Committer;tenderlove;1;1;1;2;0
73af8137d9df0ef0bbdf49c4744242f727ed227f;Mon Feb 21 01:06:34 EST 2011;Committer;tenderlove;4;34;28;62;0
6673f4e8afb9d468849bcc7d87c82c46c799f119;Mon Feb 21 01:02:41 EST 2011;Committer;tenderlove;3;36;7;43;0
39160bd46dfc3207429b256c6fa41838668259d6;Sun Feb 20 15:39:55 EST 2011;Committer;svn;1;2;2;4;0
deeda1ca87cfc80df8d7200f92b1e6287a39f80c;Sun Feb 20 15:39:53 EST 2011;Committer;kosaki;2;29;6;35;0
408a903c99f602ae2cd14f8074fa54736ea88b45;Sun Feb 20 10:59:48 EST 2011;Committer;akr;2;11;7;18;0
c4cc4d31e618a97ec4d5655a8e543514c96bcecc;Sun Feb 20 07:26:48 EST 2011;Committer;nobu;2;9;6;15;0
e7c0a6e1d745935460a226cd5f29e2f0faff5417;Sun Feb 20 07:23:55 EST 2011;Committer;nobu;8;18;8;26;0
4ab39d2202c42d3781e44ad8b8219e6e5bfa39aa;Sun Feb 20 07:22:57 EST 2011;Committer;nobu;2;6;1;7;0
4f00a27fb5028c7be9fd7c0c6bdebc689b4a703d;Sat Feb 19 20:44:08 EST 2011;Committer;ryan;11;59;53;112;0
df52785d301a991332d0bff7b37bcee31133a7c0;Sat Feb 19 18:14:30 EST 2011;Committer;kosaki;2;21;7;28;0
4250c745cace2bc26f00c3df836243c136c4e85f;Sat Feb 19 15:47:22 EST 2011;Committer;svn;1;2;2;4;0
1343f8c53647239dd63f03a9b5437b7e10fc1d39;Sat Feb 19 15:47:21 EST 2011;Committer;akr;2;10;6;16;0
e3cc8344866ee864c42e4fd61a336c2c67f72ed3;Sat Feb 19 13:41:19 EST 2011;Committer;nagachika;2;8;1;9;0
84b96e1be466b0f7621a90a9a2bbecebd105e260;Sat Feb 19 12:43:27 EST 2011;Committer;naruse;2;2;1;3;0
774eeba60de212ab3b773d56dfa814eafa319410;Fri Feb 18 21:39:11 EST 2011;Committer;svn;1;2;2;4;0
c36abbfd436b26fa7c92feade7d78d276e42d5ee;Fri Feb 18 21:39:09 EST 2011;Committer;tenderlove;3;41;2;43;0
c1afbd39e1769d705dcbf08482f91c1e6c939e8f;Fri Feb 18 10:42:50 EST 2011;Committer;shyouhei;2;17;4;21;0
80466e3fc7c136bada2b8b0321d0e0104b2890f0;Thu Feb 17 15:32:55 EST 2011;Committer;nagachika;2;7;1;8;0
946e37cfebd9f17db96192dc97bd99775d60318f;Thu Feb 17 15:08:37 EST 2011;Committer;svn;1;2;2;4;0
8147a76b23bdbfa804f5aad873e92355876f774b;Thu Feb 17 15:08:36 EST 2011;Committer;nagachika;2;6;0;6;0
594f2fcfc0ecaf32e144357f78d96f4c440e4e25;Thu Feb 17 13:37:55 EST 2011;Committer;nagachika;2;6;1;7;0
1d403c3beb1bd44a437df810a4852e378709d9d6;Thu Feb 17 12:33:09 EST 2011;Committer;svn;1;2;2;4;0
520611984470ec8f1596a040262683ad3929399a;Thu Feb 17 12:33:07 EST 2011;Committer;akr;2;12;8;20;0
36a0a1a3f3d6ede4c8d42c3beb2e5c24ea649f3c;Wed Feb 16 11:42:03 EST 2011;Committer;kosaki;3;59;37;96;0
90b86c51ab8161f49b5d88f35a3ce6cf78fe7274;Wed Feb 16 11:17:41 EST 2011;Committer;svn;1;2;2;4;0
7bcc7db83beb07dcc6da64cdfd60a8c89eef0497;Wed Feb 16 11:17:39 EST 2011;Committer;akr;2;17;13;30;0
85caed4721a4448b8ebc2524a51c6d3bec4d24e8;Tue Feb 15 12:38:11 EST 2011;Committer;akr;2;8;4;12;0
67b9e488dcb5e1a8370fbc8e7cfd299e21ec413a;Tue Feb 15 11:35:35 EST 2011;Committer;akr;2;5;1;6;0
61a4ee9b6841a18864060f3b4636711e12a71485;Tue Feb 15 10:44:58 EST 2011;Committer;kosaki;2;8;0;8;0
01e84b104c4dd7003104f202903838ff2f5fed8f;Tue Feb 15 07:24:49 EST 2011;Committer;naruse;1;1;1;2;0
1a492ba17d2c73de395d46a5f988110b2698d434;Tue Feb 15 07:14:00 EST 2011;Committer;naruse;1;4;0;4;0
c7d3b3f1b489236e47ed9bc09666964c541c25ba;Tue Feb 15 07:08:24 EST 2011;Committer;naruse;3;37;4;41;0
7798b9667efc5396b8dd7409901c950f046c917d;Tue Feb 15 07:08:20 EST 2011;Committer;naruse;2;10;1;11;0
366e1c3884e97b0d833b8805a6afcd9071ea1e8b;Tue Feb 15 07:08:18 EST 2011;Committer;naruse;3;6;9;15;0
a8f5a06a68f24ac48363083114c14e9c95ea61ff;Tue Feb 15 07:08:15 EST 2011;Committer;naruse;4;20;18;38;0
443b1517cfbee8cf3a0c44f040939edf4f94b9a0;Tue Feb 15 07:08:12 EST 2011;Committer;naruse;3;13;5;18;0
7da18cf1a25a373285eab1e317d8439713cd0d89;Tue Feb 15 00:51:52 EST 2011;Committer;svn;1;2;2;4;0
25a4c79279b3bbed2f99d5bfc14019c3f31d2807;Tue Feb 15 00:51:50 EST 2011;Committer;usa;2;7;1;8;0
d7feebb4b39be7886735acea73de825c5d54e39e;Mon Feb 14 14:13:46 EST 2011;Committer;nagachika;2;7;0;7;0
fd569ed7ca7bfdbc8c688c5140fe67f92d5dba05;Mon Feb 14 12:07:14 EST 2011;Committer;shyouhei;2;5;3;8;0
8f59ed795da4da2d77c3025a78c3b965910ae360;Mon Feb 14 12:04:28 EST 2011;Committer;akr;2;6;2;8;0
c6e6380665c83a54d32c0a7ee2ff80d6705a778b;Mon Feb 14 09:49:56 EST 2011;Committer;kosaki;2;10;0;10;0
8068d73cc11957c37a6869d4e0325191f7a9a040;Mon Feb 14 08:49:55 EST 2011;Committer;kosaki;1;13;0;13;0
cee21ad215f48c3d15f5d5d939fb4ca1c8950f1b;Mon Feb 14 08:30:00 EST 2011;Committer;kosaki;2;12;0;12;0
23301142cc9021f8364e6249198647b521a37a07;Mon Feb 14 04:17:01 EST 2011;Committer;usa;2;7;0;7;0
0755c1c8f2aaf83315353f9e99bd13b2d4ff618b;Mon Feb 14 01:34:54 EST 2011;Committer;usa;2;6;14;20;0
9c8770e05178094217632cd1af52a22a981c590b;Sun Feb 13 22:35:31 EST 2011;Committer;svn;1;2;2;4;0
bc2abdcac445500a902700d511ed10f7fffcc40b;Sun Feb 13 22:35:29 EST 2011;Committer;akr;2;8;4;12;0
63ca916ed414649e294b8dab1a30872c865a9faf;Sun Feb 13 10:41:59 EST 2011;Committer;nobu;2;19;2;21;0
0224758a7a0ceddb68e705184f7bebe6f07f4b82;Sun Feb 13 01:13:17 EST 2011;Committer;nobu;1;5;5;10;0
7c3a80272a079aded3dd290512fe3e21c2efe209;Sun Feb 13 00:56:52 EST 2011;Committer;nobu;2;7;3;10;0
afafb8c0555e7d774c1abe51a65982899cdfffe3;Sun Feb 13 00:56:48 EST 2011;Committer;nobu;2;5;1;6;0
b16fc578520875842d91b1245cadf93ad8df516e;Sun Feb 13 00:56:44 EST 2011;Committer;nobu;3;9;3;12;0
c84e52921968ddcca88ad58ab2d8bdc69c3e45ab;Sun Feb 13 00:56:40 EST 2011;Committer;nobu;2;12;2;14;0
00e84afa3343d277129d452c3b0b455fe2c71c38;Sat Feb 12 22:41:02 EST 2011;Committer;matz;2;6;1;7;0
ce430673bef566cf11b58ed4c2b7887f0912717f;Sat Feb 12 15:51:31 EST 2011;Committer;tadf;3;12;5;17;0
2eb7b57164da81ae8738395960941bbb145500ff;Sat Feb 12 15:29:25 EST 2011;Committer;svn;1;2;2;4;0
420d98e4a8e4b1f11a7d30a94a43e65f689e7e74;Sat Feb 12 15:29:24 EST 2011;Committer;nobu;3;22;4;26;0
7f46fadd9d7f8ee32d9837a67e212f55e23666b8;Sat Feb 12 14:17:54 EST 2011;Committer;nobu;10;20;15;35;0
58b325366dbc5c84be12fb336ee5e68f208d9365;Sat Feb 12 05:44:23 EST 2011;Committer;nobu;11;94;13;107;0
dda8de065c1c7691ec8627d3024a61f324bc9f73;Sat Feb 12 05:42:17 EST 2011;Committer;nobu;2;7;8;15;0
aca69e1fdc8ebf75f80b665a9d42bedc2410bd7e;Sat Feb 12 05:41:38 EST 2011;Committer;nobu;2;6;3;9;0
4e3df72f0d8542edbf34d2c225fecfe402e78570;Sat Feb 12 05:41:02 EST 2011;Committer;nobu;2;8;9;17;0
58ed5a45ff8f0bf0eeea10e3d0f3abfc649e7e2b;Sat Feb 12 00:30:13 EST 2011;Committer;nobu;2;6;0;6;0
7dea05dc6f5a5c692d226f42f0ca320c68eff894;Fri Feb 11 23:03:21 EST 2011;Committer;nobu;2;15;6;21;0
68ef047b8f185c844a79fe6ae63841a656b190bb;Fri Feb 11 16:04:08 EST 2011;Committer;nobu;2;12;0;12;0
3be7ed03cddddc813f7d3b1b2589501536bc1827;Fri Feb 11 15:03:52 EST 2011;Committer;svn;1;2;2;4;0
f17b469860dcea4186d521c1877cbd790698beeb;Fri Feb 11 15:03:51 EST 2011;Committer;yugui;2;16;1;17;0
698960439d7234518b1d0493eaf84b03104a91d6;Fri Feb 11 14:17:24 EST 2011;Committer;akr;2;6;2;8;0
c750f945c60312575708c7fd06b30e4356f00af7;Fri Feb 11 12:54:04 EST 2011;Committer;nobu;1;1;1;2;0
9c560af1b74ef031ab990ba82362192981407c42;Fri Feb 11 12:41:58 EST 2011;Committer;nobu;4;70;41;111;0
96c078c34029bbc525085c4072b7e1ebcc9ec5a3;Fri Feb 11 10:45:34 EST 2011;Committer;nobu;5;20;4;24;0
18364f541b83eddd3b35fa42077f58a8782369f0;Fri Feb 11 07:57:05 EST 2011;Committer;nobu;2;7;1;8;0
180bf48fea3acfcc762329ffba0fc04a9cc53600;Fri Feb 11 05:33:21 EST 2011;Committer;nobu;2;6;0;6;0
12000bc2dec6ccb6d26c718c65e284f81640273e;Fri Feb 11 05:29:42 EST 2011;Committer;nobu;2;7;7;14;0
4ed23fe8c5dcd6f1dcfd58cbd0a293225b1e3435;Fri Feb 11 03:06:50 EST 2011;Committer;nobu;2;45;2;47;0
020dc4ba60cbd753ac92a67a1c42776499e59fc7;Fri Feb 11 03:03:26 EST 2011;Committer;nobu;8;43;2;45;0
c7f86bb5f604f7d58e68839ebacb3c031f8b865b;Fri Feb 11 02:39:05 EST 2011;Committer;nobu;3;7;3;10;0
1e96a30c9d410c215e7a628bcc8e1081d36926d8;Thu Feb 10 14:12:59 EST 2011;Committer;svn;1;2;2;4;0
ac2c1a2968d7d1720d19ced6021044a8d7aff5e6;Thu Feb 10 14:12:57 EST 2011;Committer;akr;2;32;28;60;0
2cc0240078cd9ac0064faf922ef0fa23eb1bf387;Wed Feb 09 14:12:02 EST 2011;Committer;akr;2;5;1;6;0
e0258fa04bb96000ae50073cf2fe365fb6ac32b5;Wed Feb 09 03:12:59 EST 2011;Committer;kosaki;2;13;8;21;0
acda9a6872c4b46be760605ad562658378da37dc;Wed Feb 09 00:47:42 EST 2011;Committer;usa;2;5;12;17;0
cf679526021fd66798ade296d74822592ba7ed8e;Tue Feb 08 23:33:43 EST 2011;Committer;kazu;1;2;2;4;0
1e4bc19a91d9634c02cec284811b4c7b1b77f9a3;Tue Feb 08 15:47:53 EST 2011;Committer;svn;1;2;2;4;0
08a4d1af3f08daed2cd3021fefba047bc2764a00;Tue Feb 08 15:47:52 EST 2011;Committer;akr;2;5;1;6;0
787686ffa7a91e007cd5999097fa337823cdf975;Tue Feb 08 10:38:01 EST 2011;Committer;nobu;2;9;6;15;0
0042bbc1c1757177be0742cf1dce692dbe58a407;Tue Feb 08 10:26:42 EST 2011;Committer;kosaki;2;6;1;7;0
0559227e870c5d0119a6818c5e050be673602f0e;Tue Feb 08 07:04:45 EST 2011;Committer;kosaki;2;5;1;6;0
411e4a6cf2570a0d59cb7a4c52fec22563bcae03;Tue Feb 08 07:01:23 EST 2011;Committer;kosaki;2;5;1;6;0
a9c7af3b6e3cf06977a5346cbe2ab287a652551a;Tue Feb 08 05:03:07 EST 2011;Committer;kosaki;2;5;1;6;0
012e60f61c99ff43686e16711e12b7b09493614b;Mon Feb 07 16:01:57 EST 2011;Committer;nagachika;2;8;1;9;0
5f3e191f958a1c49603da8f6275e91fb0ec84ec4;Mon Feb 07 15:56:34 EST 2011;Committer;nobu;2;15;3;18;0
360e0b93fdd23e385e26d1fe60822c8779888b87;Mon Feb 07 15:53:15 EST 2011;Committer;nobu;3;9;3;12;0
b50d85ebc6962d8b86c22ec6a095ce4aeb7dd8e1;Mon Feb 07 14:01:01 EST 2011;Committer;nagachika;2;7;2;9;0
afe7aac47b11693090f552df05f894d2ced8ada3;Mon Feb 07 13:37:43 EST 2011;Committer;akr;3;11;0;11;0
60f2c9cf5bea6dd99fac50c460eab4809cc30b01;Mon Feb 07 07:07:12 EST 2011;Committer;drbrain;11;204;34;238;0
ca9f7009db8aea70af3dd58cb6c7de0010844d22;Mon Feb 07 04:27:46 EST 2011;Committer;naruse;1;3;0;3;0
dda0d61e684ac1662416f7fc721b452e370f9add;Mon Feb 07 02:48:04 EST 2011;Committer;naruse;2;5;1;6;0
ef6734aa9b393c3d1aaaf733691c6b3fce4ddbc1;Mon Feb 07 01:23:30 EST 2011;Committer;svn;1;2;2;4;0
55ea57af65eb77af6693ebdeb7025e7ef5c88f6f;Mon Feb 07 01:23:28 EST 2011;Committer;usa;2;25;23;48;0
28937bf81f25eb950afe94809174ffc6eced3dd8;Sun Feb 06 10:59:03 EST 2011;Committer;nobu;1;4;1;5;0
9b68d667c71480c31ad41a8db1e111995abde73a;Sun Feb 06 05:56:14 EST 2011;Committer;nobu;1;8;0;8;0
088474a20dff97f11a71c8f2f5c240bbb0283d46;Sun Feb 06 05:38:11 EST 2011;Committer;nobu;1;2;1;3;0
b5f628a84aa42724a01d6ad97abac46f857ff08b;Sun Feb 06 04:48:49 EST 2011;Committer;nobu;2;6;1;7;0
edaf78dfb69db9794e4ddf4f0a658c374e857924;Sun Feb 06 03:54:50 EST 2011;Committer;drbrain;3;21;0;21;0
b1986003bdcee30cf4e52c5638d3bc197195952b;Sun Feb 06 03:18:44 EST 2011;Committer;nobu;4;44;11;55;0
58195557b203972799cf84c3b224bf144bf5756f;Sun Feb 06 03:13:08 EST 2011;Committer;nobu;4;8;1;9;0
2eb8b115eaf41cf3533a1485e001fbd79fad5042;Sun Feb 06 02:29:51 EST 2011;Committer;svn;1;2;2;4;0
adfcc591a80fadcee5be9309708fc17fc992bf04;Sun Feb 06 02:29:49 EST 2011;Committer;akr;2;8;4;12;0
0efad539ed7a3c4c3f234aed3702a3a76d18e785;Sat Feb 05 13:48:45 EST 2011;Committer;naruse;1;2;2;4;0
e66eec9284c74312de747633cb048b5bd95d8bc5;Sat Feb 05 13:06:14 EST 2011;Committer;kosaki;2;12;3;15;0
476ba90835a78e03124d956a4f9424bdbb61ee3c;Sat Feb 05 12:47:16 EST 2011;Committer;nobu;3;23;2;25;0
dd9341f02b0d058826bb1750c9f90beb8573ca0e;Sat Feb 05 12:22:27 EST 2011;Committer;nobu;3;8;5;13;0
790f43a374b94a906d5a72ae3c9957674cbd33ae;Sat Feb 05 11:40:43 EST 2011;Committer;nobu;2;7;2;9;0
49f8799af4d612ea164f800645222d15cfc6ae02;Sat Feb 05 07:50:12 EST 2011;Committer;kosaki;2;8;6;14;0
8aa895294b8d696489b51a5e69b2986f452da905;Sat Feb 05 06:20:57 EST 2011;Committer;drbrain;17;557;283;840;0
d8ebf3829f24fcb05ff47a12a9bb83e8b993aeae;Sat Feb 05 03:05:35 EST 2011;Committer;nobu;2;8;1;9;0
74e6dd4078051efea4144fd289dc4c2b30fc9891;Sat Feb 05 02:48:55 EST 2011;Committer;nobu;3;35;7;42;0
1069e5d665599ce60086f284b575d3a850ed2b01;Sat Feb 05 02:29:18 EST 2011;Committer;nobu;5;10;6;16;0
9cc62abc6b0245e5f0e4a8f0cd9b6f53a4f9bf77;Sat Feb 05 01:30:01 EST 2011;Committer;nobu;5;34;7;41;0
bc1e4b4e2aa2a5cf6ab9b4dd3ffd8277298cb95e;Sat Feb 05 01:13:41 EST 2011;Committer;nobu;2;32;18;50;0
bf794afbf90ca3041f1046fdb10863dc049c9786;Sat Feb 05 01:09:39 EST 2011;Committer;nobu;3;29;8;37;0
e9cc51844637cc1b1e4fdcb5bc781b3c6d67d817;Sat Feb 05 00:38:15 EST 2011;Committer;nobu;2;12;9;21;0
780678dafbe330218b70981f2e1ca06502eb28c5;Fri Feb 04 18:37:52 EST 2011;Committer;nobu;5;106;77;183;0
ab53367bc7aec0ba935a62dc745f1f2e001f8a08;Fri Feb 04 18:35:07 EST 2011;Committer;nobu;2;20;17;37;0
f38aad8d878e5fbf760bf6ec71825a41d24e082e;Fri Feb 04 18:34:12 EST 2011;Committer;nobu;2;9;0;9;0
f6b4cba666b1cfb6dc6f8e2f9d57928c6d640ba5;Fri Feb 04 17:09:45 EST 2011;Committer;nobu;3;74;0;74;0
0958923530594873703ccaec9ab92aa623f5578f;Fri Feb 04 17:08:44 EST 2011;Committer;nobu;3;8;3;11;0
cae6eed6b1dc7c5dc51558e71904873bdcd28f0f;Fri Feb 04 16:05:41 EST 2011;Committer;svn;1;2;2;4;0
034540dbc1f761221c1977465b13b00b4f558108;Fri Feb 04 16:05:40 EST 2011;Committer;kosaki;3;13;2;15;0
113de0083e58282e1a411e8364951c98c3dddaaf;Fri Feb 04 10:14:53 EST 2011;Committer;akr;2;5;1;6;0
e0d1e2453b35f4b8ed4d57fd0205538fec3babb6;Fri Feb 04 03:14:57 EST 2011;Committer;kosaki;2;6;1;7;0
aa36d4df21113a36c2e368e0abb417480a6eebbd;Thu Feb 03 16:54:52 EST 2011;Committer;kosaki;2;22;0;22;0
b6371b55dece4d6636a46c366d13c220f1c14a41;Thu Feb 03 15:15:04 EST 2011;Committer;nobu;4;10;7;17;0
b3c80c05918c91bf1123258a03cd1e13c4f0dff3;Thu Feb 03 11:38:16 EST 2011;Committer;akr;1;1;1;2;0
41d0788e40bd61a033de2451be90a81157619d01;Thu Feb 03 11:05:13 EST 2011;Committer;akr;2;4;2;6;0
b4940b61e35d579639fd48912d03d4f731a45aef;Thu Feb 03 09:56:52 EST 2011;Committer;naruse;3;33;4;37;0
d6d24991bdd894f92681960117aaf0393866434b;Thu Feb 03 09:35:55 EST 2011;Committer;naruse;2;8;2;10;0
10354c7b5c5d09b2b059fe96c072938145247c5b;Thu Feb 03 07:37:25 EST 2011;Committer;naruse;5;15;4;19;0
a3b4b499a5ddd35572d7033ddb28ecf1c668bfce;Thu Feb 03 07:37:22 EST 2011;Committer;naruse;4;14;9;23;0
c008ca5ae693c8a14bb8ed5c132575a628b7471d;Thu Feb 03 00:38:55 EST 2011;Committer;naruse;2;7;1;8;0
8f84a1f537a4356bf3f66f516e6e6339007204b4;Thu Feb 03 00:25:33 EST 2011;Committer;kazu;1;4;4;8;0
b93c74c6e844282a7bc72ace9b46011ebca16743;Wed Feb 02 22:22:26 EST 2011;Committer;tenderlove;3;9;4;13;0
89ef6628ebad27dab097f0c0d09ec50637cdab4b;Wed Feb 02 22:18:14 EST 2011;Committer;tenderlove;3;14;0;14;0
71bf292ba1159f04892d40796ebcba1c59861496;Wed Feb 02 22:05:17 EST 2011;Committer;svn;1;2;2;4;0
cc6b1b3c8d4f7d617c0870c05c501903fc7fd00b;Wed Feb 02 22:05:15 EST 2011;Committer;tenderlove;5;28;2;30;0
3722e3a29aedcdd78ad07e3ed643a78b61ef345a;Wed Feb 02 08:11:29 EST 2011;Committer;kosaki;2;13;4;17;0
de15b19498028d497b528af227057edfc877b66e;Wed Feb 02 05:52:11 EST 2011;Committer;drbrain;4;357;0;357;0
cc2a16d94d744d14d4a5eb06eca22137f8a9b79e;Wed Feb 02 00:32:30 EST 2011;Committer;drbrain;49;2116;270;2386;0
af3167d5b0dc9a9c5e2a51849bf9ffbcdeaae2a3;Tue Feb 01 15:32:09 EST 2011;Committer;svn;1;2;2;4;0
6909ea443fee4daadfad78df81ab4577c30b5ace;Tue Feb 01 15:32:08 EST 2011;Committer;kosaki;2;13;0;13;0
eb70987c2d1b74704e17dbb4455f1ab565800dd3;Tue Feb 01 13:17:05 EST 2011;Committer;kazu;1;1;0;1;0
0f7fc54678963025e77752cae8b30b7d8f4a2845;Tue Feb 01 11:47:01 EST 2011;Committer;akr;2;7;3;10;0
c4bf3eba2b7b975fd5fdf45b95026cac46cbdc31;Tue Feb 01 06:15:14 EST 2011;Committer;usa;2;7;1;8;0
6e2a194fa71f136f5911e8b3dc60ef0aae962ad8;Tue Feb 01 04:33:00 EST 2011;Committer;kosaki;2;8;1;9;0
ec84bfc9e3d11a3b1dbebcaf4d1ddf1357307513;Tue Feb 01 03:11:34 EST 2011;Committer;ryan;17;201;46;247;0
f4234c9b8f4707c5979d9a3beddc19ceeb417bd8;Mon Jan 31 23:01:46 EST 2011;Committer;nobu;2;63;1;64;0
c90d5be882ea616e281361fa72bce8bae8f4f8d3;Mon Jan 31 22:56:07 EST 2011;Committer;nobu;2;5;11;16;0
fb672259d926027f4af16847a1aafe8c81506625;Mon Jan 31 17:31:18 EST 2011;Committer;tarui;3;25;0;25;0
b32992e84c5d9c76a4d60d839b4a6f059bad0b52;Mon Jan 31 16:11:07 EST 2011;Committer;svn;1;3;3;6;0
979ec8df5daf6db314b2f17e53b53d269881d6ca;Mon Jan 31 16:11:06 EST 2011;Committer;naruse;3;264;93;357;0
6b06ba0c05cf966fa495fcaea6a934434e0460da;Mon Jan 31 14:29:49 EST 2011;Committer;nagachika;2;5;1;6;0
ff4ba406a2c334ee1148b6c0797273097462f8c7;Mon Jan 31 13:08:27 EST 2011;Committer;akr;2;5;1;6;0
7fb70b4e0fe9ecfbc66a06c9dbeee766960a5eb1;Mon Jan 31 12:59:54 EST 2011;Committer;kosaki;2;6;2;8;0
a2ba50d97119044ddc0a847a89fc5fddcd6e0d83;Mon Jan 31 12:40:19 EST 2011;Committer;nagachika;2;9;2;11;0
d07940ee1316f15cf9b5fb5fc0c03bd6479aef0b;Mon Jan 31 11:57:14 EST 2011;Committer;nagachika;1;2;2;4;0
9a89f325e436460c87e58a1b25009aad79f247df;Mon Jan 31 05:46:50 EST 2011;Committer;yugui;2;6;1;7;0
48de1e292a4f65840f01d31c5f8607f6b585057d;Mon Jan 31 03:44:57 EST 2011;Committer;naruse;9;73;61;134;0
f83d4b17804f11a78a8c6f877543a7c55b734dd2;Sun Jan 30 21:47:10 EST 2011;Committer;naruse;1;1;0;1;0
a924b1768f2144cea4e6201245e3ee57aedc5318;Sun Jan 30 21:00:04 EST 2011;Committer;naruse;2;7;1;8;0
a6d0cd442b43e0ffea117bdf7eb900b195c1f687;Sun Jan 30 20:42:42 EST 2011;Committer;svn;1;2;2;4;0
88a9b878162b484099d3ff9c3c9579b98a7f1f8e;Sun Jan 30 20:42:40 EST 2011;Committer;naruse;2;12;1;13;0
627e79f13f1779fd27f75f49001eee90ba28abe9;Sun Jan 30 08:20:20 EST 2011;Committer;akr;2;43;39;82;0
ce00071053d3d5957574c2d57d021f086991001c;Sun Jan 30 07:40:31 EST 2011;Committer;nobu;2;5;2;7;0
59064a75b8ae4d19fcbbe3bf2b9fdcb9849de33b;Sun Jan 30 07:15:23 EST 2011;Committer;nobu;3;10;0;10;0
2418e5ca83f863b58a9e13caefc9a23414cae49c;Sun Jan 30 07:10:55 EST 2011;Committer;akr;3;23;1;24;0
b4be48e88d74c1e5cce9d68aed30c4e4ef17d7c5;Sun Jan 30 06:13:25 EST 2011;Committer;nobu;3;23;12;35;0
46142e472fd713023766aa2943158d7fd50011ae;Sun Jan 30 04:03:19 EST 2011;Committer;nobu;3;14;4;18;0
f989f7c7ea89bb0b4a120666f5e85c0a81c9b44c;Sun Jan 30 04:01:58 EST 2011;Committer;nobu;5;114;1;115;0
4dcc883d06cdc0f933fe83f307c7c6a5c1e41d05;Sun Jan 30 03:56:16 EST 2011;Committer;nobu;2;6;0;6;0
286615d430e25754f26c352697f5d40ee24c9693;Sun Jan 30 03:53:44 EST 2011;Committer;nobu;3;17;1;18;0
2a5177e757ca0e26c1c05c0c05b37f161513e5e6;Sun Jan 30 01:02:46 EST 2011;Committer;kanemoto;2;6;1;7;0
33671c826df70a4f2dc3ceb40219655e8c69878b;Sat Jan 29 23:03:47 EST 2011;Committer;naruse;2;5;0;5;0
5323407175fb44c366ce70577895009f640be8f8;Sat Jan 29 18:48:24 EST 2011;Committer;naruse;3;15;2;17;0
eea774d0295e422a5231124c25aae11c39fb2abd;Sat Jan 29 16:06:00 EST 2011;Committer;kosaki;2;11;0;11;0
29b1c2a501185db16e23c4ab46659b975d921d9c;Sat Jan 29 15:33:51 EST 2011;Committer;svn;1;2;2;4;0
674ea103fa113707747e572be682c11d34af739e;Sat Jan 29 15:33:50 EST 2011;Committer;naruse;3;7;1;8;0
1195ba6644dd68123beeaa1efc228f8e7cfad4b1;Sat Jan 29 11:23:42 EST 2011;Committer;kosaki;2;6;1;7;0
5b74e4f09ef4f10e5574a02f26a893569c99c945;Sat Jan 29 02:01:19 EST 2011;Committer;mame;3;25;2;27;0
934f537b458778f4786716c95b73fc72bc1ce256;Fri Jan 28 23:46:47 EST 2011;Committer;ryan;91;1434;1195;2629;0
b511e1bfbe649b938e317e00ad1795f1b9623758;Fri Jan 28 17:57:48 EST 2011;Committer;mame;3;17;3;20;0
b1e829fb30be8a1a5c842a981ed9eacf9c77b1a3;Fri Jan 28 17:57:42 EST 2011;Committer;mame;3;18;3;21;0
a2ec8666cf8fbb579fa48c73bd114908dbbc4a85;Fri Jan 28 17:57:34 EST 2011;Committer;mame;5;58;8;66;0
f0483c494fe092a35ba2022702c554eac68efddf;Fri Jan 28 17:57:27 EST 2011;Committer;mame;5;89;14;103;0
a79ff4c7d8989cca323f397fe437e6e4a6415c8a;Fri Jan 28 17:57:20 EST 2011;Committer;svn;1;2;2;4;0
b9a1e36c15a0c131ba13fc15d98ca71dd3c920f5;Fri Jan 28 17:57:19 EST 2011;Committer;mame;2;6;1;7;0
77a7137c4b3e30276af6d4271de9aea6531c621f;Fri Jan 28 14:23:04 EST 2011;Committer;kosaki;2;11;12;23;0
cb96213fad6e137f79a70babc31b2830d3d0d81a;Fri Jan 28 12:58:15 EST 2011;Committer;kosaki;2;7;3;10;0
f6de1a3f00dffc9d87c466a08bd7e9d0e2f5e2e5;Fri Jan 28 12:49:53 EST 2011;Committer;akr;2;5;1;6;0
3a0ec6810909b8da01427bc1f38c02f4e370807e;Fri Jan 28 08:50:18 EST 2011;Committer;kosaki;2;18;3;21;0
36f71db31eca74cfc3f978b820c96af895211851;Fri Jan 28 08:36:46 EST 2011;Committer;kosaki;2;7;2;9;0
a3d861ef2fb6fa47d7244d26b6de1821d6ee4010;Fri Jan 28 07:31:44 EST 2011;Committer;kosaki;2;8;2;10;0
bacc7e6a42073d60107e4a385a40807b2ba52e91;Fri Jan 28 07:21:38 EST 2011;Committer;kosaki;2;8;2;10;0
65269855223a070eeb185cc223f54b2eac1b0160;Fri Jan 28 07:13:49 EST 2011;Committer;kosaki;1;0;1;1;0
29422e5d31cd632f796966c9d4e9b32ca2368540;Fri Jan 28 07:06:48 EST 2011;Committer;kosaki;2;24;1;25;0
aea93cbed83381b9ef63c2b7cbcb2d882ea5168f;Fri Jan 28 04:05:23 EST 2011;Committer;kosaki;2;8;3;11;0
e5971e8c7e21136c509a3c2b3967352a2e064e51;Fri Jan 28 03:12:32 EST 2011;Committer;kosaki;1;1;1;2;0
cb1366b48f788e9a5655961d0ea73b0908f72223;Fri Jan 28 03:07:23 EST 2011;Committer;kosaki;2;6;1;7;0
39473b88a9b523511bcada7fe19dabbc96a86e3f;Fri Jan 28 02:57:21 EST 2011;Committer;kosaki;2;7;2;9;0
d4f8142d18f068b7bc4b82e84e44518dfda32840;Fri Jan 28 02:48:46 EST 2011;Committer;usa;2;12;2;14;0
4afa5fead876c3b732bb7bba3674231704b9df96;Fri Jan 28 02:23:58 EST 2011;Committer;kosaki;2;7;2;9;0
92c1dfd9d2b3680c156a4657e3f44a956dc834e0;Fri Jan 28 02:00:08 EST 2011;Committer;kosaki;3;11;2;13;0
58da04b39852dd1ba58db70a1986a5923baf5531;Thu Jan 27 17:37:30 EST 2011;Committer;kosaki;2;6;1;7;0
1e60af4d6779e739d205ef63f05ebfd3fb2f7223;Thu Jan 27 17:36:32 EST 2011;Committer;kosaki;2;6;1;7;0
41bbb319ddf1fad6b79c79107d3a865bc859b971;Thu Jan 27 16:36:21 EST 2011;Committer;kosaki;2;8;2;10;0
7bae5dd370d7bee955078c273208bc5aea81fc13;Thu Jan 27 16:33:24 EST 2011;Committer;svn;1;2;2;4;0
6c2b2c285372a8b5e3457058ff85ecf327e4e105;Thu Jan 27 16:33:23 EST 2011;Committer;kosaki;2;11;4;15;0
4a42b101a9521b74ded79f2dc1b6260533abca8c;Thu Jan 27 14:30:00 EST 2011;Committer;nobu;2;14;1;15;0
c5b45d252a24b10d2bf00b88f5b1180c8df986c0;Thu Jan 27 14:14:24 EST 2011;Committer;nobu;2;5;1;6;0
5a00a61681fa8d400507940600151068e69ca1b9;Thu Jan 27 12:58:44 EST 2011;Committer;kosaki;2;11;2;13;0
ac0178910ec628875dc81ee41f18b3a1757b18a8;Thu Jan 27 12:46:30 EST 2011;Committer;kosaki;2;9;7;16;0
8d397b77ead6baeaab1b5da45c83a3a2fb1043e4;Thu Jan 27 12:42:45 EST 2011;Committer;kosaki;2;4;3;7;0
2529d2c38d985f8c5952f9562b974b3b54de7a72;Thu Jan 27 12:33:57 EST 2011;Committer;kosaki;2;6;1;7;0
f7fb66bd356454614a4d6a2181f18d8b586418cf;Thu Jan 27 11:31:48 EST 2011;Committer;kosaki;2;12;3;15;0
ab720532ef884a69fbf9dc104b8a113b5a6c9a18;Thu Jan 27 09:50:30 EST 2011;Committer;kosaki;2;7;2;9;0
18c11392aff96003cc6713b447a160c20d66a0a6;Thu Jan 27 09:35:56 EST 2011;Committer;kosaki;2;9;1;10;0
21931d6aa2fb5dc0b2d058323cba33bc5772653e;Thu Jan 27 09:21:40 EST 2011;Committer;kosaki;2;10;1;11;0
11c5daa698d5a6ba4003d941fb64c765b7f99c42;Thu Jan 27 06:21:40 EST 2011;Committer;usa;1;13;18;31;0
98929a2dfdb9881cacaf58d1697373ecd079cd38;Thu Jan 27 06:12:48 EST 2011;Committer;usa;2;23;10;33;0
fa57e468962be54ffb2b359340d7e73bb0abf769;Thu Jan 27 03:46:44 EST 2011;Committer;nobu;2;5;1;6;0
beec203a1db85eab4f139a282160c7978765d3a4;Wed Jan 26 23:41:47 EST 2011;Committer;nobu;3;58;18;76;0
8489ac41cadc1ef80ea57799bc833a831d1afdc6;Wed Jan 26 23:32:22 EST 2011;Committer;nobu;3;38;0;38;0
d6eb807878922b2976831236c3f6235ccfb6edb4;Wed Jan 26 23:22:54 EST 2011;Committer;nobu;3;23;7;30;0
c8e5ba0e841e2629d282c5853fc334309f36293f;Wed Jan 26 13:59:20 EST 2011;Committer;nagachika;2;8;1;9;0
de4c25a001fea438fc3d71fa3b2a71f8545028a7;Wed Jan 26 13:45:42 EST 2011;Committer;akr;2;5;1;6;0
ab083dc64071992b42092ea8d5f8ee53b679933e;Wed Jan 26 13:34:20 EST 2011;Committer;nagachika;2;6;0;6;0
0522ffd51f03afb615fc70844e25905da31b96f8;Wed Jan 26 08:17:01 EST 2011;Committer;nahi;3;19;0;19;0
12893215b5330dc74f30a0f9dff28b1a5463d25a;Wed Jan 26 01:38:07 EST 2011;Committer;svn;1;2;2;4;0
8aa03af784b1192e5e7f6b17ccfe5699492195b5;Wed Jan 26 01:38:05 EST 2011;Committer;naruse;2;6;1;7;0
a0eeef69e79e4b1351a011cec56a9ae5c7d2bca8;Mon Jan 24 23:42:01 EST 2011;Committer;nobu;2;13;4;17;0
ced2d699b05ae5557f075ab6c0fa8111a7526b6e;Mon Jan 24 23:28:22 EST 2011;Committer;nobu;2;6;1;7;0
9a4a8673c08b1980d8bf4f9a1154bc1175c77b2b;Mon Jan 24 22:50:21 EST 2011;Committer;kazu;2;6;3;9;0
fa6f4336f39c2e7f4692ecf791c25a56d7c36a46;Mon Jan 24 22:50:18 EST 2011;Committer;kazu;2;6;1;7;0
ff4085d6cffbd034eab914cd74e756b8544a0d18;Mon Jan 24 22:50:15 EST 2011;Committer;kazu;1;3;3;6;0
7a6113d6b683ab671e2476910962fbfd5e689617;Mon Jan 24 22:00:55 EST 2011;Committer;nobu;4;47;1;48;0
68823fdea5ea47cf056c95b4e45c48c66f55c157;Mon Jan 24 18:25:20 EST 2011;Committer;kosaki;2;118;0;118;0
e9d8fd9bff33547e27c576af09626a185f3fc493;Mon Jan 24 18:23:06 EST 2011;Committer;svn;1;2;2;4;0
cab9751e97e6bfca2f34c8d52a818808ed559ebe;Mon Jan 24 18:23:05 EST 2011;Committer;kosaki;2;12;4;16;0
c11a4d8f3f56fd53f969b1b5c63336bd1dae1bd3;Mon Jan 24 12:51:13 EST 2011;Committer;akr;2;15;11;26;0
2ec31553eabe374a1f8c1b8edf0d2bb4c548949f;Mon Jan 24 12:30:02 EST 2011;Committer;kosaki;2;12;3;15;0
76789bbbb3dd74b3a9bdd6ccb98999b59699b7ba;Mon Jan 24 12:04:49 EST 2011;Committer;svn;1;2;2;4;0
97b8e4996f2aa92fe687415bebd700954af6eab5;Mon Jan 24 12:04:47 EST 2011;Committer;nobu;3;11;1;12;0
b9c0b5039c77095b36e35dc3227458b09631dd78;Sun Jan 23 14:03:24 EST 2011;Committer;kosaki;2;12;4;16;0
99ef86707ced54a1aa5a0c741cf09205f1a9e5a0;Sun Jan 23 13:20:58 EST 2011;Committer;kosaki;4;23;6;29;0
35dbe5056de5206bdc3eea36d8aa629368ebe2cb;Sun Jan 23 02:39:44 EST 2011;Committer;akr;2;6;2;8;0
6df02103887d8818fecaea4488df4504d229ac6f;Sun Jan 23 01:32:57 EST 2011;Committer;nobu;2;10;2;12;0
734b61518b85ad3fb9d6ba9406249166ec2404c0;Sat Jan 22 23:17:21 EST 2011;Committer;nobu;1;1;1;2;0
b0eaf0f621353b9075ff5ad8e4cd663da6a36dce;Sat Jan 22 23:00:12 EST 2011;Committer;nobu;2;41;16;57;0
18e3c52bc4d39881e4ab3a0ffdd9117c1f5b2ab1;Sat Jan 22 22:43:41 EST 2011;Committer;tenderlove;3;1;23;24;0
8135c466ec00ad6f858c9068f48732fef165134a;Sat Jan 22 15:46:12 EST 2011;Committer;svn;1;2;2;4;0
fe505c47c86e6ee6db45096913f81f29bf15c523;Sat Jan 22 15:46:11 EST 2011;Committer;kosaki;2;12;2;14;0
6e5aa6311a5798145daf0c42ce0a757c333f7155;Sat Jan 22 02:51:14 EST 2011;Committer;tenderlove;3;69;2;71;0
5b1c06c74b65e12c8e552bacf6faed5c0b2826cd;Sat Jan 22 02:34:50 EST 2011;Committer;tenderlove;3;30;7;37;0
7b876e65ed79d9ca4a22f7731a463ee30e35b30b;Sat Jan 22 02:23:12 EST 2011;Committer;tenderlove;3;23;1;24;0
cab95ab7126e69b6b461c38a342194f833512439;Sat Jan 22 02:18:21 EST 2011;Committer;tenderlove;1;3;2;5;0
8dd3a4af668cd92245af86206371d3d2e9619571;Sat Jan 22 01:26:40 EST 2011;Committer;tenderlove;3;34;1;35;0
0331314d278d0590ff26eb7ec156f859b590464f;Sat Jan 22 01:13:52 EST 2011;Committer;tenderlove;3;20;0;20;0
960720ef4fd9662d94bbc25d5a6cfcaa313450a3;Fri Jan 21 19:11:53 EST 2011;Committer;tenderlove;6;142;0;142;0
5f710e22cc5d2d1ddab2d3a6abea5715b6b23b69;Fri Jan 21 15:54:59 EST 2011;Committer;svn;1;2;2;4;0
741e77882704a08d70c50237bb10f14cb6afce9f;Fri Jan 21 15:54:58 EST 2011;Committer;akr;2;24;20;44;0
85f8c01a6d4763c4ba5a929fcbd087d244c14591;Fri Jan 21 09:15:30 EST 2011;Committer;nobu;2;7;0;7;0
89bd00d804dd74451cf9e0d3bf528c1dd26d8854;Fri Jan 21 00:18:20 EST 2011;Committer;luislavena;2;5;2;7;0
7fd0d4a4d39f99f526cf14f092f330970d71a6a0;Thu Jan 20 15:40:04 EST 2011;Committer;kosaki;1;2;2;4;0
c940b3939a66ab3c7d838ad1511f8b31c9791006;Thu Jan 20 15:38:44 EST 2011;Committer;kosaki;2;10;2;12;0
3c1b996a98b08c42e13519ad1c17581afef2adfd;Thu Jan 20 15:00:01 EST 2011;Committer;svn;1;2;2;4;0
6bc1937653ac6e69125e505ccf7f42428e966781;Thu Jan 20 14:59:59 EST 2011;Committer;akr;2;5;1;6;0
d41d2f26ceeca3078aa8faff704e571247eb87e8;Thu Jan 20 14:34:39 EST 2011;Committer;kosaki;3;9;2;11;0
cffda96b47bfd0451eb7bb04a0a58d8983fc8aca;Thu Jan 20 08:04:22 EST 2011;Committer;kazu;1;3;3;6;0
74535bd643d8f8344503b664c0236e53ee92a51a;Thu Jan 20 07:13:58 EST 2011;Committer;mrkn;3;12;1;13;0
1a3950e2946026780d973b294d4c49c8d9e346f0;Thu Jan 20 03:27:54 EST 2011;Committer;kosaki;2;7;0;7;0
a9f76259cee5a52ae02ca3baa11eb5a896ac6393;Thu Jan 20 02:41:09 EST 2011;Committer;usa;2;7;0;7;0
74b0a7a06f62216d46ccb1ae53b2c52121622809;Thu Jan 20 00:20:57 EST 2011;Committer;tenderlove;3;26;0;26;0
a17cdfdde29faa7e6c5feb1c31d41e4f42328daa;Wed Jan 19 23:05:53 EST 2011;Committer;tenderlove;4;39;8;47;0
64847a9cfe467b808ca5e8148dfa85a059198963;Wed Jan 19 21:23:04 EST 2011;Committer;ryan;10;273;90;363;0
df2762fb1aaa82577b4e3e8df67cc56b7aefdfb8;Wed Jan 19 21:03:38 EST 2011;Committer;svn;1;2;2;4;0
63d5d7f53a0894100a6f490af5884010ba21bbc1;Wed Jan 19 21:03:36 EST 2011;Committer;akr;2;6;2;8;0
4993a1a814b0a3ec13ae68505e40329cbb1fdf3e;Wed Jan 19 04:17:17 EST 2011;Committer;drbrain;3;5;10;15;0
b7dd8d07f6eab485ac3a08435b12058fd54690d3;Wed Jan 19 03:33:00 EST 2011;Committer;drbrain;2;6;1;7;0
6d6fe7fe6b430c39bcb05106994eb67a9486d580;Wed Jan 19 03:21:52 EST 2011;Committer;kosaki;2;10;5;15;0
84e892f85925b62bb538e811538bb34df392170d;Wed Jan 19 03:09:42 EST 2011;Committer;drbrain;6;9;21;30;0
e798ccbacf489a3af2201ae30058ff0ae7f79045;Wed Jan 19 00:08:49 EST 2011;Committer;ryan;173;2722;2456;5178;0
d26fb035cae8d351dc238376722c980230dc5fbd;Tue Jan 18 22:38:34 EST 2011;Committer;ryan;2;5;7;12;0
a525f4d5fbc4aae78ba20826360161db14af147b;Tue Jan 18 18:17:29 EST 2011;Committer;mame;2;5;0;5;0
c7ec5b5c9021badc3f1c4ba52bc05cc5154ebe8b;Tue Jan 18 17:56:12 EST 2011;Committer;svn;1;2;2;4;0
b680cd7d05b31be0d458b05232b86bb36f1296a0;Tue Jan 18 17:56:10 EST 2011;Committer;naruse;2;6;0;6;0
0858cbf3fd16ee839810e059b8ab46ead00515d4;Tue Jan 18 14:05:39 EST 2011;Committer;akr;1;2;2;4;0
196833eb80c93bb8ac1f632a9b6815b2b9e13c1b;Tue Jan 18 14:05:20 EST 2011;Committer;akr;2;15;11;26;0
aa3cb74b8105d362f48064f0798c794b7fcc9a72;Tue Jan 18 09:34:10 EST 2011;Committer;keiju;2;35;18;53;0
9ffaa7e96b91f99751592b60ea1351b5e1264c08;Tue Jan 18 06:11:41 EST 2011;Committer;nahi;2;21;2;23;0
c8e22ee12cb951b4bd9ac14bab62f7dfa34d3f61;Mon Jan 17 22:54:29 EST 2011;Committer;akr;2;11;7;18;0
f8cf213ba2789ecd8b477d4dcb40419a619e406a;Mon Jan 17 21:49:40 EST 2011;Committer;nobu;2;11;9;20;0
0b38e9bc9d030539d1a2b70f7075a92b4c5b2213;Mon Jan 17 19:44:31 EST 2011;Committer;tenderlove;4;93;3;96;0
eacee9d95f86b035263fe8ba570c19e133c29aae;Mon Jan 17 17:48:09 EST 2011;Committer;tenderlove;3;12;5;17;0
76fe9e893cc123b9651bcf38620794c6095bb11d;Mon Jan 17 17:00:36 EST 2011;Committer;akr;1;3;1;4;0
5dfd9b38db18846d13f06f6c9b9f8352bb047f43;Mon Jan 17 16:02:15 EST 2011;Committer;svn;1;2;2;4;0
9f21d18b39ea8cf445875b9e267f7e1ce3ee0825;Mon Jan 17 16:02:13 EST 2011;Committer;akr;1;37;35;72;0
355c3a250ddd0b8ea012cf5e3c4bacc960b28284;Mon Jan 17 14:37:05 EST 2011;Committer;akr;2;14;3;17;0
099f52d73d2a0ee2faae355cb5286a79048bda0e;Mon Jan 17 13:54:54 EST 2011;Committer;akr;2;8;4;12;0
6c887c51b48690877357489da5e2a8b207555c87;Mon Jan 17 12:40:32 EST 2011;Committer;svn;1;2;2;4;0
8561ae195fd8561a6b7f9f59276b1b4042de0d89;Mon Jan 17 12:40:30 EST 2011;Committer;nobu;3;6;1;7;0
1d3a253e0243beb8ce52b5136b4a9325b08a1b6b;Sun Jan 16 11:56:20 EST 2011;Committer;svn;1;2;2;4;0
4f1894a0b697ddd1912093ea2cbfc17e15bf5af6;Sun Jan 16 11:56:18 EST 2011;Committer;akr;2;8;4;12;0
49cf75e675c2498489df553b702a9b45a8555a8a;Sat Jan 15 03:01:19 EST 2011;Committer;nobu;1;2;1;3;0
b794a2bd8c40526c000abde831e372744c3fa3e0;Sat Jan 15 02:57:36 EST 2011;Committer;nobu;6;103;24;127;0
ca6a75cd38c97774b2c58a3d305dd5e1c9055772;Sat Jan 15 01:04:16 EST 2011;Committer;nobu;3;4;3;7;0
2ec4b694cb8f8f2aa30009f9eac114a81bef8dc5;Sat Jan 15 01:00:09 EST 2011;Committer;nobu;2;5;1;6;0
7350562e5ea1246032f88cf008b8f0434e375da5;Sat Jan 15 00:48:16 EST 2011;Committer;nobu;3;11;4;15;0
fea355647eb8420d26d961b8a2ab1540fba0ec79;Sat Jan 15 00:42:14 EST 2011;Committer;nobu;3;12;2;14;0
8dc0eb6c4b433c23c1675162f5cf2c28c7ed63de;Fri Jan 14 14:26:27 EST 2011;Committer;akr;2;8;4;12;0
9d155ebf5142f3018b3d340d350f9d6ea326a2e0;Fri Jan 14 06:38:32 EST 2011;Committer;shugo;2;7;2;9;0
2661691698568ed745d89ad5bc7663c3746185db;Fri Jan 14 05:57:50 EST 2011;Committer;naruse;2;7;2;9;0
2dbf7d11f2df4a4f4f40ff7b688097ede497cb35;Fri Jan 14 05:03:22 EST 2011;Committer;naruse;3;8;1;9;0
a2e9ec244e1c1b6355b9404f9573c6de44ff9e1a;Fri Jan 14 04:54:51 EST 2011;Committer;naruse;1;1;1;2;0
ec9a859c76ce2819105e704aef892e41fa71877e;Fri Jan 14 04:51:34 EST 2011;Committer;naruse;2;7;1;8;0
377b85f2cbdc9f9142594b1a7c1f980c92102fc9;Fri Jan 14 02:37:34 EST 2011;Committer;usa;3;8;3;11;0
f52c2cc24d1070f1997921c1d870cdd55327ba2a;Fri Jan 14 02:02:12 EST 2011;Committer;ryan;10;40;277;317;0
8409156e243f670590708742354c8af6a99def3b;Thu Jan 13 22:30:52 EST 2011;Committer;svn;1;2;2;4;0
7909af18edf02a924c8a9ace9e657c9651a93c76;Thu Jan 13 22:30:50 EST 2011;Committer;nobu;3;21;1;22;0
6ac9fea36f3d41862702ad232749560fe26a4c61;Thu Jan 13 11:58:20 EST 2011;Committer;akr;1;2;0;2;0
def8c8c347fbeaf5e14c223be33b3651a0941b7c;Thu Jan 13 11:49:54 EST 2011;Committer;akr;2;9;5;14;0
96874ec46e5190bcaf929920e28149499467046b;Thu Jan 13 04:37:25 EST 2011;Committer;mrkn;2;9;4;13;0
5b9b8d9cfeac6b3cdcc1bfe0e2d803925aaf5c58;Thu Jan 13 04:23:30 EST 2011;Committer;mrkn;2;7;2;9;0
36a0e432f26cc3e52706c7be983a4c5f66844d29;Wed Jan 12 22:05:05 EST 2011;Committer;ryan;2;8;1;9;0
b404cbac7723558f42865ff78ed79aa313a72d9e;Wed Jan 12 21:53:31 EST 2011;Committer;ryan;1;2;2;4;0
4c703e3d47743a8364a1aaed9fc68420263ba14a;Wed Jan 12 15:35:08 EST 2011;Committer;svn;1;2;2;4;0
e57215bf51b99836a766f497a405760e8026d2ec;Wed Jan 12 15:35:07 EST 2011;Committer;naruse;2;9;1;10;0
b1f8bbf4f7fca70b3a173932f2f3c9cfed07b075;Wed Jan 12 14:22:39 EST 2011;Committer;kosaki;2;8;0;8;0
da235830b561960905d62604fa0dc6b56e640900;Wed Jan 12 14:16:01 EST 2011;Committer;kosaki;2;7;1;8;0
caab5dcee77d8278fdf578334b6d4e7f8595052e;Wed Jan 12 14:11:06 EST 2011;Committer;kosaki;2;17;0;17;0
38f129397bdd566a381395b3ba56062d7f762765;Wed Jan 12 10:37:32 EST 2011;Committer;akr;2;5;1;6;0
d737ae54496e6ea5a4d9f054245503ca06a5bfcd;Wed Jan 12 10:36:08 EST 2011;Committer;akr;1;5;1;6;0
fd2f238560fb1dfc664036618f05eaa9ebc8cbaa;Wed Jan 12 10:35:36 EST 2011;Committer;akr;3;14;1;15;0
e1680f8cc1c6ba464710bc164720e47e749b0ac8;Wed Jan 12 10:27:48 EST 2011;Committer;akr;2;20;4;24;0
ef0736604a327e30568ea97ca07637c7d144544e;Wed Jan 12 07:26:18 EST 2011;Committer;yugui;4;73;14;87;0
6c977786187b4287c53c3df1de2a20df89feab72;Wed Jan 12 07:26:15 EST 2011;Committer;yugui;3;16;1;17;0
596872f21d9c1fd61b0ef525ac09aecbebea4954;Wed Jan 12 06:54:09 EST 2011;Committer;usa;2;5;1;6;0
4acff773ae8abaafbac90c4f8d9f3545688bfd8d;Wed Jan 12 02:35:07 EST 2011;Committer;naruse;2;9;0;9;0
6bcf7098384e96bc756356ee08bc0dd92584244f;Wed Jan 12 00:37:12 EST 2011;Committer;naruse;4;35;6;41;0
23733f1014b4f3e8445a2f5606085a554e026668;Tue Jan 11 23:37:17 EST 2011;Committer;svn;1;2;2;4;0
79654f3fd3b39938dd7f7d3ea231a8faf74167b2;Tue Jan 11 23:37:15 EST 2011;Committer;nobu;3;19;3;22;0
5a17f4c4a341618d2d25c03c64ac72d71234303a;Tue Jan 11 11:34:12 EST 2011;Committer;akr;1;1;1;2;0
391d81e54da735f73d01d9c6955ef205097dacf2;Tue Jan 11 11:33:53 EST 2011;Committer;akr;2;5;1;6;0
489d6a24e40c396239e9a7f8d9d905cfa80c8fd8;Tue Jan 11 06:34:14 EST 2011;Committer;kazu;1;2;2;4;0
113b645b259249a88e6a91a37da11cf10f889469;Tue Jan 11 04:09:05 EST 2011;Committer;svn;1;2;2;4;0
c480ca0f131a5f87b8c49b8bf6af3684a13b2e84;Tue Jan 11 04:09:02 EST 2011;Committer;usa;2;11;1;12;0
dd55661f56d7105adb5f6d5fe3ea1994f9d36390;Mon Jan 10 13:46:47 EST 2011;Committer;nobu;4;43;9;52;0
3e82d923383d0ae7c7fc6059aa7e831cbc6510ac;Mon Jan 10 12:34:15 EST 2011;Committer;nobu;2;10;2;12;0
fd7c5303eb7b8c597d51b9d816cecee65a99968f;Mon Jan 10 05:32:59 EST 2011;Committer;nobu;2;13;0;13;0
594793f588f60d143a4d462edecd8193edf5a3d0;Mon Jan 10 04:51:20 EST 2011;Committer;nobu;3;32;27;59;0
ee0f448feabba24bac4476c76563a8afea9df002;Mon Jan 10 02:24:04 EST 2011;Committer;akr;2;39;35;74;0
1ca87609027bba20999365b43db7589c98e33fb9;Sun Jan 09 22:44:19 EST 2011;Committer;kazu;2;6;0;6;0
0b47f776b2365734d3971a9f5d5649ce48d1a0b6;Sun Jan 09 22:44:17 EST 2011;Committer;svn;1;2;2;4;0
57e0bf96c626b8106cfe9e8b30e31888c7d4fd66;Sun Jan 09 22:44:15 EST 2011;Committer;kazu;1;1;1;2;0
41c93065da59bcb0b5adada40fbb135e54fa679f;Sun Jan 09 11:38:55 EST 2011;Committer;akr;2;6;2;8;0
45493bb28a012fb066b972508359d4db51611f0d;Sun Jan 09 07:39:22 EST 2011;Committer;yugui;3;79;49;128;0
b128f7ffcdf3d1e815d409ac9bce86c2cf11445c;Sun Jan 09 07:39:16 EST 2011;Committer;yugui;2;15;10;25;0
0c560941f1b38c3ac0c8f83ddceb3566277da773;Sun Jan 09 05:54:35 EST 2011;Committer;svn;1;2;2;4;0
38f5ffefe1014882e3cfbea139e7a124d0c76dce;Sun Jan 09 05:54:33 EST 2011;Committer;kouji;2;105;0;105;0
d3b337c58dcdbfc09c77f812be9426ec3ba70b5c;Sat Jan 08 13:07:20 EST 2011;Committer;akr;2;3;3;6;0
113f27ba68e69f9e6bdb3e75b7be2dd8180c0484;Sat Jan 08 12:48:12 EST 2011;Committer;akr;2;7;15;22;0
8eec9c941348db179c900c896797c78b22d33261;Sat Jan 08 12:25:03 EST 2011;Committer;akr;2;18;23;41;0
13c4c551d19c63770e94255a1a3a6709ffc487a6;Sat Jan 08 11:52:11 EST 2011;Committer;akr;2;9;21;30;0
b85ed255fafe48e3d435eee31d6403af5558afb9;Sat Jan 08 10:51:14 EST 2011;Committer;akr;1;8;0;8;0
c36ad781ef177e1d3e44b662951dc6b399438e0d;Sat Jan 08 10:29:15 EST 2011;Committer;akr;2;13;9;22;0
6fd9c37124a678a54933051833851175a2b9d2a4;Fri Jan 07 16:32:11 EST 2011;Committer;svn;1;2;2;4;0
8e96c2c57b853b5b3e246d67d4d0b3c820a95223;Fri Jan 07 16:32:10 EST 2011;Committer;tenderlove;2;1;10;11;0
35f78ac1f80e63522453d0d9b0192afd4fd5b424;Fri Jan 07 14:07:51 EST 2011;Committer;nobu;2;5;3;8;0
29ed2f308ce5cd3d445113a4696487c00624bc1d;Fri Jan 07 12:57:34 EST 2011;Committer;nobu;3;6;1;7;0
a262f71f37c2990265524b715910f416f4f148a3;Fri Jan 07 12:54:10 EST 2011;Committer;nobu;2;6;1;7;0
dc06b7b7156e0b1e32f32acf0b89925fd1c4b79f;Fri Jan 07 00:17:06 EST 2011;Committer;matz;2;12;6;18;0
b215d61d9f4c16c864e378c42c7e213e9bd8e27d;Thu Jan 06 15:38:16 EST 2011;Committer;svn;1;2;2;4;0
df925d91e2c7057a5de63c33fca28cfd2478c68e;Thu Jan 06 15:38:14 EST 2011;Committer;akr;2;19;15;34;0
a6fac6a669135a33f263d16b033db47ff5b5e070;Thu Jan 06 11:58:44 EST 2011;Committer;usa;2;7;1;8;0
10284a049af43112881d658abacaa32900ed0d0e;Thu Jan 06 02:29:18 EST 2011;Committer;tenderlove;3;10;1;11;0
b092e967b05ba203323a3eeec2ef1133d7c194bb;Thu Jan 06 00:39:50 EST 2011;Committer;tenderlove;1;1;1;2;0
9bc8ccf4d46b35bd4e80c506891c9622bfaa7a0f;Thu Jan 06 00:24:45 EST 2011;Committer;tenderlove;3;26;0;26;0
5d0fb7c155f446fd76bf7ccc5aa17c47729f5f2e;Thu Jan 06 00:18:16 EST 2011;Committer;tenderlove;3;24;1;25;0
56317927278dffa906092fccd1093786a9380484;Wed Jan 05 20:47:01 EST 2011;Committer;nobu;2;7;7;14;0
65ea2eed78bf5f70e70885dca9be3a40e38b67d2;Wed Jan 05 20:25:50 EST 2011;Committer;nobu;3;6;1;7;0
be7e8ca7722344de7ff37148b530e142c9e5fbcf;Wed Jan 05 20:17:36 EST 2011;Committer;nobu;1;1;1;2;0
5528903d01816a99313404672f96229798663a10;Wed Jan 05 20:16:32 EST 2011;Committer;nobu;4;10;6;16;0
d8d9bac5c8b071135e50ad3f21c8a9b6a9c06e54;Wed Jan 05 20:14:43 EST 2011;Committer;nobu;3;17;3;20;0
8cc0ee4a967af26feb0f1d723c5178cafd434ce8;Wed Jan 05 20:12:50 EST 2011;Committer;nobu;1;4;0;4;0
c8aaf31fdd06df05c8c58df3d312280c5a02fc09;Wed Jan 05 20:10:59 EST 2011;Committer;nobu;5;90;0;90;0
697a45b196c606147997372c20d14c6b2eccdda4;Wed Jan 05 20:03:28 EST 2011;Committer;nobu;5;20;3;23;0
69c484784ea4b1302ec484ab785601c2afc1b5ad;Wed Jan 05 19:52:51 EST 2011;Committer;nobu;1;6;6;12;0
7d079c99148010f8657fec7882785ff8d521bd7e;Wed Jan 05 19:50:33 EST 2011;Committer;nobu;1;3;3;6;0
46662e673740c714b1cc86f86e05c1743d31092d;Wed Jan 05 17:57:40 EST 2011;Committer;svn;1;2;2;4;0
e9e01ec4a0a86835a55a0bc56d8d10e8693c3ae1;Wed Jan 05 17:57:38 EST 2011;Committer;tenderlove;3;26;1;27;0
f86ca534601ba66b43d60d3b595c1977ed03b3dd;Wed Jan 05 05:22:54 EST 2011;Committer;shyouhei;2;5;2;7;0
89d6841175f4e3a853c1dfc5c03ee9314fe984c4;Wed Jan 05 05:18:48 EST 2011;Committer;ryan;1;1;2;3;0
68f8df9e15a3348d472ba58ff38fd497ae94d3a8;Wed Jan 05 05:17:18 EST 2011;Committer;tenderlove;1;4;2;6;0
ae931140b96eeeaab1da03c6fb681a15d8febcab;Wed Jan 05 05:06:44 EST 2011;Committer;usa;2;6;0;6;0
0d375e732d83c96451a671f7eb9522c773cd3038;Wed Jan 05 04:58:57 EST 2011;Committer;knu;3;12;1;13;0
76731871e70398afbd044e16e9cf4151b471841b;Wed Jan 05 04:57:27 EST 2011;Committer;tenderlove;2;9;1;10;0
20e2c4cb365041c3672760f1ef829d870b7c2601;Wed Jan 05 03:13:18 EST 2011;Committer;tenderlove;8;15;11;26;0
d56a76a66406ce08d34ebadba7896b50fb0c8950;Wed Jan 05 01:13:14 EST 2011;Committer;svn;1;2;2;4;0
09aefc43a54bff5c27c856de71af4d18e9223d59;Wed Jan 05 01:13:12 EST 2011;Committer;yugui;2;40;42;82;0
7ba4cafdedfd514ee2b95c40f6e9d8a55456fed7;Sat Jan 01 03:02:31 EST 2011;Committer;kazu;1;1;1;2;0
ccc55bb7c3753cc4e6ba736eed69162c43b63370;Sat Jan 01 02:45:04 EST 2011;Committer;akr;2;13;9;22;0
778796b00813a96925ab1156d8f8a41f3315c2c2;Sat Jan 01 02:10:30 EST 2011;Committer;nobu;2;80;42;122;0
281bdd3125bf0486b5838f81755d48067e285e3d;Sat Jan 01 02:03:59 EST 2011;Committer;nobu;3;10;1;11;0
2d5bd6b1943c39baebcad30f6830d8e86aae007d;Sat Jan 01 01:59:14 EST 2011;Committer;nobu;2;5;1;6;0
bb4f62f234e83487b5c5545ffe8ad42354ca5d3c;Sat Jan 01 01:52:15 EST 2011;Committer;akr;1;1;0;1;0
8714384d98a3f110650849bf377e086a78c24686;Fri Dec 31 19:26:32 EST 2010;Committer;svn;1;4;4;8;0
4a744b3d7875cb529a5fc090c841de9373348dcb;Fri Dec 31 19:26:30 EST 2010;Committer;naruse;2;8;2;10;0
74b08ff339091385f39d910af53a14fd9ec90933;Fri Dec 31 03:02:53 EST 2010;Committer;akr;2;54;14;68;0
484e94a89c84cea432e4aad8ec365632ea913365;Fri Dec 31 02:46:50 EST 2010;Committer;nobu;3;27;4;31;0
cf1cc4bd8b6afcd78d456036541759e520a4910a;Fri Dec 31 02:16:00 EST 2010;Committer;nobu;2;6;0;6;0
095c2deca0a51cced9866ce5af8e8493c35e7001;Fri Dec 31 01:28:41 EST 2010;Committer;akr;2;36;32;68;0
3d38ba877eb14cc4d6b711e41d64953b366a502b;Thu Dec 30 18:53:41 EST 2010;Committer;naruse;3;10;1;11;0
6eae4ecb0b4a6e2fb668e2471c30e8896e585c85;Thu Dec 30 18:03:15 EST 2010;Committer;svn;1;2;2;4;0
584a099fcaba9ca500fdc7c9c930bee250a07c23;Thu Dec 30 18:03:13 EST 2010;Committer;kazu;2;6;2;8;0
af8df10d3b8b58d934b3603211d2ec9043098b3b;Thu Dec 30 14:17:32 EST 2010;Committer;wanabe;3;23;2;25;0
962b75384e4b6b388806fa3ff8d4381a2329ccb4;Thu Dec 30 11:21:54 EST 2010;Committer;kosaki;2;15;11;26;0
78f6130528002fc63dcaa9260f0f7e6727e42a29;Thu Dec 30 11:18:12 EST 2010;Committer;kosaki;2;14;10;24;0
918a712cf87f0dfec943069b617d1763e7f824a8;Thu Dec 30 11:06:18 EST 2010;Committer;kosaki;2;8;4;12;0
e8fc308315bfab764ceffe30243715c91153739a;Thu Dec 30 02:58:42 EST 2010;Committer;akr;1;19;3;22;0
03ac5a15d46f151f0048de20124fe7bfb4884819;Thu Dec 30 02:50:36 EST 2010;Committer;svn;1;2;2;4;0
ae47a529f457274dcec1f25cbc95b7409abf9769;Thu Dec 30 02:50:34 EST 2010;Committer;akr;2;16;12;28;0
ae167e1e79c73c589f0f410b1582795d17184205;Wed Dec 29 12:20:16 EST 2010;Committer;nobu;2;20;16;36;0
f8b2f4e05dd2beee71079f085cba0cf80f78eb34;Wed Dec 29 11:37:47 EST 2010;Committer;nobu;2;4;1;5;0
3a28aaaa3a6c4d7f1692d0bf3943541c09dea435;Wed Dec 29 11:33:54 EST 2010;Committer;nobu;1;0;1;1;0
4f15664f6e758b34d0925b224fe9ae87c64e114e;Wed Dec 29 11:31:23 EST 2010;Committer;nobu;2;8;1;9;0
0dfd81cb2397600ce92bd690f4c4f9152518b952;Wed Dec 29 11:27:36 EST 2010;Committer;nobu;4;21;17;38;0
055e4558bdd9f49720789dba7363fe785444f453;Wed Dec 29 09:26:12 EST 2010;Committer;usa;1;1;1;2;0
183bbd8b69077ff98c2c39f5ebc61ffe60725786;Wed Dec 29 09:24:37 EST 2010;Committer;usa;2;8;3;11;0
89f9c4144ff1ea07f3ca977e6a7336b01473e383;Wed Dec 29 01:33:28 EST 2010;Committer;akr;1;3;3;6;0
fc38c70ce95a25db609610d9b9f68bad1d89043e;Wed Dec 29 01:07:26 EST 2010;Committer;akr;2;6;2;8;0
b2d68b28262a717dd4ed0d16994a8c727411a7cd;Tue Dec 28 22:22:58 EST 2010;Committer;drbrain;3;6;290;296;0
485889a01fd153badc7809733cef190e9b5ce203;Tue Dec 28 22:08:59 EST 2010;Committer;svn;1;2;2;4;0
e2efe8e81dc7e9fce40b024df6a20bbf4b830350;Tue Dec 28 22:08:56 EST 2010;Committer;drbrain;28;494;56;550;0
90d5bcf9104fe58887cf705b718a9c7b537b51a5;Tue Dec 28 09:43:49 EST 2010;Committer;usa;4;33;7;40;0
8af7ed60368c030e95ec782022538254d256d590;Mon Dec 27 22:37:59 EST 2010;Committer;akr;2;20;16;36;0
1f4401ebe09881647bb995ed408f7f387ff1333f;Mon Dec 27 22:27:13 EST 2010;Committer;kazu;1;1;1;2;0
02a24aaedcd07ea02031df3f5725496dda5b4994;Mon Dec 27 22:27:10 EST 2010;Committer;kazu;2;14;0;14;0
4fefafb1e67c377a8c08e8628b1c02fcbc1cae42;Mon Dec 27 22:27:07 EST 2010;Committer;kazu;2;7;0;7;0
5c99ee83ad8995205559a6dfa5bb52ba5c70e799;Mon Dec 27 19:34:00 EST 2010;Committer;tenderlove;3;16;0;16;0
b66fc7ac3cdb02c5fe753d5ca45274c5230f7567;Mon Dec 27 16:48:15 EST 2010;Committer;svn;1;2;2;4;0
c1c02696ae2c1f6fbd42ef36e2ecb64bb97cdbed;Mon Dec 27 16:48:14 EST 2010;Committer;kazu;2;11;1;12;0
0585d81d51fa95cbe6e57b8e03c985890b2ad125;Mon Dec 27 11:42:21 EST 2010;Committer;kosaki;2;5;3;8;0
195992f0328b86dd3cec381214e241b51394e3f5;Mon Dec 27 09:27:43 EST 2010;Committer;akr;2;7;3;10;0
ea7158919f20745bbd2c633f4a835b7f79c9d1b4;Mon Dec 27 06:23:19 EST 2010;Committer;usa;2;10;4;14;0
c5158538e7b60d9339f64432257f5d6e632e8e7f;Mon Dec 27 03:16:30 EST 2010;Committer;usa;2;6;1;7;0
aefc03ba1e8e5e614d09cf889c3efa5c8d71bf2d;Mon Dec 27 01:49:36 EST 2010;Committer;nobu;1;6;6;12;0
ca96e8da24c6fc9b9e29d4e52c0cb88ec69cb8c5;Mon Dec 27 01:36:19 EST 2010;Committer;naruse;2;15;4;19;0
e755ecacf904d9376323df32eb837cee9fbfb07f;Mon Dec 27 01:36:16 EST 2010;Committer;naruse;1;9;3;12;0
d298593f56429d97808a15370f0b91aea0ff6bc5;Sun Dec 26 23:30:38 EST 2010;Committer;kazu;2;6;0;6;0
0924e52c246878380ac6bb73f3d6acf44910a9d4;Sun Dec 26 23:30:33 EST 2010;Committer;kazu;2;6;1;7;0
2ea38fdd27bf875fb8f0d4d7e94eed95e3ab789d;Sun Dec 26 16:31:03 EST 2010;Committer;svn;1;2;2;4;0
011bcd47b42a83406c016af8b97989bc4a6a1f4c;Sun Dec 26 16:31:01 EST 2010;Committer;akr;2;8;2;10;0
205cc6c068ae48f1ec9d7f78c0c228f70855ab97;Sun Dec 26 14:10:41 EST 2010;Committer;kosaki;3;13;1;14;0
43b4bae567b4580fbfcb143b7812ce180144959c;Sun Dec 26 13:46:02 EST 2010;Committer;kosaki;2;7;1;8;0
cf7dae0e17e831140a46b2380339705edf0cbe3b;Sun Dec 26 13:25:10 EST 2010;Committer;nobu;3;7;4;11;0
1b00c45dc0a70f1d6b454cd8132e872a6a5fd385;Sun Dec 26 13:24:17 EST 2010;Committer;nobu;3;17;5;22;0
5d276ea14a84de7fd204dfd635ac7b6d17ea9039;Sun Dec 26 12:59:19 EST 2010;Committer;kosaki;2;8;0;8;0
2316cd4d0c903d6ee54fff09ffe6c4feef6582ce;Sun Dec 26 11:54:18 EST 2010;Committer;akr;2;6;1;7;0
9694fa95179125fd410a8f8081d866ba660369b7;Sun Dec 26 10:43:53 EST 2010;Committer;akr;1;1;1;2;0
6446be302b27e8ea203c9048de51a4d7757f2d4f;Sun Dec 26 10:38:44 EST 2010;Committer;akr;2;8;0;8;0
bcd39a085110ffef93aef848f70dc68c12b62ca2;Sun Dec 26 04:26:10 EST 2010;Committer;akr;1;4;1;5;0
fc0df967d776c3c7b0c2e47400940ef91b25b978;Sun Dec 26 03:16:34 EST 2010;Committer;nobu;3;13;8;21;0
cc479b25ba715099ac721ad9d0b1b4237fa2b9f9;Sun Dec 26 02:39:14 EST 2010;Committer;nobu;4;33;10;43;0
6d8c13bc61c465ab400a12e0a44e9de52f117b7b;Sun Dec 26 02:15:55 EST 2010;Committer;nobu;13;25;22;47;0
dd5ad24735bebabb7e20df7b408c33b34f784b8f;Sun Dec 26 00:36:08 EST 2010;Committer;akr;2;18;14;32;0
326ec51f4ec024c32d3b73ae301d830b052c4e7b;Sun Dec 26 00:25:14 EST 2010;Committer;akr;2;55;16;71;0
5d47965174bb16e93170c877d4d6faf522441a4b;Sat Dec 25 19:33:46 EST 2010;Committer;luislavena;2;6;1;7;0
acc69509cb82e7f5a1b1a384259e0e5c40f25a61;Sat Dec 25 17:37:36 EST 2010;Committer;naruse;2;0;6;6;0
085e40d45b94285415e4a9909a32fc0532a210c3;Sat Dec 25 17:25:02 EST 2010;Committer;kosaki;3;31;6;37;0
6bd4afaab89b7542eac3273fce55e02e61edb828;Sat Dec 25 17:21:08 EST 2010;Committer;kosaki;2;10;5;15;0
f30eca26639ce538339bc488c7ed1fd397b0c13f;Sat Dec 25 16:41:15 EST 2010;Committer;svn;1;2;2;4;0
7c9fbd226b1f998eef845bea4e41d23e2c3aa5c2;Sat Dec 25 16:41:13 EST 2010;Committer;usa;3;36;6;42;0
01da08a29c3732abff521bf43ba43050b07cc0ce;Sat Dec 25 14:35:28 EST 2010;Committer;akr;3;164;3;167;0
ef990446737fc7923aed358e5b2c618a77a12d65;Sat Dec 25 13:49:14 EST 2010;Committer;nobu;13;23;3;26;0
c41b036f4d6b0ddd3f2310641f44763c270a7712;Sat Dec 25 13:41:11 EST 2010;Committer;nobu;14;32;43;75;0
3e7c68119c1528f1589e53d9a795bc303dbddc1c;Sat Dec 25 13:32:48 EST 2010;Committer;nobu;3;32;20;52;0
7df8b94926b79f280ed0be387897fa3d0187fb44;Sat Dec 25 13:08:07 EST 2010;Committer;nobu;4;38;18;56;0
36feefecb9db8f66dd228d4cfb3e185679dbdf0d;Sat Dec 25 13:04:43 EST 2010;Committer;nobu;3;22;13;35;0
c9958d6ab46bb5562dbb67fad116b176a0fba9fc;Sat Dec 25 10:22:48 EST 2010;Committer;kosaki;2;6;0;6;0
1b40391d3d41ed361bae41896315e18fc77ba759;Sat Dec 25 09:29:24 EST 2010;Committer;akr;3;42;1;43;0
08d99ac9e35ddcd22885303306116cb10c6a992c;Sat Dec 25 09:04:33 EST 2010;Committer;nobu;3;36;7;43;0
9ff4e23741448fb6c02090ebc95671d83b2d03a0;Sat Dec 25 09:02:03 EST 2010;Committer;naruse;2;21;4;25;0
e271684d2fc7d0d3b6a86a46e2c34c7593dcb35d;Sat Dec 25 08:50:53 EST 2010;Committer;kosaki;2;7;0;7;0
eadc639598670c1ae04bbd2f73250eef1b1463a8;Sat Dec 25 08:33:58 EST 2010;Committer;nobu;2;5;2;7;0
9c017ca5fb24e89463e5aee0304bd6a2305143df;Sat Dec 25 08:32:27 EST 2010;Committer;nobu;3;25;40;65;0
9a907880f05fef475d5b61ed7f03f045b6103ed8;Sat Dec 25 07:44:50 EST 2010;Committer;nobu;1;10;3;13;0
b4876f5e0422e020d617b77145a492c5bc327f08;Sat Dec 25 07:04:38 EST 2010;Committer;nobu;3;9;10;19;0
d05217109fb5e909bbd7849bcc799b6404c7c8b0;Sat Dec 25 06:58:58 EST 2010;Committer;nobu;13;80;54;134;0
47a1cd1291f1f52cc8d36cb533e0d653d128930a;Sat Dec 25 06:28:05 EST 2010;Committer;kosaki;2;5;1;6;0
9b0f2e48d7cc0cd9ee235eda33a040e40bd4a62b;Sat Dec 25 06:04:07 EST 2010;Committer;nobu;2;10;2;12;0
402402741dccdda8d52e548cc9dc89b806d852f9;Sat Dec 25 05:31:04 EST 2010;Committer;kosaki;2;8;0;8;0
522c538e93cfdb55ea2848d1029f5bca99e403da;Sat Dec 25 05:27:12 EST 2010;Committer;nobu;3;60;7;67;0
f83bc706bf9fba4873972f885c792613b32c651c;Sat Dec 25 05:01:32 EST 2010;Committer;ryan;1;2;2;4;0
9698217cda5089178e7c6cd73d00be15e2e24e0d;Sat Dec 25 04:55:15 EST 2010;Committer;ryan;4;68;6;74;0
03ca47972881f7accdfcc853f610629871588acc;Sat Dec 25 04:49:34 EST 2010;Committer;nobu;2;2;2;4;0
4a722bd73aabe679943ababa549ea44a0275c64d;Sat Dec 25 04:24:37 EST 2010;Committer;ryan;1;4;0;4;0
0c232beb9c109e3f35c5c9604312e959b5ddb7a4;Sat Dec 25 04:08:22 EST 2010;Committer;akr;2;8;4;12;0
1aff775d398793d6ff606a1e7efb9eac6099c152;Sat Dec 25 03:48:57 EST 2010;Committer;nobu;2;5;1;6;0
d0830a222c261922cb73e340ae32bf6f32f6845e;Sat Dec 25 02:07:13 EST 2010;Committer;drbrain;2;13;1;14;0
91c6ba23336789f340878f69b5fee1defe0fa5d5;Sat Dec 25 02:02:55 EST 2010;Committer;nobu;3;125;16;141;0
aeb8d7f5e591915d7c4e290a3bee3185c84f0630;Sat Dec 25 01:59:15 EST 2010;Committer;nobu;2;15;10;25;0
bd3c7a7e90466158dac4139e3be7dce6f959cfdc;Sat Dec 25 01:54:28 EST 2010;Committer;nobu;1;4;4;8;0
514a5b3b7150dcaa78fee45676742c1be4f69804;Sat Dec 25 01:51:06 EST 2010;Committer;nobu;2;3;6;9;0
d0598d27ff78a1bb56fa5b840b55e6ab306ead44;Sat Dec 25 01:50:02 EST 2010;Committer;svn;1;2;2;4;0
483bfa27e8aee08f0d6d5cc822733f85d03a55b9;Sat Dec 25 01:49:59 EST 2010;Committer;nobu;2;8;1;9;0
a0484364619d72426dff1c13d028aa87b1a82a60;Thu Dec 23 23:52:42 EST 2010;Committer;akr;1;3;2;5;0
a041f129af10c4e3f6cc7720db1b3fdeec1e9d80;Thu Dec 23 23:46:39 EST 2010;Committer;akr;2;13;9;22;0
2383807c69b19b90009740310cd9c05e2325bb0d;Thu Dec 23 23:22:35 EST 2010;Committer;svn;1;2;2;4;0
601886650fece7686f19cbea79496d5553f31296;Thu Dec 23 23:22:33 EST 2010;Committer;kazu;1;8;8;16;0
dae189e8c67d60dc76807a734f690a71b0f271d3;Thu Dec 23 10:25:44 EST 2010;Committer;yugui;3;107;54;161;0
462f3626fc8caacef83f2cb22a3e13407962d1ed;Thu Dec 23 02:17:13 EST 2010;Committer;akr;2;126;122;248;0
c5a19b38afb0df3fbc4eb190b08840603039d5fb;Thu Dec 23 02:00:12 EST 2010;Committer;nobu;2;9;1;10;0
26e6372a8718e2670890dcab0db4f9adac515d3e;Wed Dec 22 23:32:57 EST 2010;Committer;tenderlove;1;36;0;36;0
3971bc3c70f12a21907069d4426a3391b1e05c53;Wed Dec 22 23:26:05 EST 2010;Committer;tenderlove;2;27;1;28;0
d236a0ca3bf63e2c5164310a4c849beabb64f3c8;Wed Dec 22 23:18:05 EST 2010;Committer;tenderlove;1;1;1;2;0
0a2392a50aaffcb751aaf9ba1f0d5dccab6a6206;Wed Dec 22 23:13:49 EST 2010;Committer;tenderlove;3;24;9;33;0
df8e7db7c5f296df63db09e2b041336f0a8c6452;Wed Dec 22 23:09:05 EST 2010;Committer;tenderlove;1;37;0;37;0
4a7f4d1f4874898a89f929102d03d7ce5821045d;Wed Dec 22 21:37:13 EST 2010;Committer;tenderlove;3;109;2;111;0
7a033184ae9ecdf4a50c80ac4b181490b4b07a27;Wed Dec 22 16:49:40 EST 2010;Committer;svn;1;2;2;4;0
1ebba08dab7861fef842479ff8a58ffe701a6d26;Wed Dec 22 16:49:39 EST 2010;Committer;kazu;2;5;1;6;0
049cdff0eb8ed42503f1c1b5d89268a88744c1e1;Wed Dec 22 05:38:41 EST 2010;Committer;matz;2;5;1;6;0
6a50d2723122a9fc98ee38aa689123e5cc7e8de3;Tue Dec 21 23:59:42 EST 2010;Committer;kazu;2;10;0;10;0
92413833522742d45487436133b6d434b0c331e0;Tue Dec 21 23:59:39 EST 2010;Committer;kazu;1;34;34;68;0
ee4a024c3cac44078bfcc0bd56114a66b3b8975f;Tue Dec 21 23:03:28 EST 2010;Committer;svn;1;2;2;4;0
d5eea8c1376b54221c6e02737992dc0ad6f56de3;Tue Dec 21 23:03:26 EST 2010;Committer;kazu;2;6;0;6;0
12329a58e17a837072e20a64bf3ec6a84e38cc8f;Tue Dec 21 03:45:21 EST 2010;Committer;nobu;4;12;4;16;0
379f68fe4fa656bb717eee23e9415cfb6660744b;Mon Dec 20 22:39:55 EST 2010;Committer;akr;2;40;36;76;0
182b6148692f94263dd2adc575b9398c8da0306a;Mon Dec 20 21:25:49 EST 2010;Committer;nobu;3;18;12;30;0
f4db8aedc87d0ff901206e4c59478554b7b952a6;Mon Dec 20 21:10:24 EST 2010;Committer;nobu;6;16;24;40;0
da4d3e846407a538aef893af8478aa13ba7d8cb8;Mon Dec 20 16:45:08 EST 2010;Committer;tarui;2;40;36;76;0
12b8ff1f464e86df401ccc7b532a0e0074f0babb;Mon Dec 20 15:40:07 EST 2010;Committer;kosaki;2;13;0;13;0
1ff6a1953cafbec8ec93fe07112599f59c7cb873;Mon Dec 20 15:20:17 EST 2010;Committer;kosaki;4;10;2;12;0
49fbf28b4579e15676e7371e4734f32d6392a0f4;Mon Dec 20 15:16:42 EST 2010;Committer;svn;1;2;2;4;0
97da02b2a6acc8e8cd5440413c85df41783ba9e9;Mon Dec 20 15:16:41 EST 2010;Committer;kosaki;2;18;3;21;0
7503f1934669b2a50ffabe5394148fa8ddb7dfa2;Mon Dec 20 14:49:18 EST 2010;Committer;kosaki;2;14;3;17;0
8f6c729601bc7b0d8676a8b8799dcaeac5c9f463;Mon Dec 20 14:13:12 EST 2010;Committer;akr;2;8;4;12;0
13569788b2532d04cf59feb2c83eef9f3dd08d8c;Mon Dec 20 11:06:19 EST 2010;Committer;kazu;2;5;1;6;0
237edd7a2f7fc63babff283fae20a5ccd831ff54;Mon Dec 20 10:25:02 EST 2010;Committer;kosaki;2;5;0;5;0
1695653f548c5187ab3df0653e17e153f3246836;Mon Dec 20 04:50:13 EST 2010;Committer;drbrain;2;10;0;10;0
9d767bc265738ed2ea1daa249ad768dd7473361f;Mon Dec 20 03:32:22 EST 2010;Committer;drbrain;1;0;1;1;0
2ef9c50c6e405717d06362787c4549ca4f1c6485;Mon Dec 20 03:22:49 EST 2010;Committer;drbrain;108;9032;4333;13365;0
d7effd506f5b91a636f2e6452ef1946b923007c7;Sun Dec 19 16:18:17 EST 2010;Committer;svn;1;2;2;4;0
a3ba982c75719cbe4e3372ad73d3f4cee9caae59;Sun Dec 19 16:18:16 EST 2010;Committer;kosaki;2;9;0;9;0
3f929a07431ca69c7d11abdb44ac8391ceef8706;Sun Dec 19 10:15:59 EST 2010;Committer;svn;1;2;2;4;0
9035b0e7590ea93f3081582097c6503498996d60;Sun Dec 19 10:15:57 EST 2010;Committer;akr;2;8;4;12;0
7d0e6734df331acf7017562bcef215303367308d;Sat Dec 18 12:55:06 EST 2010;Committer;kazu;2;6;1;7;0
cd3f980ea2652b169bbeede8b9135066ac656978;Sat Dec 18 07:02:35 EST 2010;Committer;nobu;6;14;2;16;0
0316582ebcd400aefd80773997f56943527fa943;Sat Dec 18 05:43:01 EST 2010;Committer;akr;2;9;5;14;0
5683ad100dc7e9f29eb62027bf28aab5a4cac457;Sat Dec 18 01:07:12 EST 2010;Committer;nobu;3;21;10;31;0
591ae37a59889221c84b453de235185cd3884f61;Fri Dec 17 13:25:19 EST 2010;Committer;matz;2;7;2;9;0
5cb9711323b5dc0d36c138e64497b114fcd11535;Fri Dec 17 10:35:20 EST 2010;Committer;nobu;3;49;0;49;0
96064d18895b2c2569f99d02a27181d99316c0b1;Fri Dec 17 09:35:42 EST 2010;Committer;nobu;1;1;1;2;0
f913368b578c99afe61a5d479e884da34f5bc98d;Fri Dec 17 08:04:35 EST 2010;Committer;nobu;1;2;0;2;0
c5d383bae1e5b3d0df94e85bffe5964bf4861ac0;Fri Dec 17 04:29:16 EST 2010;Committer;usa;2;8;0;8;0
2d39e5265fac59c43520d758b885805cc692383f;Thu Dec 16 22:08:50 EST 2010;Committer;nobu;1;0;1;1;0
594ab9c8fd7da4262096cf1684982b4751697c52;Thu Dec 16 22:06:33 EST 2010;Committer;nobu;1;15;15;30;0
a0e62485d41ed9bd8dfbe826a72b567429359fe5;Thu Dec 16 22:05:58 EST 2010;Committer;akr;2;14;10;24;0
457e481b20b038630f63b5d6138a41fc327e6a20;Thu Dec 16 19:20:51 EST 2010;Committer;drbrain;2;28;23;51;0
39058e1d876cccf7f721925b57cd6bf43ff040d5;Thu Dec 16 15:36:49 EST 2010;Committer;kosaki;1;32;32;64;0
46823951c08a8130ba498eee27be0b1a8657f1e9;Thu Dec 16 15:01:57 EST 2010;Committer;svn;1;2;2;4;0
cc9b886691bc4d2f9b81edc5583c929fda7ea769;Thu Dec 16 15:01:55 EST 2010;Committer;kosaki;4;207;1;208;0
e46e5d2438089b24048927840d646c731dc882cf;Thu Dec 16 14:29:25 EST 2010;Committer;nobu;2;6;1;7;0
e5ad455a0845aea720ed1a9f1764635ea30bfbfa;Thu Dec 16 12:53:09 EST 2010;Committer;akr;2;16;12;28;0
f18d0400616b1f456214e05738badfc0f9369449;Thu Dec 16 12:46:44 EST 2010;Committer;nobu;2;21;1;22;0
b9b26300da434f0bca833aa6603274dcffe756b9;Thu Dec 16 10:55:11 EST 2010;Committer;usa;4;15;8;23;0
698fe540b9ac94b2cf7e7261a47d1f5b7d8d09d0;Wed Dec 15 23:04:50 EST 2010;Committer;nobu;2;6;3;9;0
202cb99c86387f351f38266aff95fc1563a5ede7;Wed Dec 15 22:51:51 EST 2010;Committer;nobu;3;5;4;9;0
5c9194fe1f5ebfc864b3516beb0c23be2af2f9e3;Wed Dec 15 22:23:52 EST 2010;Committer;ryan;1;14;5;19;0
01c0fea7d35bbf552cf2e172330cf1ae2a9afe94;Wed Dec 15 19:50:03 EST 2010;Committer;svn;1;2;2;4;0
033cea7d8e36f388f8d9cea01283932fae32f79e;Wed Dec 15 19:50:00 EST 2010;Committer;tenderlove;17;20;94;114;0
1c932619833f3056a969740248eb313e77b20c9f;Wed Dec 15 11:45:57 EST 2010;Committer;usa;2;7;0;7;0
79d800c37eae0e4c2bf23d3af9c1a77873fdea3a;Wed Dec 15 02:31:58 EST 2010;Committer;nobu;1;1;1;2;0
b2c7ef2f76c843d29a3a3804f1fd2f8b557663cb;Wed Dec 15 02:22:08 EST 2010;Committer;nobu;1;2;0;2;0
fc233f516c53af069c90ce3434171fa7dc946e4e;Wed Dec 15 02:20:37 EST 2010;Committer;usa;2;7;2;9;0
eb36519b964f4a9bac8f185ae7edb99b708b6fc8;Wed Dec 15 02:07:37 EST 2010;Committer;nobu;2;39;15;54;0
7b5e72c3a95dbf213a38b94a5fb4dbf04e03943e;Tue Dec 14 22:18:39 EST 2010;Committer;akr;2;9;5;14;0
b61c256181cf660a4d55acb17d9da8da448e420f;Tue Dec 14 18:24:44 EST 2010;Committer;kosaki;2;7;1;8;0
b2f69c4c1fccbd07200974767a46178a8fccda4b;Tue Dec 14 18:21:31 EST 2010;Committer;kosaki;2;7;1;8;0
61906b0ec31145f63c1b3771917a9a9578ca0234;Tue Dec 14 15:01:34 EST 2010;Committer;svn;1;2;2;4;0
bdd3f75598818a89b20185a2829c3dca6d30e2fa;Tue Dec 14 15:01:32 EST 2010;Committer;naruse;2;17;5;22;0
8c757a326876062889e67e62368aa0f5bdd996d6;Tue Dec 14 11:32:59 EST 2010;Committer;akr;2;21;17;38;0
949e6d454e0ad11cbd47ad4c5ce92c474d5b9d2e;Tue Dec 14 09:32:36 EST 2010;Committer;usa;2;7;3;10;0
58f1c8fca8e5d20fa6c86dedfe7c2aeeaacbc391;Tue Dec 14 09:19:55 EST 2010;Committer;usa;2;5;1;6;0
d6273007fc214eb201ca735877630eda7af15af2;Tue Dec 14 06:06:18 EST 2010;Committer;usa;2;29;12;41;0
4d257293f8b434adc6325b1dff962f6ee27347a7;Tue Dec 14 05:26:34 EST 2010;Committer;usa;2;9;2;11;0
a5b77d1cf70d6d76141712dd6fb809cd8f7cb0d3;Tue Dec 14 04:54:20 EST 2010;Committer;usa;2;12;2;14;0
dcca25f003df9fee9ce5f4e4172fe556be158aff;Tue Dec 14 04:36:14 EST 2010;Committer;usa;2;49;9;58;0
cba0d62d9119a6722a18b092fab070d4b3946674;Tue Dec 14 04:05:03 EST 2010;Committer;naruse;3;7;0;7;0
b33cb3c017d7891505848dacd3c1e599733bf20b;Tue Dec 14 03:57:26 EST 2010;Committer;usa;2;155;129;284;0
842110e6a6d09dc02d5f3108de055873a80962af;Tue Dec 14 02:42:40 EST 2010;Committer;naruse;1;1;1;2;0
fae9930033c786f61616be8a053368e80f0e60a8;Tue Dec 14 02:34:46 EST 2010;Committer;usa;2;24;4;28;0
00aab585373614bb54f11c89267c1306533b2003;Tue Dec 14 02:33:07 EST 2010;Committer;naruse;2;8;1;9;0
bd0a9d2fb603d308086b37499773bae50065a1fa;Tue Dec 14 02:33:04 EST 2010;Committer;naruse;2;7;0;7;0
28507c96270e2b2d067f82367e3a47c47e75ef0f;Tue Dec 14 01:30:43 EST 2010;Committer;svn;1;2;2;4;0
c1d9e252be110a649fec99623e064779384c41d2;Tue Dec 14 01:30:41 EST 2010;Committer;usa;2;6;1;7;0
903538cbb348d51bda9e439770dc6f2777f15c52;Mon Dec 13 12:28:09 EST 2010;Committer;naruse;2;11;3;14;0
7d481b5423de7312f3fe0f79539fbe342d69dae8;Mon Dec 13 09:37:09 EST 2010;Committer;naruse;2;8;1;9;0
b130018e86173b15b4cbb68f3821bcb695bd8528;Mon Dec 13 04:17:42 EST 2010;Committer;tenderlove;1;149;0;149;0
53360bd50ade682d5e1c0542d366745fe69e336d;Mon Dec 13 03:01:12 EST 2010;Committer;akr;2;26;22;48;0
b36c91b6b51fbfc213e627975881dd8ce6fdbdf0;Mon Dec 13 02:34:50 EST 2010;Committer;naruse;2;32;8;40;0
e1dc8e0c2262169400bc9dd2d2d389e2ff7e93cb;Mon Dec 13 01:04:40 EST 2010;Committer;svn;1;2;2;4;0
1c9f703a4705b75a31308682828a57330422c706;Mon Dec 13 01:04:37 EST 2010;Committer;naruse;4;241;1;242;0
31c99ce745fabe5b996446af5d849e265cf2d2ca;Sun Dec 12 14:45:30 EST 2010;Committer;nobu;3;56;9;65;0
9f4107a9061e92032242fe8f3226ad2f681d7cd3;Sun Dec 12 13:45:51 EST 2010;Committer;nobu;2;6;3;9;0
90e1ed91c465e03200c36dc9279353ef6ded987f;Sun Dec 12 12:06:36 EST 2010;Committer;kazu;1;3;3;6;0
e8c539a7e31d6143b314591375bbd2187997d25a;Sun Dec 12 11:49:32 EST 2010;Committer;kazu;2;9;2;11;0
89c7efed6f7fe1d0e550acd4fadd39d67b0516f9;Sun Dec 12 11:40:29 EST 2010;Committer;kazu;3;22;6;28;0
5227164cdc6ce59a22ffa16cc219882b230045fd;Sun Dec 12 04:28:29 EST 2010;Committer;akr;2;6;2;8;0
c4442536b246f95181fd281e103e29c2f64a7102;Sun Dec 12 02:54:23 EST 2010;Committer;akr;2;7;3;10;0
2b79366f5243fad65ad13005e12e78c88d3a95ba;Sat Dec 11 19:03:26 EST 2010;Committer;naruse;3;13;2;15;0
c19f9a508f50ee6c813b2b4f7908c95b6fd9e3c3;Sat Dec 11 17:45:44 EST 2010;Committer;svn;1;2;2;4;0
b82ba189903355381570341b054be141d4660a8d;Sat Dec 11 17:45:42 EST 2010;Committer;tenderlove;3;352;27;379;0
5e14eeb482949569516ea23c2b10bd025c75dcc7;Sat Dec 11 08:46:28 EST 2010;Committer;kazu;2;6;1;7;0
e1e671d60dd5015993220b64593e0ee3f87addae;Sat Dec 11 01:25:25 EST 2010;Committer;tenderlove;5;9;23;32;0
864f60b8375eb0446ea1184f314d3bcac6fb7b87;Sat Dec 11 00:28:25 EST 2010;Committer;akr;2;5;1;6;0
6c7608c0b190ff1f6564c18de2325894e37b5bd2;Fri Dec 10 23:13:47 EST 2010;Committer;drbrain;3;145;55;200;0
62e2f9052be5a2cfb02169cd41edd28443006df2;Fri Dec 10 21:26:23 EST 2010;Committer;drbrain;3;32;0;32;0
1bd8a97eb5c7ca5f37c2a531d9540babaa7df319;Fri Dec 10 21:01:49 EST 2010;Committer;nagai;1;2;0;2;0
30b7855f75f9f88e808f76091b28b9a9c947cbc5;Fri Dec 10 20:58:10 EST 2010;Committer;nagai;2;77;58;135;0
c3752248944a46ba0212de6f24cb94491869611c;Fri Dec 10 17:24:31 EST 2010;Committer;svn;1;2;2;4;0
f6b49243eb0c21bea1c4198cdd52a549e6ead075;Fri Dec 10 17:24:30 EST 2010;Committer;tenderlove;2;13;5;18;0
e14a0042d25173f699042a3259cb32edcfc32bd9;Fri Dec 10 13:34:08 EST 2010;Committer;akr;2;5;1;6;0
a18a4811a0713b0a2a9eadc7d7a74ca31e0d8da0;Fri Dec 10 11:05:52 EST 2010;Committer;nobu;2;7;2;9;0
1a4bf59430667c73e3b0330882ee17a28cc943c4;Fri Dec 10 09:29:22 EST 2010;Committer;nobu;2;6;1;7;0
f5aca8a49ee91812b62617065719e79613bb57f8;Fri Dec 10 09:28:42 EST 2010;Committer;nobu;2;8;2;10;0
31a974dfdb4ce245cd85cf58050e73f0d1a45ef5;Fri Dec 10 09:27:53 EST 2010;Committer;nobu;2;18;12;30;0
61d197a62da53b11518f40a1dfb793f8ef85d89b;Fri Dec 10 09:12:33 EST 2010;Committer;nobu;3;42;1;43;0
30e0f51a5df6a207ebeec105317cbb4cb5566be6;Fri Dec 10 09:11:48 EST 2010;Committer;nobu;4;40;3;43;0
b38cc52c136b9aa46ee1b0cf644aa50778f41d2c;Fri Dec 10 09:11:10 EST 2010;Committer;nobu;5;22;4;26;0
fe1f0df92b87357c5592cb1ecafd50f9ef40ce4c;Fri Dec 10 02:42:06 EST 2010;Committer;kazu;5;20;6;26;0
9ea7e27d582990f7628f071a676b6f325e12f7a4;Fri Dec 10 01:50:51 EST 2010;Committer;naruse;2;8;4;12;0
450680a5d747b828ba43962758c720b26ca68703;Fri Dec 10 01:41:02 EST 2010;Committer;usa;2;9;0;9;0
d10fab3139f862d490ab8df58803bdc380946777;Fri Dec 10 01:21:13 EST 2010;Committer;naruse;1;2;0;2;0
c37ca966921deaef483a0c14ed44da1b15946e92;Fri Dec 10 01:08:45 EST 2010;Committer;naruse;3;22;145;167;0
ac5482dcb60ffc376ff510232a77ac6a95fa045a;Thu Dec 09 17:18:55 EST 2010;Committer;svn;1;2;2;4;0
16a166dd35ffde44eff0f4f96a4d064ee95ab3f4;Thu Dec 09 17:18:54 EST 2010;Committer;tenderlove;5;27;13;40;0
2dc98cd0f3b8a0c4466337b01d48ba0797c05a5b;Thu Dec 09 11:14:42 EST 2010;Committer;nobu;2;16;8;24;0
1547331cf39700d6181ba70da6b13a2eff94de3a;Thu Dec 09 10:26:14 EST 2010;Committer;akr;2;10;6;16;0
d99801bbc86dbdbf8832475a56fd7e9b07e58b4f;Thu Dec 09 10:16:50 EST 2010;Committer;akr;3;15;0;15;0
11b3b5ed9024fa0d02400f90373269c0b91bbddf;Thu Dec 09 06:46:25 EST 2010;Committer;matz;2;17;14;31;0
fc2748e71ef3ae809a25dde6fdda84907c504a44;Wed Dec 08 22:00:59 EST 2010;Committer;nobu;2;3;3;6;0
b2ea6df3b58cb125a80564e791f2c2f23d150cdd;Wed Dec 08 13:29:25 EST 2010;Committer;naruse;3;7;2;9;0
af6708144630678ada8684bb77228ccc2056cb56;Wed Dec 08 12:39:13 EST 2010;Committer;nobu;1;1;1;2;0
2f26014e38ba5a407c71d1b548158224459e6548;Wed Dec 08 12:36:20 EST 2010;Committer;nobu;3;17;1;18;0
fad7d95a18e57bbf8ea33f144f4de94da1388738;Wed Dec 08 11:38:29 EST 2010;Committer;akr;2;20;16;36;0
af3d6b53dc28524b4b33f780b1a6a65f74e8ead2;Wed Dec 08 10:55:39 EST 2010;Committer;svn;1;2;2;4;0
87a826b8c22a898dc954627b1cf43d9b62728333;Wed Dec 08 10:55:36 EST 2010;Committer;shyouhei;4;67;93;160;0
2e65b0d8bb9f00e458e4bc1e468e913f5404e0c1;Wed Dec 08 00:52:38 EST 2010;Committer;nobu;1;1;1;2;0
43cfe6c63edc7142aa3c0a361191bc8eec912d9d;Tue Dec 07 22:29:47 EST 2010;Committer;nobu;4;93;67;160;0
7fd6016e1c3928d588e9bd7d787171f054674bd3;Tue Dec 07 14:24:40 EST 2010;Committer;naruse;2;5;0;5;0
9865ee2c46b7cc9244c3d78b786ee14a7a302e53;Tue Dec 07 13:38:36 EST 2010;Committer;tarui;2;8;1;9;0
11ef87461a79877796786af7f0c1eee75ab4f0bf;Tue Dec 07 13:31:11 EST 2010;Committer;nobu;5;26;15;41;0
ff1fb427348e3e19acc324e851a1ad0e49867d0a;Tue Dec 07 13:29:49 EST 2010;Committer;nobu;2;6;2;8;0
4ec63ef2450d57e368aeef52fe30f95c1feda07e;Tue Dec 07 13:12:10 EST 2010;Committer;naruse;1;1;1;2;0
5bf72d1fa60e195641cb9347c5e5bd98e85da72e;Tue Dec 07 13:05:26 EST 2010;Committer;nobu;5;73;9;82;0
c207b0b727d817793a1a508faf7060b2eae5cd7b;Tue Dec 07 13:01:36 EST 2010;Committer;kou;2;4;1;5;0
40a5012381a18ffbb476a02c4c296fde49377c17;Tue Dec 07 12:57:35 EST 2010;Committer;kou;2;5;1;6;0
d5e607eb52d0c0e619999c65495d5e13fd020a95;Tue Dec 07 12:55:12 EST 2010;Committer;kou;2;9;3;12;0
766d38e65933951039bb395250db5c5a2232b81a;Tue Dec 07 12:16:10 EST 2010;Committer;akr;2;5;1;6;0
9ce40aacef33a9bcb7c565f2fc0bfd493bf73088;Tue Dec 07 12:10:23 EST 2010;Committer;kou;3;51;5;56;0
85eb93d062934ef711074ec6bd1eaab33fed64aa;Tue Dec 07 11:47:39 EST 2010;Committer;naruse;3;17;5;22;0
1f70a6ba67f90b20e4eb3e32786d82cd1985c89d;Tue Dec 07 11:32:45 EST 2010;Committer;kou;2;5;1;6;0
25a6a3fd99b7322a12e1664c89ed0320a06f1a8d;Tue Dec 07 11:31:46 EST 2010;Committer;kou;2;5;1;6;0
eb20de889cd25999f0a2cd04337918150569b371;Tue Dec 07 11:30:19 EST 2010;Committer;kou;3;72;67;139;0
fd019a5cbdb6c3dd3a96abe64c53f6918d07ff3a;Tue Dec 07 08:07:12 EST 2010;Committer;shugo;3;48;1;49;0
e806b0fed77d94ea426bfc0269ab3b01feaf218c;Mon Dec 06 23:00:47 EST 2010;Committer;nobu;4;63;20;83;0
75877a30a49708d6bd2a883b1bb066aacb76f111;Mon Dec 06 20:56:04 EST 2010;Committer;akr;2;9;5;14;0
029891629226094f91fe4e96758662b6564c01a5;Mon Dec 06 15:29:46 EST 2010;Committer;svn;1;2;2;4;0
88ab39f6ab4f2a81d6e100513cafc7424d8f6531;Mon Dec 06 15:29:45 EST 2010;Committer;tarui;2;12;1;13;0
03693cd590edd3dade1142e9409f93de8f3593b8;Mon Dec 06 14:47:54 EST 2010;Committer;nobu;1;1;6;7;0
c42bfb08b2cd2d1588aa6bf61718bfb7d7d49117;Mon Dec 06 14:43:50 EST 2010;Committer;nobu;1;4;1;5;0
5d8fd7f1ba3ebd13beaf4a572ff72582e8dee4e7;Mon Dec 06 14:18:26 EST 2010;Committer;nobu;2;5;8;13;0
6852bf0933055bc7193259e934935d051481469f;Mon Dec 06 14:17:40 EST 2010;Committer;nobu;2;7;14;21;0
a3732110fbfe79be3b17fe697186f0d8a7c823cc;Mon Dec 06 13:55:15 EST 2010;Committer;nobu;3;8;1;9;0
76c286d19581e2339782e7c8b4744dd2cdb8df17;Mon Dec 06 13:47:19 EST 2010;Committer;nobu;3;9;1;10;0
6c715d1de8f170822197dfce7f794e9919e0c92d;Mon Dec 06 10:01:53 EST 2010;Committer;kazu;2;6;2;8;0
71f81f81364882e278e1bf7275e509d9d0349604;Mon Dec 06 10:01:51 EST 2010;Committer;kazu;2;11;0;11;0
9208951d3322a5c7a5a1ff68efd3d60934d6f90b;Mon Dec 06 10:01:48 EST 2010;Committer;kazu;1;2;2;4;0
dd77ae9f6c8d272e08cd4572affaf693e7cb5a1a;Mon Dec 06 10:01:45 EST 2010;Committer;kazu;2;13;0;13;0
9600d9693c4e94e2755001e2e10caedcc761a69c;Mon Dec 06 10:01:42 EST 2010;Committer;kazu;2;10;0;10;0
8d7e9e53437e696e9e121431e96d2755c2106f75;Mon Dec 06 10:01:40 EST 2010;Committer;kazu;2;3;3;6;0
68b18291acc84bc4068e531d3085bfda8a5419de;Mon Dec 06 01:41:10 EST 2010;Committer;naruse;3;7;2;9;0
41bfc7a7218d34b9b9ffbe8154a728b2e044211f;Mon Dec 06 00:54:44 EST 2010;Committer;drbrain;14;623;56;679;0
2a35a782abac006df0d20e0d93cac3b0e3b568ad;Mon Dec 06 00:19:28 EST 2010;Committer;naruse;2;11;5;16;0
e959e9f34acb696da9dc42c1bdd962b5fd66ba35;Mon Dec 06 00:19:27 EST 2010;Committer;svn;1;2;2;4;0
02c0481f8ea257c45bf14bead07a69396576c46e;Mon Dec 06 00:19:25 EST 2010;Committer;naruse;2;5;1;6;0
1a3f4dbafad89a13c5007c23e3fcd15847cb2304;Sun Dec 05 08:56:42 EST 2010;Committer;nobu;2;6;1;7;0
504e6b4dacf4071ffc8ead7460098fe560de4f04;Sun Dec 05 03:09:34 EST 2010;Committer;nobu;3;17;1;18;0
af54c1694cc4139d06797475f9091664d83d8a75;Sun Dec 05 02:27:13 EST 2010;Committer;nobu;3;12;0;12;0
c19cba441465b3c51337fe07cf2847f19c137ab0;Sun Dec 05 01:37:18 EST 2010;Committer;svn;1;2;2;4;0
02441dabf56995717d9392cd40475b35f2676432;Sun Dec 05 01:37:16 EST 2010;Committer;akr;2;14;10;24;0
f462afa5cf29d15d572f8c0bdfc3583249fa628e;Sat Dec 04 02:41:13 EST 2010;Committer;drbrain;2;16;0;16;0
2d4b0d626170c2dada457ea3d11d1d6732775db4;Sat Dec 04 02:21:53 EST 2010;Committer;nobu;3;43;0;43;0
5c6b43d91eadb3e9aa96ef8b2ff5a244081e30f0;Sat Dec 04 02:18:42 EST 2010;Committer;akr;2;7;3;10;0
0987b3cbc6d8cdc353d9b6475310a63b493ea963;Sat Dec 04 02:08:05 EST 2010;Committer;nobu;2;5;0;5;0
3c11b2f2c9fcba96ae3d97958c3db64201c8eaf3;Fri Dec 03 23:50:13 EST 2010;Committer;nobu;2;7;1;8;0
b942e7891a4ac1a74f1ed45612b21aee617bc163;Fri Dec 03 23:25:19 EST 2010;Committer;nobu;3;9;22;31;0
b95ce36ed4a7c99a57da056e7f7a193abd6024cb;Fri Dec 03 22:46:55 EST 2010;Committer;svn;1;2;2;4;0
eb8ccbad0ada2793aa2b45daff0d89528644e273;Fri Dec 03 22:46:53 EST 2010;Committer;nobu;2;6;1;7;0
7b0b9df60ec0fff1463b235779ad48cb8897956a;Fri Dec 03 13:36:49 EST 2010;Committer;nobu;3;8;7;15;0
9e3e0ca3fe5dbfb611445f266f30f72bc06fe3de;Fri Dec 03 11:23:48 EST 2010;Committer;nobu;3;19;9;28;0
e33b7f338158ec83f4817bbb4c91248ed2b13b2d;Fri Dec 03 10:53:53 EST 2010;Committer;nobu;3;98;13;111;0
7031b99bca22bd8fa1d078b182226f59007250f0;Fri Dec 03 10:48:12 EST 2010;Committer;nobu;3;12;9;21;0
e18e1314a969ae8ad81a0f83f0100d0a6eeb888e;Fri Dec 03 03:58:54 EST 2010;Committer;shyouhei;1;1;1;2;0
eb702efcfafa63c3a13920db1cb00338007d4708;Fri Dec 03 03:56:21 EST 2010;Committer;usa;2;6;1;7;0
9d3ba342c90aeec8cec3011967b31bd1d03ae86b;Fri Dec 03 03:53:21 EST 2010;Committer;shyouhei;3;21;3;24;0
adc978adc3932e5fdeb0bdc0622d2f52bf846dba;Fri Dec 03 03:17:22 EST 2010;Committer;nobu;3;28;1;29;0
bfcd4e54538b1dd415ed1f3bebe482df11b383c2;Thu Dec 02 22:08:45 EST 2010;Committer;nobu;3;12;1;13;0
15dad95dfcb092fea28ebc1e1a6aba6df119b1e0;Thu Dec 02 21:53:08 EST 2010;Committer;akr;2;55;51;106;0
cd13326a628cf40bfd25dc286e82e2930a4b5d0e;Thu Dec 02 21:45:49 EST 2010;Committer;nobu;1;1;1;2;0
e59b9e9e43881a818f21a2a5cf6a702d42142c75;Thu Dec 02 19:19:47 EST 2010;Committer;naruse;2;12;9;21;0
3010758245f755dbb9e936c173a700612387b208;Thu Dec 02 19:19:44 EST 2010;Committer;naruse;2;3;6;9;0
4e788aa17e4d4c52e49f3386313bcb948431ea9a;Thu Dec 02 17:40:13 EST 2010;Committer;naruse;2;6;3;9;0
13bfd090211b099095f6b768cee8966323e1d8bb;Thu Dec 02 17:40:11 EST 2010;Committer;svn;1;2;2;4;0
c99a895e28c8dcf8c359720ea0d1b8c9887bedf4;Thu Dec 02 17:40:10 EST 2010;Committer;naruse;2;5;1;6;0
7911d42f1b3b4d6fdaab7a70d69c7bb1351af06c;Thu Dec 02 14:58:41 EST 2010;Committer;shyouhei;3;17;7;24;0
2f1a781e8506cb878cba878070e8bcaa7e6e5d5d;Thu Dec 02 14:06:54 EST 2010;Committer;usa;2;11;1;12;0
c20b8f75dd2aa3797e35aa48ec45dc45e487ae7a;Thu Dec 02 12:28:45 EST 2010;Committer;naruse;3;4;210;214;0
260e8ce6370f2c415d707728ffa249cf92707665;Thu Dec 02 12:28:42 EST 2010;Committer;naruse;2;19;4;23;0
51da92ea1216e9d5139d03308618def2f9d4746a;Thu Dec 02 11:06:32 EST 2010;Committer;shyouhei;5;65;0;65;0
cf39e78e1f2248dfda6ba602ed3d73cd201fdb88;Thu Dec 02 08:01:24 EST 2010;Committer;akr;2;7;3;10;0
064f6af2cbf53d014a2548b9daa6553b0e544dc1;Thu Dec 02 06:37:01 EST 2010;Committer;usa;1;1;1;2;0
82ec8baa955a45e385569251de9b4da0d82ce5da;Thu Dec 02 06:32:01 EST 2010;Committer;usa;2;5;1;6;0
77049334aa25b0bc93558b443e5f6072cb3a932c;Thu Dec 02 04:49:28 EST 2010;Committer;usa;1;1;1;2;0
6f3225f69890da5ed192d191d01462e03cfd6735;Thu Dec 02 04:42:29 EST 2010;Committer;usa;2;12;3;15;0
7eadd51dfe2631b11cbfc1ea20a4bec4f21faa20;Thu Dec 02 04:36:54 EST 2010;Committer;naruse;1;8;0;8;0
e41ed50bf0b2a2f657b88b0a328331f91385d6c0;Thu Dec 02 04:33:56 EST 2010;Committer;naruse;2;26;3;29;0
f5bdc774fdb0dbb9f23d3b314db5177f01d80714;Thu Dec 02 01:46:45 EST 2010;Committer;naruse;2;8;11;19;0
1cdcd40ec876c67d05c0bc424aa8d9f6ad85ea84;Thu Dec 02 01:46:42 EST 2010;Committer;naruse;2;6;6;12;0
173f69146c7dd0cf6cf2116cadbd050eddce6edb;Thu Dec 02 01:20:36 EST 2010;Committer;usa;2;5;1;6;0
6d74458037fd11612af429f95482a14cfa7d1381;Thu Dec 02 01:12:41 EST 2010;Committer;naruse;3;8;20;28;0
a04d93acc2da5fa4efb097d42484e1abb62b97c8;Thu Dec 02 01:03:55 EST 2010;Committer;naruse;2;8;0;8;0
5f37d6902a4d3ac75f76218ff97799fb75193cb6;Wed Dec 01 22:20:23 EST 2010;Committer;nobu;2;31;1;32;0
64740adcffbb18b298086ebff4d41c512fbc9435;Wed Dec 01 22:15:15 EST 2010;Committer;nobu;2;23;2;25;0
0e24a11b597840f4690ac9738fbc3a2f7fa61b8a;Wed Dec 01 22:08:41 EST 2010;Committer;nobu;2;14;1;15;0
ec8f4038c92004ba684851ac6196c39207fbb316;Wed Dec 01 17:31:20 EST 2010;Committer;drbrain;2;13;11;24;0
95bff6e828b39a8e2929210e7e2aa435b68de65c;Wed Dec 01 16:40:16 EST 2010;Committer;naruse;1;22;24;46;0
521876c373ba3d1fac5de2dfe82539d98381bc10;Wed Dec 01 16:26:15 EST 2010;Committer;naruse;3;22;10;32;0
4a84c27e3ee50c4989591fcde2b7a10c5ccc0395;Wed Dec 01 16:26:13 EST 2010;Committer;naruse;16;567;1692;2259;0
b60cc77902972047e6b1dcaf22f90d19448b0510;Wed Dec 01 15:07:36 EST 2010;Committer;svn;1;2;2;4;0
594633fbea10405b76101970d0ba54db18de49fd;Wed Dec 01 15:07:35 EST 2010;Committer;naruse;3;296;323;619;0
91d2ee737d599139a629d58d52e52cb4105d4772;Wed Dec 01 13:05:17 EST 2010;Committer;usa;2;7;0;7;0
8c8814230f949b421206edb9f52ba6e9c822e104;Wed Dec 01 12:44:03 EST 2010;Committer;akr;2;28;24;52;0
6dea556eb7f85f234a0b698aa0dd4b1882c4e8ca;Wed Dec 01 12:42:50 EST 2010;Committer;akr;3;20;6;26;0
bb9464dea8f8f49facfe727a9f9816be98d3aed4;Wed Dec 01 11:07:03 EST 2010;Committer;kazu;5;13;13;26;0
c3757c216564a47ac83a9575d6126c8d3094e574;Wed Dec 01 11:07:00 EST 2010;Committer;kazu;1;15;15;30;0
1972f9eec1ff9a46fd7d97744f789d3ac5832617;Wed Dec 01 06:09:22 EST 2010;Committer;usa;2;6;0;6;0
b5e1dfdb1b8175ec1b9543c4117c12de71493125;Wed Dec 01 06:03:57 EST 2010;Committer;naruse;1;1;3;4;0
417ea3a3c37395c49df9bc8bed21d3627736c288;Wed Dec 01 05:36:39 EST 2010;Committer;nobu;3;8;1;9;0
d264d3cc38696d8b66d7261ae75a96fb8bdf2729;Wed Dec 01 05:33:32 EST 2010;Committer;ryan;14;2147;1546;3693;0
ed22b0ecee668cbd58d469c05b10e74cd6f604ab;Wed Dec 01 01:20:56 EST 2010;Committer;naruse;3;16;1;17;0
54fd6de064142633f3bb592b0bd6486d262cd2b2;Wed Dec 01 01:12:31 EST 2010;Committer;naruse;13;1535;2145;3680;0
22b2c638553c26e265a88a6b68ec31d132361ec7;Wed Dec 01 00:32:19 EST 2010;Committer;naruse;2;78;28;106;0
3632f4cf1cfda24d81e1dbe0576fbce52fcb85af;Tue Nov 30 22:45:53 EST 2010;Committer;ryan;13;2145;1535;3680;0
715ec08107c4b96175049efb288925a5bd463ec2;Tue Nov 30 16:47:25 EST 2010;Committer;svn;1;3;3;6;0
05d7d889ea4034ed2ee6fec8e9ddd6256b72065b;Tue Nov 30 16:47:24 EST 2010;Committer;naruse;3;38;4;42;0
87703540b03e31d3d34a0645b2e03011471f4167;Tue Nov 30 08:06:24 EST 2010;Committer;naruse;2;9;0;9;0
a926288bee10a49a8ce095a3997db075256d697e;Tue Nov 30 08:06:22 EST 2010;Committer;naruse;2;10;0;10;0
4bded50f0ddab6913f9c1c74d0173d21633c3a46;Tue Nov 30 08:06:19 EST 2010;Committer;naruse;2;70;10;80;0
e4288860d8ecbab35c31cdb6efff648c530ebf7a;Tue Nov 30 03:26:43 EST 2010;Committer;usa;2;10;2;12;0
80c21e35cb9660c5f10ee49ddc466866ed089e60;Tue Nov 30 02:56:14 EST 2010;Committer;naruse;2;288;152;440;0
fbf5f324162e6f9aa4a264defc0b937b553a15be;Mon Nov 29 20:24:00 EST 2010;Committer;svn;1;2;2;4;0
ff3e943d1f0fa78736065bc00e314c1ba310c350;Mon Nov 29 20:23:59 EST 2010;Committer;drbrain;3;33;9;42;0
839ee606876c71d6ca2fadf13ee4d0dbfebbf25c;Mon Nov 29 13:55:27 EST 2010;Committer;nobu;3;8;1;9;0
f0a2b08b4461f9c6add51738679ec8e06e3e0fae;Mon Nov 29 13:53:16 EST 2010;Committer;nobu;2;7;5;12;0
8fba2b63ec2a8c0f5e43606325af9a283dd90976;Mon Nov 29 13:52:26 EST 2010;Committer;nobu;2;6;1;7;0
f4c909b96551cad967140448db96a02362d6d710;Mon Nov 29 12:12:54 EST 2010;Committer;nobu;2;5;1;6;0
05a0c30adcf0a8e0d918b8ed32804e9f8c163003;Mon Nov 29 12:11:19 EST 2010;Committer;nobu;2;6;0;6;0
62cd77327bcd94624fd8d1188386200b39b85e30;Mon Nov 29 09:55:14 EST 2010;Committer;usa;1;1;1;2;0
5ff2c82a080c9677ea1e752117f2d7c2d5fea342;Mon Nov 29 09:33:08 EST 2010;Committer;duerst;2;12;4;16;0
95f0f27dd04c902932c0f64e1e2cc20ab5974885;Mon Nov 29 05:33:15 EST 2010;Committer;usa;2;8;1;9;0
dd4c394564d05f6d70afcf78671b62350c2ab179;Mon Nov 29 05:20:08 EST 2010;Committer;usa;2;5;1;6;0
5b54e9e6859c6d89c7e1ffda6a20108628d22a74;Mon Nov 29 05:11:50 EST 2010;Committer;svn;1;2;2;4;0
3d245920080dcf9d2446a91b56c6e69e9738dc90;Mon Nov 29 05:11:49 EST 2010;Committer;usa;2;12;7;19;0
53d06bb081ad2f180eb277f3e1dd62889ab61a31;Sun Nov 28 13:25:58 EST 2010;Committer;nobu;1;3;0;3;0
283c36e761b55a6f393b088261b7ceee8c83d6e8;Sun Nov 28 13:16:50 EST 2010;Committer;ko1;2;11;5;16;0
e4cf9c59fda102a80aa767c3a66a4738e26f6213;Sun Nov 28 13:00:49 EST 2010;Committer;ko1;2;16;35;51;0
7a4b99129b1e05221add4132533a92de4c454da3;Sun Nov 28 12:55:43 EST 2010;Committer;ko1;2;22;4;26;0
16d4733ee49d749e4dad3de896a3f02e0573eeff;Sun Nov 28 12:46:27 EST 2010;Committer;nobu;2;16;6;22;0
bc8b1008731e5aadca308c464b184066e2856e76;Sun Nov 28 05:56:39 EST 2010;Committer;nobu;2;9;6;15;0
f0445d156caf032135777f4c3974a4adc945470e;Sun Nov 28 05:55:49 EST 2010;Committer;nobu;2;6;2;8;0
925da00b022b05b5bf70e5d757b9149493e6946c;Sun Nov 28 05:48:31 EST 2010;Committer;nobu;3;12;3;15;0
079545cd8c7a2c0da45977bec7d88aa3d1232820;Sun Nov 28 05:46:32 EST 2010;Committer;nobu;2;13;4;17;0
450463d5fbc7098666c1405b5ea1ece4c8dd04a5;Sat Nov 27 20:15:59 EST 2010;Committer;ko1;8;328;82;410;0
ac0f5a53b6d567b319df73878bd08d70cbbdc37c;Sat Nov 27 19:49:58 EST 2010;Committer;luislavena;3;34;0;34;0
1342c3ba27e21aef1d1eb362a55f79df94c59d19;Sat Nov 27 19:22:54 EST 2010;Committer;svn;1;2;2;4;0
baf7a09d3509f7d858fc7a705e14feaaf5ad56b6;Sat Nov 27 19:22:53 EST 2010;Committer;naruse;2;65;66;131;0
cf869bc14d80dda4fea5390bb16ed44878e82100;Sat Nov 27 10:12:48 EST 2010;Committer;akr;2;10;6;16;0
2451d735a79d7c5f4bdb019335b7083bd081df69;Sat Nov 27 09:08:29 EST 2010;Committer;nobu;3;9;1;10;0
0ebec8cf722da3e3c1c557ae28cce8943eef0d4d;Sat Nov 27 09:03:26 EST 2010;Committer;akr;2;8;4;12;0
3e57529e3edf120d0c6444ed0b21d4ea2b44133a;Sat Nov 27 06:45:30 EST 2010;Committer;nobu;2;11;2;13;0
3c36edc0d2b5da5444b8ebbcc605367de9745fe5;Sat Nov 27 06:43:30 EST 2010;Committer;nobu;4;8;2;10;0
238198406963869a5d3e75030f7f7e63aee1f1b7;Sat Nov 27 05:01:13 EST 2010;Committer;shugo;2;6;1;7;0
d412050e722681b6f3a464607d69337016abffda;Sat Nov 27 03:08:12 EST 2010;Committer;matz;2;17;13;30;0
7050069d8020684af2979cbf67b7702d4f7823fd;Sat Nov 27 02:29:26 EST 2010;Committer;nobu;2;7;2;9;0
e394ddd2f720a8a39f25b5b2c6dad5e31ab2be36;Sat Nov 27 02:02:43 EST 2010;Committer;nobu;1;1;0;1;0
ca86a063d575afddae055700f60192bb2769ed26;Fri Nov 26 23:16:24 EST 2010;Committer;nobu;3;10;3;13;0
39e7b2fb9495924e7f519a1e4f82d89f90ae78e4;Fri Nov 26 04:39:23 EST 2010;Committer;naruse;2;15;2;17;0
086301ac73c34bc2231f98b67d56b50c65480cc1;Fri Nov 26 03:28:50 EST 2010;Committer;naruse;6;577;1;578;0
f8f3585416d93af69f2d0dce595ea933c3d43694;Fri Nov 26 03:28:48 EST 2010;Committer;naruse;3;22;0;22;0
f55d567b5910fe1dacf623fa471d771c99ba4fef;Fri Nov 26 02:42:46 EST 2010;Committer;usa;2;7;1;8;0
952a357274a9eb794aa999780c88ce7575d9cfed;Fri Nov 26 02:10:25 EST 2010;Committer;usa;2;9;2;11;0
b96d267c7ec85ba5820bdf1a425c4b43da921335;Fri Nov 26 01:50:18 EST 2010;Committer;usa;2;7;2;9;0
ca8405298f87a7ab857d91d646c48bbad2cecb1f;Fri Nov 26 00:50:42 EST 2010;Committer;usa;2;6;0;6;0
cc494bcb2080a3071867fbbfd30e0f8fac9fef7f;Fri Nov 26 00:34:50 EST 2010;Committer;usa;1;5;0;5;0
6f581a68b88599b4a9933e462956a36cf167bb8f;Fri Nov 26 00:34:04 EST 2010;Committer;usa;1;2;1;3;0
bc0fcc5357ae4b4421df8f71ee527d87389a7388;Fri Nov 26 00:24:30 EST 2010;Committer;svn;1;2;2;4;0
25787431990b979f74b81c90ef42616e09d758ce;Fri Nov 26 00:24:28 EST 2010;Committer;naruse;2;40;15;55;0
756dfe9f402b112cfee02cd2f964b83d884a2c93;Thu Nov 25 14:31:36 EST 2010;Committer;nobu;2;2;2;4;0
bd98301784605e72eb8b4c61cae9cb57c802dea1;Thu Nov 25 14:14:44 EST 2010;Committer;naruse;3;18;4;22;0
b00dfcca177fde79630e182934f509fcdd9f3998;Thu Nov 25 01:31:21 EST 2010;Committer;usa;2;14;1;15;0
69a248a0736aba6e540670aff0cace024533cd68;Thu Nov 25 01:03:52 EST 2010;Committer;usa;2;7;4;11;0
ed637d01d7f3769ab96546f437fa8bda81f93eb3;Wed Nov 24 16:40:40 EST 2010;Committer;svn;1;2;2;4;0
b98ea1505ca49a757d392635ffc34091490b8c5b;Wed Nov 24 16:40:38 EST 2010;Committer;naruse;4;37315;4;37319;0
99606f89c04d0156e8149329d39e9b2ab4754549;Wed Nov 24 06:18:43 EST 2010;Committer;usa;2;8;1;9;0
7329f4e92c90709fe57115f16a8ac9784a51b509;Wed Nov 24 03:50:03 EST 2010;Committer;usa;2;23;0;23;0
220d07d2fcf5b8d66327e2c78770448c43c33db5;Wed Nov 24 02:20:11 EST 2010;Committer;naruse;2;13;0;13;0
38b482be8c3b53809fa44e35cb0eded148b132c8;Wed Nov 24 00:08:04 EST 2010;Committer;naruse;3;101;1;102;0
bcf80a5140c1b08899b20d9bbcd5fd9e13db4017;Tue Nov 23 21:37:56 EST 2010;Committer;nobu;1;2;2;4;0
3c4fecda3f3dd3c264999aefe7f4374e2270eb3e;Tue Nov 23 21:13:35 EST 2010;Committer;nobu;2;23;38;61;0
7f38397b6c01b65219deb622c027e177bdc23ede;Tue Nov 23 20:49:56 EST 2010;Committer;naruse;3;35;5;40;0
3ab82a65d701db47cea2ccbe9e7821468e71dd90;Tue Nov 23 18:23:03 EST 2010;Committer;naruse;3;15;8;23;0
952006388f528513c43eb105857fda761d5a9273;Tue Nov 23 16:42:48 EST 2010;Committer;svn;1;2;2;4;0
78bee9c26a38343dcf6de3cbad0115ddac0756b6;Tue Nov 23 16:42:47 EST 2010;Committer;naruse;4;91;0;91;0
92b190fa24e1997bb2c39e8b233375a9db69af8e;Tue Nov 23 14:36:37 EST 2010;Committer;tadf;2;2;2;4;0
4ffe7a1734ad9eea45c230931fc1f2a3880d7b36;Tue Nov 23 14:28:55 EST 2010;Committer;tadf;2;11;11;22;0
16cb5ce483b87646258e0c10fbda4520a0faf343;Tue Nov 23 12:59:50 EST 2010;Committer;nobu;2;11;4;15;0
3c575a15c24f2eda10c57e3f30037ee3c372f994;Tue Nov 23 09:54:07 EST 2010;Committer;nobu;3;29;0;29;0
b828fb85dda5970334d42f1a0b542c8d3ebf825b;Mon Nov 22 22:59:48 EST 2010;Committer;tadf;3;11;5;16;0
bacd54785856a7d7a7dd3ea995b9aa6f9c56a3da;Mon Nov 22 22:32:57 EST 2010;Committer;tadf;2;38;0;38;0
1d8ca7a237825a4d606e08ff3544aa6a8489f6f9;Mon Nov 22 22:31:55 EST 2010;Committer;tadf;3;8;4;12;0
6e9ca6484380cfe2d5ba25c3cd31133afe64105a;Mon Nov 22 22:28:53 EST 2010;Committer;tadf;2;4;0;4;0
ed5c01b9a3b40110956b4b57a9135288b4f9f52c;Mon Nov 22 22:28:01 EST 2010;Committer;tadf;2;5;0;5;0
04608d226c45a659883e74385a6fa7601dffe063;Mon Nov 22 22:23:04 EST 2010;Committer;nobu;1;5;4;9;0
66d4bdd114e2bed46b4da84894793e331e7e90e0;Mon Nov 22 21:30:54 EST 2010;Committer;nobu;3;19;3;22;0
a97c07fb2e70c2076c2da3def4a0da361540d4bd;Mon Nov 22 21:30:22 EST 2010;Committer;nobu;2;8;1;9;0
74217f04224ca5bde2f0cb7905f70b869b43f5af;Mon Nov 22 21:26:28 EST 2010;Committer;nobu;1;4;0;4;0
c3b9133e018f5aef013bb3e2ca2b9210650e9ec1;Mon Nov 22 16:06:39 EST 2010;Committer;svn;1;2;2;4;0
18c0fc890c4847eb19e1997b88c4f8e043321f9b;Mon Nov 22 16:06:38 EST 2010;Committer;naruse;3;7;2;9;0
94e6c0c233bd386e09e5700d947d4f5e4fca3914;Mon Nov 22 12:30:58 EST 2010;Committer;nobu;3;14;1;15;0
5d8a64b1afe08a0bf6d19b702453e0be4a58e5c7;Mon Nov 22 11:35:55 EST 2010;Committer;naruse;4;76244;0;76244;0
42e17a0b3fcb5ff4bb775c7d97226de108368eef;Mon Nov 22 09:45:46 EST 2010;Committer;nobu;2;8;2;10;0
60dfa6b655239a176c4fef4067c409c8b3f86e5d;Mon Nov 22 09:35:08 EST 2010;Committer;naruse;7;67;32103;32170;0
6ade3a42918e94be1c6d4b1bd9273ec1e3265525;Mon Nov 22 09:33:32 EST 2010;Committer;nobu;3;11;2;13;0
456f3980b20ca031a2925094feff86ceb0032b8e;Mon Nov 22 05:28:22 EST 2010;Committer;naruse;1;1;1;2;0
33356ff75b3c33f85aa21707e2e23bcba0fe7c17;Mon Nov 22 05:25:15 EST 2010;Committer;naruse;3;10;2;12;0
3002e5e1f9767e914ccd3e1fcfd96b38b1fd438f;Mon Nov 22 03:01:45 EST 2010;Committer;naruse;3;8;0;8;0
d9615bf9c54414906ea9bac51f2a6e7ffd10c5cf;Sun Nov 21 16:51:13 EST 2010;Committer;svn;1;2;2;4;0
c70988cbe93359c9f9f423f88717e329f2c088d0;Sun Nov 21 16:51:12 EST 2010;Committer;tadf;2;36;11;47;0
bbbf9998c7e2d2eca9803f268e0f82ecd60fde0f;Sat Nov 20 19:38:44 EST 2010;Committer;svn;1;2;2;4;0
1346b84c195cd6587f93dfe7faac199acc8f6936;Sat Nov 20 19:38:42 EST 2010;Committer;naruse;1;6;0;6;0
99aaee351e42ca0d823ca959241668dc2eb77df2;Sat Nov 20 03:04:59 EST 2010;Committer;nobu;2;21;4;25;0
c62c8f725d3786ddd9341f8207742205dd35140d;Fri Nov 19 22:47:20 EST 2010;Committer;tenderlove;2;7;9;16;0
460d4c4925dbc19f702a1b7db444c85b6882e193;Fri Nov 19 17:05:40 EST 2010;Committer;svn;1;2;2;4;0
e2501757f64c7d60bd867f0df261ce7bfe120245;Fri Nov 19 17:05:39 EST 2010;Committer;arton;2;5;1;6;0
e7fbb33c911d41317a6667fa29a655cacdb73fc2;Fri Nov 19 14:05:50 EST 2010;Committer;nobu;2;5;3;8;0
d468660c9a1baf23151e18eaf7c43f5e462f3ee7;Fri Nov 19 13:58:13 EST 2010;Committer;nobu;1;16;16;32;0
83e274d46df99b2c0880f47cfe5d52308029feae;Fri Nov 19 13:44:06 EST 2010;Committer;nobu;3;6;3;9;0
8565b62aef0d48f6f271157d606f2014f22581c5;Fri Nov 19 13:43:14 EST 2010;Committer;nobu;1;16;16;32;0
54142064c4dc8559e3c6d13a1fdb95bcb5f06d95;Fri Nov 19 13:11:20 EST 2010;Committer;kou;2;16;1;17;0
91c0ff4f7d28856645b72d09f58dbabfa5e862ad;Fri Nov 19 12:07:09 EST 2010;Committer;nobu;4;105;1;106;0
67f3280cfe75391f97bb342da10186fa190373b2;Fri Nov 19 11:26:57 EST 2010;Committer;nobu;1;4;0;4;0
644f0445e86034dde399d6db8261c82cf34b8e07;Fri Nov 19 11:26:54 EST 2010;Committer;nobu;4;127;9;136;0
3c1f696a507fb8f7deb87b7111d44458efb8c051;Fri Nov 19 05:11:37 EST 2010;Committer;naruse;1;0;8;8;0
ad64b9669fc7b59c78c1435f4b9862531b7a87db;Thu Nov 18 15:00:05 EST 2010;Committer;svn;1;2;2;4;0
d05029240ed4aef5bb616b00b3f5e0bcb26404ef;Thu Nov 18 15:00:03 EST 2010;Committer;nobu;2;5;3;8;0
7ae23d32c2044ad21a29045f611a1f0c6dde59a0;Thu Nov 18 14:56:34 EST 2010;Committer;nobu;2;50;12;62;0
6fcd0b37b3cf9b37f3bd2833cef614ae22f3f7ca;Thu Nov 18 14:25:03 EST 2010;Committer;kou;3;33;5;38;0
c6e4767068df673200351c23c203c22731e6102a;Thu Nov 18 13:58:47 EST 2010;Committer;nobu;3;227;224;451;0
9be87b1eb6b320e027919079f6e050f042347205;Wed Nov 17 22:37:48 EST 2010;Committer;nobu;3;23;3;26;0
d646c540b7320576a09ea2185c43f5a182d2c69a;Wed Nov 17 22:16:53 EST 2010;Committer;nobu;2;5;1;6;0
ef3d9fb408f14e64c096c2ef748ce05287e388f1;Wed Nov 17 15:03:26 EST 2010;Committer;svn;1;2;2;4;0
b028e8d45d90bec5ee5bcc9c4e42adc96f5d6f14;Wed Nov 17 15:03:25 EST 2010;Committer;jeg2;3;15;3;18;0
7afe174b9e7a4c977df77163ffdfae98090371a3;Wed Nov 17 14:19:24 EST 2010;Committer;nobu;2;16;14;30;0
4fc08fd17d839f673275292d023363b6860cded8;Wed Nov 17 14:17:26 EST 2010;Committer;nobu;3;15;11;26;0
49959bfd629304db8971be5581d124fc7d1ce42d;Wed Nov 17 10:13:25 EST 2010;Committer;nobu;3;11;5;16;0
023eab52018a87a63a465aa73d25a58162115663;Wed Nov 17 09:38:38 EST 2010;Committer;nobu;6;16;12;28;0
a7de3755047fb697e0b3d292a3713145c7e04447;Wed Nov 17 09:32:44 EST 2010;Committer;nobu;1;2;2;4;0
1b45a27a8912afeda2ae3e352886276c78b8df74;Wed Nov 17 09:22:45 EST 2010;Committer;nobu;2;11;2;13;0
3a0e9cb075fb91cb1aa8a9313e2f1e02654c8e44;Wed Nov 17 07:14:13 EST 2010;Committer;yugui;2;25;0;25;0
8903faf1a1e8cec44b3587a3cd88bf25cfe10515;Wed Nov 17 07:08:07 EST 2010;Committer;yugui;2;12;0;12;0
8e2a1cba362cf4a464b6233f23f485f7b91696c3;Wed Nov 17 06:21:11 EST 2010;Committer;naruse;4;37;24;61;0
07b1f01b335ea67f54e64e24e666dfdafb5b43c1;Wed Nov 17 00:49:49 EST 2010;Committer;naruse;3;8;2;10;0
36e908901baa9c113b4896f280e615828bbbe8c7;Tue Nov 16 23:55:31 EST 2010;Committer;svn;1;2;2;4;0
40e5b3933662ef3cd41f57fe8e8003b3f7c04b05;Tue Nov 16 23:55:29 EST 2010;Committer;jeg2;3;62;38;100;0
6cba0f06639897912539f797cd1d5f502909dc1e;Tue Nov 16 13:32:30 EST 2010;Committer;mame;2;6;1;7;0
3124b5fc3efcd1ffc74e6093f96156139dfa2061;Tue Nov 16 06:20:06 EST 2010;Committer;naruse;1;2;1;3;0
0ec61a315626fe978317e7b6d1fb8c6db9e1212e;Tue Nov 16 00:37:31 EST 2010;Committer;mrkn;2;6;1;7;0
8b09bf2a72e4e59bb5107c15be367cf8808e6667;Mon Nov 15 21:39:39 EST 2010;Committer;nobu;3;13;1;14;0
0dbe6b611339af6a95eadd56d327d27c1ae9131b;Mon Nov 15 16:06:35 EST 2010;Committer;mame;2;17;14;31;0
16b7c1e3c6db0ab41acd74cd12f48735b84e1c01;Mon Nov 15 15:09:41 EST 2010;Committer;svn;1;2;2;4;0
4c17014bf3e49f480a2a5018e9cd4d855bece432;Mon Nov 15 15:09:40 EST 2010;Committer;mame;2;12;3;15;0
9ffd060b30b85a1783d6dd81dd41ebf447e9b3e1;Mon Nov 15 14:57:18 EST 2010;Committer;mame;2;6;1;7;0
7b7210439cac9a1b6b35035cb59af8a4fd8488ee;Mon Nov 15 14:44:19 EST 2010;Committer;mame;2;11;4;15;0
e20d736467c93723827c3afc9c7e72bb027fd326;Mon Nov 15 13:48:37 EST 2010;Committer;mame;2;7;1;8;0
cb2235c112aade58af0f0c367b71f3a2662c89bc;Mon Nov 15 09:09:39 EST 2010;Committer;naruse;1;1;5;6;0
b73d1fbd2518c4d06ab245c7999dffa579d2b4f9;Mon Nov 15 02:47:05 EST 2010;Committer;tenderlove;2;13;4;17;0
8a6ebf4c513cbc6be7a8b099eedc7ab4e149d0b6;Mon Nov 15 02:46:55 EST 2010;Committer;tenderlove;1;1;1;2;0
a33b5edda009c91302d1e5f72ae0d21c221b7b48;Mon Nov 15 02:37:23 EST 2010;Committer;naruse;1;3;1;4;0
10c73a7b44c452b46325b59bf925cae0c6d01598;Mon Nov 15 02:37:19 EST 2010;Committer;naruse;1;1;1;2;0
b89bd51d9c0419c3e032dce85b4d25f2331604a0;Sun Nov 14 21:46:10 EST 2010;Committer;svn;1;2;2;4;0
fb7a337e97db438d11dd48a33e9fd75483eefed8;Sun Nov 14 21:46:08 EST 2010;Committer;tenderlove;3;10;1;11;0
54e1affd1639943531cad80cb0db1f83c2acec35;Sun Nov 14 08:57:53 EST 2010;Committer;nobu;2;7;2;9;0
b5c3fb246579d99d3f7316477f12580963cd9cf8;Sun Nov 14 07:49:06 EST 2010;Committer;nobu;3;63;4;67;0
f2dd4eb3cc32b5edd4f6cbff34b922f662300ea5;Sun Nov 14 03:05:29 EST 2010;Committer;nobu;3;37;4;41;0
261903223a967079521c68dda54fe722de98cbf5;Sat Nov 13 23:48:12 EST 2010;Committer;nobu;2;7;2;9;0
327adb32e372d90ce5c53eee5915a9857910a062;Sat Nov 13 19:32:35 EST 2010;Committer;azav;1;6;0;6;0
18ae7423698a7f3b85b17008b7175afc6a9aa750;Sat Nov 13 19:26:55 EST 2010;Committer;azav;1;2;0;2;0
5e8efdd610581652af927e6ee9ce7920f4ae4500;Sat Nov 13 19:21:13 EST 2010;Committer;svn;1;2;2;4;0
2ffe5e7d986109edbc2a2f9a1b6477ae69444a69;Sat Nov 13 19:21:12 EST 2010;Committer;azav;1;4;3;7;0
223c0b48a17df432a197638299414367d27179ac;Sat Nov 13 07:38:01 EST 2010;Committer;nobu;4;46;39;85;0
c37066fab7040fc9fd9d9efaa69cfea45c2ca138;Sat Nov 13 07:26:16 EST 2010;Committer;nobu;2;6;2;8;0
89616d6fe3ed6f7a22a3acdedd7938a98d6e0812;Fri Nov 12 16:38:44 EST 2010;Committer;arton;1;1;2;3;0
89189767efb110adf419cb6ea1d8f2ea57ec6e2e;Fri Nov 12 16:32:00 EST 2010;Committer;svn;1;2;2;4;0
f4c98c3e10553de73c6e039064f2e618f5851103;Fri Nov 12 16:31:59 EST 2010;Committer;arton;2;6;1;7;0
fe2295ea759ebc986f0a1ef9e80495af905e983e;Fri Nov 12 11:52:45 EST 2010;Committer;nobu;4;42;35;77;0
fd7c0279f87411d77beadd232fc208b0a0d8f9e4;Fri Nov 12 11:51:42 EST 2010;Committer;nobu;8;91;170;261;0
54ba50918e6ebb38ce36a7cfce7751855d86c947;Fri Nov 12 07:54:27 EST 2010;Committer;naruse;2;16;0;16;0
7b109f17728f4a02a3cc7f3dd7de8a40c296ba09;Fri Nov 12 01:00:39 EST 2010;Committer;usa;2;7;1;8;0
a22b9b09458369dca68d5edc9ae304c484925331;Thu Nov 11 16:36:04 EST 2010;Committer;nobu;1;4;6;10;0
812fc57a9a6140d547214e094807e8ddce621a53;Thu Nov 11 15:53:07 EST 2010;Committer;nobu;1;1;1;2;0
5937e8d5d6628cc387cf0f16eec7beec4eff6c07;Thu Nov 11 15:31:59 EST 2010;Committer;nobu;1;58;0;58;0
430da2ad303714bcabafe15d7cc458256e3856f5;Thu Nov 11 15:30:25 EST 2010;Committer;svn;1;2;2;4;0
32bd439f76f874f21c70feacf72c953a9983415b;Thu Nov 11 15:30:24 EST 2010;Committer;nobu;2;6;0;6;0
feb67bc72942770ab8dd42436293776d8a7aa8b4;Thu Nov 11 14:56:48 EST 2010;Committer;nobu;1;2;3;5;0
54fb9d3ca7c7ca6db8ed53888c973672e3abf97b;Thu Nov 11 14:38:36 EST 2010;Committer;nobu;2;6;1;7;0
12f742306ed574062e0ac0e8a19632d0e166e6dd;Thu Nov 11 14:32:15 EST 2010;Committer;nobu;2;10;7;17;0
6a256d448dabd77319d3b8096374029cc02d5ce1;Thu Nov 11 14:29:42 EST 2010;Committer;nobu;2;10;5;15;0
a774aa4e79933d6c96258c1660f1b8ee2a0cc349;Thu Nov 11 14:04:48 EST 2010;Committer;nobu;2;29;1;30;0
a77d2ac5ba56e92fac2d9d88b7d57cce20129d57;Thu Nov 11 14:03:17 EST 2010;Committer;nobu;2;13;3;16;0
684a6059e9ea9b0c7aefd26976e7c0488ece883a;Thu Nov 11 13:37:35 EST 2010;Committer;nobu;1;3;3;6;0
fa5034ed02f8fc349a84768a17c302770eb1b649;Thu Nov 11 13:37:33 EST 2010;Committer;nobu;1;10;1;11;0
6c5115379daaa7d971190729099379005c66d72d;Thu Nov 11 13:03:42 EST 2010;Committer;nobu;2;24;1;25;0
41131d42158158f5a327f4f9dd6b7b469bef5974;Thu Nov 11 12:56:16 EST 2010;Committer;nobu;2;55;2;57;0
b3dcfcf22b053fc4b50d417ca98a540ee8908b99;Thu Nov 11 12:52:18 EST 2010;Committer;nobu;2;28;1;29;0
994876860b4f2a9bf4f22c436527e7220c82d5b4;Thu Nov 11 12:49:11 EST 2010;Committer;nobu;2;6;2;8;0
78c48e48baec3336e597dfb564c12db5474fdfbb;Thu Nov 11 12:47:17 EST 2010;Committer;nobu;2;13;1;14;0
f2f7a7740a0c4542ae8dc8db393f184a7a6b2174;Thu Nov 11 12:46:23 EST 2010;Committer;nobu;7;99;6;105;0
7ef29a9f5e6b0ac8e194e6bb81353c992aac5669;Thu Nov 11 12:41:12 EST 2010;Committer;nobu;1;3;1;4;0
59a666a25f9c03320a5fcc5b576b86c3a87a9317;Thu Nov 11 12:32:15 EST 2010;Committer;nobu;3;23;4;27;0
8a7aad995210ce7a66e9be4315693feb7756670a;Thu Nov 11 12:30:39 EST 2010;Committer;nobu;8;23;25;48;0
a5eb40b99935a5d1bc29e2c086d00883d6b98858;Thu Nov 11 12:30:35 EST 2010;Committer;nobu;1;1;1;2;0
db0ebb32c92b592ff2a9f0f0cf84d0037edbfbae;Thu Nov 11 12:26:30 EST 2010;Committer;nobu;1;1;1;2;0
41cae1744fcc9d7dd0c6d332ab3b94eaf954d1dd;Thu Nov 11 12:24:41 EST 2010;Committer;nobu;4;46;10;56;0
fe9f1e8cf8a1d49c7d4d6baff2f1797ff89e7956;Thu Nov 11 11:49:54 EST 2010;Committer;nobu;3;49;23;72;0
8a7d063c1f46fb47d12119e6c2b6dcbfcbc1d909;Thu Nov 11 11:45:34 EST 2010;Committer;svn;1;2;2;4;0
18bd7f8c845e392995d738f3bca3675b7b265e23;Thu Nov 11 11:45:32 EST 2010;Committer;nobu;5;23;12;35;0
536e266e58e6fda550e781d7a88317fdfe149cfa;Tue Nov 09 22:20:12 EST 2010;Committer;nobu;7;85;6;91;0
5ddcc93a3f9ffaeed5a78aa0fa7a847880102600;Tue Nov 09 12:57:53 EST 2010;Committer;nobu;2;30;22;52;0
6f4bfdc11554951e00f7ab7afab10c3ecff9c688;Tue Nov 09 12:57:51 EST 2010;Committer;nobu;1;0;1;1;0
ef98740d31e9df52f49093fc31f3a58d4f242691;Tue Nov 09 12:14:58 EST 2010;Committer;nobu;2;8;2;10;0
e9c4a44f238153114d91b5996bc8cb04e7a573a0;Tue Nov 09 12:13:06 EST 2010;Committer;nobu;2;10;4;14;0
ac21a6ef7db04faa703a3b010c7dc591b50af75c;Tue Nov 09 10:14:47 EST 2010;Committer;naruse;1;1;1;2;0
dbf7e6f9f232a3173b118c5f1ad57f97aa7e4e9d;Tue Nov 09 07:36:33 EST 2010;Committer;naruse;5;43;9;52;0
63b0601792541615b2ef18c690c167c16593078d;Tue Nov 09 04:30:15 EST 2010;Committer;usa;2;8;1;9;0
3c18caa4c2ea88129f01d88fab8174a38281a9d6;Tue Nov 09 04:22:25 EST 2010;Committer;naruse;1;1;1;2;0
c383fbf93f691f443eb16761351a6943bc29d3f9;Tue Nov 09 01:57:49 EST 2010;Committer;naruse;3;16;2;18;0
b3c7867df7cd186e73021f0ed9d17680999f190f;Mon Nov 08 22:30:20 EST 2010;Committer;nobu;3;30;1;31;0
b188d19ee080e954b9a86c746d0c0ee4068266c1;Mon Nov 08 22:28:17 EST 2010;Committer;nobu;1;2;1;3;0
f3e35474078895e1d178e15cfbfc6743f9ffc62d;Mon Nov 08 20:59:01 EST 2010;Committer;marcandre;37;62;73;135;0
cceca83afe046b8c2b53eab6ab7c52faa1719b6d;Mon Nov 08 20:58:42 EST 2010;Committer;marcandre;12;17;19;36;0
571ed8655fa499084114024c4a7f249228a8bc3d;Mon Nov 08 20:58:28 EST 2010;Committer;marcandre;7;6;10;16;0
ec67ee3387e5e1e70c6c6997c651f5eff49043cb;Mon Nov 08 20:58:12 EST 2010;Committer;marcandre;2;5;6;11;0
ed4eaf7ce718dbcbcbc296d570e9ae4986706b5c;Mon Nov 08 20:57:58 EST 2010;Committer;svn;1;2;2;4;0
64167ddda8606e57f5490e9dd62d6c095987442f;Mon Nov 08 20:57:56 EST 2010;Committer;marcandre;1;1;1;2;0
e640e1c56543f12795813e4eca0890751d3764a0;Mon Nov 08 09:28:42 EST 2010;Committer;naruse;2;7;3;10;0
599a7071c1789013dc8c8a4edeb5d54bc2fb71a6;Mon Nov 08 06:44:39 EST 2010;Committer;naruse;3;8;0;8;0
1f3e96b7ac73401c15df4d77bdcf6f441813c443;Mon Nov 08 05:41:49 EST 2010;Committer;usa;2;7;3;10;0
a0265b06629a0ae835adcf0f66fdba070653a785;Mon Nov 08 05:32:45 EST 2010;Committer;naruse;8;23921;4269;28190;0
294070d86a0d3f2d9afdc539a3ad45ac0bb1493c;Mon Nov 08 03:19:14 EST 2010;Committer;shyouhei;2;6;0;6;0
7dd7ce0ff74bae43ff2859215899c15349ac03cf;Mon Nov 08 02:48:07 EST 2010;Committer;usa;2;47;94;141;0
877e90f17a3b59bfff51c4a7811a7036f47ef798;Mon Nov 08 02:03:40 EST 2010;Committer;usa;2;57;39;96;0
7b5e9245ace2baefdfc38b109a3c02d510ff7aea;Mon Nov 08 00:50:13 EST 2010;Committer;naruse;2;7;0;7;0
2cff55dbb37e5453a807320769aad42184bd0229;Sun Nov 07 22:26:25 EST 2010;Committer;nobu;3;8;3;11;0
958456db0f5dae2a1bcb360adcf92f0c8475f07b;Sun Nov 07 01:13:33 EST 2010;Committer;nobu;2;5;1;6;0
37e7bf7619f61b1a523652bbc8033a55daa7be0e;Sat Nov 06 21:19:11 EDT 2010;Committer;tenderlove;1;2;5;7;0
4032e6d62268bfb35d9fd7d6b0bb5028ba149c61;Sat Nov 06 21:19:04 EDT 2010;Committer;svn;1;2;2;4;0
e6a8cbc2a2be064da4cbef3b0b310c1cb8ed8b93;Sat Nov 06 21:19:00 EDT 2010;Committer;tenderlove;2;60;0;60;0
967e92af874b33b739c349633f091033645f831e;Fri Nov 05 22:33:18 EDT 2010;Committer;nobu;2;13;2;15;0
8f5689bf3c6dd9bf56caa63a7d3fca7be70f3869;Fri Nov 05 22:33:14 EDT 2010;Committer;nobu;1;10;6;16;0
ec50e32dbdd78e7f44783e1bd1d53dfde81ad61d;Fri Nov 05 22:30:13 EDT 2010;Committer;nobu;2;27;2;29;0
41a25b855a9ba8a3659cc031427567789e384a31;Fri Nov 05 22:28:45 EDT 2010;Committer;nobu;2;13;1;14;0
6d9cd4840d88ce955eae823d1174c2b13d08b50b;Fri Nov 05 22:24:06 EDT 2010;Committer;nobu;3;8;3;11;0
340c3b4638fd671d84a6249a33f71c71774d94b3;Fri Nov 05 22:03:54 EDT 2010;Committer;nobu;2;6;1;7;0
a7188103fd615ce7887d4cecdd200742fac114b9;Fri Nov 05 15:49:44 EDT 2010;Committer;svn;1;2;2;4;0
2b620bec1280550b5503f37272032822646cc86d;Fri Nov 05 15:49:38 EDT 2010;Committer;tenderlove;2;22;3;25;0
6c9e95df88d124a5fd0e7c996ce10b47471ee39d;Fri Nov 05 03:23:10 EDT 2010;Committer;nobu;3;6;3;9;0
1cf7194e0cda863a75318bfac66cc9e3acebf534;Fri Nov 05 03:18:03 EDT 2010;Committer;nobu;2;7;1;8;0
12ae5bb8929ba607b723702233eb814e953b4991;Fri Nov 05 02:58:39 EDT 2010;Committer;kazu;1;5;5;10;0
d0553ffbb53c10ff5354d063c4c4d15348fe955e;Thu Nov 04 16:21:38 EDT 2010;Committer;nobu;4;55;7;62;0
ee388f6ee2790908dffbb4b20d7d1d43b8ddb38a;Thu Nov 04 15:39:07 EDT 2010;Committer;nobu;3;29;0;29;0
e2a62c218c9abcd0759d176e9865920fad8f8d9d;Thu Nov 04 15:26:18 EDT 2010;Committer;nobu;1;1;1;2;0
2ff053749339dabb4e7fc47ac6c4188556b14a7d;Thu Nov 04 15:15:42 EDT 2010;Committer;svn;1;2;2;4;0
8c196cfba84b945bfabb819511e92803811977e8;Thu Nov 04 15:15:39 EDT 2010;Committer;tenderlove;2;6;1;7;0
71603f3f011bd47993e3ae0db441916ec2533991;Thu Nov 04 12:06:08 EDT 2010;Committer;ko1;2;21;17;38;0
be4eee217c5630c62e16fb31ae729cf6754ad013;Thu Nov 04 11:51:11 EDT 2010;Committer;ko1;1;8;0;8;0
ad3427002c196abbac9d7a62c4c32b205ecff4dd;Thu Nov 04 11:48:01 EDT 2010;Committer;ko1;1;3;9;12;0
e95b72a1f1817180ef4958bb5f8573459c0c2c33;Thu Nov 04 11:46:26 EDT 2010;Committer;ko1;2;13;6;19;0
ba0143b59138a905eaf5f6a05fb17c81d5882bb2;Thu Nov 04 11:27:09 EDT 2010;Committer;ko1;2;6;2;8;0
3ff23bf9268d98597b14eb3198bc31dc40810841;Thu Nov 04 11:21:44 EDT 2010;Committer;ko1;2;10;5;15;0
08db452620d5e39cf239b5fc82b7fed0a33cce37;Thu Nov 04 11:15:36 EDT 2010;Committer;ko1;2;10;8;18;0
eb691b7cf177e5dfbd0f626146ab7e281f23bf88;Thu Nov 04 01:34:35 EDT 2010;Committer;shyouhei;2;8;0;8;0
d433ec574a3e5afb2c4a35c888ff9b19d15eda3c;Wed Nov 03 17:08:35 EDT 2010;Committer;mame;2;9;0;9;0
ea3c50885d6f1cebfedf6d464a0f410ab795a7d0;Wed Nov 03 17:08:30 EDT 2010;Committer;svn;1;2;2;4;0
a9afb7e5c6c608ba8e996dd5771b1da38ef8a9b3;Wed Nov 03 17:08:25 EDT 2010;Committer;mame;3;14;1;15;0
5098e6f7df107086c5b88196d2dbdd6b9a4e9242;Wed Nov 03 05:24:02 EDT 2010;Committer;nobu;1;1;1;2;0
81567892d0695b095829e3c45cada221fb083cd2;Wed Nov 03 05:23:56 EDT 2010;Committer;nobu;1;3;3;6;0
4ec86dcc5761a3eaca546ffe121c9d03d7e1e0cd;Wed Nov 03 05:17:25 EDT 2010;Committer;nobu;3;21;1;22;0
742d440cba11e4c4a72f6b8d1bbaadc207553243;Wed Nov 03 05:13:54 EDT 2010;Committer;nobu;3;20;1;21;0
f6b2490fdb7d30d0c4ab37d63801f969c1aad4d5;Wed Nov 03 01:01:12 EDT 2010;Committer;ko1;4;11;78;89;0
2d189f672b21968ef9dbd27a2bddcfea146595c1;Tue Nov 02 22:50:31 EDT 2010;Committer;matz;2;6;1;7;0
d295957957c828588a8ca3c7b8619c7a93be6b5c;Tue Nov 02 22:37:08 EDT 2010;Committer;akr;2;8;0;8;0
3d2e701396d014fa1aff49e3441ab1cf0ab63fd7;Tue Nov 02 21:25:27 EDT 2010;Committer;tenderlove;3;11;9;20;0
d5b2de3af1dd52ae9104fbd00cd352c6248e4a82;Tue Nov 02 21:25:15 EDT 2010;Committer;svn;1;2;2;4;0
ad9aa5368fb6a34294fb9cd4e48aed3bae244dbf;Tue Nov 02 21:24:54 EDT 2010;Committer;tenderlove;2;16;10;26;0
8114da9e6be525e0d4bd5107f8f2aa97c5560bc6;Tue Nov 02 12:47:18 EDT 2010;Committer;kou;2;5;1;6;0
76bce610c73e952ce3fe9826dbb6d1cd34fb4774;Tue Nov 02 11:13:47 EDT 2010;Committer;arton;2;6;0;6;0
39f3eb153bf85b8c75307398be924c1c57c4981d;Mon Nov 01 15:27:01 EDT 2010;Committer;svn;1;2;2;4;0
f6150aa7df1edf951d4efca5d06d4e0f687bb47f;Mon Nov 01 15:26:58 EDT 2010;Committer;usa;2;6;1;7;0
83c5219287937d3dffe60ebd85a5c1f808006238;Mon Nov 01 12:43:59 EDT 2010;Committer;shyouhei;2;15;0;15;0
93880659c00b33c6429f6b9cd7a15ff9ee499a70;Sun Oct 31 15:41:16 EDT 2010;Committer;svn;1;3;3;6;0
7b0d48c1fad4185f7d72ce469c296068474389c4;Sun Oct 31 15:41:14 EDT 2010;Committer;ko1;2;43;42;85;0
5eced07cd74dbe76207ace5b04b58068a34ad192;Sun Oct 31 13:32:13 EDT 2010;Committer;nobu;2;5;1;6;0
a2c4b890be2004660db6e595040a8918423984a7;Sun Oct 31 13:24:19 EDT 2010;Committer;nobu;2;20;14;34;0
f6003894b91987f309cfd0164561db86d5eaa82c;Sun Oct 31 13:11:02 EDT 2010;Committer;nobu;5;27;13;40;0
fa98c5752d1f6624a7cdf272606a06fb109ea4a9;Sun Oct 31 01:42:58 EDT 2010;Committer;svn;1;2;2;4;0
b76fd8283aa28794c082c61615b57bc0e80acdc7;Sun Oct 31 01:42:54 EDT 2010;Committer;ko1;6;110;72;182;0
2b82e06aaf112d8ebb48c5424940cb08e738d9b4;Sat Oct 30 14:39:20 EDT 2010;Committer;kou;2;49;46;95;0
994f066f76857a781f8819b8da2c2aeceedbf87b;Sat Oct 30 12:10:56 EDT 2010;Committer;kou;28;126;489;615;0
767fe5170d97461be5c79936b467dee3d4eb7179;Sat Oct 30 08:23:40 EDT 2010;Committer;nobu;3;41;14;55;0
bd7daa5ac5923692eb145d8f989efde689101d00;Sat Oct 30 06:39:53 EDT 2010;Committer;nobu;1;14;14;28;0
f46689f68ff14275c3758bea5c726877cb8000fd;Sat Oct 30 05:37:43 EDT 2010;Committer;nobu;3;29;4;33;0
d78e20912fd47e600e6c6bf2fcdb6e2e6593f298;Sat Oct 30 02:33:59 EDT 2010;Committer;nobu;3;13;2;15;0
af859f8d549e1aea04141e36aaf7070fd66dcc9a;Sat Oct 30 01:25:41 EDT 2010;Committer;marcandre;2;8;3;11;0
786e4ce25ace9d5630245fe05c7d94fb8a3c59e3;Sat Oct 30 00:40:56 EDT 2010;Committer;nobu;3;10;7;17;0
6c416e96f079927aba69118820e75d72ab0aa8b1;Sat Oct 30 00:09:42 EDT 2010;Committer;nobu;1;7;0;7;0
6b48289bb737b820d2b0315baee284bcf5ce3253;Sat Oct 30 00:08:30 EDT 2010;Committer;nobu;2;8;5;13;0
4e11a8997decc2dfbea5daad5108d1301f287e53;Fri Oct 29 23:50:57 EDT 2010;Committer;nobu;1;52;52;104;0
aeab9011fef77ea09786818a01a684c5f8adbd4a;Fri Oct 29 22:02:39 EDT 2010;Committer;akr;3;9;4;13;0
fea0365dea00cf7a120c07b76f9cc47c2d66e105;Fri Oct 29 21:40:09 EDT 2010;Committer;akr;2;9;0;9;0
2bb96458e7da360b82519745e607bfa89ae00dc4;Fri Oct 29 21:01:53 EDT 2010;Committer;akr;2;25;3;28;0
340bb04efe438e10a972c3d159451636b69ead1e;Fri Oct 29 15:36:33 EDT 2010;Committer;ko1;2;6;1;7;0
031488962744356a1c1531d3d8f19ff19f4b3120;Fri Oct 29 15:29:20 EDT 2010;Committer;svn;1;2;2;4;0
0a0c6572856431d822e76348bd2c0f0933b537e0;Fri Oct 29 15:29:16 EDT 2010;Committer;ko1;2;9;0;9;0
32623a16276b8c99a8c142c570cb2f50dc3df737;Fri Oct 29 14:35:53 EDT 2010;Committer;ko1;3;64;0;64;0
f85b841a012bb07e4b5b22a792974d7d929a091d;Fri Oct 29 01:03:21 EDT 2010;Committer;naruse;6;2464;426;2890;0
84b86f106f22e8a719541b92842acde1cea59294;Thu Oct 28 22:18:51 EDT 2010;Committer;kazu;1;4;4;8;0
8121a4f5a856b94345f68dd60a8873afc5d1620f;Thu Oct 28 20:23:21 EDT 2010;Committer;ko1;3;44;15;59;0
8bf968ff052df72167e7354f74fc81214050ec4a;Thu Oct 28 18:04:28 EDT 2010;Committer;svn;1;2;2;4;0
30ab36c7dc743d584a1534c5695ba37fbfb1c78e;Thu Oct 28 18:04:23 EDT 2010;Committer;nobu;3;23;5;28;0
87c0b99446b0aa2265e25d0cf06ba5676e1683a9;Thu Oct 28 14:34:06 EDT 2010;Committer;ko1;2;6;1;7;0
fc9176ac0e0edd4ba35059768cb2c1bdd3ec529b;Thu Oct 28 11:14:05 EDT 2010;Committer;naruse;7;6752;4926;11678;0
64bd18c58832e5cac9cb74cade92d1861e64f8dd;Thu Oct 28 11:07:25 EDT 2010;Committer;naruse;2;6;1;7;0
dde59a7cd4c2051e4320121313508c5422f72557;Thu Oct 28 05:30:16 EDT 2010;Committer;naruse;1;1;1;2;0
a671a06d2574ef888018081ed29bb80851a086f7;Thu Oct 28 04:53:57 EDT 2010;Committer;naruse;2;10;2;12;0
492d120877e6687fa27d68c3bb17f776d14340fc;Wed Oct 27 19:02:24 EDT 2010;Committer;ko1;3;69;1;70;0
8f709e143a80d823e7acf3cdd761cc8dc0748689;Wed Oct 27 18:16:46 EDT 2010;Committer;svn;1;2;2;4;0
b36aa7af03a481fc1f41533256a78946498ba0ae;Wed Oct 27 18:16:39 EDT 2010;Committer;ko1;3;69;3;72;0
430c1d3fe4d107e141676fedf56ace98221b3b99;Wed Oct 27 14:55:31 EDT 2010;Committer;nobu;2;5;0;5;0
5cf605b1d2769239de77fe9836cbd320b4482257;Wed Oct 27 09:54:27 EDT 2010;Committer;usa;2;11;3;14;0
7a5d45fc3c0fd7644a6025367f299ee344e62ee7;Wed Oct 27 09:28:08 EDT 2010;Committer;usa;3;15;8;23;0
1503e320d9ab33da37f79242fa30b780bd8835d5;Wed Oct 27 09:15:02 EDT 2010;Committer;usa;2;8;4;12;0
f30e1877b2402f9a92c6c1db12fed05b88ebaba1;Wed Oct 27 06:08:37 EDT 2010;Committer;usa;2;9;2;11;0
c265d57595a1d799c433de2422aeaa22f7ab5706;Wed Oct 27 05:56:01 EDT 2010;Committer;usa;1;2;2;4;0
a012bf6ed432028dd3fe8fc75dc7451c23407151;Wed Oct 27 04:53:34 EDT 2010;Committer;usa;3;48;7;55;0
6223582f2a114f89642ba22daec25b3976b4ae51;Wed Oct 27 03:06:27 EDT 2010;Committer;usa;2;5;0;5;0
6ef1aa79644736cbfef51a788750741db300c976;Wed Oct 27 03:00:26 EDT 2010;Committer;usa;2;6;1;7;0
bb2dc7e98693ad0c27c21d02f8ffd049fa2589a4;Wed Oct 27 00:26:29 EDT 2010;Committer;naruse;2;33;21;54;0
b88c9aa1fe0ec07db14544939f9001d66de1bd0a;Tue Oct 26 17:27:44 EDT 2010;Committer;mame;5;89;1;90;0
a11576816197d75fa17d959e74cabb612ba8b8be;Tue Oct 26 17:27:32 EDT 2010;Committer;mame;8;116;18;134;0
e169ea0cacc981c506f75a2d3e093558e599d21d;Tue Oct 26 17:27:24 EDT 2010;Committer;svn;1;2;2;4;0
2285a8d813814e936484d302dacf1ff39e40e33c;Tue Oct 26 17:27:21 EDT 2010;Committer;mame;7;78;40;118;0
6ca3ad34a044f48fa25d250076f5e8c9c8810b38;Tue Oct 26 12:39:33 EDT 2010;Committer;naruse;2;7;0;7;0
767d70841a998c16a7487f9b286a9a944f69e7b7;Tue Oct 26 09:09:45 EDT 2010;Committer;nobu;5;60;3;63;0
67d7448fca92474e2701e4ca973c03dbb06b4690;Tue Oct 26 09:09:39 EDT 2010;Committer;nobu;1;8;2;10;0
51d25ca8c0eb7da192f5bdf2729fc856e8f81a9d;Tue Oct 26 09:04:59 EDT 2010;Committer;nobu;2;6;1;7;0
749ad16aa7015438a12686556d4567a7b295f27a;Tue Oct 26 03:47:15 EDT 2010;Committer;nobu;5;22;3;25;0
fd74e1414c76288af00b47517144244134e40cc4;Tue Oct 26 03:44:56 EDT 2010;Committer;nobu;1;1;0;1;0
7b410abfb8e976a78f7f9a7139ad5140a67b41ad;Tue Oct 26 00:13:37 EDT 2010;Committer;nobu;3;19;1;20;0
3ea90fc38e6fa8c4f60539dba2185270dd45c792;Mon Oct 25 23:46:27 EDT 2010;Committer;nobu;1;1;1;2;0
4d9a6ab181225f091ebcdf6b8ddb9b2bc75260fd;Mon Oct 25 15:29:32 EDT 2010;Committer;nobu;6;67;2;69;0
a6ed06e51306ffe7311640040dade563419cb953;Mon Oct 25 07:57:51 EDT 2010;Committer;shyouhei;1;2;2;4;0
2c770d676c4089d7f57abb9ed885d3e458ba6b39;Mon Oct 25 07:46:53 EDT 2010;Committer;shyouhei;2;22;0;22;0
0d78d991caa9aed8ff3db19586dcf2ac6c3a7fe6;Mon Oct 25 00:34:14 EDT 2010;Committer;nobu;1;1;1;2;0
bbf0fd4e9c9b1efa6b1bf9c8d3eda4c893798220;Sun Oct 24 21:21:40 EDT 2010;Committer;nobu;3;12;1;13;0
df26e9d44e5c4555b5e42f593ab6afe50503f1d6;Sun Oct 24 18:00:20 EDT 2010;Committer;ko1;2;10;0;10;0
7bbea01a5ac3103891deb075ca02f6d078548a8f;Sun Oct 24 15:30:30 EDT 2010;Committer;svn;1;2;2;4;0
4fcd5e3fc14e773999d750c515ebf240c8a87807;Sun Oct 24 15:30:25 EDT 2010;Committer;tadf;2;22;33;55;0
23e8deaf0d4d44746d838489cc112c5fc4684402;Sun Oct 24 08:14:05 EDT 2010;Committer;nobu;12;29;58;87;0
58d3597e743967bb4c486b108e7dcd0db5c3efca;Sun Oct 24 08:05:55 EDT 2010;Committer;nobu;3;24;1;25;0
5383964f98659ea0cd371d77b9ed97f46702e591;Sun Oct 24 06:16:36 EDT 2010;Committer;nobu;2;11;1;12;0
b560b080145a477d5d8a00d7e403248b1609cfa1;Sun Oct 24 05:18:12 EDT 2010;Committer;nobu;2;6;1;7;0
071e1ba1f86211d742e43a67bc5e106b5a69cddf;Sun Oct 24 05:13:55 EDT 2010;Committer;nobu;2;14;2;16;0
98ac9b866747306edd7cd9437d74c7af51a3a9da;Sun Oct 24 05:11:26 EDT 2010;Committer;nobu;3;7;1;8;0
8a40d614a3aca6e1ef0c2fec439bf6661466f282;Sun Oct 24 03:11:20 EDT 2010;Committer;tenderlove;2;38;32;70;0
4e3fda080c9186193e1fcc9c843d05f995629c2d;Sat Oct 23 15:25:20 EDT 2010;Committer;nobu;3;9;4;13;0
c2fdd98eb054fb5825061782ae610551ee00840c;Sat Oct 23 05:40:11 EDT 2010;Committer;nobu;3;6;2;8;0
874ab2e63985f8bd920ad8aa55f5320d6361813a;Sat Oct 23 02:02:56 EDT 2010;Committer;svn;1;2;2;4;0
3bd7384c76c439a80a7b2157888edb3d132c8cf2;Sat Oct 23 02:02:50 EDT 2010;Committer;ko1;2;47;4;51;0
cb9ffb8d1cc1a784674e0f1594582b1406547dbd;Fri Oct 22 05:50:17 EDT 2010;Committer;nobu;2;10;2;12;0
e1d15712565ef38f7acd605dc1aafb3884b6a008;Fri Oct 22 05:10:40 EDT 2010;Committer;naruse;2;6;1;7;0
b3ee43bb6ea50fd45e7e84c5d8e84452b9fc93c8;Thu Oct 21 21:15:06 EDT 2010;Committer;ryan;1;6;4;10;0
c400795c8cf9668fc11db369e42876974c20ec6f;Thu Oct 21 15:03:58 EDT 2010;Committer;svn;1;2;2;4;0
e923b67707d05f0ab55885cf94037fd9aab75876;Thu Oct 21 15:03:56 EDT 2010;Committer;ko1;2;6;1;7;0
e5db83ec65775cae80275a7a3771bb3b7b9bb205;Thu Oct 21 14:56:55 EDT 2010;Committer;nobu;2;18;10;28;0
48b4512f76aa3b2a7db3a1a904769d9e9cbbd58c;Thu Oct 21 14:52:02 EDT 2010;Committer;nobu;2;5;1;6;0
125b4b702089d65e74bc3f0d68b8a7ed41f4e39f;Thu Oct 21 14:47:13 EDT 2010;Committer;nobu;2;5;5;10;0
f1dc85e237e4d1aa83f451ef4f85d3f7b8200d4a;Thu Oct 21 07:09:17 EDT 2010;Committer;naruse;2;52;16;68;0
f3fb1954eb010b73b20f1a5c04975dfbc383f237;Thu Oct 21 06:56:17 EDT 2010;Committer;naruse;2;7;0;7;0
d835a87cc1afff63764b2b952cd397190c8623ab;Thu Oct 21 06:51:49 EDT 2010;Committer;naruse;2;22;7;29;0
0d5a81f497653d5ab5ea75591e900a951a825d81;Thu Oct 21 06:45:33 EDT 2010;Committer;naruse;2;9;0;9;0
a29dc5676415163b0e2416a07de4a9d8055a4670;Thu Oct 21 04:18:09 EDT 2010;Committer;nari;2;75;30;105;0
4c962daa2d1679b9685e984fe04eef521007aa3e;Wed Oct 20 20:01:33 EDT 2010;Committer;ryan;1;5;0;5;0
24181da2c55a2df3ba99b6eab079d905a2507545;Wed Oct 20 15:05:48 EDT 2010;Committer;nobu;4;609;456;1065;0
d8dfba24bb82fa66f19197e94eb555c58ddc56fd;Wed Oct 20 14:54:40 EDT 2010;Committer;nobu;2;284;1;285;0
05ba0b1dd52193c57c149115839f81e929b11626;Wed Oct 20 01:48:24 EDT 2010;Committer;naruse;3;11;4;15;0
9e14a3fa1d851525374a4bb0b3d1100f2e88a297;Wed Oct 20 01:03:23 EDT 2010;Committer;svn;1;2;2;4;0
e9240114a0e8114823c9d0227b4315f71349828c;Wed Oct 20 01:03:18 EDT 2010;Committer;naruse;3;14;7;21;0
fb796561f0b601148c7b242ad1a3e847ef60e3c9;Tue Oct 19 10:34:13 EDT 2010;Committer;naruse;3;8;0;8;0
73057fb85bb00d57e9c8056437d4284a5bf8ade6;Tue Oct 19 03:26:35 EDT 2010;Committer;nobu;1;4;2;6;0
671b498070c0fa33fa6afaf4f4672441ae61661a;Tue Oct 19 03:25:29 EDT 2010;Committer;nobu;13;59;160;219;0
12cbb588193ac5148b6421fc8953c817acb0ae9f;Tue Oct 19 03:22:03 EDT 2010;Committer;nobu;13;160;59;219;0
c511d26f6ae87f16956fe40fe5a5cfb6b66811b2;Tue Oct 19 03:19:30 EDT 2010;Committer;nobu;3;7;2;9;0
da55cfdf724beccb3fcfddf0ce318f9fb1b36c85;Mon Oct 18 18:08:58 EDT 2010;Committer;nobu;4;21;8;29;0
81e40399fb33bdb0b942893a7251dd12b9f46c28;Mon Oct 18 06:42:01 EDT 2010;Committer;naruse;2;8;0;8;0
799f4754c95f98c6423878d70badfb609f32f2bc;Mon Oct 18 06:33:50 EDT 2010;Committer;naruse;3;12;32;44;0
74cacd0df4e6c6a504969d7eb10e76676a607fa3;Mon Oct 18 04:26:06 EDT 2010;Committer;knu;3;19;0;19;0
0a8d8b8a684dc66669c6b2add3637c78673a97fe;Mon Oct 18 04:12:35 EDT 2010;Committer;naruse;3;28;13;41;0
b2556b548104edc594b10af20982fa23bc3ce928;Mon Oct 18 03:59:53 EDT 2010;Committer;akr;2;31;30;61;0
35388369dc5343d71794598edb79593f13cbc06b;Mon Oct 18 01:53:41 EDT 2010;Committer;naruse;1;1;1;2;0
b1361d5be1446a70ae2119b0aeba761bc667f70c;Mon Oct 18 01:20:37 EDT 2010;Committer;naruse;2;6;1;7;0
c0e6dab0b7c6d001f5675056972ddfa1db3b9504;Mon Oct 18 00:59:36 EDT 2010;Committer;svn;1;2;2;4;0
a7e8b12f96bcea99a855092e4b200ddfed6c8c41;Mon Oct 18 00:59:31 EDT 2010;Committer;naruse;3;15;0;15;0
d41305b393d1aa33a93dcad15ee1424e24a1a737;Sun Oct 17 13:37:38 EDT 2010;Committer;tadf;2;6;2;8;0
f3a72d49059f79b87e3363ab1288d5297513c5ef;Sun Oct 17 01:47:15 EDT 2010;Committer;nobu;2;9;2;11;0
137d82569f961a908daa0331a0664a0eca3e8f93;Sun Oct 17 01:40:22 EDT 2010;Committer;nobu;4;13;2;15;0
59a88b94f031ff9da31fa0206ddcf7490cf49836;Sat Oct 16 02:14:32 EDT 2010;Committer;suke;2;7;2;9;0
835a5edf52c2ffd321678aba45264f6be42fcd35;Sat Oct 16 01:55:01 EDT 2010;Committer;nobu;3;11;2;13;0
7e0920723c0915673bcb52e1d4f4f3338ad68697;Sat Oct 16 01:06:13 EDT 2010;Committer;nobu;3;23;7;30;0
92a7cf0455f716b7e5031d1a9ee60b14c3bef92a;Fri Oct 15 23:39:16 EDT 2010;Committer;nobu;2;11;4;15;0
d2623b2281e9a2d8b9d751fc9816765f3960e5f8;Fri Oct 15 23:39:11 EDT 2010;Committer;nobu;1;3;3;6;0
22a957a08091d585ef174b35d826673c90e2602c;Fri Oct 15 15:10:20 EDT 2010;Committer;svn;1;2;2;4;0
261661517af17df2cb8602594ab263b25c39132c;Fri Oct 15 15:10:17 EDT 2010;Committer;ko1;2;13;1;14;0
efddc4b63276e19e25fe06d4e2530aae7e1453b8;Fri Oct 15 14:56:47 EDT 2010;Committer;nobu;1;1;0;1;0
ba8dc58ebbc5a225ffe6788c29ffdd0442b30e67;Fri Oct 15 14:36:28 EDT 2010;Committer;nobu;2;15;0;15;0
e8e2ea4866729544943438b1bef072891e3adc30;Fri Oct 15 14:11:26 EDT 2010;Committer;nobu;1;1;1;2;0
12dc1ffd47cf5e368fb30fe77868b40f8c94c718;Fri Oct 15 13:55:47 EDT 2010;Committer;suke;2;15;3;18;0
8a4966d133452682086270b719e93fadf69cd266;Fri Oct 15 13:47:38 EDT 2010;Committer;nobu;2;9;2;11;0
a45936d454104b1d1e7ea663f1580339ce1f1071;Fri Oct 15 11:30:33 EDT 2010;Committer;nobu;3;9;11;20;0
8a0cd16de1b523fa80ec0e02ae7f114d28fa41b7;Fri Oct 15 08:31:58 EDT 2010;Committer;naruse;4;14;19;33;0
6a443e2eb2ce6dcde4d01be4a48fd1158dc96356;Fri Oct 15 08:28:18 EDT 2010;Committer;naruse;2;9;2;11;0
a160986d90cf90a86e01d60eddb04ffe0e584c36;Fri Oct 15 08:28:12 EDT 2010;Committer;naruse;4;19;14;33;0
ccaf61d5aff59f5e11a772c4f9bd0d1c10232e25;Fri Oct 15 07:42:21 EDT 2010;Committer;naruse;3;11;2;13;0
dfd139b81977bd9405b497f9eced411d3334886d;Fri Oct 15 07:35:52 EDT 2010;Committer;svn;1;2;2;4;0
0751cca16d9e8d4ef0903709cd839e8e585be575;Fri Oct 15 07:35:50 EDT 2010;Committer;naruse;1;40;8;48;0
22c791e16375e036a20401bcbf291dbf93a24c24;Thu Oct 14 14:23:03 EDT 2010;Committer;suke;2;20;47;67;0
559fd3e439194bbc8d55cae30c8c1ba13832c8e8;Thu Oct 14 13:19:30 EDT 2010;Committer;ko1;4;26;21;47;0
5825359dd87a26d5daf7a604583baa0ab48cc543;Thu Oct 14 13:12:56 EDT 2010;Committer;naruse;4;160;83;243;0
b1085abaeb5f19dd76ac5650c9c8ec50c1e4db02;Thu Oct 14 11:56:10 EDT 2010;Committer;suke;3;19;1;20;0
694826d7e2c75e4960b317a475110903458e3c17;Thu Oct 14 00:09:07 EDT 2010;Committer;naruse;1;3;3;6;0
51427700cc7da46430f0873f4d3b3478016786d9;Wed Oct 13 23:09:56 EDT 2010;Committer;naruse;3;29;5;34;0
7735e63593a4bef31c0c573e793eec5474b4bac1;Wed Oct 13 22:22:18 EDT 2010;Committer;nobu;5;35;29;64;0
421076be676005a59f2f47fc0d3da6ecebe85db1;Wed Oct 13 19:17:51 EDT 2010;Committer;svn;1;2;2;4;0
ded94d1c8ca7b318aad0c92ca290d1b6b2f3814d;Wed Oct 13 19:17:49 EDT 2010;Committer;naruse;4;23;5;28;0
b238a3f3fdb575749121f35bbf37bfc1baed050c;Wed Oct 13 14:16:49 EDT 2010;Committer;nobu;6;8;1;9;0
e0a7c207ffd386f5c4d270755817e4d7a4735c96;Wed Oct 13 14:08:29 EDT 2010;Committer;nobu;1;1;1;2;0
e69bba13a0d064bfda1dbcfd27ef07e21bf70bb6;Wed Oct 13 14:07:22 EDT 2010;Committer;nobu;3;9;5;14;0
9d0c732f0d6bd6927a8385c12312d9e054712958;Wed Oct 13 13:53:22 EDT 2010;Committer;nobu;2;4;2;6;0
dc647aea2ea83622e22b94b11df60b18d6e3c31b;Wed Oct 13 13:51:20 EDT 2010;Committer;nobu;2;6;2;8;0
fc6d58ccc469e07e7a2ef89942014a23303206eb;Wed Oct 13 13:39:13 EDT 2010;Committer;xibbar;3;7;1;8;0
74dcda0d418c5a5eb27047cd0e4a2bf04b637834;Wed Oct 13 12:13:53 EDT 2010;Committer;naruse;2;14;1;15;0
7724d1363582b00a322e402e220737d313fe2c0b;Wed Oct 13 10:28:25 EDT 2010;Committer;shyouhei;2;7;3;10;0
e79fbf3dfef38883a4173b4d1a58448343407f2f;Wed Oct 13 05:58:35 EDT 2010;Committer;naruse;2;9;2;11;0
a01e62831818ed1c8c00e79991b8f34c02327127;Wed Oct 13 03:56:31 EDT 2010;Committer;naruse;3;47;5;52;0
acd98555b59522b8f81b8feff70964e92adb902f;Wed Oct 13 03:36:20 EDT 2010;Committer;akr;2;5;3;8;0
c94c6a1a1604f24f8388463849094676dac49568;Wed Oct 13 03:10:49 EDT 2010;Committer;usa;2;20;7;27;0
8022385ba4d7031031372846d62d686422c108ed;Wed Oct 13 02:04:10 EDT 2010;Committer;nobu;4;13;13;26;0
5ba5d4c889a4f80f39be65d52746e4528b6f20e2;Wed Oct 13 01:52:54 EDT 2010;Committer;nobu;2;5;0;5;0
82ff894c047f0ae130e457b74235cd5e861c0404;Wed Oct 13 00:27:41 EDT 2010;Committer;naruse;1;4;4;8;0
769f5fc41cbc2e32f757a4e26e4ad7f2920e1671;Tue Oct 12 21:04:35 EDT 2010;Committer;naruse;1;9;2;11;0
0ba69794c683d53cbcf1d5500828a20f2bef8970;Tue Oct 12 20:54:29 EDT 2010;Committer;naruse;1;1;1;2;0
e7413bc6ecdff9751394ceeb37911beda4ca738a;Tue Oct 12 20:23:53 EDT 2010;Committer;naruse;3;10;0;10;0
2d4e8b4e22e966f2da9dd8bb9ea0b008e0d1d26c;Tue Oct 12 15:21:20 EDT 2010;Committer;nobu;2;21;11;32;0
537d7ff1407390ef1b89ba32f0c418e1a1266dde;Tue Oct 12 15:18:22 EDT 2010;Committer;nobu;2;8;4;12;0
a176b065d2e19f64c7425c2928829f5280532cce;Tue Oct 12 15:10:04 EDT 2010;Committer;nobu;2;2;2;4;0
cea3919ae61ae16e04a5ee5c5394970c3960a0af;Tue Oct 12 15:03:51 EDT 2010;Committer;nobu;11;41;18;59;0
150b4efa5510d77fdde7b9692b3c391fbde6ac19;Tue Oct 12 14:58:23 EDT 2010;Committer;nobu;2;22;13;35;0
85d1cba8830add63579f10b8638fed525c675bd1;Tue Oct 12 14:55:14 EDT 2010;Committer;nobu;2;4;2;6;0
2f0b8e2793b384146cc042decdd483e8331f86f9;Tue Oct 12 14:54:06 EDT 2010;Committer;nobu;2;4;2;6;0
b736c9b5dcdda56597a1b28bae11762f8042fee5;Tue Oct 12 14:54:02 EDT 2010;Committer;nobu;1;1;1;2;0
abd94c3376f9060464cc4e948071002d0f9d17ac;Tue Oct 12 14:53:59 EDT 2010;Committer;nobu;1;3;2;5;0
d410639a6d422e0ae032f049ccfbbbb45b312d6f;Tue Oct 12 14:47:23 EDT 2010;Committer;nobu;13;73;40;113;0
17c48bebf87828abeb5be91ed8ba0a2b72bc5479;Tue Oct 12 14:35:40 EDT 2010;Committer;nobu;5;13;9;22;0
3c24bea4b5bfa33b3dddde688638cc2892f9512c;Tue Oct 12 14:09:27 EDT 2010;Committer;nobu;2;6;3;9;0
0172f3181ff592f3ce20b5a04c1eff603f48f557;Tue Oct 12 14:03:24 EDT 2010;Committer;nobu;2;11;6;17;0
f5bcc56bcd3ca55131d5d766f953c5d52b2924cc;Tue Oct 12 13:41:12 EDT 2010;Committer;nobu;2;5;3;8;0
4fe1e7c69b3767737ac4936d7634f9dd8d7a61dd;Tue Oct 12 13:18:21 EDT 2010;Committer;nobu;2;6;1;7;0
681e551369c83d3dbca368e0e6db1cc875f2d8a2;Tue Oct 12 12:39:22 EDT 2010;Committer;naruse;2;14;4;18;0
628c802eae8cb2807c283f2bab2ca7bcb115ecdd;Tue Oct 12 10:09:31 EDT 2010;Committer;naruse;2;6;0;6;0
b487f7881fd220a13313ebeb3968f17d45bb2b23;Tue Oct 12 09:30:42 EDT 2010;Committer;naruse;2;5;2;7;0
1e22306569e43251f946145ab49662ee6fe76151;Tue Oct 12 09:25:33 EDT 2010;Committer;naruse;3;14;16;30;0
2d8612e9666a9fb0ddf240b2920dc4cf69632ad8;Tue Oct 12 08:56:00 EDT 2010;Committer;naruse;2;6;2;8;0
232257238acfaf3c34f3e6c4b2d6e1200fd217e8;Tue Oct 12 08:50:30 EDT 2010;Committer;naruse;2;16;8;24;0
fb44f02aa11674b5754f1053d40797ab6973b41d;Tue Oct 12 07:05:56 EDT 2010;Committer;usa;2;10;0;10;0
cba4cda71d66a12eeba28b3614b97669218e221c;Tue Oct 12 06:54:52 EDT 2010;Committer;usa;2;21;0;21;0
7587eb706a593f1728fcc0f3c4480856159e5d2a;Tue Oct 12 06:37:27 EDT 2010;Committer;naruse;3;34;5;39;0
0a8f047a983deaf853e8ddc9f70da78f3a83f9ef;Tue Oct 12 06:18:11 EDT 2010;Committer;naruse;4;28;3;31;0
e960fffda106cc1689b10fca54f99e7a8555bb6f;Tue Oct 12 06:18:08 EDT 2010;Committer;naruse;3;25;11;36;0
6913b2734a80fab9dffea70f573555d96b45e226;Tue Oct 12 05:14:23 EDT 2010;Committer;naruse;3;10;3;13;0
243831cd37bd6bb6504eba062c5b0e02bb69711f;Tue Oct 12 03:22:13 EDT 2010;Committer;usa;2;6;2;8;0
83906099d06f8d7a4fc4d87f4b2b69cd989cb0bc;Tue Oct 12 01:39:11 EDT 2010;Committer;nobu;3;7;3;10;0
3f34ecc536f6b569774e2c41702cf70020d962b6;Mon Oct 11 11:23:35 EDT 2010;Committer;naruse;2;7;1;8;0
c1b24588d378ae1d976ebd1521f2d9083214f9e7;Mon Oct 11 08:43:31 EDT 2010;Committer;naruse;2;14;1;15;0
44691b901e4d93debf64af33d4349662553e61e5;Mon Oct 11 05:15:03 EDT 2010;Committer;naruse;3;10;0;10;0
47cb5a93e50c26114434dddb3008e5e4912a76f5;Sun Oct 10 21:54:22 EDT 2010;Committer;naruse;3;30;7;37;0
6221ba109c9ae7ce8f752f1d35703c3f0cb07c0f;Sun Oct 10 21:29:31 EDT 2010;Committer;svn;1;2;2;4;0
e1646652e734f383fc61db94407c8e495807aab4;Sun Oct 10 21:29:29 EDT 2010;Committer;naruse;2;11;1;12;0
72ef219804e5524848170a197887a95718334e2a;Sun Oct 10 09:45:36 EDT 2010;Committer;knu;2;6;2;8;0
3ec721b9c2a382185b76ebadef317c85e85d9558;Sun Oct 10 01:20:11 EDT 2010;Committer;nobu;2;13;3;16;0
ff6ce776cb5e991a6c90d8a39d9d908f11d1466e;Sat Oct 09 20:33:21 EDT 2010;Committer;nobu;4;9;7;16;0
0ac2f9513fd1c75983d6214241aac2073ab5adf5;Sat Oct 09 07:54:42 EDT 2010;Committer;nobu;2;6;1;7;0
fd17a9092f18e67212f2e1af38cf49e6d872cb6b;Sat Oct 09 07:14:57 EDT 2010;Committer;kazu;1;3;3;6;0
549b0c53a8b744c12dfeaed14bbb3d390209f516;Sat Oct 09 02:00:21 EDT 2010;Committer;nobu;3;124;17;141;0
c3032fa749594900b130593481b40b9c34c9076b;Sat Oct 09 01:51:19 EDT 2010;Committer;nobu;2;73;24;97;0
88533a5351c302a5d67a506a63db1b199244d143;Fri Oct 08 23:16:20 EDT 2010;Committer;nobu;3;10;6;16;0
9c06fa133e0826bea96c1c80cddc92151ddd535b;Fri Oct 08 01:54:41 EDT 2010;Committer;nobu;1;2;0;2;0
a1d7e6910606b237248fa95f011873ff86fa8c28;Fri Oct 08 01:52:37 EDT 2010;Committer;nobu;4;6;8;14;0
b6c817e3c607b6312d20fb3b85aa68983fdd79b8;Thu Oct 07 15:25:25 EDT 2010;Committer;svn;1;2;2;4;0
b6e0e981172f7070581a31aa9155d67fc7717055;Thu Oct 07 15:25:23 EDT 2010;Committer;jeg2;2;8;4;12;0
0dd56a828eb4cb6840a5bba83a2c59adbbe6c8d9;Thu Oct 07 09:10:47 EDT 2010;Committer;nobu;3;8;2;10;0
9b158969594f3a87701da97feb106ded14669a79;Thu Oct 07 00:48:05 EDT 2010;Committer;svn;1;2;2;4;0
fba68f4c31d636e557c4264527ad880e7fedfc27;Thu Oct 07 00:48:03 EDT 2010;Committer;naruse;2;8;3;11;0
4f8376c655eee5038584e26534457b94f78229f6;Wed Oct 06 03:32:41 EDT 2010;Committer;akr;1;1;1;2;0
e5a47fb60e33aaa730fd913c0cb3a386baf2d9a2;Wed Oct 06 03:31:36 EDT 2010;Committer;akr;1;5;0;5;0
5fd45a4b79dd26f9e7b6dc41142912df911e4d7d;Wed Oct 06 03:30:49 EDT 2010;Committer;akr;5;88;12;100;0
915ae780c37478fea358d6c77513a728e86a10f2;Wed Oct 06 02:52:26 EDT 2010;Committer;nobu;3;45;3;48;0
a413c84e543528d31190f22ecdf1a5f7363cedc9;Wed Oct 06 00:08:46 EDT 2010;Committer;svn;1;2;2;4;0
046a5818bba16444b1046523c972b499f2e5d80e;Wed Oct 06 00:08:44 EDT 2010;Committer;nobu;1;4;0;4;0
cd936ca5abd8ac3f81d368000a41da597540b2bb;Tue Oct 05 13:20:51 EDT 2010;Committer;svn;1;2;2;4;0
349c3c7a8caea17e12286bbde730e5808fc8326e;Tue Oct 05 13:20:49 EDT 2010;Committer;wanabe;2;5;4;9;0
d3dabbca718a64083b154e03227d9f0c099401ff;Mon Oct 04 03:43:50 EDT 2010;Committer;nobu;3;9;1;10;0
25eebc3ad5579b1f1da0e355b2d150769ac9396f;Mon Oct 04 01:24:01 EDT 2010;Committer;naruse;2;6;1;7;0
b259e449d14e47e225960ec0fce12a5b2c1bec6d;Mon Oct 04 01:23:58 EDT 2010;Committer;naruse;3;11;6;17;0
3a633b812e3676d4a1c8f20426d0354be530e056;Mon Oct 04 00:33:22 EDT 2010;Committer;naruse;3;12;1;13;0
eaa4e02d4507ad0658d95403a7a53b78ebb2ed53;Sun Oct 03 23:00:21 EDT 2010;Committer;naruse;2;6;1;7;0
e1d5d4e7f2dce151a2e768d0e2cea38f88185958;Sun Oct 03 22:57:23 EDT 2010;Committer;naruse;5;13;12;25;0
c51e356c680c303fe143ef7aff737e444e55d6b2;Sun Oct 03 21:42:23 EDT 2010;Committer;naruse;2;7;2;9;0
edd008c9cec2888c5de682eb0eafbc0b6769ad34;Sun Oct 03 15:06:26 EDT 2010;Committer;svn;1;2;2;4;0
a21409ff5f3347c3ab79386412d950561d560749;Sun Oct 03 15:06:23 EDT 2010;Committer;wanabe;3;11;29;40;0
65119c75b0fadd63d330af82b066ff11eb3a6091;Sun Oct 03 11:50:21 EDT 2010;Committer;arton;1;1;1;2;0
8cf50c746298fd4b39830b50cf2ea4cadf0972be;Sun Oct 03 11:47:52 EDT 2010;Committer;arton;1;4;0;4;0
4ad4083b164aa92c569a9ae54184ff804cded540;Sun Oct 03 11:45:17 EDT 2010;Committer;arton;1;5;0;5;0
67330643299bdaa16fbccefe8bb49b0929fff5fc;Sun Oct 03 10:44:31 EDT 2010;Committer;svn;1;2;2;4;0
fc8c4690d5117daa9370bfc1ab30bd07387089dc;Sun Oct 03 10:44:30 EDT 2010;Committer;nobu;2;6;0;6;0
8e5c46c8a1cd8551d34f28196be1421e553e8948;Sat Oct 02 14:03:05 EDT 2010;Committer;svn;1;2;2;4;0
cb8deae606fbb84061653061bd776c433aabbe37;Sat Oct 02 14:03:03 EDT 2010;Committer;suke;2;24;0;24;0
0b1bccdb824fb30cd2c4ac2e7bfb4692ce40c8a8;Fri Oct 01 08:04:40 EDT 2010;Committer;svn;1;3;3;6;0
43ce320c4c4b7a06e1153022177f568860c5c6d6;Fri Oct 01 08:04:37 EDT 2010;Committer;shyouhei;2;6;0;6;0
b602f6516fd290a1cf4867b5edc299ed3cbc2241;Thu Sep 30 14:17:31 EDT 2010;Committer;matz;2;28;10;38;0
1fcb7a5ee0f346f755735d349a405eeccf81fc40;Thu Sep 30 07:12:49 EDT 2010;Committer;usa;3;8;2;10;0
85bcd2587794dbe653523847bc01cab4948be2d4;Thu Sep 30 01:57:17 EDT 2010;Committer;usa;2;7;1;8;0
c4087bcb129535303c53a6a0fffaff36b071174b;Thu Sep 30 00:48:01 EDT 2010;Committer;naruse;3;36;18;54;0
652ab6d3a53a09032f944e58367948c1688aedc9;Thu Sep 30 00:35:27 EDT 2010;Committer;svn;1;2;2;4;0
02a0e528f9cfadcf1003121a95039644657cf6df;Thu Sep 30 00:35:23 EDT 2010;Committer;usa;2;9;5;14;0
c637e7b458e0b17dff3c67937b4fe1ba656d656c;Wed Sep 29 12:06:42 EDT 2010;Committer;shyouhei;2;19;10;29;0
7d61b7e13fd848449770f2226a7dc7dbd41fadfd;Wed Sep 29 09:38:31 EDT 2010;Committer;nobu;2;9;4;13;0
3e85e584117f21b7d31e56274da4eb8585a39a9a;Wed Sep 29 08:55:17 EDT 2010;Committer;mrkn;2;10;0;10;0
ecfc868bdb5e43cdb585767006e9df2de575eed2;Wed Sep 29 08:55:11 EDT 2010;Committer;mrkn;3;11;1;12;0
e6ad15393d7733d197394207235716b7cefd36fb;Wed Sep 29 07:18:39 EDT 2010;Committer;usa;2;6;4;10;0
fed832d7f29a9d30b3af9afbe5ab10e515d253e5;Wed Sep 29 04:32:20 EDT 2010;Committer;mrkn;3;16;1;17;0
98d7c2b8f186bb1b036f531465a1e5b006922102;Wed Sep 29 03:48:21 EDT 2010;Committer;usa;2;11;5;16;0
ee1a4eefa531a5c4601ee74b0b1ac1ef8f6921db;Wed Sep 29 03:37:44 EDT 2010;Committer;nobu;1;0;2;2;0
f20f30fc07890b6668daf79494b2e1a875cb7486;Wed Sep 29 03:35:31 EDT 2010;Committer;nobu;2;6;2;8;0
a236e7348bf7788791980687b174e2d562baeb76;Wed Sep 29 03:31:36 EDT 2010;Committer;svn;1;2;2;4;0
510ae756becfc5d3954e39c37e49f9b00691d077;Wed Sep 29 03:31:32 EDT 2010;Committer;nobu;2;5;0;5;0
d2cd8f44712a17ee13a6ac41e6aaf623850f0d51;Tue Sep 28 11:50:29 EDT 2010;Committer;nobu;2;7;2;9;0
85120dc419987680b5799321cfa1ea547c4ae8b8;Tue Sep 28 11:08:58 EDT 2010;Committer;svn;1;2;2;4;0
340997aec7f80aaf489e53b7c4f59b9567016334;Tue Sep 28 11:08:56 EDT 2010;Committer;usa;2;194;5;199;0
86a8b820d636a36ddc49f9c906f5d0744dd3ef23;Mon Sep 27 14:47:30 EDT 2010;Committer;ko1;3;9;33;42;0
93fba33b47524f24b018c09b79a01712a5605093;Mon Sep 27 06:57:39 EDT 2010;Committer;shyouhei;2;19;1;20;0
39ac0609d57fbbd89ddd8f23383edcc64a8a5378;Mon Sep 27 06:29:02 EDT 2010;Committer;svn;1;2;2;4;0
36cfaa805294b1f2d00f3eeadf03c179a387d568;Mon Sep 27 06:28:59 EDT 2010;Committer;shyouhei;3;25;6;31;0
ae9264678cfde7bcc27d20d70c7643d2704a8dbd;Sun Sep 26 13:59:48 EDT 2010;Committer;nobu;2;18;1;19;0
7b77b436f088ca41405390a5b1d55056cb8ac3b7;Sun Sep 26 13:24:52 EDT 2010;Committer;wanabe;5;13;5;18;0
a67600d12b503b52995240f92031eb2ac7079f13;Sun Sep 26 01:25:38 EDT 2010;Committer;svn;1;2;2;4;0
f3bd5ee5bd06c13c42a30658078cdff74dde8fc3;Sun Sep 26 01:25:34 EDT 2010;Committer;nobu;3;103;140;243;0
d3a8adc0dee2fba1b5967f968fa608bceaf9afff;Sat Sep 25 13:48:42 EDT 2010;Committer;nobu;2;6;2;8;0
bab83d26280b3eb5cc563012e8ef603b96f26edf;Sat Sep 25 01:30:52 EDT 2010;Committer;nobu;2;33;1;34;0
4fd8930898802ea8c34a280f71b7bcfdb7560ac4;Sat Sep 25 00:52:20 EDT 2010;Committer;kosaki;2;6;1;7;0
feacd3c2e077e26c266d8f3f6bafad2be71a72d2;Fri Sep 24 16:34:56 EDT 2010;Committer;nobu;4;35;0;35;0
c5d52c3bb35690b1190dc17f8761fb53fa07863c;Fri Sep 24 16:05:44 EDT 2010;Committer;svn;1;2;2;4;0
c81e5864aeec6ea8ece19e33e7984c70bca8b0eb;Fri Sep 24 16:05:43 EDT 2010;Committer;akr;1;1;1;2;0
f5b0cb07e24bddb6c9cef3741cb2d79095ba0e91;Fri Sep 24 14:45:19 EDT 2010;Committer;nobu;6;42;1;43;0
08d2e528aa35ea30087f7e8990e5028f4c2693ab;Fri Sep 24 07:37:26 EDT 2010;Committer;shyouhei;1;7;1;8;0
c49a1d11b99041e5ae2c2ff26cdf589af1a0f280;Fri Sep 24 06:52:25 EDT 2010;Committer;naruse;2;7;2;9;0
955507313be5003ae132bd92344569da9e7218da;Fri Sep 24 06:28:35 EDT 2010;Committer;naruse;2;8;3;11;0
aa836e539f154e49587e48791d44f829d239766b;Fri Sep 24 05:25:55 EDT 2010;Committer;shyouhei;2;31;0;31;0
9da7920d6b3df25509eef26123edc2502c849a1d;Fri Sep 24 00:43:44 EDT 2010;Committer;naruse;1;1;1;2;0
d021b311b8c1a54c08cc4ec98bcb7e2e93a9320a;Thu Sep 23 21:27:23 EDT 2010;Committer;svn;1;2;2;4;0
4c6551b7d36d8741ec5418de073a10d5c01e7246;Thu Sep 23 21:27:19 EDT 2010;Committer;ryan;3;80;27;107;0
d1a4b542186800607a60490d3aef8e244e00ca0c;Thu Sep 23 14:09:22 EDT 2010;Committer;nobu;2;6;0;6;0
67d1d75fcbc04d1c2a2dd2aa1ae7139c7051950c;Thu Sep 23 14:08:55 EDT 2010;Committer;nobu;2;7;3;10;0
e63c5b3a62f387bb346fb7042911e253fa6d1a6b;Thu Sep 23 12:42:49 EDT 2010;Committer;wanabe;2;10;5;15;0
d339fed3ad9b6002712a3da09f2a7cdc604b694b;Thu Sep 23 12:22:43 EDT 2010;Committer;naruse;1;14;1;15;0
060f18c0d930f8f65749f427b6f901bd2c575397;Thu Sep 23 10:29:27 EDT 2010;Committer;wanabe;2;8;3;11;0
d06f38c6b9e72bcd7539c31e8ee4ae8833d383a4;Thu Sep 23 09:59:38 EDT 2010;Committer;wanabe;3;25;2;27;0
e1819967a85e90d03f3676c5f4edd274bf970382;Thu Sep 23 00:01:44 EDT 2010;Committer;svn;1;2;2;4;0
9ccd4fe12792929f5aafd7aae3f8f79fb95cf94f;Thu Sep 23 00:01:40 EDT 2010;Committer;nobu;3;31;9;40;0
631d23c57bc7cda4bf3ef332597f88c8739c0615;Wed Sep 22 08:16:49 EDT 2010;Committer;kazu;2;6;1;7;0
a33353f8804211e6d0d98c180068c465f49cf242;Wed Sep 22 08:03:55 EDT 2010;Committer;yugui;2;14;5;19;0
e2c1e2969df27a1bde0906139c723cdeaea979ab;Wed Sep 22 04:13:03 EDT 2010;Committer;knu;1;11;1;12;0
f01fae288597249bacff89e89ebfbc3067036f82;Tue Sep 21 16:56:59 EDT 2010;Committer;ko1;2;5;1;6;0
9831508ba3296789f9d00ef4296e7b75d2d8b965;Tue Sep 21 16:53:06 EDT 2010;Committer;ko1;2;9;0;9;0
c72e6c7b869fa8f454c495cda4dee49d4c72487b;Tue Sep 21 15:56:41 EDT 2010;Committer;eban;2;6;0;6;0
102501e0346e409f44ec6de8ab5800f58b1c630e;Tue Sep 21 15:01:14 EDT 2010;Committer;svn;1;2;2;4;0
a5a51abfc5dbe8f29fee38ba34a275063d01b548;Tue Sep 21 15:01:11 EDT 2010;Committer;akr;3;17;10;27;0
e7381db962823f3d6f6e746b5bfedefd897d32d0;Tue Sep 21 13:20:07 EDT 2010;Committer;usa;2;5;1;6;0
39be861346d7fbc23575a7df8f260f8f3b099674;Mon Sep 20 17:44:35 EDT 2010;Committer;svn;1;2;2;4;0
27727621c468ec9d07ba84f8066d1f3eb25589e3;Mon Sep 20 17:44:31 EDT 2010;Committer;kazu;2;5;1;6;0
89130aa8e17642a8b60c02030610e12124f25721;Mon Sep 20 14:23:16 EDT 2010;Committer;nobu;3;19;0;19;0
c7caeda5ed20938974ccb7dd6bfddad1e65cb18e;Mon Sep 20 02:26:30 EDT 2010;Committer;akr;3;6;4;10;0
971a57004e346d87c7f0f55d16f1abb66fe24451;Sun Sep 19 17:38:18 EDT 2010;Committer;mrkn;3;15;6;21;0
ac69adf5dea3b6b0b3df34db73cc2255fb481aa0;Sun Sep 19 17:28:32 EDT 2010;Committer;svn;1;2;2;4;0
0433134947a051d5eba5ba3771f346ef437facb8;Sun Sep 19 17:28:30 EDT 2010;Committer;naruse;1;1;1;2;0
3038eae7f6e95dfc85f7256763560f0b47b71e46;Sun Sep 19 13:10:31 EDT 2010;Committer;yugui;2;75;0;75;0
32e00d382f4ef204ac21868ded101597e36d230d;Sun Sep 19 13:10:27 EDT 2010;Committer;yugui;2;28;8;36;0
4a028d2c7ea9c00fef49844127fffaa6d8ed6ec0;Sun Sep 19 13:10:25 EDT 2010;Committer;yugui;4;30;7;37;0
e8291588c992571af4fc545f14da75cfd910c92a;Sun Sep 19 04:44:31 EDT 2010;Committer;nobu;2;7;1;8;0
f9f73768486da483d039a2b6b7e7c31fe5842944;Sat Sep 18 22:49:34 EDT 2010;Committer;akr;3;31;13;44;0
fb7fe14575f3b71fb98309a53fa05b32ada50203;Sat Sep 18 21:06:08 EDT 2010;Committer;mrkn;3;155;67;222;0
d6e9eebd747108650671847bf7ddcef3853107f8;Sat Sep 18 20:19:40 EDT 2010;Committer;svn;1;2;2;4;0
3cbda570c22f0324502a43dc668223b3da5d241b;Sat Sep 18 20:19:38 EDT 2010;Committer;mrkn;3;131;54;185;0
9dffbcfc09dc54d77bfb99dc91e0c5ea01182925;Sat Sep 18 11:10:36 EDT 2010;Committer;akr;3;27;13;40;0
c095a38cad9acc00f6ddbae74df6a1d7596bd8aa;Sat Sep 18 08:34:37 EDT 2010;Committer;nobu;5;518;518;1036;0
dbac0837d6b25a1eba478ba5214a86f0b85f17b1;Sat Sep 18 06:56:43 EDT 2010;Committer;svn;1;2;2;4;0
a91ee12dd0566ab451b9c23be6be916be9426236;Sat Sep 18 06:56:41 EDT 2010;Committer;ryan;1;26;3;29;0
d8c3fa15069932cac36790df2485d148f7f4c807;Fri Sep 17 14:47:20 EDT 2010;Committer;kou;3;31;1;32;0
7bf12316a1716c2116908c494e9e259dc39eb8a5;Fri Sep 17 14:23:56 EDT 2010;Committer;kou;2;18;21;39;0
ede915ce25611fc10e34b712b94bdc0b16b8ab6a;Fri Sep 17 14:11:10 EDT 2010;Committer;kou;2;41;21;62;0
2a15d25a5941301b5be6bc29eb4ac97d5aafe3dc;Fri Sep 17 13:46:56 EDT 2010;Committer;kou;23;1791;1796;3587;0
146bf4fdafefc780d65f20c983d65f9cbe3bfe2d;Fri Sep 17 13:31:16 EDT 2010;Committer;kou;12;75;57;132;0
d357d7279ab23275b769b594a2c4670797afc353;Fri Sep 17 13:15:37 EDT 2010;Committer;kou;2;5;82;87;0
91ed484f92040e5c2006a3a00ec77a54d552cf37;Fri Sep 17 13:14:14 EDT 2010;Committer;kou;89;34722;0;34722;0
045491d5be06b615d66d3f66cca2b5d2bc3c1929;Fri Sep 17 07:52:21 EDT 2010;Committer;shyouhei;2;31;11;42;0
0f0d0dcdb3390fa25f9a34ac38f4d69396093dd7;Thu Sep 16 23:30:30 EDT 2010;Committer;nobu;2;6;1;7;0
dc259038f1cc0f0c764406cd71878f5e1da4068b;Thu Sep 16 17:28:43 EDT 2010;Committer;svn;1;2;2;4;0
a88191b1cacfcc27944edff728753944ee20e166;Thu Sep 16 17:28:42 EDT 2010;Committer;knu;2;17;11;28;0
08c467330ba0bc92150a65a01cd397562a5ea78d;Thu Sep 16 14:48:20 EDT 2010;Committer;akr;3;18;4;22;0
5c1fd225c85157cba69996683a345d8e4a831ba2;Thu Sep 16 13:53:40 EDT 2010;Committer;akr;1;1;1;2;0
b2a0191b800e955b69c1b91af4a48068098e390c;Thu Sep 16 13:20:11 EDT 2010;Committer;knu;2;3;13;16;0
5bfac0d9cf1d40df317645f53ee4f55b22d2876f;Thu Sep 16 12:40:40 EDT 2010;Committer;nobu;3;31;40;71;0
9bc2e3280a5ef48395b47fa6155ad8cdc303e606;Thu Sep 16 12:31:29 EDT 2010;Committer;nobu;2;24;12;36;0
75d694e535282cd5e2b0ab4ac3743042e0d03e05;Thu Sep 16 12:02:34 EDT 2010;Committer;nobu;2;7;2;9;0
d91f4777dffb2fda9e166803b5ffa642077f7a27;Thu Sep 16 11:22:00 EDT 2010;Committer;knu;2;13;3;16;0
201267b1c555a33adeb03d41d8748cb40562c0a8;Thu Sep 16 06:03:13 EDT 2010;Committer;shyouhei;2;8;1;9;0
4f98aa2bcfff913a112c56f190727213de9173af;Wed Sep 15 23:30:46 EDT 2010;Committer;nobu;2;8;2;10;0
afd241f7ee13dd228fdfe1b1af87b33c4d96d46a;Wed Sep 15 23:27:48 EDT 2010;Committer;nobu;2;6;1;7;0
d0e9ac151e4b508221de5118ee653fafec3851c0;Wed Sep 15 21:08:19 EDT 2010;Committer;akr;3;15;3;18;0
ef5948f0dca6cfad510754d6e721adc3fd9b381b;Wed Sep 15 16:14:05 EDT 2010;Committer;naruse;1;5;0;5;0
84842f7784f0118417eb0603aed1fdfa27f9c8be;Wed Sep 15 15:40:52 EDT 2010;Committer;naruse;1;22;0;22;0
2fe39b886457633a89f0eda10aacb3419f2504fa;Wed Sep 15 15:40:15 EDT 2010;Committer;naruse;2;5;5;10;0
1c96fb43719d1fa59cda2c2e822cbe71dae54b52;Wed Sep 15 15:35:32 EDT 2010;Committer;svn;1;2;2;4;0
2cd6800fd8437b1f862f3f5c44db877159271d17;Wed Sep 15 15:35:31 EDT 2010;Committer;naruse;3;16;5;21;0
363ed27fa7a9f95111e2dfa0df8ae120cfc95d8d;Wed Sep 15 12:07:43 EDT 2010;Committer;akr;4;22;3;25;0
cc9b6ba611711aca1a124e6666b9a57c7dda9d2b;Wed Sep 15 07:56:04 EDT 2010;Committer;shyouhei;4;6;31;37;0
6bab4ea9917dc05cd2c94aead2e96eb7df7d4be1;Wed Sep 15 06:01:00 EDT 2010;Committer;shyouhei;4;31;6;37;0
64beb15dbc16ad251a55545bb89775bf23a6a845;Wed Sep 15 04:40:40 EDT 2010;Committer;shyouhei;1;14;0;14;0
0d58b7a4e6b8dde4418576856d38b1e882a92616;Wed Sep 15 04:37:45 EDT 2010;Committer;shyouhei;1;7;7;14;0
61ee785c61da48a23112727e763bd465a81a37ba;Wed Sep 15 00:12:05 EDT 2010;Committer;nobu;3;40;1;41;0
3f4a73f0e1d79184c51d3d696ec06376c323e0b5;Tue Sep 14 23:26:03 EDT 2010;Committer;nobu;1;5;4;9;0
757f5bcb971d2fa1edeaccce0f4fd877c12b0b6d;Tue Sep 14 22:27:54 EDT 2010;Committer;nobu;3;14;6;20;0
f84f1644138d20263f0939606dc8fc4f83fcc29f;Tue Sep 14 22:23:09 EDT 2010;Committer;akr;3;30;4;34;0
d3a0629afc0fc0e1f59b1060ece81b973a9cdad8;Tue Sep 14 17:15:31 EDT 2010;Committer;svn;1;2;2;4;0
204f8d6820d4f9d9162f1e6a421cbb51079f4894;Tue Sep 14 17:15:30 EDT 2010;Committer;tenderlove;2;6;1;7;0
bf77099923011a3a0fa0186a8f2dcfb52bdb71bf;Tue Sep 14 11:18:37 EDT 2010;Committer;akr;4;23;3;26;0
6d9b5fdffcfe2fc2783c5b03f93e2deb372fd260;Mon Sep 13 20:14:04 EDT 2010;Committer;akr;4;43;9;52;0
1428b74ff9acdfb435b8bddf3d19e3b50868dfd8;Mon Sep 13 16:02:36 EDT 2010;Committer;svn;1;2;2;4;0
54886d087690c1c89eda709ff5ee94fabd38b26d;Mon Sep 13 16:02:35 EDT 2010;Committer;kanemoto;2;6;1;7;0
878747437c662aaeac55e27254c6dbc3fb720b7d;Mon Sep 13 11:48:58 EDT 2010;Committer;akr;3;15;7;22;0
4c916ec8b735d1b526d7ec93b4072101bf16a2fc;Mon Sep 13 10:56:52 EDT 2010;Committer;nobu;3;16;2;18;0
3e86bd8f3ad76dca34a61e2f0053cbcfd18e7eae;Mon Sep 13 09:11:58 EDT 2010;Committer;nobu;2;6;1;7;0
bed2696508c63223e609e5caf39adf5c10fb0cb7;Mon Sep 13 07:58:47 EDT 2010;Committer;knu;1;9;9;18;0
2590d7447a96ba81a1ea2ae5b0e705f00a1631ac;Mon Sep 13 01:15:39 EDT 2010;Committer;naruse;3;14;1;15;0
1973984f903fd6149034308e4723aa090801b69a;Mon Sep 13 01:15:36 EDT 2010;Committer;naruse;1;1;1;2;0
6ebb345dd7c634461fa0cc272d3590a86ebe2aad;Mon Sep 13 00:40:10 EDT 2010;Committer;naruse;3;24;1;25;0
f31eccfa183e7284b37edda6600397c724ee13cc;Sun Sep 12 21:46:07 EDT 2010;Committer;svn;1;2;2;4;0
a335ded4c9c9a47f5425fea1795eda918f457b5c;Sun Sep 12 21:46:04 EDT 2010;Committer;akr;3;15;3;18;0
d50b19ff275aa3332c1b99f857e15f49ca4d39d3;Sun Sep 12 12:24:17 EDT 2010;Committer;tadf;2;6;2;8;0
5cc5e1c5beed714998d46209d439e3b9674178a8;Sun Sep 12 10:31:01 EDT 2010;Committer;akr;3;15;3;18;0
a42f6882c835e4374cf1885680b47c5ddf27767b;Sun Sep 12 00:26:19 EDT 2010;Committer;akr;3;15;3;18;0
3f0fd715f4e8fc0dcdc6da2558f4549b448cf431;Sun Sep 12 00:15:27 EDT 2010;Committer;akr;1;8;0;8;0
7bda092ee86c0f4615e0c68773cfe894bdfbe966;Sat Sep 11 23:43:13 EDT 2010;Committer;akr;1;2;2;4;0
d900ed31f776a85291a6aee870c942a57ab86e6b;Sat Sep 11 23:38:44 EDT 2010;Committer;akr;3;61;13;74;0
c755baf85f553e7ea20290facdeff56c490162a1;Sat Sep 11 19:55:08 EDT 2010;Committer;akr;1;10;10;20;0
62c11715602a92d23a3d4763587f642aa148e251;Sat Sep 11 19:28:09 EDT 2010;Committer;svn;1;2;2;4;0
b4ac655acc32682a1cc430acdd2661124ecb5ba2;Sat Sep 11 19:28:07 EDT 2010;Committer;akr;2;47;26;73;0
da47bbd1db646794fba94449d4d226d35ec2b2ff;Sat Sep 11 07:47:44 EDT 2010;Committer;nobu;4;43;20;63;0
073e6ccc7ba29e1391865107f105b8069352ee52;Sat Sep 11 06:21:51 EDT 2010;Committer;drbrain;3;77;0;77;0
6329215dbfcda2e517981367a783ce183b237367;Sat Sep 11 03:32:08 EDT 2010;Committer;nobu;2;6;2;8;0
72e1df781be8a94e2df5b64a1d4ab3fce7573653;Sat Sep 11 00:19:10 EDT 2010;Committer;akr;1;1;1;2;0
e13bd1ba01c9da7fe8e5a384729190b011bf9c44;Fri Sep 10 21:54:27 EDT 2010;Committer;svn;1;2;2;4;0
0f070a1f4bb6227cb0a18b1e6dab6e5f972a1c9b;Fri Sep 10 21:54:24 EDT 2010;Committer;akr;3;15;3;18;0
1a8a6580e9dab1267187e592f182ada8a39a0747;Fri Sep 10 14:04:07 EDT 2010;Committer;akr;3;15;3;18;0
a4fa58f9ab9883a03bf7ed95655501acfb2fa554;Fri Sep 10 10:20:35 EDT 2010;Committer;nahi;4;53;0;53;0
7f438d8402f53c2f78c5c6512c3d2f68d9fb20ac;Fri Sep 10 08:54:50 EDT 2010;Committer;nahi;6;22;14;36;0
cb81b56de2f1edc56ac84366a73b96a3266305ee;Fri Sep 10 08:20:47 EDT 2010;Committer;knu;1;5;0;5;0
cb39e5dbfae0fb69dc3447ae3426fa85d411d37a;Fri Sep 10 07:59:58 EDT 2010;Committer;knu;1;1;1;2;0
82abe79b9fa3b5a648f453076a28ed9566d02ec8;Fri Sep 10 07:51:58 EDT 2010;Committer;knu;8;130;83;213;0
4f77c495cddcdfcbb15e363ba21d09e5a9ddfd37;Fri Sep 10 05:44:57 EDT 2010;Committer;naruse;1;1;1;2;0
493f72185499f3fea1212b04d177a0870d6e89c3;Fri Sep 10 05:44:54 EDT 2010;Committer;naruse;4;21;7;28;0
7c73db266ac8632905438fba5cd9d6216ce4084c;Fri Sep 10 05:03:40 EDT 2010;Committer;nobu;1;1;0;1;0
94edc5a9d9dd2de515fe3e5f4e972d88ed5b2bc7;Fri Sep 10 04:13:21 EDT 2010;Committer;nahi;2;6;1;7;0
9e39c618da89cda4819b62f14f82348372f32d63;Thu Sep 09 22:29:16 EDT 2010;Committer;nobu;3;14;2;16;0
e7ab96f6ede27a19ef8317a1062f70f691122a07;Thu Sep 09 22:04:22 EDT 2010;Committer;akr;3;15;3;18;0
6a99679ce29ccdd589b5c02d1ce416d8a6623dc4;Thu Sep 09 17:19:53 EDT 2010;Committer;svn;1;2;2;4;0
a75a46710232c09f172523b90756a0e0f79e4811;Thu Sep 09 17:19:52 EDT 2010;Committer;akr;2;15;5;20;0
83a827ac9be0249471b23ee56980bc33a542a0fa;Thu Sep 09 14:25:56 EDT 2010;Committer;nobu;3;14;1;15;0
eb0c31b1adaa23051b952b3c0de0640a5283afd4;Thu Sep 09 13:43:37 EDT 2010;Committer;akr;3;15;3;18;0
96688ecbab2e18be02af7172bcb3732e57d9290e;Thu Sep 09 13:40:14 EDT 2010;Committer;wanabe;4;55;8;63;0
e54c30c05eb16897bc1d44b3bec06083ef1ae779;Thu Sep 09 08:17:51 EDT 2010;Committer;nahi;2;6;1;7;0
050d7453b71029816091c302b2d389811b722aaf;Thu Sep 09 01:46:07 EDT 2010;Committer;naruse;2;7;1;8;0
4d2787c67b84542c6fcce4370c3f41f9a644bbb0;Thu Sep 09 00:17:11 EDT 2010;Committer;naruse;2;6;1;7;0
0787deb64c3f718b543c381546d0d6f4d4be85f6;Wed Sep 08 15:52:34 EDT 2010;Committer;svn;1;2;2;4;0
66a2c8a4b94a3402833566d2571ebc4985ad4a62;Wed Sep 08 15:52:33 EDT 2010;Committer;kazu;1;2;2;4;0
849c34783334c3a49e015aa9b5e260c52bd6a53d;Wed Sep 08 13:52:25 EDT 2010;Committer;nahi;2;8;1;9;0
bafa881327f7de02f756e526e35ed78ffd051011;Wed Sep 08 11:57:34 EDT 2010;Committer;akr;3;15;3;18;0
b684424176de9104bb262758daa00729ca621f50;Tue Sep 07 21:26:35 EDT 2010;Committer;svn;1;2;2;4;0
c37ec5c9d2b5a45443149af56f1312956591a8b4;Tue Sep 07 21:26:33 EDT 2010;Committer;akr;3;15;3;18;0
8e3c2ced73e6e8b149b1567b84e621041add19a4;Tue Sep 07 12:04:19 EDT 2010;Committer;svn;1;2;2;4;0
b9f2ea847e0004e41dae591816e5a16f06437bba;Tue Sep 07 12:04:17 EDT 2010;Committer;akr;3;15;3;18;0
746f85beb448078ff915cb0aa8f1b05954ef3991;Mon Sep 06 14:08:08 EDT 2010;Committer;akr;3;15;3;18;0
dad43c29f88081fc683a3f2993073d4a315d5ffe;Mon Sep 06 02:08:30 EDT 2010;Committer;nahi;3;15;3;18;0
8233db65b6a8fc83848805d92bf3ce823e4b89a1;Mon Sep 06 01:53:00 EDT 2010;Committer;nahi;2;6;1;7;0
59f551635a6dfdb2ed5b84b275fdf8e4cdbf803f;Mon Sep 06 01:38:51 EDT 2010;Committer;naruse;3;9;1;10;0
a69423beb8e9d827eb4cadda35b21586767d8737;Mon Sep 06 01:00:29 EDT 2010;Committer;naruse;3;9;2;11;0
0ed5aee00074547ed58c55bef6d346a9a4dd4925;Mon Sep 06 00:46:48 EDT 2010;Committer;naruse;3;17;6;23;0
fab386fbff87a6fe3fa6d8521e0948b34be6a941;Sun Sep 05 21:17:56 EDT 2010;Committer;svn;1;2;2;4;0
efe86e6c0d34733b53f7be8d45cf103c85fdc45d;Sun Sep 05 21:17:54 EDT 2010;Committer;akr;3;15;3;18;0
cdaf07f6193656433a76522e1a2316408d41245c;Sun Sep 05 14:03:08 EDT 2010;Committer;svn;1;2;2;4;0
5e620bdd65c703c8527d7165f41155b89a8b36a4;Sun Sep 05 14:03:06 EDT 2010;Committer;akr;3;15;3;18;0
0fd37b09ee800e051fcfb433f50c70a81d811813;Sat Sep 04 14:48:55 EDT 2010;Committer;nobu;3;10;2;12;0
097d58a594984674475cd271fb206ca940e90552;Sat Sep 04 01:41:04 EDT 2010;Committer;nobu;3;20;1;21;0
8889aef16267f112e6ff7ca9184ff33bf789ce4f;Fri Sep 03 15:57:39 EDT 2010;Committer;yugui;2;8;1;9;0
9c5a56a0d6dfbcda4e122c993c5c0e53f62e8a0d;Fri Sep 03 15:57:34 EDT 2010;Committer;svn;1;2;2;4;0
60b41810f83a938f5c2a94c6dee9dfc6f895006d;Fri Sep 03 15:57:33 EDT 2010;Committer;yugui;2;6;0;6;0
0c5b7fd01bd4333f1af1c051889570c458a70bf7;Fri Sep 03 14:51:51 EDT 2010;Committer;akr;3;15;3;18;0
aa5c05b8ba0c1ab9255730f8cd7acab68c0af600;Thu Sep 02 21:40:55 EDT 2010;Committer;nobu;4;124;58;182;0
163b4dee96abb2bdd3c208b6dd71ade4fbe09349;Thu Sep 02 21:17:31 EDT 2010;Committer;akr;3;15;3;18;0
185e9705abbb8c2f96e748a400b76db61e129902;Thu Sep 02 21:14:51 EDT 2010;Committer;nobu;4;22;3;25;0
d878c51357f6a0e72271b6d0299480711b70701a;Thu Sep 02 13:11:13 EDT 2010;Committer;akr;3;15;3;18;0
51f6d787ac87417a8847567c6d30cdc640ef11ca;Thu Sep 02 00:12:43 EDT 2010;Committer;usa;2;17;4;21;0
d35fdf3335b14393d33eb8a2da9d6f89c655a15b;Thu Sep 02 00:02:52 EDT 2010;Committer;usa;2;41;11;52;0
cec2a542b75619eacf2851416387feed9a157c30;Wed Sep 01 21:54:39 EDT 2010;Committer;svn;1;2;2;4;0
8ea12e525effff6b78017680ad4463c206f99d8e;Wed Sep 01 21:54:36 EDT 2010;Committer;akr;3;15;3;18;0
b1729db2924cd4a04c9ac2ff22621f22e8b21562;Wed Sep 01 13:04:10 EDT 2010;Committer;akr;3;15;3;18;0
ee9e8f82d4baccd90e82d8a0acd75001aa495b0f;Wed Sep 01 08:40:53 EDT 2010;Committer;ryan;5;385;201;586;0
09fb7189ec8b886b356618274b6b7b5bcc4aebe8;Wed Sep 01 07:52:16 EDT 2010;Committer;naruse;3;29;19;48;0
d53e0fe330649007a843a837108583fb670e192d;Wed Sep 01 05:36:33 EDT 2010;Committer;naruse;2;6;1;7;0
5c132d0ad28687bbc9d448301c2817ffa51f50d2;Wed Sep 01 05:36:31 EDT 2010;Committer;naruse;2;6;1;7;0
8086b525acc199123250bc0782160ba137986e79;Wed Sep 01 03:56:39 EDT 2010;Committer;nobu;4;25;3;28;0
3121057559fa8848c734c6dc270b3ff4a1c370a2;Tue Aug 31 12:11:02 EDT 2010;Committer;akr;4;16;4;20;0
b0993426bb87d658ee630c7e7f20114e5857d6a9;Tue Aug 31 08:34:56 EDT 2010;Committer;nagai;2;10;1;11;0
0156faf5a2de9f5863f514b7112b7442f155a031;Mon Aug 30 21:50:11 EDT 2010;Committer;akr;1;4;0;4;0
013952e61bcfc0aa7e6536eb4d6bec4c31548e27;Mon Aug 30 19:45:32 EDT 2010;Committer;svn;1;2;2;4;0
d074ef4d60e389348d10dd1d81e76634c17acb2d;Mon Aug 30 19:45:30 EDT 2010;Committer;naruse;6;22;9;31;0
16ceba03968244e64e015965c2f3ec6a8f1836fb;Mon Aug 30 12:30:14 EDT 2010;Committer;akr;3;16;4;20;0
1a02ec9170db08c0574978a9d09478422ff261fa;Mon Aug 30 06:01:14 EDT 2010;Committer;naruse;3;27;9;36;0
96ebf3bdd9e41b9d500534a134a35070e2947e23;Sun Aug 29 22:33:11 EDT 2010;Committer;svn;1;2;2;4;0
b8adf336a670fa84e4d8c9b1f74be225c199b561;Sun Aug 29 22:33:09 EDT 2010;Committer;akr;3;15;3;18;0
f4b2d14572161896c0b6408b552fb6be3498c995;Sun Aug 29 14:54:16 EDT 2010;Committer;nobu;2;5;2;7;0
ccf4fbf78da3376ef2be6dbe222b77983008e4a6;Sun Aug 29 14:47:01 EDT 2010;Committer;nobu;3;8;1;9;0
d2da9597c3b9f2dded80f53c16f4bf2c630e0ffe;Sun Aug 29 14:25:23 EDT 2010;Committer;nobu;3;20;2;22;0
8ffeda041b92f1dbdc05d9356e05d9f624922ef3;Sun Aug 29 07:09:40 EDT 2010;Committer;naruse;3;14;4;18;0
79316a1c735badcc6b06441f34d6580b904381c5;Sun Aug 29 05:16:08 EDT 2010;Committer;akr;1;1;1;2;0
e6f86c982f210ed9f97f4afa8e3c9cab6c31351d;Sun Aug 29 04:22:55 EDT 2010;Committer;nobu;3;14;1;15;0
b9432e7630f3a85944730b3ba1b1aa4a8a753612;Sun Aug 29 03:51:39 EDT 2010;Committer;nobu;3;17;0;17;0
7e53b3b6bab79ee56de54b8ad62d7026f9a1f603;Sun Aug 29 03:48:21 EDT 2010;Committer;nobu;0;0;0;0;0
946a037e3022c4667f22ca92b64379315f9535c0;Sun Aug 29 03:20:04 EDT 2010;Committer;nobu;3;13;2;15;0
909d638aecb3597536e912599f5ee355aac828c0;Sun Aug 29 00:50:58 EDT 2010;Committer;usa;1;10;5;15;0
000f1c5b759ba08b8ca29456376202e4d5536812;Sun Aug 29 00:42:05 EDT 2010;Committer;naruse;1;7;0;7;0
b2eb38fac5a0e5a8360d8d9d1e57287dcde04ba6;Sun Aug 29 00:36:24 EDT 2010;Committer;naruse;2;12;3;15;0
1e5f5c8b5017d272bff9ba90a1799673c2bf6c13;Sat Aug 28 21:34:55 EDT 2010;Committer;svn;1;2;2;4;0
2d0cbb3c3a4020eabb65b1d37ed5f5e3abf6bad7;Sat Aug 28 21:34:52 EDT 2010;Committer;akr;3;15;3;18;0
a2bf9203e8b74065eb1452dd13741b3de7305eaf;Sat Aug 28 08:52:14 EDT 2010;Committer;mrkn;3;90;0;90;0
b6595225c1a68f212eb2d11f35de7732b9114fd7;Fri Aug 27 23:19:30 EDT 2010;Committer;akr;3;15;3;18;0
55c2e00d6503365e7140cc2e8fc5cb854f420553;Fri Aug 27 21:50:08 EDT 2010;Committer;svn;1;2;2;4;0
d9dd3f9159168ef47f654994c809e7ff25ce4488;Fri Aug 27 21:50:06 EDT 2010;Committer;knu;1;4;0;4;0
03f466bd3386139eb9993a66d6173a3edb8d20b6;Fri Aug 27 12:17:13 EDT 2010;Committer;shyouhei;1;1;1;2;0
cff3c3d52a5406a61be62c81fc6101c4d514731f;Fri Aug 27 07:33:19 EDT 2010;Committer;shyouhei;3;42;0;42;0
0cfe185f39d575f9c620bd14707a81bd5c29fe11;Fri Aug 27 06:29:47 EDT 2010;Committer;usa;2;9;0;9;0
909477ec1de6f7f89d29405eb3ad268ecbd3ebf7;Fri Aug 27 06:26:41 EDT 2010;Committer;nobu;4;18;15;33;0
9614d22b5d6dcb4e0ee6fe12bad0c1021230cacf;Fri Aug 27 06:23:56 EDT 2010;Committer;nobu;1;1;1;2;0
e52469a43d6ef58c5c5432ce1b1476e943b70b41;Fri Aug 27 03:58:00 EDT 2010;Committer;mrkn;1;1;0;1;0
9be503f332515719475216e7788e6a7fab6c78d0;Fri Aug 27 03:51:56 EDT 2010;Committer;mrkn;3;18;2;20;0
f64358db7d5f9991bd2c8f6f382ee32767a1c26a;Fri Aug 27 03:45:24 EDT 2010;Committer;nobu;1;5;0;5;0
3a297bb1f07e252d5b15f7143be1c893cfaa327a;Fri Aug 27 03:27:50 EDT 2010;Committer;usa;2;6;3;9;0
3e5e1b6c452d13c8c9748a046ebcd30dedf011a9;Fri Aug 27 03:25:08 EDT 2010;Committer;nobu;2;18;0;18;0
e26c0d6d824101c679a7783d32f1c88cf6ffc7c9;Fri Aug 27 01:48:58 EDT 2010;Committer;nobu;2;488;479;967;0
5b7ccc0629baa7cd2c7ab92802ee1bf62e3ec0f4;Thu Aug 26 22:57:39 EDT 2010;Committer;nobu;3;108;19;127;0
6e08cd5ec2e4133bbb02ccd196206c60f9cb6795;Thu Aug 26 20:16:27 EDT 2010;Committer;svn;1;2;2;4;0
9eb726258965a35191b8b84a25448d5dd203faea;Thu Aug 26 20:16:25 EDT 2010;Committer;akr;3;24;6;30;0
71cf670f0fc5556a51d6e209a14cceafcf6550d7;Thu Aug 26 13:54:03 EDT 2010;Committer;nobu;2;6;1;7;0
bafaff1f43cf44430fed590dda00928b61821b6e;Thu Aug 26 12:50:13 EDT 2010;Committer;akr;3;26;3;29;0
0eb31be6818ee400b30899f77f6bcbe0722ea35f;Thu Aug 26 07:41:55 EDT 2010;Committer;nobu;1;1;1;2;0
b3545895d1bb5a72e1311022c69b882d6ce90033;Thu Aug 26 01:50:07 EDT 2010;Committer;naruse;2;8;1;9;0
6ef6cbc4f6e6a9a81af48cbd4cad16f1eb6998e2;Thu Aug 26 01:16:53 EDT 2010;Committer;kanemoto;3;62;0;62;0
7e4015e16d3d3c5780440a9d15af4bcae8d4e4e1;Thu Aug 26 00:49:54 EDT 2010;Committer;nobu;3;8;0;8;0
3dc6edf793c33483c9d7365b865152d57fa994fb;Thu Aug 26 00:14:18 EDT 2010;Committer;mrkn;4;180;37;217;0
8554e163557a4f32f6e9427146d594df31ac024a;Wed Aug 25 22:30:03 EDT 2010;Committer;nobu;5;50;10;60;0
2034fe610fd9da3781f4a1e39079128da812748c;Wed Aug 25 13:11:43 EDT 2010;Committer;akr;3;25;4;29;0
2531892cbc997ae25a121e21cca321722ec663c3;Wed Aug 25 12:14:38 EDT 2010;Committer;shyouhei;4;9;52;61;0
00dcf07ebcb7af10753c1d6bbac3c6bb94740369;Wed Aug 25 11:22:55 EDT 2010;Committer;nobu;1;1;1;2;0
fd1022c065509846dd234914e3c9b725d20e928a;Wed Aug 25 09:31:46 EDT 2010;Committer;nobu;3;28;3;31;0
ae6a9009dcb5e475ef51a3448a613e7f4428855d;Wed Aug 25 09:00:17 EDT 2010;Committer;nobu;3;20;7;27;0
569d8219292fefe205979fd8ea951619316d4f72;Wed Aug 25 08:56:47 EDT 2010;Committer;nobu;2;6;1;7;0
c6465aeeb153428057426663d51906052e39b36c;Tue Aug 24 18:46:24 EDT 2010;Committer;usa;2;11;0;11;0
f9f6289b103f0e3918f7c35333e25683045b1049;Tue Aug 24 17:24:14 EDT 2010;Committer;svn;1;2;2;4;0
bb897dc79a2e85e802780fbec0df6a71577ea1d0;Tue Aug 24 17:24:13 EDT 2010;Committer;nagai;2;366;126;492;0
53081b87177fab3976c5d5886a572d784b5a46b3;Tue Aug 24 14:29:39 EDT 2010;Committer;mame;2;16;0;16;0
f21230b4916955440028e54c73eb965a44980368;Tue Aug 24 13:08:00 EDT 2010;Committer;akr;3;26;3;29;0
f2ff3eb6ec1473f0ec584557a32315ff74f8ef91;Tue Aug 24 01:11:14 EDT 2010;Committer;nobu;5;17;9;26;0
2f6c0e3be38b057239eb044426c152ac5633c88f;Mon Aug 23 22:07:39 EDT 2010;Committer;nobu;5;88;18;106;0
89339af9c19c28eaa9e2814fb75aa09768971f0e;Mon Aug 23 21:08:19 EDT 2010;Committer;nobu;5;26;5;31;0
0d5b1718c2f5fdbcd7f06aec6f6ac0fbac5a81ac;Mon Aug 23 21:03:42 EDT 2010;Committer;nobu;3;80622;80622;161244;0
4be11cde44351c109eaf07669046a2152f151c78;Mon Aug 23 20:58:28 EDT 2010;Committer;nobu;2;80624;80606;161230;0
e586e054981719292c6955075976a5c7f564e5f0;Mon Aug 23 16:22:07 EDT 2010;Committer;svn;1;2;2;4;0
af8cae1e7fe0a5ee0b9404aaf8ed7c9888272d09;Mon Aug 23 16:22:04 EDT 2010;Committer;mrkn;3;41;9;50;0
526d246f715a1a0046942f942173c2d9447e78a5;Mon Aug 23 14:16:06 EDT 2010;Committer;akr;4;52;10;62;0
645114b25c067f88c5d7e15e850f671272487b7d;Mon Aug 23 13:31:10 EDT 2010;Committer;nobu;2;6;1;7;0
298a6e1cd5a28bf4fa08f47b909a5048c9e81b10;Mon Aug 23 04:12:08 EDT 2010;Committer;nahi;3;34;0;34;0
d078f51f578402c2ad6b9a8f9068dfc88584ed99;Mon Aug 23 03:32:58 EDT 2010;Committer;naruse;2;6;1;7;0
815ab02971f7b94e276823f407b8fc2723bf703b;Mon Aug 23 03:19:58 EDT 2010;Committer;naruse;3;13;2;15;0
54f344095916f83a2755a177f94e65a1c390a612;Sun Aug 22 15:24:07 EDT 2010;Committer;svn;1;2;2;4;0
9d2025c881f44264ae20f5339067e753456768fa;Sun Aug 22 15:24:03 EDT 2010;Committer;tadf;4;5;7;12;0
b25bda4547b63e3c6e0ac723d6168c72696a250a;Sun Aug 22 00:10:06 EDT 2010;Committer;akr;2;6;1;7;0
119da02e87bb7a75a45ab4b45eadbfee53aa40b9;Sat Aug 21 21:46:31 EDT 2010;Committer;nobu;2;17;11;28;0
6eb922763f25537237865f976b42c52bd6ae3d1a;Sat Aug 21 20:55:09 EDT 2010;Committer;nobu;3;8;3;11;0
df5f6825dbd90cb3568ee7ba35da0eec61226ba8;Sat Aug 21 14:38:17 EDT 2010;Committer;wanabe;1;45;0;45;0
72c811a3d8a4bfe4b98219f225cc20784e373122;Sat Aug 21 11:10:24 EDT 2010;Committer;naruse;2;6;0;6;0
d1b77f5eee442d6104b92e7edf272c8bdac6be44;Sat Aug 21 10:00:55 EDT 2010;Committer;wanabe;2;10;0;10;0
a161f1243550930a38028d58ed6d5f2ae9b6a38b;Sat Aug 21 08:37:31 EDT 2010;Committer;svn;1;2;2;4;0
86b26898ebe3bbb53fa76a41fbf12c41a91ce4bd;Sat Aug 21 08:37:28 EDT 2010;Committer;akr;3;23;8;31;0
b88a5027b86d8bfd8a0892588322e1083e9caa1d;Fri Aug 20 05:13:39 EDT 2010;Committer;naruse;1;6;1;7;0
fedc3756fb6d311f9ddaa0714192f5c5b0fcf542;Fri Aug 20 01:40:55 EDT 2010;Committer;svn;1;2;2;4;0
19fb560d219f583066241293f2e0f92cd898595e;Fri Aug 20 01:40:51 EDT 2010;Committer;akr;4;29;3;32;0
1fa5a50cd05de69d94815757da628eab29471a1f;Thu Aug 19 13:50:43 EDT 2010;Committer;nobu;1;4;0;4;0
b7bc826b9ebd2898f94a35251d1fb4bde771a8f6;Thu Aug 19 13:45:02 EDT 2010;Committer;nobu;2;20;2;22;0
c40c2839d6f488f25d00fceca4b3fd8f9e3073f8;Thu Aug 19 13:34:40 EDT 2010;Committer;nobu;2;9;2;11;0
85198c5e3cf702a333cf1acfbbbe8e925419e148;Thu Aug 19 10:54:56 EDT 2010;Committer;akr;3;8;2;10;0
b73ea4b64ac0d7ad9666b4325d94f180849f97f3;Thu Aug 19 10:29:30 EDT 2010;Committer;akr;2;6;1;7;0
3c9efc1d2db6fef5d534715b1c10f6ca4f36d812;Thu Aug 19 10:16:35 EDT 2010;Committer;naruse;1;207;0;207;0
bc6c904a8ba143477cfe2c8f281c143b7e27aea5;Thu Aug 19 10:14:17 EDT 2010;Committer;naruse;1;5;0;5;0
15c39b07bd1301cb262b2d697707afb7f203bfd1;Thu Aug 19 08:22:31 EDT 2010;Committer;nahi;6;625;428;1053;0
1d04aedb5a913a3e89bfe50550344dc698c7b3d9;Thu Aug 19 03:10:15 EDT 2010;Committer;mrkn;3;24;4;28;0
fee5e4ff5f427ac06b6ffd2891c7ef775324d483;Thu Aug 19 02:12:32 EDT 2010;Committer;naruse;2;6;1;7;0
078d19b29f689e4a17e86b134d563978eb7a5fd8;Thu Aug 19 01:06:49 EDT 2010;Committer;akr;3;16;3;19;0
bacb45c8775c94e19cc5c7f84b3abaa9aa3b3311;Wed Aug 18 21:03:36 EDT 2010;Committer;svn;1;2;2;4;0
eba16d7444e3dc4dc917ac2a3b1340bc193df1c4;Wed Aug 18 21:03:32 EDT 2010;Committer;nobu;2;6;0;6;0
354e3760283d0f06ac1b7271eaf761a704a403cb;Wed Aug 18 10:13:54 EDT 2010;Committer;mrkn;1;4;1;5;0
dbb05925f7be3ca359291e89734e135559019834;Wed Aug 18 10:11:06 EDT 2010;Committer;mrkn;1;5;0;5;0
4023ffa92f87c497659e737c41da6808df716a50;Wed Aug 18 09:42:36 EDT 2010;Committer;mrkn;3;11;4;15;0
21cf543d38513a723f1b1f5567dc028b16e56f4f;Tue Aug 17 16:53:28 EDT 2010;Committer;svn;1;2;2;4;0
ce5827c6fb5f211a937282dcbda3b857f8845a9b;Tue Aug 17 16:53:25 EDT 2010;Committer;naruse;3;8;18;26;0
3eabe19ea9cdee6064231d298683701e7ba0056e;Tue Aug 17 11:06:22 EDT 2010;Committer;akr;2;8;1;9;0
e44f5bcbd90d51a1d638e19ec08726b1f9b10664;Tue Aug 17 06:18:53 EDT 2010;Committer;naruse;2;11;6;17;0
05745ccfb367ab670ebbad8c992edf2cf70d8b4b;Tue Aug 17 04:02:32 EDT 2010;Committer;akr;3;17;3;20;0
1572070fa07dfc57cd63d0a2ab14538cf67005eb;Mon Aug 16 22:50:40 EDT 2010;Committer;nobu;3;11;2;13;0
94fc95c8b04df32db8d473be058d4a98b72ab8ec;Mon Aug 16 22:42:46 EDT 2010;Committer;nobu;2;11;5;16;0
0afddf7b0a8ebb1695b87a4aee75c06544bd5563;Mon Aug 16 22:38:46 EDT 2010;Committer;nobu;5;11;4;15;0
adff6d4477a77eaf03a377d5b37365e8b2b0de04;Mon Aug 16 13:16:41 EDT 2010;Committer;akr;2;4;1;5;0
16cd13c05188bf52c5dfb056f02ebf4574bb1bc3;Mon Aug 16 12:40:10 EDT 2010;Committer;akr;4;23;3;26;0
66c25e4ca14fda15c4a0d5cd619e573060ebd756;Mon Aug 16 11:31:58 EDT 2010;Committer;nari;2;6;2;8;0
a5207399bd3c32965c06cb27ae78537ffbf8da82;Mon Aug 16 11:31:54 EDT 2010;Committer;nari;2;22;16;38;0
a043fb8642c5e8fcf1dbf30ac76d04862f20e7a5;Mon Aug 16 10:23:22 EDT 2010;Committer;nobu;1;8;6;14;0
a043fb8642c5e8fcf1dbf30ac76d04862f20e7a5;Mon Aug 16 10:23:22 EDT 2010;Committer;nobu;2;13;7;20;0
d17ff1a6a5288d3c9e341123ec7a9fc6fb402c55;Mon Aug 16 10:22:36 EDT 2010;Committer;nobu;1;3;3;6;0
d17ff1a6a5288d3c9e341123ec7a9fc6fb402c55;Mon Aug 16 10:22:36 EDT 2010;Committer;nobu;2;8;3;11;0
5269e14162fbd00c515173100c777c8f3772d295;Mon Aug 16 10:22:33 EDT 2010;Committer;nobu;1;2;2;4;0
03226ec1a6fe6e6d3898c4fb897c80d0344b1471;Mon Aug 16 08:46:53 EDT 2010;Committer;akr;2;7;1;8;0
29b30b66f3eaba883827b3da607e3dc31a45e0ad;Mon Aug 16 03:41:12 EDT 2010;Committer;shyouhei;2;8;1;9;0
966532cc40525380ec291ba3d7e89c005d1a6c7a;Mon Aug 16 03:29:08 EDT 2010;Committer;nobu;4;19;2;21;0
7a80e95edd8ae8f42c27ca79d0398defbe12a7f8;Mon Aug 16 01:02:26 EDT 2010;Committer;svn;1;2;2;4;0
8eb121d8122394c275ba8fb9583b4584639c932a;Mon Aug 16 01:02:23 EDT 2010;Committer;usa;3;10;3;13;0
56d3b926ce01e79388c0e8caa29448b24dd21e06;Sun Aug 15 09:20:44 EDT 2010;Committer;mrkn;2;19;13;32;0
5dde183d0ad5362174e4f2cfac080b667c230089;Sun Aug 15 07:22:57 EDT 2010;Committer;usa;2;5;1;6;0
1148f6a327e23a003640f2dc691b20a5bf826a04;Sun Aug 15 04:32:40 EDT 2010;Committer;mrkn;3;11;4;15;0
b167f42ca32e186f7ec0f14d6acdbaa06d93924f;Sun Aug 15 02:37:51 EDT 2010;Committer;akr;1;6;6;12;0
d86da0fcf1954397587ab6b9cb16400bd93c2695;Sat Aug 14 15:22:43 EDT 2010;Committer;mrkn;5;347;315;662;0
01e3f613d75fd06264fd9264dcccfe383a410796;Sat Aug 14 15:16:22 EDT 2010;Committer;svn;1;2;2;4;0
5c55715c089f189ec1004b13de6ec6f95d9ba0af;Sat Aug 14 15:16:19 EDT 2010;Committer;akr;3;15;3;18;0
f214490d90b1e813114fcfde84555e15335e9794;Sat Aug 14 12:04:31 EDT 2010;Committer;nobu;4;6;3;9;0
78b10588bfbfa8288b57816237d7f0a836a84f44;Sat Aug 14 11:59:35 EDT 2010;Committer;nobu;1;17;0;17;0
9f41782ec8170c69598f49c6fedf5e7ca35724a4;Sat Aug 14 10:12:13 EDT 2010;Committer;nobu;5;11;5;16;0
e5731864074cc642c2b4e77d74334ca2b72302d8;Sat Aug 14 09:01:12 EDT 2010;Committer;nari;4;56;1;57;0
dccf9e0c45f1f450d28ba0700dbb459247ba9f9d;Sat Aug 14 06:33:06 EDT 2010;Committer;nobu;9;31;23;54;0
a23b1f745038f93e5cd2542fbf17b363686ccfd7;Sat Aug 14 06:19:57 EDT 2010;Committer;nobu;3;5;3;8;0
a979eb4548bf8b8d7479ba83e4a2f25f77175f4d;Sat Aug 14 06:17:38 EDT 2010;Committer;nobu;4;7;3;10;0
23b1a3d3fa8ec7d5e6f4d9f89540207682502c66;Sat Aug 14 06:11:03 EDT 2010;Committer;nobu;3;19;7;26;0
a33fdc4ec0e8110a7fe3581e1ee37b871efbdce3;Sat Aug 14 05:58:19 EDT 2010;Committer;nobu;3;8;5;13;0
92cb7d0ad49d5c681119471862698d9de00bd1a6;Sat Aug 14 04:23:31 EDT 2010;Committer;nobu;3;6;3;9;0
6fe403b0d77d2c66cd5fe461aa9d3d1b801389b5;Sat Aug 14 04:21:04 EDT 2010;Committer;svn;1;2;2;4;0
3bf1afbdd8446faaa5e125dfcfb8741a4893e89e;Sat Aug 14 04:20:59 EDT 2010;Committer;nobu;4;15;10;25;0
87da8f0a292798126a40dfc3f06a4a8f98aa9073;Fri Aug 13 13:49:24 EDT 2010;Committer;akr;3;15;3;18;0
d7d361a316ab554aaa2e773d2dee9644c81b2ff5;Fri Aug 13 07:12:18 EDT 2010;Committer;nobu;3;16;5;21;0
05d9fabda16bfde3249fc0a047142e6f4a7f38d0;Thu Aug 12 14:39:46 EDT 2010;Committer;akr;3;18;3;21;0
98f53d5db2d2c78a6fb673336b28bc84bc716bf9;Thu Aug 12 12:18:44 EDT 2010;Committer;akr;3;15;3;18;0
2b1f8574c7fb97d6333c60ab312a93d260eedca3;Wed Aug 11 20:58:11 EDT 2010;Committer;nobu;4;20;2;22;0
73f5b841d48b0e6687424374fe739266d17ffce4;Wed Aug 11 20:56:23 EDT 2010;Committer;nobu;1;35;35;70;0
9229d998b579bc6b0a72fb3b2b44c66bac2e7062;Wed Aug 11 17:16:20 EDT 2010;Committer;akr;1;1;0;1;0
8caba237da7f03af9bdb992106f34c54c76ad753;Wed Aug 11 15:21:12 EDT 2010;Committer;svn;1;2;2;4;0
3583c42c713ef66f3f112edb26a4301bfa43a68f;Wed Aug 11 15:21:09 EDT 2010;Committer;akr;2;28;18;46;0
9b0b9ac237c60d34c9cd06538d1a133eed9f7130;Wed Aug 11 14:30:47 EDT 2010;Committer;mrkn;3;16;1;17;0
c89bdea7c9ea3776e1a8994590dffd847c61f1df;Wed Aug 11 12:00:42 EDT 2010;Committer;kazu;2;30;11;41;0
988b2ae95efb2c4d1cfa0150904809ef9e9284df;Wed Aug 11 07:04:46 EDT 2010;Committer;shyouhei;2;0;14;14;0
676d0641d8802c73beadfd39a97178cce2d3c3d4;Wed Aug 11 03:18:03 EDT 2010;Committer;nobu;2;14;0;14;0
f2c65c0a3306114253d0109426c27dc550de18a5;Wed Aug 11 02:02:16 EDT 2010;Committer;mrkn;2;5;1;6;0
6d6a31f135fdd6111657467e28605dc67740057b;Tue Aug 10 21:19:09 EDT 2010;Committer;svn;1;2;2;4;0
e5215bfdc5201327964f80548aef9ca28190de0c;Tue Aug 10 21:19:01 EDT 2010;Committer;akr;3;15;3;18;0
bbb5a6d6f741be235abccff4da4cc424085869e6;Tue Aug 10 12:20:49 EDT 2010;Committer;tadf;2;8;3;11;0
e6f6033b16a64eb04f2e8c3ea970356a61ac1621;Tue Aug 10 12:02:52 EDT 2010;Committer;akr;3;8;1;9;0
2f8ddcd8cd324b23b291de1d21a63dd2dc6f2910;Tue Aug 10 11:58:21 EDT 2010;Committer;tadf;2;21;18;39;0
45bfb5318f26b296c651e32257444578867cc5c0;Tue Aug 10 11:45:57 EDT 2010;Committer;akr;3;15;3;18;0
f89a50b62c576b38796f9f41dac9b840945e230b;Tue Aug 10 11:17:00 EDT 2010;Committer;usa;2;5;1;6;0
f635d1b041015478f3bc790ebec469a68cde5a5a;Tue Aug 10 10:59:17 EDT 2010;Committer;tadf;3;10;6;16;0
d4c63f862b574863011a110e4502162b0ab9fa0a;Tue Aug 10 08:25:23 EDT 2010;Committer;usa;2;6;1;7;0
7694956ef757c5dabcf397bc85be44b75ddd07bb;Tue Aug 10 06:25:27 EDT 2010;Committer;mrkn;4;285;298;583;0
678af70ce8230ea8b88fd2ca2b26fe68b5c4a887;Tue Aug 10 06:25:23 EDT 2010;Committer;mrkn;3;11;3;14;0
6434e1e690e757ec8b753133c270e3bbbdaed45f;Tue Aug 10 05:59:11 EDT 2010;Committer;naruse;2;10;0;10;0
073ac4ff5a67570409056971578bb4294649f006;Tue Aug 10 02:29:04 EDT 2010;Committer;usa;2;6;2;8;0
81f1c62e3e2cb437b390373f33610db08f464be3;Mon Aug 09 21:27:26 EDT 2010;Committer;svn;1;2;2;4;0
8aa17733fa55828db19bb00a9943a1f6ee61782b;Mon Aug 09 21:27:20 EDT 2010;Committer;akr;3;19;5;24;0
ec5bb26fa031288fd8f935443805f68e5637ee75;Mon Aug 09 13:15:49 EDT 2010;Committer;akr;4;44;6;50;0
55584cb206746bd632ef13356cf88036cc59c353;Mon Aug 09 13:13:31 EDT 2010;Committer;akr;1;36;36;72;0
acff965a5feeae3bdb3b48346c040c59e3c933d9;Mon Aug 09 13:12:54 EDT 2010;Committer;akr;2;10;3;13;0
d1a4390eedb54094a883993dc11b2355df9a9a31;Mon Aug 09 07:05:26 EDT 2010;Committer;naruse;3;11;3;14;0
f795d0f4180a3e46b93af72303d75bde80c11b8e;Mon Aug 09 05:11:04 EDT 2010;Committer;naruse;2;8;3;11;0
8d92ac23d15da245404a586a48f390948e617697;Sun Aug 08 21:53:02 EDT 2010;Committer;nobu;2;5;1;6;0
22223dc6dd59ef6925862931f8cd0d6a61f18fd7;Sun Aug 08 21:51:02 EDT 2010;Committer;nobu;2;6;1;7;0
a5e1a4b6355f4c4273998689ef0069cc92d858f3;Sun Aug 08 15:18:46 EDT 2010;Committer;nobu;3;7;3;10;0
c60cd341e86e2739a59d71b700e83d614918f22a;Sun Aug 08 11:41:15 EDT 2010;Committer;akr;1;1;1;2;0
239692dde86f19c9a13bace56082b1c290b1d7e9;Sun Aug 08 10:29:16 EDT 2010;Committer;akr;3;18;3;21;0
1c8c901e3c553bdd15d2a1e5e9d8ce4c5c6c7aa2;Sun Aug 08 07:42:51 EDT 2010;Committer;nobu;3;8;9;17;0
b26000068e8d87ea69501cadc93bd2bdc9f2a692;Sun Aug 08 07:27:11 EDT 2010;Committer;nobu;1;2;2;4;0
e45d17b9d24d3d70eb974f52a6e981b212f47f6c;Sun Aug 08 07:22:07 EDT 2010;Committer;nobu;3;14;9;23;0
efbad5fa481a6e34f4d8b9f9355df2a6d7602a95;Sun Aug 08 07:08:55 EDT 2010;Committer;nobu;3;11;2;13;0
739e022d006b755b4c6641eda958bdfb5969b65d;Sun Aug 08 04:21:26 EDT 2010;Committer;akr;3;16;4;20;0
aac4f022e2b4bb601f5068bfc7e25de49493563f;Sun Aug 08 03:41:30 EDT 2010;Committer;nobu;3;13;1;14;0
98c8e1cd91819042b13eb5aa69d86cb813a9bcaa;Sun Aug 08 01:08:27 EDT 2010;Committer;akr;2;6;2;8;0
288b9de79de7b0cf04f184cd5d19bc3821059c27;Sat Aug 07 23:58:57 EDT 2010;Committer;nobu;2;6;1;7;0
f9845684b11b5692f1d410868dca88944f9cb162;Sat Aug 07 23:58:53 EDT 2010;Committer;nobu;1;1;2;3;0
574cadc970c83ec9d1a4780fceb3929ac125173b;Sat Aug 07 23:55:49 EDT 2010;Committer;nobu;2;6;1;7;0
8488b62d59dde799a3a38b9daaf62a4f06755327;Sat Aug 07 23:30:45 EDT 2010;Committer;akr;1;3;3;6;0
5f5e0b7191f0ecf00f0c1718c9562fee6112f04a;Sat Aug 07 22:50:05 EDT 2010;Committer;akr;2;8;1;9;0
b50fb9034e8efd45319ce6ac3c7984bf98b548de;Sat Aug 07 22:33:51 EDT 2010;Committer;akr;4;30;9;39;0
d82dd262d076c4b43fdc95c9c648badf3dec5692;Sat Aug 07 22:19:17 EDT 2010;Committer;akr;3;10;4;14;0
3fabdc8e405e7145ec9d499f7fb08caca1ed8dbe;Sat Aug 07 15:44:30 EDT 2010;Committer;svn;1;2;2;4;0
bb0ef922db4682dc57f5150c065b1a3fe2fc1f02;Sat Aug 07 15:44:27 EDT 2010;Committer;akr;4;28;8;36;0
06efb04e8e2dd45c96b8f245d601f1d3c38486de;Sat Aug 07 10:53:13 EDT 2010;Committer;akr;2;18;13;31;0
2f2b6ace050bbabba106c80658068e3d40244bba;Sat Aug 07 10:05:37 EDT 2010;Committer;akr;2;9;1;10;0
3e7c24fe6e4899619e3cf1c1c79b96cd361a13e2;Sat Aug 07 09:38:21 EDT 2010;Committer;akr;2;6;0;6;0
49cb5a78a14584de5932637d16fbd4ee0733d9d3;Sat Aug 07 09:21:37 EDT 2010;Committer;akr;4;15;4;19;0
f6404fa6d58927e28fb24f3f66b5e3b3c5c1b0c9;Sat Aug 07 08:49:18 EDT 2010;Committer;nobu;3;13;11;24;0
df96e4184556346d821541d847f9fca7b53e29a5;Sat Aug 07 08:40:32 EDT 2010;Committer;nobu;3;8;1;9;0
e4e9758aa5a096ccf7679dace5ef52a00b959a92;Sat Aug 07 08:18:42 EDT 2010;Committer;nobu;2;7;1;8;0
c53664c84da2365623a0998f1ed52969d3b57e78;Sat Aug 07 05:43:21 EDT 2010;Committer;nobu;33;0;188;188;0
c260a0c70c0eb6fa3608eaab6372e867afac56a7;Sat Aug 07 05:19:29 EDT 2010;Committer;naruse;2;8;4;12;0
a438fce7e349c38fc9d0136da79806c2adf357ba;Sat Aug 07 04:59:27 EDT 2010;Committer;nobu;3;11;2;13;0
fd0485acf7936e865903d643715433a7b861afbb;Sat Aug 07 04:33:33 EDT 2010;Committer;nobu;5;33;0;33;0
93426cd6e883bd436b73c32a08cd14a29b10b7f4;Sat Aug 07 00:49:59 EDT 2010;Committer;suke;2;12;3;15;0
d1893fe74d24109634cce58a02c7349dfd5f4551;Sat Aug 07 00:32:20 EDT 2010;Committer;akr;2;6;1;7;0
6bc65b35bdf8611837a81dd381eb8c7b61442fc6;Sat Aug 07 00:29:52 EDT 2010;Committer;akr;3;15;4;19;0
261bb184c61b8d881a60c39efba3580472bfbc36;Fri Aug 06 23:27:28 EDT 2010;Committer;akr;3;15;3;18;0
a1d1c102d727d9f51837068ae15a45fdfe396532;Fri Aug 06 17:09:34 EDT 2010;Committer;svn;1;2;2;4;0
9352485e47d878b21441511286e99ff74c4b3ee8;Fri Aug 06 17:09:31 EDT 2010;Committer;akr;3;15;3;18;0
c4c4bff456a6f0eb28de0b1e6f6d7bfe4d3e5291;Fri Aug 06 12:30:28 EDT 2010;Committer;akr;3;15;3;18;0
cba4d057853fc9d2dfe536a391d191d40cd03180;Fri Aug 06 11:13:48 EDT 2010;Committer;nobu;3;7;9;16;0
edd4332a3803fa30b4624371c1cc37fe75d19ff4;Fri Aug 06 11:12:35 EDT 2010;Committer;nobu;3;10;1;11;0
8aa6059dbfcf840b9e7870ca9639194e707b05a0;Fri Aug 06 09:59:31 EDT 2010;Committer;nobu;2;6;2;8;0
b4ba3ba6410d33e4ac15cce8b633f8d1f525f107;Fri Aug 06 09:56:22 EDT 2010;Committer;nobu;2;8;4;12;0
775188a0a2d7c186a089cf358c4bbb8449c63783;Fri Aug 06 08:44:33 EDT 2010;Committer;naruse;3;8;2;10;0
f3372c22a6c335d73319eac549fa577bc4386b06;Fri Aug 06 08:40:30 EDT 2010;Committer;naruse;2;9;3;12;0
2b071787d2d5f572eb5f41262b6610bfde5eabb1;Fri Aug 06 08:40:27 EDT 2010;Committer;naruse;4;20;9;29;0
f4c1540b969dbf3e9756f5bc8234f1b4746f4173;Thu Aug 05 20:53:59 EDT 2010;Committer;svn;1;2;2;4;0
dc2676a8a06b2126f7a5abbab9ebbd1f9b4726ce;Thu Aug 05 20:53:56 EDT 2010;Committer;akr;3;15;3;18;0
9bf69293e7db531f4ab8d8420b86f3ed627d3b96;Thu Aug 05 13:09:53 EDT 2010;Committer;akr;3;17;3;20;0
5ffe59faf8ad8f3ccfa39ec1d0d1791dfc02ac55;Thu Aug 05 12:32:02 EDT 2010;Committer;mame;3;51;7;58;0
fa9d53d00faa6fb038f6e61570adb51b201276df;Thu Aug 05 12:31:55 EDT 2010;Committer;mame;3;2;45;47;0
600601c338006d9701ce3a8ee9922cdc47d9fed8;Thu Aug 05 11:30:50 EDT 2010;Committer;nobu;3;34;3;37;0
3a32ef53aaab15199e59c643630726b041c9fa88;Thu Aug 05 11:14:05 EDT 2010;Committer;nobu;3;38;0;38;0
b80ddbf461a9a215513d6bbd78bab7185a927a31;Thu Aug 05 11:00:18 EDT 2010;Committer;nobu;2;10;0;10;0
50b50499210bb52d1bbae6b65009f058426d2d1a;Thu Aug 05 10:52:08 EDT 2010;Committer;nobu;3;14;2;16;0
5274f892015b2a41dc64c63a4ce1c843f4fb0a66;Thu Aug 05 09:36:16 EDT 2010;Committer;nobu;6;25;1;26;0
359d53787821dc287d0411565801d54791f0a9c6;Thu Aug 05 09:25:39 EDT 2010;Committer;nobu;3;12;2;14;0
b35f5db57ebd756361cfa41555f1c652ec49499b;Thu Aug 05 08:18:32 EDT 2010;Committer;matz;2;6;1;7;0
36992251c369a3e9ce227a1ea6476a5a8acccbe8;Thu Aug 05 07:57:26 EDT 2010;Committer;nobu;2;25;14;39;0
8965ed167dbca9471ccc41e9bebe7e2fb1fa9fcb;Thu Aug 05 07:42:47 EDT 2010;Committer;nobu;6;71;0;71;0
5425f8fe6ead9c2b57547cc64f5b4316fc86bdf1;Thu Aug 05 05:12:50 EDT 2010;Committer;nobu;2;5;1;6;0
ae824807055802a812a23f19cd1a5086223df11d;Thu Aug 05 03:39:19 EDT 2010;Committer;nobu;2;7;1;8;0
a2ebc53ec49b0fe42c3fe91dba13e3400a93ade7;Wed Aug 04 21:44:20 EDT 2010;Committer;akr;2;5;0;5;0
eb8449111929c044e9fe3a4e50a827b2c6271aa3;Wed Aug 04 17:31:11 EDT 2010;Committer;svn;1;2;2;4;0
7eb5352e24393201fa259bf85de2d84507039d68;Wed Aug 04 17:31:09 EDT 2010;Committer;mame;1;1;1;2;0
5f13d888cf0aece7c1bb13b72773f66a4b9cebff;Wed Aug 04 11:08:28 EDT 2010;Committer;nobu;5;1;35;36;0
36044b07730033911580501cbe1a060e820e927e;Wed Aug 04 10:37:05 EDT 2010;Committer;nobu;2;6;1;7;0
99d96a89ce57edc4de2ff1acb1d4ed7737144140;Wed Aug 04 07:09:47 EDT 2010;Committer;nobu;5;35;1;36;0
c37b2ef8dcb88bc7a60e254bfc4f8f19279fe45e;Wed Aug 04 06:52:18 EDT 2010;Committer;usa;2;7;2;9;0
71a3defd34574a8af738639def919024a2aa02b9;Tue Aug 03 21:25:47 EDT 2010;Committer;svn;1;2;2;4;0
88e78ac59b042365a09199aa72488405bcbcad95;Tue Aug 03 21:25:43 EDT 2010;Committer;akr;3;15;3;18;0
5e9c47c81d986219b1d6c64e4e490179527cd916;Tue Aug 03 14:35:34 EDT 2010;Committer;akr;1;602;0;602;0
a4c0f7dfaefeb6d3fe83a9ac130926b7699c3186;Tue Aug 03 12:16:06 EDT 2010;Committer;nobu;3;24;1;25;0
b80d5f14df01ac626a42668f40ede3724e4425ef;Tue Aug 03 12:01:13 EDT 2010;Committer;nobu;3;12;1;13;0
292c39098da3d6c9036eabcb9f8a5f7b07c86ab0;Tue Aug 03 11:30:19 EDT 2010;Committer;nobu;4;26;1;27;0
b5dc2576cc60930099cd942ffa1de2c2d759471b;Tue Aug 03 05:48:05 EDT 2010;Committer;naruse;4;9;3;12;0
2fc40194d2ddc05a481c0eddc8fe9a1c95e23196;Tue Aug 03 05:22:51 EDT 2010;Committer;usa;2;7;1;8;0
46a93a65df6e51c8317cd958d44f21313b5a28ee;Tue Aug 03 03:05:39 EDT 2010;Committer;shyouhei;2;6;6;12;0
45992b4b252b015702581589c584a61831346416;Mon Aug 02 22:52:25 EDT 2010;Committer;nobu;5;7;20;27;0
cefa9413d24ce1c253516d0a6901c9aaed11f45f;Mon Aug 02 22:37:38 EDT 2010;Committer;nobu;1;1;0;1;0
aa1141e16721e09d2ec468bcab0e545af52fbb4c;Mon Aug 02 22:34:44 EDT 2010;Committer;nobu;1;2;2;4;0
a4209572de70242c16e99d301f8de6e880ecb908;Mon Aug 02 15:53:48 EDT 2010;Committer;nobu;4;11;6;17;0
1849a2baf1823c7620b1d59b5924cc74211a68ce;Mon Aug 02 12:51:18 EDT 2010;Committer;nobu;2;9;2;11;0
d4fc0799b7cc9fbb7af1bcc6580e1e3091dd087b;Mon Aug 02 12:21:00 EDT 2010;Committer;suke;3;16;4;20;0
6198f539bb0897886f53e2ff77045a8d051fb5c1;Mon Aug 02 07:35:35 EDT 2010;Committer;usa;2;6;1;7;0
49e259ec587fd72d96210fcb33593f3955555795;Mon Aug 02 03:25:12 EDT 2010;Committer;usa;3;6;1;7;0
b25465592263c90ae4893f041ae99df17fd05eba;Sun Aug 01 20:35:37 EDT 2010;Committer;svn;1;2;2;4;0
88431b74fcb16e92e67ec3d3abf205793b255772;Sun Aug 01 20:35:33 EDT 2010;Committer;akr;3;21;10;31;0
33d848d841a2579febf14b550f0ffe9ff8657065;Sun Aug 01 14:09:40 EDT 2010;Committer;akr;2;10;6;16;0
4be5721dcba2d6adec05c4572f3cfebb89e32c51;Sun Aug 01 14:04:39 EDT 2010;Committer;nobu;2;43;19;62;0
6da48ad9977d71647ab1dc1b3c24c39eb4821034;Sun Aug 01 13:24:01 EDT 2010;Committer;mrkn;1;1;0;1;0
98685cc70fd4ea86bccc81983283c29eb7b2afd7;Sun Aug 01 13:20:22 EDT 2010;Committer;mrkn;2;8;6;14;0
c29b801afad1dc5cb4227bcef9e4bc004c967b8a;Sun Aug 01 11:57:58 EDT 2010;Committer;akr;3;23;11;34;0
b496cd64e5c8a588f19ff699beda175e2d453d72;Sun Aug 01 08:27:34 EDT 2010;Committer;nobu;2;6;0;6;0
caa05197d34667fea40a4637b899669dd65f536f;Sun Aug 01 05:59:49 EDT 2010;Committer;akr;3;37;9;46;0
ffe49186c971e751e2082db342dd4b04f1520b49;Sun Aug 01 01:48:57 EDT 2010;Committer;mame;2;7;0;7;0
6ad3f616638b4bfa9140318897a1e68df5b29eec;Sun Aug 01 01:12:54 EDT 2010;Committer;mame;3;10;2;12;0
b6f174afdb81f0f0cbe0ff848dddad047d00c40f;Sun Aug 01 00:50:28 EDT 2010;Committer;akr;1;1;0;1;0
a35c3cf34137c8a58a35d7e543af9cfa9d4725f6;Sun Aug 01 00:46:18 EDT 2010;Committer;akr;2;7;1;8;0
572b8b37498a875382220d957d1b4285ae046eaf;Sun Aug 01 00:22:18 EDT 2010;Committer;akr;3;23;19;42;0
933e5e091106a83dd8f7c402e02703c183f644ee;Sun Aug 01 00:12:51 EDT 2010;Committer;nobu;2;7;0;7;0
c9a7829604854830c68c77662b7864b61afa57ce;Sat Jul 31 23:54:54 EDT 2010;Committer;svn;1;3;3;6;0
e8f2d9e808359a6ba5c5519c1d32340404c51986;Sat Jul 31 23:54:49 EDT 2010;Committer;suke;2;6;2;8;0
b6ebd0622c0d730e5843dcb4dae1800fd5634884;Sat Jul 31 14:16:10 EDT 2010;Committer;akr;3;15;4;19;0
9006bd201535061bdf11192430432fee33bc9327;Sat Jul 31 07:21:42 EDT 2010;Committer;akr;3;12;3;15;0
0794c1da9325b51c627dab99ec2e7ff71a5bcdda;Sat Jul 31 00:36:12 EDT 2010;Committer;nobu;1;1;1;2;0
c57e8f7ddc816746e0541c26a3df6cdbd65ba435;Sat Jul 31 00:13:10 EDT 2010;Committer;akr;3;15;5;20;0
faca64d5dd30b9db0bc54c80ad1835b626c461b1;Fri Jul 30 23:26:56 EDT 2010;Committer;svn;1;2;2;4;0
d61f475bb10ae5c54d0e4cc2a0840eb6edb0ecfd;Fri Jul 30 23:26:53 EDT 2010;Committer;nahi;2;8;2;10;0
be2f3c58e693a6e10693153ef2422b0235661e3e;Fri Jul 30 12:44:41 EDT 2010;Committer;akr;3;14;5;19;0
47fd9eb6e16ca14ee9415e4e2734c28ce5eeca36;Fri Jul 30 07:06:51 EDT 2010;Committer;nobu;1;1;0;1;0
a55567a066b1cf8851da606a1dafbe38f4cec520;Fri Jul 30 05:50:54 EDT 2010;Committer;nobu;1;20;3;23;0
63a555ee4e3bb9e95bdee4c28b64b84e2536a249;Fri Jul 30 03:42:05 EDT 2010;Committer;nobu;2;9;6;15;0
2d8228c28e3604ff5ec533eaf73e81c349b15bf1;Fri Jul 30 03:38:26 EDT 2010;Committer;nobu;2;15;6;21;0
6d56e80ad1bce411b1d4fe425e2842768a3bcfa6;Thu Jul 29 23:51:53 EDT 2010;Committer;nobu;3;31;4;35;0
a99de8466396ba4d056c126040dbf19ca5af20ff;Thu Jul 29 23:33:21 EDT 2010;Committer;nobu;3;10;6;16;0
7ae7ac4abab04f4351ae84f63f81b61a41843aff;Thu Jul 29 22:59:54 EDT 2010;Committer;nobu;7;91;6;97;0
bc8e65073588035b6d6d272be8c697a8dc27ee81;Thu Jul 29 22:54:01 EDT 2010;Committer;nagai;2;10;5;15;0
91c8bbdff7eddc338b1f803d1e7cd708a979d972;Thu Jul 29 21:13:35 EDT 2010;Committer;svn;1;2;2;4;0
8db76b2135353ed6795a0fe13150b5a69c09159a;Thu Jul 29 21:13:34 EDT 2010;Committer;akr;2;177;177;354;0
3608baa9909b4b20a8366fcc48393b7763b4be41;Thu Jul 29 13:29:20 EDT 2010;Committer;akr;3;43;6;49;0
8d228b25795dc2f598a9511ec18769285fd11109;Wed Jul 28 21:51:31 EDT 2010;Committer;nobu;3;17;2;19;0
b67ecc80df8502e10ddce0ceaeb7b5dfb5f8fba4;Wed Jul 28 20:52:16 EDT 2010;Committer;nobu;2;7;6;13;0
793af6993f90c80250c6d4be6829ca5b88b9d885;Wed Jul 28 17:38:59 EDT 2010;Committer;svn;1;2;2;4;0
de06330e8b7c53ba92a3fbeed3b170315bfc0dff;Wed Jul 28 17:38:56 EDT 2010;Committer;naruse;2;5;1;6;0
7996581a82836fc7635bba858b946c67edc56bba;Wed Jul 28 13:24:55 EDT 2010;Committer;akr;3;21;12;33;0
4b8f2ed7cc0fb9623ba7582c4576fa37e3620737;Wed Jul 28 13:24:42 EDT 2010;Committer;akr;1;14;0;14;0
a5e6532c4b0adacf481f4449e7bd56254d652136;Wed Jul 28 12:28:03 EDT 2010;Committer;nobu;1;10;0;10;0
97bc1a122b55e026a367e7c92de8b2245efb3b12;Wed Jul 28 10:39:33 EDT 2010;Committer;usa;2;15;0;15;0
51b6bfb0119356c689fbacf4c399e3e1816dec47;Wed Jul 28 08:12:01 EDT 2010;Committer;nobu;18;26;0;26;0
e53a60147ba68ab98fbe7a078b43311274d59f00;Wed Jul 28 00:38:21 EDT 2010;Committer;usa;2;6;2;8;0
8bc55563db64a73d33fc5983d3f7232cbad50d38;Wed Jul 28 00:25:57 EDT 2010;Committer;svn;1;2;2;4;0
392ab9d05ef90570bcc439fa3d8e66ada76ba7a7;Wed Jul 28 00:25:53 EDT 2010;Committer;naruse;2;12;6;18;0
0cb17010c437232e03d8a35cda69dccddba4f4f8;Tue Jul 27 14:14:14 EDT 2010;Committer;akr;3;16;3;19;0
53b6ab6a047864c32f12a4d4497144c32e25b705;Tue Jul 27 10:03:23 EDT 2010;Committer;nobu;1;2;1;3;0
444b943e354725bf623a050c88a4a8bd3f926c74;Tue Jul 27 09:59:29 EDT 2010;Committer;nobu;2;31;0;31;0
58f1d31a1ddd071f092600d155601592f3930163;Tue Jul 27 09:33:55 EDT 2010;Committer;nobu;7;25;8;33;0
592d885caa63c13cfec14cfc9b48ddc3bc55bb57;Tue Jul 27 07:27:48 EDT 2010;Committer;usa;2;6;1;7;0
7175a9073ea23abe565f606aa042ea015c7340b9;Tue Jul 27 07:13:43 EDT 2010;Committer;naruse;11;22;15;37;0
9cce6d1071c3d84d07db891fab781620a287a9fe;Mon Jul 26 20:53:11 EDT 2010;Committer;nobu;2;2;6;8;0
aa4f1d8e81b21d9f0ee19b5041595effacf77201;Mon Jul 26 13:35:18 EDT 2010;Committer;akr;3;14;1;15;0
195a7da4ec0b726005b22c8f88f353d7c3f24bfc;Mon Jul 26 09:18:21 EDT 2010;Committer;nobu;4;23;1;24;0
8e9a9cf0ec11550ec1c76dee354240e44dff1b97;Mon Jul 26 05:38:23 EDT 2010;Committer;nobu;2;5;1;6;0
705586b1a17cdd649ca6bc46f811d5808694d3b4;Mon Jul 26 05:10:25 EDT 2010;Committer;usa;2;6;2;8;0
c6cda4e3363f82fd4a5055534b2a25d906fc6386;Mon Jul 26 04:53:06 EDT 2010;Committer;naruse;2;6;1;7;0
af4986f515bfccadc404709985422897217504c8;Mon Jul 26 04:01:38 EDT 2010;Committer;nobu;2;9;1;10;0
201d99cc5f0c5f9da671245befe12e4036ff0c99;Mon Jul 26 03:05:25 EDT 2010;Committer;naruse;4;14;3;17;0
5edb56b83c350724dd084cfad37afdc763dad0be;Mon Jul 26 00:51:38 EDT 2010;Committer;svn;1;2;2;4;0
7d2ed51843a5e208044d93e4c91694d4d02ea202;Mon Jul 26 00:51:33 EDT 2010;Committer;nobu;2;6;1;7;0
7bfa1146e298acb72d9ee0301fcf37acb4699197;Sat Jul 24 20:37:31 EDT 2010;Committer;nobu;3;25;4;29;0
8d3bb806b0fd301d5180a211dfe5880fd2ee2506;Sat Jul 24 20:26:34 EDT 2010;Committer;nobu;4;24;6;30;0
b2d009fc7bead0a8c0ee45821acd46defa8a912b;Sat Jul 24 00:40:26 EDT 2010;Committer;nobu;1;2;2;4;0
8621d0908aa3db4524566fea7702a5556bb25501;Fri Jul 23 07:14:54 EDT 2010;Committer;shugo;3;34;0;34;0
38c4242cf68091af5aaf474ef5ddc35569c56581;Fri Jul 23 06:09:22 EDT 2010;Committer;nobu;2;6;1;7;0
b4080cf9eabc7c106a32b248c66ef9f780c439f5;Fri Jul 23 06:05:43 EDT 2010;Committer;nobu;2;21;15;36;0
8044ac7b43ffcc5ac8885db0b7dc41fac6f5bab0;Fri Jul 23 00:02:51 EDT 2010;Committer;nobu;2;14;6;20;0
85bf9bede487ff102c467d8e9bb40b886f3b7b4b;Fri Jul 23 00:00:12 EDT 2010;Committer;nobu;3;10;0;10;0
a58890c10da37591587438192271d517c6b7fe7b;Thu Jul 22 23:48:17 EDT 2010;Committer;svn;1;2;2;4;0
95c6a8a3b785284ee9014245163f90581621ccd4;Thu Jul 22 23:48:13 EDT 2010;Committer;matz;2;10;3;13;0
1b1041f84780c387443578d31506c58aac46fc77;Thu Jul 22 11:59:03 EDT 2010;Committer;nobu;2;4;13;17;0
6e7f56fdc76e0c1b9e19fba776f3cf72c1005e5a;Thu Jul 22 11:15:16 EDT 2010;Committer;mame;2;6;2;8;0
203ebcbb92db498f093a0b1936a28165b73f5ad3;Thu Jul 22 07:29:32 EDT 2010;Committer;naruse;3;11;3;14;0
24b17a2e871ce96df361749d7f4c1e2a9cdc1f00;Thu Jul 22 05:41:54 EDT 2010;Committer;naruse;2;13;0;13;0
d5a1efdc6114350d074c9f92c4f8dcce3478049d;Thu Jul 22 03:58:18 EDT 2010;Committer;nobu;2;22;13;35;0
cc703f2d5673a2fe24f7684a19dd993178ff23df;Thu Jul 22 03:30:59 EDT 2010;Committer;nobu;2;5;1;6;0
0563ae8608a84dbd26b6cedcbfd44ed30b420eba;Thu Jul 22 03:09:31 EDT 2010;Committer;nobu;1;5;2;7;0
062b4d675231fe9f8d266bed4406b6f591844fde;Thu Jul 22 03:02:40 EDT 2010;Committer;nobu;9;26;12;38;0
0bd71ff35455d308c838c00a7e16fd093d36e4d7;Wed Jul 21 21:38:25 EDT 2010;Committer;nobu;26;200;3;203;0
6abe539cfc9b91178be7e1d75173165dcf6ca1bc;Wed Jul 21 21:26:56 EDT 2010;Committer;nobu;5;15;6;21;0
3afa01255dfbc80bd4830d4d18f1d394c0e54202;Wed Jul 21 18:23:09 EDT 2010;Committer;nobu;2;5;0;5;0
90bf911fec8136d8b0afb0d16a3f663a47c103cc;Wed Jul 21 18:03:37 EDT 2010;Committer;svn;1;2;2;4;0
3befc304b5a0297ca7a618cc4775beb71e5ce644;Wed Jul 21 18:03:34 EDT 2010;Committer;drbrain;2;7;2;9;0
2527936cfcbe042678883ee5a87bfb6984702deb;Wed Jul 21 14:07:21 EDT 2010;Committer;nobu;2;7;2;9;0
6113a5add0a05eea33935fb9dd95a8c8e5c2755d;Wed Jul 21 06:30:40 EDT 2010;Committer;evan;3;26;6;32;0
6e2850aa46b25d2f76fdd60c7466060f73994a85;Wed Jul 21 06:16:07 EDT 2010;Committer;naruse;3;17;0;17;0
3f606b9aca26a4730559db0021c2bfde667dc281;Wed Jul 21 06:00:25 EDT 2010;Committer;nobu;2;6;1;7;0
ad717fa7e657703205c44df1b00f7d7d4a60d8ca;Wed Jul 21 05:00:53 EDT 2010;Committer;naruse;3;17;13;30;0
5647b2cd881bc45e531a71d51c1b9f9bbee9ce7f;Wed Jul 21 04:38:40 EDT 2010;Committer;marcandre;3;14;36;50;0
c618db17ee082b5b125bfea8410214058fc1fe17;Wed Jul 21 03:43:43 EDT 2010;Committer;mame;2;7;1;8;0
770af8649a22f721408e75d7d92b5c4323472f28;Wed Jul 21 03:32:41 EDT 2010;Committer;marcandre;2;25;9;34;0
9a89e864ea8211561c119052b0fa051a348b0ac7;Wed Jul 21 02:55:10 EDT 2010;Committer;nobu;3;6;1;7;0
9d0d4d8a172a6ea61d184c473d645e1faadea804;Tue Jul 20 18:36:25 EDT 2010;Committer;evan;2;11;3;14;0
ca7a11e838a50f3e57b8af3f910c46fe78e2cafa;Tue Jul 20 18:30:52 EDT 2010;Committer;svn;1;2;2;4;0
bb43e6892c25570605ddb183364e5690c3b22708;Tue Jul 20 18:30:46 EDT 2010;Committer;evan;5;40;111;151;0
b117475e18baa73a1787d8038693b1801dafd9f8;Tue Jul 20 09:47:50 EDT 2010;Committer;nobu;2;0;6;6;0
06e935a1267a43031a47472c93ed944e2bcf5dfc;Tue Jul 20 09:39:22 EDT 2010;Committer;nobu;3;29;12;41;0
6de2f601af43364b284dea4c133329da2ac80da9;Tue Jul 20 09:23:08 EDT 2010;Committer;nobu;3;8;2;10;0
81cc3b26550324e94cc50d24d113174cd4339062;Tue Jul 20 06:14:40 EDT 2010;Committer;nari;2;15;8;23;0
a52dd6cc5c011fbebc3e00261eaade73ec981bf8;Tue Jul 20 04:00:46 EDT 2010;Committer;shyouhei;2;6;0;6;0
a3419bc919b49d2c4a6efe04b375e7700f43e4b8;Tue Jul 20 03:50:41 EDT 2010;Committer;nobu;3;56;32;88;0
1433c13b257fcc5bb03217932b61a638be49d116;Tue Jul 20 03:28:03 EDT 2010;Committer;svn;1;2;2;4;0
878384483d99fd4b887c5ddf44765b4178e72e42;Tue Jul 20 03:27:59 EDT 2010;Committer;nobu;3;26;1;27;0
b698066bbd6a760658a38971958adf08f0ec685c;Mon Jul 19 11:36:23 EDT 2010;Committer;akr;1;35;35;70;0
a0d5258df027dd309f4208cdff89084eb24b904f;Mon Jul 19 09:35:31 EDT 2010;Committer;akr;3;30;5;35;0
79dfc605ff239213cc67d9e5429669764f52a0c7;Mon Jul 19 05:45:14 EDT 2010;Committer;nobu;1;1;1;2;0
8ef7bb8c211d156b33f1f97f7c500e5b465fdf5b;Mon Jul 19 04:54:06 EDT 2010;Committer;tenderlove;3;7;8;15;0
87d8a3b9ce775529f8fee6d39061cd958092bf1e;Mon Jul 19 03:33:33 EDT 2010;Committer;nobu;2;9;1;10;0
4d5eee3602b8e6ed342d184b07c416f3c685da90;Mon Jul 19 00:01:02 EDT 2010;Committer;nobu;2;13;8;21;0
cc6294a73ac6ecd6d4223a4a9ecea122119e776f;Sun Jul 18 20:46:13 EDT 2010;Committer;nobu;3;10;2;12;0
10a90fbce86c20f98dc4499eb0a34d9f347fdd29;Sun Jul 18 12:20:14 EDT 2010;Committer;nobu;2;10;2;12;0
25b9eb5e5746665ca098f7117ba207692b2bd78d;Sun Jul 18 07:31:54 EDT 2010;Committer;nobu;25;119;70;189;0
ad654fe58e0355096fba7e1ae5b5f06eea62c200;Sun Jul 18 03:23:10 EDT 2010;Committer;nobu;1;2;2;4;0
abb855513ca83e987b3a2a7a86066fd798fc8558;Sat Jul 17 23:33:16 EDT 2010;Committer;akr;1;1;0;1;0
4acc8102eb0500327864d07aa09d70fdf7d16694;Sat Jul 17 16:12:49 EDT 2010;Committer;akr;1;11;11;22;0
17749e51681383304984f310a14a2939e554b593;Sat Jul 17 16:10:19 EDT 2010;Committer;akr;2;5;0;5;0
fffb949e47a94bb84882c7388fca158f228984d4;Sat Jul 17 15:03:34 EDT 2010;Committer;svn;1;2;2;4;0
03bb750d5654f4ff4890fd1d39e680ac0860340f;Sat Jul 17 15:03:31 EDT 2010;Committer;akr;3;45;15;60;0
327da86aafc7cb4f5437ed0a9c46f61260aedf56;Sat Jul 17 10:01:49 EDT 2010;Committer;nobu;4;124;61;185;0
c68de8ee083eb80c2e11f019ff1504a60871901f;Sat Jul 17 09:30:54 EDT 2010;Committer;akr;2;28;16;44;0
e4820b1cfadbd7cbd5713d774a0bc0db527e479d;Sat Jul 17 05:10:22 EDT 2010;Committer;nobu;2;9;5;14;0
4bf3cb5ba9c0242bd5a6d0d55b7db9f837c09edf;Sat Jul 17 04:50:19 EDT 2010;Committer;akr;6;1077;1053;2130;0
c04d79f8674aba919400e0469bfdd8cf5fc4c5df;Sat Jul 17 04:04:51 EDT 2010;Committer;nobu;3;16;1;17;0
3f01f3b6dbebbaa0117487c28b36b5c71d2eba1b;Sat Jul 17 01:08:08 EDT 2010;Committer;svn;1;2;2;4;0
43f3e3779cd0b163b268ff4445f4303d8d484e57;Sat Jul 17 01:08:04 EDT 2010;Committer;nobu;4;46;9;55;0
d98d3fe12a46203b056c23f50d845028e3a73a7a;Fri Jul 16 13:09:44 EDT 2010;Committer;mame;4;12;35;47;0
048d2e6d32315e13962a01e8df6459487c57b98c;Fri Jul 16 07:40:37 EDT 2010;Committer;nobu;2;5;6;11;0
96863dc358cc86435099627a7afc1ec58a1fd79c;Fri Jul 16 05:58:39 EDT 2010;Committer;nobu;4;42;7;49;0
adf37e2fde99839f62554e5ddbc8fbd2807e2300;Fri Jul 16 03:06:10 EDT 2010;Committer;nobu;3;7;3;10;0
b79e96ae62bf61530c955053c61125f652c2a8fe;Thu Jul 15 12:55:23 EDT 2010;Committer;mame;2;7;1;8;0
dc7ba7e49a62ada70e20a971542841ca9057a0b9;Thu Jul 15 12:39:36 EDT 2010;Committer;mame;2;5;0;5;0
b4608406f17097508d4666ceacf8764a746efa3e;Thu Jul 15 06:55:42 EDT 2010;Committer;naruse;3;12;5;17;0
1df8d6dbc37d3da200a8335f053bbf554984081f;Wed Jul 14 21:13:41 EDT 2010;Committer;tenderlove;3;23;2;25;0
b782aea75f5b9e8d49ef12b9f7fe3ef0dbf9fd51;Wed Jul 14 21:05:00 EDT 2010;Committer;akr;3;20;3;23;0
874224888489924c3674b2f9a7c3f1caeac47400;Wed Jul 14 17:44:51 EDT 2010;Committer;tenderlove;2;26;12;38;0
853c7211272aa377bb34bb19981e6666427dcc52;Wed Jul 14 15:38:33 EDT 2010;Committer;svn;1;2;2;4;0
8ffda7cd1467f55866c9c5c433ae9a95b510ee2e;Wed Jul 14 15:38:30 EDT 2010;Committer;akr;3;76;31;107;0
0f36e8fc03a5c6433972d6bb5f177d5f6e106bac;Wed Jul 14 11:23:10 EDT 2010;Committer;nobu;7;57;1;58;0
e53a46a58b76fc8c8f43fb0cc389948e77be44ff;Wed Jul 14 10:04:02 EDT 2010;Committer;knu;1;2;0;2;0
93f3c3adf868dcb7e7d49825ce9536c124dee634;Wed Jul 14 09:22:42 EDT 2010;Committer;svn;1;2;2;4;0
9ac0263c2fca2f45f85e372108328097aeadfed6;Wed Jul 14 09:22:39 EDT 2010;Committer;naruse;2;7;2;9;0
2dbc92b07d903fa6db9eb1c79001c8a7d8896ca5;Tue Jul 13 12:34:19 EDT 2010;Committer;nobu;2;9;0;9;0
afbd5661a0ca041ac818c9e5732911c5db21c9f9;Tue Jul 13 12:31:17 EDT 2010;Committer;nobu;2;22;9;31;0
52aa6ab21dcf2e0c6cb0190fbc4f8276248ade6b;Tue Jul 13 12:28:37 EDT 2010;Committer;nobu;3;13;3;16;0
9a8440e5d46c67f9938b58d7491659d094c7c4b2;Tue Jul 13 12:26:16 EDT 2010;Committer;nobu;1;1;1;2;0
9afb0f0837976093225442c37283cdeacb573a29;Tue Jul 13 12:01:45 EDT 2010;Committer;nobu;2;24;13;37;0
7035fd60088016c75814d08cf69c2d9492bba90a;Tue Jul 13 11:58:58 EDT 2010;Committer;nobu;2;30;2;32;0
7aa4c13360447c3b853d19bf19c068678c4d1656;Tue Jul 13 11:46:01 EDT 2010;Committer;nobu;2;6;1;7;0
c483dcea7d90593df29739387c7b81b8582b37cd;Tue Jul 13 04:15:33 EDT 2010;Committer;svn;1;2;2;4;0
29b4247ca1fc4a70ca99b1f99fbc552f78780ff0;Tue Jul 13 04:15:30 EDT 2010;Committer;naruse;2;16;0;16;0
6d7ee07a93a78ec7d3e1dcb53395e9b215112460;Sun Jul 11 16:59:14 EDT 2010;Committer;svn;1;2;2;4;0
70510d026f8d86693dccaba07417488eed09b41d;Sun Jul 11 16:59:10 EDT 2010;Committer;marcandre;10;38;21;59;0
c6820cc3bea5476f605a51e38c1207d266f45ff6;Sun Jul 11 12:20:28 EDT 2010;Committer;nobu;3;19;6;25;0
9d64fe7ed207ae4cb74e433159ccd1bd98394da9;Sun Jul 11 10:05:27 EDT 2010;Committer;mrkn;1;1;0;1;0
a3de9759e03f6d10f3e2dda43a4081d0e72fa39b;Sun Jul 11 08:01:59 EDT 2010;Committer;nobu;3;6;7;13;0
9d3d606907e3b4b3ac239d7a53d242e6b43f1e5a;Sun Jul 11 06:36:21 EDT 2010;Committer;nobu;3;11;3;14;0
9c37d74a8c9e999a494fdff1cf01945e19b53ba6;Sun Jul 11 02:09:13 EDT 2010;Committer;svn;1;2;2;4;0
7ea26779ab3d41f050febdccfb2583a0160cda1d;Sun Jul 11 02:09:09 EDT 2010;Committer;mame;2;9;0;9;0
d06a6b22f59012399236597101dafbba7a884f70;Sat Jul 10 12:43:54 EDT 2010;Committer;akr;2;7;2;9;0
a26417fec9ced9360e3d51fd9ad21910056e22aa;Sat Jul 10 11:26:55 EDT 2010;Committer;svn;1;2;2;4;0
9c9cef7fe360c4788df1676d1328f70bb857d489;Sat Jul 10 11:26:54 EDT 2010;Committer;akr;1;68;28;96;0
e51e679f14f61f260275e97b6624bfcbae7c9c39;Fri Jul 09 13:33:39 EDT 2010;Committer;akr;2;4;28;32;0
98e949f7f8d9dbee8a22f2b2bc1d41f209345b7c;Fri Jul 09 12:21:43 EDT 2010;Committer;akr;1;58;22;80;0
85f10041b2400a8c87cf718df642e0003ec797ac;Fri Jul 09 12:21:26 EDT 2010;Committer;akr;2;6;0;6;0
6f1c1b496e7a5866f9b50b27650473ef1be5d85b;Fri Jul 09 12:04:26 EDT 2010;Committer;akr;2;5;44;49;0
00f97ed41a56f8146a8066db0934b574615b9760;Fri Jul 09 11:33:46 EDT 2010;Committer;akr;3;24;1;25;0
4eec1b31b90f89101a482600770df1faae041a13;Thu Jul 08 16:51:28 EDT 2010;Committer;tenderlove;1;2;5;7;0
a5dec230451cfbfa5df77c2d9f7e8dc5d8c568e4;Thu Jul 08 16:10:10 EDT 2010;Committer;tenderlove;3;13;0;13;0
8d44c908cac7981e7e8d386c2095f3f559437e14;Thu Jul 08 16:02:29 EDT 2010;Committer;svn;1;2;2;4;0
ba9a959a183d08df424b822bb188d148d4fade43;Thu Jul 08 16:02:26 EDT 2010;Committer;tenderlove;4;42;1;43;0
74d40e41961903f91894463504d4af60acc93058;Thu Jul 08 14:39:09 EDT 2010;Committer;akr;1;78;54;132;0
9818dd26e5eccbd05004ddce29cef1924822d185;Thu Jul 08 13:05:41 EDT 2010;Committer;akr;1;0;77;77;0
c2e127a768bb22299cbeeada5b0d4d8e90a5425a;Thu Jul 08 13:05:17 EDT 2010;Committer;akr;1;2;0;2;0
3a6fd339d54dc9b11a137567d6b1aefe5f3ec53d;Thu Jul 08 08:18:07 EDT 2010;Committer;naruse;2;10;4;14;0
646b6995362aff14abfc08db24d091d01f5879d0;Wed Jul 07 23:18:27 EDT 2010;Committer;tenderlove;3;41;1;42;0
3a185ede69ac5845aebbde38dc8e6fbe4f64308a;Wed Jul 07 23:05:45 EDT 2010;Committer;tenderlove;8;73;8;81;0
a5d37d10a9e18952badcf821679104613590e779;Wed Jul 07 21:07:01 EDT 2010;Committer;akr;4;69;10;79;0
8f11f4bcb4e3ed3b087d19a163f3efda7de07821;Wed Jul 07 15:40:55 EDT 2010;Committer;svn;1;2;2;4;0
d1de97e0bcdb0f9b79cc3dbce843c4a8ac705443;Wed Jul 07 15:40:52 EDT 2010;Committer;mame;4;40;15;55;0
ce9c95293757a211bf9dcdb45908a835e5080f7d;Wed Jul 07 10:59:44 EDT 2010;Committer;shyouhei;2;5;5;10;0
09e1383bcf4cb28a9a55e7d25277194b0222d051;Wed Jul 07 04:22:30 EDT 2010;Committer;usa;2;16;6;22;0
42f4a548f0e8ad0fa22a4132b164c7ab76e3bf45;Wed Jul 07 04:06:32 EDT 2010;Committer;knu;3;28;14;42;0
2520f3f79c0b65894cea4914c041f06b8d29b41a;Wed Jul 07 03:03:19 EDT 2010;Committer;usa;2;5;1;6;0
01e1a0ac78217f912115df046f5ae07dc146176f;Wed Jul 07 02:44:04 EDT 2010;Committer;nobu;3;58;4;62;0
8ff0574198d1d32c7f80044c611d54f6e3b1aace;Wed Jul 07 01:29:22 EDT 2010;Committer;naruse;4;80;1;81;0
492d8e67d792fea29e48bbbec2b953c4e31c69b9;Tue Jul 06 22:02:25 EDT 2010;Committer;nobu;1;2;0;2;0
415a3ef9ab82c65a7abcba4a7d5b0a982af0b4d4;Tue Jul 06 16:06:21 EDT 2010;Committer;svn;1;2;2;4;0
3b87ff32de3d97780e7b077aabebc5b56a8283ab;Tue Jul 06 16:06:20 EDT 2010;Committer;tenderlove;3;16;9;25;0
5bf4c6a635d30ba2e209fa9a2f824e06a6fa479b;Tue Jul 06 13:59:12 EDT 2010;Committer;akr;2;7;2;9;0
80b9fb5a7b9b96589d3b096e42af2796b07b560d;Tue Jul 06 12:47:18 EDT 2010;Committer;usa;2;6;1;7;0
1be8c17f0b843d569f463430c8513d38dbccd194;Tue Jul 06 11:18:58 EDT 2010;Committer;usa;1;14;0;14;0
13f5a607fb3e1269b079bb7a262addd7e718791b;Tue Jul 06 01:23:07 EDT 2010;Committer;tenderlove;1;3;1;4;0
bb7b62af8ddff241b3ebfbd045f75da61d1de441;Mon Jul 05 23:39:51 EDT 2010;Committer;tenderlove;1;1;0;1;0
ff10d93563e740d02a7a9815df9bd7b7d4b6d3d5;Mon Jul 05 23:38:35 EDT 2010;Committer;tenderlove;3;21;2;23;0
c27e0ebab690d2a6c709a5a2c83af2d7a4968492;Mon Jul 05 23:12:44 EDT 2010;Committer;tenderlove;2;5;5;10;0
f32ae44629199af0462be3ac15359a9ad7c56999;Mon Jul 05 18:14:37 EDT 2010;Committer;tenderlove;1;1;1;2;0
68ab3ede30d3e644c220a6fe3b0732b2442bcc6c;Mon Jul 05 15:57:20 EDT 2010;Committer;mame;2;10;0;10;0
0fa3c65b66f6f14436803fd480812d26cddb9cc9;Mon Jul 05 15:32:38 EDT 2010;Committer;svn;1;2;2;4;0
4f7b82475a23cdd8edeb7130f4096488b973335d;Mon Jul 05 15:32:35 EDT 2010;Committer;mame;2;6;1;7;0
78a78b45d69c44a5d9278c8f22a83f953b70d219;Mon Jul 05 07:11:44 EDT 2010;Committer;knu;4;81;2;83;0
b2e340bf70a6cc09dc67ae0a45ed37c68b342d3d;Mon Jul 05 03:34:00 EDT 2010;Committer;svn;1;2;2;4;0
ce2e7368d73b762a86690fe3531e0754301299be;Mon Jul 05 03:33:56 EDT 2010;Committer;tenderlove;3;24;17;41;0
9f56a870af1c88430a053b4e50ba39c244a4bd57;Sun Jul 04 13:50:34 EDT 2010;Committer;akr;3;26;19;45;0
c5de4d4cbd28c1763259f814c4cc29ea01e6af59;Sun Jul 04 13:03:04 EDT 2010;Committer;akr;2;6;29;35;0
16923c25a1d1d3bcb8177737a682cc1084de8c2b;Sun Jul 04 12:01:46 EDT 2010;Committer;akr;3;32;28;60;0
6fb59decd09488d0eafa683650c5c090d72c460b;Sun Jul 04 08:13:15 EDT 2010;Committer;nobu;3;31;3;34;0
7ef57c613a8c5f4ee25763ca4e047ea05bd31e4c;Sat Jul 03 15:44:13 EDT 2010;Committer;svn;1;2;2;4;0
4b31e99b8f254c93af6acb9746dcd68109e5957f;Sat Jul 03 15:44:12 EDT 2010;Committer;akr;1;4;1;5;0
d24d2d3ca4558aee0feed31b71c3268a13ef685b;Sat Jul 03 14:29:26 EDT 2010;Committer;akr;1;60;9;69;0
1c3e07f0d6d237222192f41c84716c15731b3158;Sat Jul 03 07:47:00 EDT 2010;Committer;mrkn;5;43;3;46;0
59cad45f9963b359b16c1b9a9324b78e5e0873d5;Sat Jul 03 00:52:43 EDT 2010;Committer;tenderlove;5;65;13;78;0
6fe92a3cd6b4116580ff7663180407bc0c38030f;Sat Jul 03 00:15:51 EDT 2010;Committer;tenderlove;4;14;9;23;0
fcb613ae477e7bf1aeb8d7c6a15ddf2585d514e7;Fri Jul 02 15:01:55 EDT 2010;Committer;svn;1;2;2;4;0
9c1884066726007588f9c212c5d9b9e04a2d7654;Fri Jul 02 15:01:54 EDT 2010;Committer;akr;1;3;3;6;0
fc90d4a10969321f5ec75a3a2a513f11407a9602;Fri Jul 02 14:58:16 EDT 2010;Committer;akr;1;3;3;6;0
09ee12bb20f037233228ae546dc352b0a669cc23;Fri Jul 02 14:31:26 EDT 2010;Committer;usa;4;168;95;263;0
8f4c474bd374010dac656c0a6eff7157edd87252;Fri Jul 02 08:40:51 EDT 2010;Committer;nobu;1;2;1;3;0
707d22f1dd19cc18bed95f17374d1081d0efd248;Thu Jul 01 21:04:10 EDT 2010;Committer;akr;1;2;0;2;0
55da5c46031b6512600c8fa1956b4c89529b8bdd;Thu Jul 01 20:39:35 EDT 2010;Committer;svn;1;2;2;4;0
26202fba935372c269d690b4273b96e61ef58b7c;Thu Jul 01 20:39:32 EDT 2010;Committer;akr;2;24;6;30;0
5d229db887ec42178ef90c20c014d5073c49cc6f;Thu Jul 01 14:11:02 EDT 2010;Committer;jeg2;2;12;0;12;0
8bab1aff2c6b9cdb5f840691f98fc078ce9b7cb9;Thu Jul 01 13:34:13 EDT 2010;Committer;akr;2;6;1;7;0
e12c43ee8c92ba028ab53b9b9d76bf919bd0f563;Thu Jul 01 13:09:04 EDT 2010;Committer;nobu;1;101;0;101;0
57ba9de9e01401ca670c85f363c7496ab0dde148;Thu Jul 01 12:37:58 EDT 2010;Committer;nobu;2;47;185;232;0
6957c6d9cf0b6a1e211c4b0175bc5474296f2031;Thu Jul 01 07:25:20 EDT 2010;Committer;naruse;2;10;0;10;0
678f6b37164303417c04a93e855af11cc6d1be62;Thu Jul 01 04:00:56 EDT 2010;Committer;nobu;2;6;1;7;0
12b0ccc20483de26021d092155a722b22a225afe;Wed Jun 30 23:40:37 EDT 2010;Committer;nobu;2;12;3;15;0
64bcb87cc6cf6907108e76d51d9e43b305f73e38;Wed Jun 30 22:14:39 EDT 2010;Committer;svn;1;3;3;6;0
211618419019f66e077e56e52c8a04f4db907a96;Wed Jun 30 22:14:38 EDT 2010;Committer;marcandre;1;53;35;88;0
1f7eb6e7aed27b1618adf2b443be93c8eab1a395;Tue Jun 29 22:29:12 EDT 2010;Committer;nobu;2;17;4;21;0
14a70cf7b10fc3011eb939407c6e98d5b74920fb;Tue Jun 29 17:29:30 EDT 2010;Committer;svn;1;2;2;4;0
78d48a330d481948f1d899d72ae5b122b7756533;Tue Jun 29 17:29:27 EDT 2010;Committer;kanemoto;3;19;1;20;0
a9ffa5cecf5e84d78cfc5ecd9b1dcaedb162a1fa;Tue Jun 29 12:20:52 EDT 2010;Committer;tarui;1;0;1;1;0
952b1bf355b8fb4f8d05dfef18eb12236c5dc02d;Tue Jun 29 12:12:07 EDT 2010;Committer;tarui;2;6;0;6;0
835da2f07b41655296a1a73d56bf3c97d3c6275f;Tue Jun 29 10:49:38 EDT 2010;Committer;suke;2;6;1;7;0
cb7a106c211a6eb9de454c46b113ded60d2ef24a;Tue Jun 29 06:22:08 EDT 2010;Committer;usa;1;4;0;4;0
e2f4729d42555b285d6da595f7e3de733f023e27;Tue Jun 29 05:20:06 EDT 2010;Committer;usa;2;22;4;26;0
12b76ec890836ee650b7985851116594d6469309;Tue Jun 29 03:11:05 EDT 2010;Committer;nari;2;32;11;43;0
3e8540543e4037ff58ae4ea2d8fabad1c56c0e29;Mon Jun 28 21:22:57 EDT 2010;Committer;nobu;1;2;2;4;0
18bbb1cfc85d2ea93fb9e69d09f4004d274ac8c6;Mon Jun 28 17:28:52 EDT 2010;Committer;tarui;2;2;0;2;0
50bb2544bb38cef85cae6467763d0fde336f9ee3;Mon Jun 28 16:26:59 EDT 2010;Committer;tenderlove;2;54;0;54;0
f6a93900dc95beb85240c48d2e5ae06039b8a69d;Mon Jun 28 16:01:23 EDT 2010;Committer;svn;1;2;2;4;0
5f960a9ca26a3c4205aa9de7f0d961f0fe225935;Mon Jun 28 16:01:22 EDT 2010;Committer;tarui;3;6;12;18;0
5b5c6378c7758af3b264972250f715c054ed0a37;Mon Jun 28 13:16:17 EDT 2010;Committer;mame;2;11;3;14;0
82f7a9823642a46ca021794de5efc9c9c894d0e7;Mon Jun 28 13:05:07 EDT 2010;Committer;akr;1;128;126;254;0
d9d650ecfd0cc8336c7a08da50ff4b076e6c3ee5;Mon Jun 28 12:58:03 EDT 2010;Committer;mame;2;9;2;11;0
392255310cb3922a53bde134ea46cdeeec4798b0;Mon Jun 28 11:38:48 EDT 2010;Committer;suke;2;9;19;28;0
19e835f952baed4f466fbc0eb836460cd86264e9;Sun Jun 27 20:36:12 EDT 2010;Committer;mame;2;8;3;11;0
be1c68caeb878f6822e9720687152b41dcc160a5;Sun Jun 27 18:13:06 EDT 2010;Committer;mame;2;11;0;11;0
9b94dabe77d39e72f9694ba81c8d04111ea844ee;Sun Jun 27 17:47:21 EDT 2010;Committer;mame;2;7;0;7;0
fff5de3bd418ebb58d5a620403f9da488c7e7148;Sun Jun 27 15:13:25 EDT 2010;Committer;nobu;2;6;6;12;0
a67f1a9534322914367d6eb17eb01badd87e7f79;Sun Jun 27 14:31:19 EDT 2010;Committer;nobu;5;43;22;65;0
d9edd4ca87bff687dc9548de6517792443746ddd;Sun Jun 27 04:30:31 EDT 2010;Committer;akr;2;13;2;15;0
165ebcd5acbf65373418db78a5e932c08f5a2bf6;Sun Jun 27 03:10:20 EDT 2010;Committer;marcandre;1;1;1;2;0
3ca40d253132156f7a056a1f4be3b66c6745f98a;Sun Jun 27 01:41:40 EDT 2010;Committer;nobu;3;13;11;24;0
967e3a3598143df7fdecbb3e1b7bf45789bd2211;Sat Jun 26 04:07:20 EDT 2010;Committer;nobu;4;23;0;23;0
8508e37b515804bb6774e79ab774ef7cc696c9cf;Sat Jun 26 02:56:41 EDT 2010;Committer;nobu;2;7;1;8;0
6f957923472fe57ff1dc29644f9b874d87ad191b;Sat Jun 26 01:08:46 EDT 2010;Committer;nobu;2;7;1;8;0
a2fde3fc79aefe1666a726b858a71ddcacc3e180;Fri Jun 25 23:45:42 EDT 2010;Committer;mame;2;6;0;6;0
7e195fa7347ec7cc3c2cc633ee03f4ee2f29fb4f;Fri Jun 25 23:05:32 EDT 2010;Committer;suke;2;28;1;29;0
52b05d259f1bbf5ebf3216d53d01c7247424b8e1;Fri Jun 25 19:43:21 EDT 2010;Committer;svn;1;2;2;4;0
db4a0d42dd03b942ab86843c4286a66362cfd6ff;Fri Jun 25 19:43:15 EDT 2010;Committer;tarui;3;20;2;22;0
b652b55c51779ce5f22b636e6a2106f26a2eb55b;Fri Jun 25 14:17:51 EDT 2010;Committer;jeg2;1;1;1;2;0
effa0c76d9813a2a823531cf15e4f62702fd1571;Fri Jun 25 02:59:20 EDT 2010;Committer;jeg2;3;29;2;31;0
89a3e2ed7acd822f23caa69b4d384e767c7140d7;Fri Jun 25 01:07:29 EDT 2010;Committer;nobu;2;5;1;6;0
fdf5a3dd8da72ae1ab63bd6712597a42e5a36b22;Fri Jun 25 00:58:57 EDT 2010;Committer;nobu;2;9;13;22;0
9f16d373f3fcd1113f82f1f2b48c990c78113094;Fri Jun 25 00:57:03 EDT 2010;Committer;nobu;2;7;2;9;0
13158c4d79aaf6d2d7f71804a5acf4bff0def168;Thu Jun 24 21:25:03 EDT 2010;Committer;nobu;1;5;1;6;0
4fcc6f1ef1428f6357150695843ca314c6e1d5a1;Thu Jun 24 21:15:33 EDT 2010;Committer;nobu;2;6;3;9;0
a4d39115034313b70addd078e6997d94c8685064;Thu Jun 24 20:49:37 EDT 2010;Committer;nobu;2;9;2;11;0
430088224994c14f6652f96eafccdbb69ca46e3e;Thu Jun 24 16:11:19 EDT 2010;Committer;svn;1;2;2;4;0
12c2e07a3de52d139baf206b215ead95861c7da8;Thu Jun 24 16:11:05 EDT 2010;Committer;tarui;2;11;0;11;0
f5ea2822e6aab93b2b9a4f52d27f059dc4a9c43e;Thu Jun 24 13:38:34 EDT 2010;Committer;akr;1;1;1;2;0
90b1eb1317f4687c4a471c44d8c24a10e73c95f5;Thu Jun 24 13:37:58 EDT 2010;Committer;akr;1;2;0;2;0
f77d8722c2d7728e0e57c59751a373cba464efab;Wed Jun 23 21:24:31 EDT 2010;Committer;akr;2;26;20;46;0
23af1d2a4bd3dd09de1b82e0bc216fcd4d148b41;Wed Jun 23 20:44:44 EDT 2010;Committer;nobu;2;27;32;59;0
78cfe7155500018476d7d49fc717fbeefcd4fba5;Wed Jun 23 15:05:50 EDT 2010;Committer;svn;1;2;2;4;0
512a35693b7819d6acc30a0e0b916c5ee7a88b5c;Wed Jun 23 15:05:25 EDT 2010;Committer;akr;2;9;4;13;0
70003c05a7034a37d43eca168960f8d6bc740d8d;Wed Jun 23 14:47:00 EDT 2010;Committer;mame;2;8;0;8;0
89f2c44d376033435a83fbbf795051bebb32bd13;Wed Jun 23 13:56:20 EDT 2010;Committer;akr;2;5;1;6;0
0864df17fbc41780e51e100ad64bd264f970d386;Wed Jun 23 12:41:26 EDT 2010;Committer;suke;2;13;3;16;0
eab33b597d7f1460566fbe3c3a3e8f47024ce71f;Wed Jun 23 12:35:04 EDT 2010;Committer;akr;1;1;0;1;0
acb8b3f7a99cd692da469e8ee729a6b6ec11c85d;Wed Jun 23 12:25:07 EDT 2010;Committer;akr;3;42;0;42;0
80684e9c09338adcbbf1bc4827938f28178e84c1;Wed Jun 23 08:25:12 EDT 2010;Committer;nobu;14;380;380;760;0
c7d001465cdb2956b6d0804b1ab34104846275ce;Wed Jun 23 08:12:54 EDT 2010;Committer;nobu;5;59;32;91;0
0de2d84af82935ba01ba1d3328c9fdcf287bf3e1;Wed Jun 23 05:32:46 EDT 2010;Committer;naruse;9;12;17;29;0
d514cd3ca0dedfd62e86698e53b4dc01dff75ed2;Wed Jun 23 03:44:55 EDT 2010;Committer;nobu;3;16;3;19;0
596a275035e2cd7ef4bd86f344f54fa4dd31c54e;Tue Jun 22 22:00:23 EDT 2010;Committer;nobu;1;2;1;3;0
419d8cd6a278cb6e8053bf2cb0670012ed561cb7;Tue Jun 22 21:44:37 EDT 2010;Committer;nobu;2;4;2;6;0
6e708d72bb713ca9c7f8b25aa1f6ee8d8e83282a;Tue Jun 22 21:43:02 EDT 2010;Committer;nobu;3;18;4;22;0
bf8cec6db1cf9568a808449186f0bdb4e853ee36;Tue Jun 22 14:13:09 EDT 2010;Committer;akr;2;36;17;53;0
7d8d8c4f590982b47eaeb0ea0c447b29d6eeff82;Tue Jun 22 13:41:16 EDT 2010;Committer;akr;2;5;2;7;0
85a4f84e79ac0e7f7a57c7979190ca6072cf136c;Tue Jun 22 12:33:33 EDT 2010;Committer;nobu;2;7;4;11;0
2926a585ffba2029ea8b2be6b25a2f13b743a1be;Tue Jun 22 10:57:40 EDT 2010;Committer;nobu;2;9;0;9;0
4349da9c1be4f9584c156a1bff8a51b59e3a65f5;Tue Jun 22 05:46:01 EDT 2010;Committer;marcandre;1;1;1;2;0
fde37bb6e3adec8591a82798d4d2e008cee51c57;Tue Jun 22 05:45:22 EDT 2010;Committer;marcandre;1;2;2;4;0
52ebd4b7f48a443152bf09343d81f57e783c0c63;Tue Jun 22 04:52:03 EDT 2010;Committer;marcandre;1;4;3;7;0
8af6c8ddc249fc058994244f9d7823b1ecd07b67;Tue Jun 22 04:24:15 EDT 2010;Committer;svn;1;2;2;4;0
6233ed4dcd0892b8ac2cd6acdbee3633db34b636;Tue Jun 22 04:23:59 EDT 2010;Committer;marcandre;2;42;4;46;0
52fcd9975d57888629520e38a489a6b66396e0fd;Mon Jun 21 14:44:06 EDT 2010;Committer;svn;1;2;2;4;0
99299e1961202fa396def185f4db2d6f4711dce3;Mon Jun 21 14:43:58 EDT 2010;Committer;wanabe;3;29;1;30;0
d31350f827b02bbbd5154e8a34cbe55c49240af9;Sun Jun 20 07:17:46 EDT 2010;Committer;nobu;4;12;6;18;0
14a15f8b7f21d26fdeaa9acd0d886ede9acb57c7;Sun Jun 20 06:14:22 EDT 2010;Committer;nobu;2;5;2;7;0
47fb01e35bda888642efa577b08c3626a1eb199f;Sun Jun 20 05:41:07 EDT 2010;Committer;nobu;4;76;9;85;0
7a8a264f1d5e656fb2168f5d35e68eb0e49b4c2e;Sat Jun 19 02:12:40 EDT 2010;Committer;matz;2;9;4;13;0
b77773f44dfbd7eacc115d0a20ac6cab7d118e42;Fri Jun 18 18:39:15 EDT 2010;Committer;svn;1;2;2;4;0
b09ad2b8476d3e42d35ef8bf17cbfa94d45150e1;Fri Jun 18 18:38:19 EDT 2010;Committer;tenderlove;3;19;4;23;0
da3cdd2ddf9cabc4f50ee7461c04a24333c4eb34;Fri Jun 18 01:44:52 EDT 2010;Committer;naruse;4;18;4;22;0
72fa4d34c09a59c6127365832e8f04b50fdd9916;Fri Jun 18 01:16:13 EDT 2010;Committer;naruse;3;8;0;8;0
d35f8ea8858ab34733f35d3e0abf4f7a8fed54c9;Thu Jun 17 16:58:25 EDT 2010;Committer;mame;3;107;108;215;0
191ad1b157a2760a65aa146fb0caf5a22f273879;Thu Jun 17 16:26:10 EDT 2010;Committer;svn;1;2;2;4;0
ab408009fcca4b8b0d307857e1b7116ad1f4ff10;Thu Jun 17 16:26:00 EDT 2010;Committer;mame;2;12;2;14;0
2db572514cd9f5cc8957ab8f35f39650bb243ea7;Thu Jun 17 14:32:20 EDT 2010;Committer;mame;6;24;9;33;0
4df965f4ed21353b6e0c89ac8286c64c6266ec04;Thu Jun 17 09:46:30 EDT 2010;Committer;usa;3;33;7;40;0
f4d7a34c01256591004bc477c683868ef748f3bd;Thu Jun 17 06:11:08 EDT 2010;Committer;kazu;1;4;4;8;0
3a12a0463e028d6741b2d0bbbf6c1b1323914192;Thu Jun 17 01:04:16 EDT 2010;Committer;svn;1;2;2;4;0
86d72ac7cfcf5211fb6d2314df6e6d8601ff859b;Thu Jun 17 01:04:09 EDT 2010;Committer;naruse;3;6;69;75;0
4ac263ce680169626d150778e150a0b006ad70fb;Wed Jun 16 09:35:35 EDT 2010;Committer;usa;2;5;1;6;0
cf79bdc6d013687d99984dee5c79a07ea6ffca07;Wed Jun 16 09:20:14 EDT 2010;Committer;nobu;3;65;6;71;0
953f511bb9e8a2fb75b53546b7796936bc4c369d;Wed Jun 16 08:21:28 EDT 2010;Committer;nobu;2;6;5;11;0
de26eababa2e77e5c9274eac5633a62355bcc7b1;Wed Jun 16 06:41:56 EDT 2010;Committer;usa;2;6;1;7;0
3ccd6c0aab516bb1ca8402b985db83a90dbd0eb2;Tue Jun 15 16:43:46 EDT 2010;Committer;mame;2;9;1;10;0
06ecaa4943754f5c8d1c8f99ff1f7bf35458e8b1;Tue Jun 15 15:08:35 EDT 2010;Committer;svn;1;2;2;4;0
29b22ba2c618801116abeac5f01c0e8bdc24dfc9;Tue Jun 15 15:08:29 EDT 2010;Committer;mame;2;28;15;43;0
6e10636d32a7b90f0636cfb9cda42ca68350a6ba;Tue Jun 15 08:16:33 EDT 2010;Committer;eban;2;5;1;6;0
77f0c30612e4b3c924018c272dcfe33f0a5bcc0a;Tue Jun 15 04:48:42 EDT 2010;Committer;naruse;1;3;3;6;0
423b4d815f231654ecd506d21dfa12cedaef57d4;Tue Jun 15 03:14:34 EDT 2010;Committer;eban;2;5;1;6;0
895b0d4cdb9f3b99d0e67488cad69b1b148eddbe;Tue Jun 15 01:50:48 EDT 2010;Committer;naruse;1;3;3;6;0
a1a529e603dbe3b1323ce6a253d69050ad197394;Tue Jun 15 00:09:26 EDT 2010;Committer;nobu;1;1;1;2;0
1d408c933a3e07a6f314e8986733020ea746091b;Mon Jun 14 17:32:03 EDT 2010;Committer;nobu;5;28;8;36;0
3a4231cdf47dadb91ebc9b5c6835033540cd624b;Mon Jun 14 13:46:06 EDT 2010;Committer;akr;3;11;2;13;0
0556fa02de8da996d928fee64d59343827c8cadb;Mon Jun 14 09:36:44 EDT 2010;Committer;seki;1;1;1;2;0
b54b86d8985fa5828820cc7a01b20464d0f5caeb;Mon Jun 14 08:52:30 EDT 2010;Committer;seki;4;12;3;15;0
7eec027f0600ea84b9205f1bf35afd54592ca3f8;Sun Jun 13 19:06:25 EDT 2010;Committer;naruse;2;14;7;21;0
065b574bdda3609ffe6f46e9e8f97f7897e77fa1;Sun Jun 13 18:53:34 EDT 2010;Committer;svn;1;2;2;4;0
ca2402f5e4731466b02ba9fa43ffa4b3e7665654;Sun Jun 13 18:53:27 EDT 2010;Committer;naruse;1;3;3;6;0
d1dd727533a1df1b59553b5d3feec87bb1dd951f;Sun Jun 13 06:47:44 EDT 2010;Committer;mame;2;18;0;18;0
58f779170d9f2a93668c784063d36c34422fb491;Sun Jun 13 05:01:04 EDT 2010;Committer;naruse;1;3;3;6;0
0486db01fdf823c1efcd7bca1bd20f79cd76fd7a;Sat Jun 12 19:25:03 EDT 2010;Committer;marcandre;2;18;2;20;0
78f5b54f1b2cdacfc4fab9b37cc71a1d195d9424;Sat Jun 12 17:13:54 EDT 2010;Committer;naruse;4;17;10;27;0
051af24359916791ee09cc6c685d9668e780b61f;Sat Jun 12 16:40:25 EDT 2010;Committer;naruse;2;6;1;7;0
75033ea16f86679164eac5030c230ca50d86d1cf;Sat Jun 12 15:28:47 EDT 2010;Committer;naruse;2;5;1;6;0
2be632476e8f2b3db28e463ca7b1a2c0cf0f83b7;Sat Jun 12 15:28:44 EDT 2010;Committer;svn;1;2;2;4;0
5422161026d4b08f94bdfa39f6dcd266696de64c;Sat Jun 12 15:28:40 EDT 2010;Committer;naruse;2;9;0;9;0
d65d2384a6ef555f0eb10c65def1198f01e17e4b;Sat Jun 12 07:56:23 EDT 2010;Committer;nobu;1;13;0;13;0
99058e83be0849cf2995d60da10e4d19adbc1349;Sat Jun 12 04:06:34 EDT 2010;Committer;nobu;1;6;0;6;0
c0ea75f966dd6b402ff2d7016eeeaef12f95ebdf;Sat Jun 12 02:58:47 EDT 2010;Committer;nobu;1;10;0;10;0
622fb1ca50ca273924a2cd6ad58a6a6ff2a7f18e;Sat Jun 12 01:05:20 EDT 2010;Committer;matz;2;6;1;7;0
ff0252701e43f8f0ff40a5c4ba55977b5d902612;Sat Jun 12 00:20:27 EDT 2010;Committer;matz;2;7;1;8;0
fbfd5fdcb0ba290aa6f6634302cfd5a1cb4d1eb3;Fri Jun 11 23:03:28 EDT 2010;Committer;nobu;1;4;10;14;0
e1a52d82b04f1787477a558e34c6e0df8bed3b93;Fri Jun 11 21:47:41 EDT 2010;Committer;tarui;1;1;1;2;0
c4f3a04cc1a8cf088afe85660953839b5bf078ea;Fri Jun 11 21:34:44 EDT 2010;Committer;tarui;1;8;4;12;0
2acc30eead0f8653c7266e0d9365ece41f2f458f;Fri Jun 11 16:14:15 EDT 2010;Committer;akr;1;11;0;11;0
5e48356627d0ef216c8c44ff8b7f13b2e292127e;Fri Jun 11 15:47:59 EDT 2010;Committer;mame;1;1;1;2;0
ae18daf62c648bf3e02c0d63cc2e401c8b369a2b;Fri Jun 11 15:40:43 EDT 2010;Committer;svn;1;2;2;4;0
8af5f01a1775958654de459c47c3d2f2032d6701;Fri Jun 11 15:40:39 EDT 2010;Committer;mame;2;12;3;15;0
8c7786bf5831918da34d6614755ac303d8b21925;Fri Jun 11 14:26:57 EDT 2010;Committer;akr;2;7;1;8;0
78e3dfd95bd56ed4f1a81738e9c83899fd7c21b7;Fri Jun 11 14:06:23 EDT 2010;Committer;naruse;2;8;2;10;0
b04fa7b8e1877c871f0db8f4e6753712deeb6a29;Fri Jun 11 14:00:35 EDT 2010;Committer;akr;2;7;1;8;0
48c5afeba09c3d3098bff1176b79a7b169469dfd;Fri Jun 11 13:42:54 EDT 2010;Committer;mame;3;10;5;15;0
22ce9f81c335a81a3728ac4ef8faac965bc6fcbf;Thu Jun 10 22:37:40 EDT 2010;Committer;akr;2;6;2;8;0
cb962c5ae59f9237038d6400d9c1e709bed80efd;Thu Jun 10 15:45:34 EDT 2010;Committer;akr;2;9;3;12;0
42eca4f46e2cf48a0a1a66bc5d6599c8414bb67e;Thu Jun 10 15:27:07 EDT 2010;Committer;akr;1;6;2;8;0
5f8eeea3669cddbc607ac8a64e440039f86f0260;Thu Jun 10 15:15:49 EDT 2010;Committer;svn;1;2;2;4;0
670b62a61c9e26a34dce43fe1e6a50ad57c92923;Thu Jun 10 15:15:47 EDT 2010;Committer;akr;1;21;6;27;0
9c2a96885560cfb85e0f68793fd43dc71e7a467c;Thu Jun 10 14:54:50 EDT 2010;Committer;akr;1;64;38;102;0
094ca0281e1ddbfcd9d7c36363cea2222885527b;Thu Jun 10 14:10:25 EDT 2010;Committer;akr;3;20;5;25;0
ebda24ccd876257655305d73a9b2b496b381884a;Thu Jun 10 12:34:40 EDT 2010;Committer;akr;1;3;2;5;0
b06885ff4f38f0ed10cf5532f00034212092d834;Thu Jun 10 12:33:03 EDT 2010;Committer;akr;1;173;63;236;0
c659f4044671e55f833d0b308b90b75274f0d805;Thu Jun 10 04:31:08 EDT 2010;Committer;naruse;9;112;143;255;0
020bd635acc3f2f2c53ea1e55f0e6005677367c5;Thu Jun 10 00:11:26 EDT 2010;Committer;matz;2;15;3;18;0
55fb81e75f7d782648017e051c9b34f31953498e;Wed Jun 09 21:51:24 EDT 2010;Committer;svn;1;2;2;4;0
77f690583b8f1f4cbee7282e8d1ffc9ff15b1895;Wed Jun 09 21:51:21 EDT 2010;Committer;akr;1;136;0;136;0
82e646ea7a0874e762c7c7e335a53fef9a52deb0;Wed Jun 09 13:54:03 EDT 2010;Committer;akr;2;30;16;46;0
2560c3aaf7d0ba98445780d0634b9e6c6c1a76a8;Wed Jun 09 13:13:47 EDT 2010;Committer;svn;1;2;2;4;0
2a1d97cc1fc3699caf2b55943c12c63d5f8e6b6a;Wed Jun 09 13:13:44 EDT 2010;Committer;akr;2;23;5;28;0
b5f7766f72921bfecdd65a2121479943d263f065;Tue Jun 08 02:08:20 EDT 2010;Committer;nobu;1;1;1;2;0
2258b0c7efcc175f1aa27908db2b5c82e12e2d54;Mon Jun 07 21:28:54 EDT 2010;Committer;nobu;1;1;1;2;0
2b322524cdd0a5b6767eb72422cacc04b71902f2;Mon Jun 07 21:27:16 EDT 2010;Committer;nobu;12;171;113;284;0
c9331864f847a78550da88a780a5981bd283a6c7;Mon Jun 07 21:04:56 EDT 2010;Committer;nobu;3;18;10;28;0
550532d90224db0b860a2b52e37b8db9ebb28afa;Mon Jun 07 18:30:42 EDT 2010;Committer;nobu;1;1;1;2;0
f5534ad5b48e62d262883cf2165789ced4d06b3a;Mon Jun 07 18:30:35 EDT 2010;Committer;nobu;2;2;3;5;0
88eb029a2c88f60fe88b9c629fb492f55aeeade1;Sun Jun 06 13:37:23 EDT 2010;Committer;nobu;2;13;3;16;0
0363b91bf653453cf8900d66f35747e35ffabc03;Sun Jun 06 13:06:51 EDT 2010;Committer;nobu;1;5;0;5;0
ec440b0b570a10fd90e549af7c318fb4302eb9cc;Sun Jun 06 10:59:50 EDT 2010;Committer;akr;1;2;2;4;0
58772d711059308d874b092f42ef4a8ac65add3d;Sun Jun 06 10:56:45 EDT 2010;Committer;akr;2;6;0;6;0
6ae881af48b578f2f2ffd4248991ddb4534e8d54;Sun Jun 06 04:27:29 EDT 2010;Committer;tarui;1;2;2;4;0
28754d0aa9a61d401fad2791deda139338ba2df0;Sun Jun 06 04:12:20 EDT 2010;Committer;nari;2;29;16;45;0
c22b223cb0a48342cef7412e139313e60a913e71;Sun Jun 06 01:44:38 EDT 2010;Committer;nobu;4;22;0;22;0
f40d2c967005e49914046bbc6a7a8c06c46b1d38;Sat Jun 05 23:26:43 EDT 2010;Committer;akr;5;17;3;20;0
60d6d93b28da4686ee83632750ffa8df75988659;Sat Jun 05 23:21:20 EDT 2010;Committer;nobu;3;6;3;9;0
7376a528defdb622f52f18905168ec3163aabc2b;Sat Jun 05 13:47:09 EDT 2010;Committer;naruse;1;1;0;1;0
3a80743ccf57259ada074c1861592fe552c96459;Sat Jun 05 11:32:05 EDT 2010;Committer;naruse;3;63;22;85;0
0d49737b4f8fed8bd5224eda57382891c4492f46;Sat Jun 05 11:31:58 EDT 2010;Committer;naruse;2;9;1;10;0
291809f473ad009f6b42760b0aded72f320f6683;Sat Jun 05 11:31:54 EDT 2010;Committer;naruse;2;36;22;58;0
7f51312344e6634a4a4b93278466938026abb1f8;Sat Jun 05 11:28:23 EDT 2010;Committer;akr;1;1;1;2;0
0133aee46c576594b049629139f587f130ef249b;Sat Jun 05 07:39:47 EDT 2010;Committer;akr;2;5;1;6;0
af97da84edac2ccbacc9b10661002b1ddf86e7f8;Sat Jun 05 06:59:12 EDT 2010;Committer;nobu;3;13;8;21;0
2c2ae5b16450db3597815d190c557e82c10104d6;Sat Jun 05 06:15:55 EDT 2010;Committer;nobu;2;10;1;11;0
f75ab0150dfa44f00921f60f1e43b3b3637d62dc;Sat Jun 05 05:11:15 EDT 2010;Committer;nobu;2;6;0;6;0
159fd9ee6cd7583bc78d8d092b3f4ba5cded5508;Sat Jun 05 04:18:08 EDT 2010;Committer;marcandre;2;10;3;13;0
87c1da091cb9e9fdce5059dc2f27b89fbc705dc0;Sat Jun 05 04:17:44 EDT 2010;Committer;marcandre;1;16;20;36;0
d81b2491f7e59ae0fcd8d006736c4b41bb27d990;Sat Jun 05 02:01:29 EDT 2010;Committer;akr;2;11;1;12;0
8bca09325d9ce89fe32c0e6356865fcc905c7a2c;Sat Jun 05 01:04:15 EDT 2010;Committer;akr;2;11;2;13;0
2ef85089eca4a634a5619bc37084d276053f98ea;Sat Jun 05 00:57:02 EDT 2010;Committer;nobu;4;19;7;26;0
45815f9c9d334e0d7a0c40ba939661efdba08153;Fri Jun 04 23:30:48 EDT 2010;Committer;nobu;3;7;2;9;0
72992b97d35813a5d21c384b465517a361163717;Fri Jun 04 21:22:51 EDT 2010;Committer;svn;1;2;2;4;0
79aac054745e7f0180c2e3948a6553996b3e7c62;Fri Jun 04 21:22:47 EDT 2010;Committer;drbrain;4;9;7;16;0
c052958912009e52af0cd4261684783af5b4a5a3;Fri Jun 04 02:24:32 EDT 2010;Committer;tenderlove;1;4;0;4;0
da0ac85107ef9f26b68f0480b7c08893611d2be4;Fri Jun 04 01:46:36 EDT 2010;Committer;nobu;2;9;1;10;0
bc561d0b93f3f73b0e55a153e05b6543f193a344;Fri Jun 04 00:37:39 EDT 2010;Committer;svn;1;2;2;4;0
408f0a92ef62dfc4145ff9e7f1380937e5535296;Fri Jun 04 00:37:36 EDT 2010;Committer;usa;2;5;1;6;0
e1ef999dad8cf8f5f24e6896b631b06dc8bd4873;Thu Jun 03 14:59:44 EDT 2010;Committer;knu;1;12;4;16;0
24be1f14e65e567acb4f68addec7d5e481342378;Thu Jun 03 14:48:23 EDT 2010;Committer;knu;2;13;0;13;0
8984ef470547d0cb510a8937ae4b4f878f9eaba6;Thu Jun 03 10:33:57 EDT 2010;Committer;nobu;3;9;12;21;0
7336f32c3b42e36f496972b73fd56f0205804dcb;Thu Jun 03 09:58:32 EDT 2010;Committer;nobu;4;12;5;17;0
140d43a73f2ae2969a3acedf87852c77a687408b;Thu Jun 03 09:40:25 EDT 2010;Committer;nobu;1;0;1;1;0
55789617ae7178b4bebf84173c974451aca8dd9a;Thu Jun 03 09:17:49 EDT 2010;Committer;nobu;2;11;31;42;0
188881b2a886b7c75559d6774ec1783cf12de950;Thu Jun 03 04:05:20 EDT 2010;Committer;nobu;2;16;2;18;0
3a08f62b4f5cabd5e279abab17d3e332cfc0e5e0;Thu Jun 03 01:24:42 EDT 2010;Committer;usa;1;2;2;4;0
fdc432670238c967fd687e996c49c3f5e06b2e14;Thu Jun 03 00:38:59 EDT 2010;Committer;usa;2;6;1;7;0
325d06c7373a01b5aa5d147376f0fe31355334a1;Wed Jun 02 21:49:32 EDT 2010;Committer;nobu;1;0;1;1;0
d57a8a44a878ec5fb8714975a38ae99914da0f16;Wed Jun 02 21:30:23 EDT 2010;Committer;nobu;2;5;2;7;0
54fe5bf6e7209a99d9a3565b12efe1be751b349d;Wed Jun 02 21:25:18 EDT 2010;Committer;nobu;2;7;2;9;0
18b4480e31e83d6dfb0283075698613e0f852fa7;Wed Jun 02 20:42:29 EDT 2010;Committer;ryan;2;8;1;9;0
ed02f66eca55e3dd87219bb080f949f4346a15b2;Wed Jun 02 16:24:29 EDT 2010;Committer;nagai;2;13;4;17;0
2b71200ad47d45d2fecfd6f1284e1153695395f4;Wed Jun 02 16:02:52 EDT 2010;Committer;svn;1;2;2;4;0
230ca5ffe52421e68e2434d8ff25454f3abd5331;Wed Jun 02 16:02:48 EDT 2010;Committer;tenderlove;3;20;1;21;0
fabba1b93b0ae8e034a2ef3b9e0694ea01caad12;Wed Jun 02 14:06:25 EDT 2010;Committer;nobu;2;4;2;6;0
597d60f7920311ce595781d6683e5c0fe9298743;Wed Jun 02 07:49:00 EDT 2010;Committer;usa;1;6;4;10;0
35eb899004ebd1af668e1b9e96c34f677af10cbc;Wed Jun 02 03:05:11 EDT 2010;Committer;svn;1;2;2;4;0
276fb7e77b20b33f099a11c89e94388ffe3ae40d;Wed Jun 02 03:05:06 EDT 2010;Committer;matz;4;56;11;67;0
4c897fdde1fe20918a6577765b77c7d091a5ee98;Tue Jun 01 14:20:59 EDT 2010;Committer;naruse;2;6;0;6;0
ab70e53ac3b5102d4ecbe8f38d4f76afad29d37d;Tue Jun 01 12:30:52 EDT 2010;Committer;naruse;4;70;10;80;0
b64083376ef9fdd04ea48d7b4002934ab4f921b9;Mon May 31 18:48:16 EDT 2010;Committer;naruse;2;12;1;13;0
508e987ac64ca8447c7384183d298b44f1647d36;Mon May 31 16:16:45 EDT 2010;Committer;svn;1;3;3;6;0
f8bdd8dd08b021b71d234c1368d83ab7c9ebad49;Mon May 31 16:16:39 EDT 2010;Committer;tarui;2;9;0;9;0
d369a50c2bb5f40dee850b4de5f091b4a69181d4;Mon May 31 14:50:39 EDT 2010;Committer;nagai;5;585;120;705;0
a4702079b844cf415c047cbd45a501a13a0e0a23;Mon May 31 13:37:50 EDT 2010;Committer;akr;1;1;1;2;0
7011534ea865cd5fd19050388cc77495cabfba09;Mon May 31 12:51:13 EDT 2010;Committer;akr;2;7;1;8;0
3642fa19920a3ad567ead8b1211fdac9a4e963d1;Mon May 31 10:26:01 EDT 2010;Committer;nobu;3;11;2;13;0
4acf013ffd0fa36b278a742226fb853fb594d8a0;Mon May 31 09:27:06 EDT 2010;Committer;nobu;1;1;1;2;0
97a1d656f8deb0363921fc9d3a5a98d61dbceef5;Mon May 31 09:22:25 EDT 2010;Committer;nobu;2;6;1;7;0
455554b64ca84a11c11b5513efb5ace56af652e7;Mon May 31 08:47:08 EDT 2010;Committer;naruse;3;10;2;12;0
d16fc7ca69d497159cd7456ae76642a651396dad;Mon May 31 06:04:27 EDT 2010;Committer;naruse;3;15;1;16;0
d13e191d2593093f3c34a2cb6778d8676ca54d6f;Mon May 31 05:46:58 EDT 2010;Committer;naruse;2;7;1;8;0
b5cd43c998038156ecf5fc28e5138b7f88b9aafe;Sun May 30 19:03:47 EDT 2010;Committer;nobu;3;11;2;13;0
e0ad353fe0419b642fd1f6070e8527b61cb0e4ed;Sun May 30 17:20:15 EDT 2010;Committer;matz;2;14;2;16;0
b6e91b9ddf09ef89cb72207cd690bd079e3030b6;Sun May 30 16:43:56 EDT 2010;Committer;svn;1;2;2;4;0
89efbfe0fa7939d88fa7cce44df0c144cafd82f1;Sun May 30 16:43:52 EDT 2010;Committer;marcandre;2;41;4;45;0
1d06ff976184b4956a58a867132061c6a5902cd6;Sun May 30 13:19:09 EDT 2010;Committer;marcandre;3;34;0;34;0
d346b26be43140e8fb26f9e0cf8ea2793ba925ed;Sun May 30 12:53:08 EDT 2010;Committer;mame;2;5;1;6;0
d980b8f61a7126ea75a4f64d5343c4a5218feb16;Sun May 30 12:51:32 EDT 2010;Committer;mame;2;7;1;8;0
2a0c12cce4691a2cab93e17129768a06f0b132e5;Sun May 30 09:48:28 EDT 2010;Committer;naruse;2;11;6;17;0
208a51ffa3551bc7548aa878a46ebb72901110a1;Sun May 30 09:27:24 EDT 2010;Committer;mame;2;6;1;7;0
59c74fab7967bcbad628a7b161577024939251ca;Sun May 30 08:10:04 EDT 2010;Committer;mame;2;7;11;18;0
a8cd15c96c02827f593d9a63fae66c2cdac5bdb6;Sun May 30 06:42:12 EDT 2010;Committer;nari;2;16;15;31;0
480b4d0a788d1222a57a3964321e68641094df67;Sun May 30 00:33:39 EDT 2010;Committer;nobu;1;1;1;2;0
45f6fbf339e3666ea1e64d9e13fd40c61977248d;Sat May 29 18:51:39 EDT 2010;Committer;nobu;19;86;92;178;0
5d394118fff7fb94cbba4fc2e3f6d740932e33ce;Sat May 29 18:40:48 EDT 2010;Committer;nobu;4;22;27;49;0
abeb6dce85257f97e1674da67f10c02637a1a09a;Sat May 29 18:05:06 EDT 2010;Committer;naruse;2;6;1;7;0
12a99794b42de8c67d3caf596d20b8dbebdd2de6;Sat May 29 17:26:01 EDT 2010;Committer;tarui;3;5;11;16;0
1887f60a8540f64f5c7bb14d57c0be70506941b8;Sat May 29 17:22:46 EDT 2010;Committer;mame;2;6;0;6;0
41557b4774f53ea316d8332db5d9f0891e9847e3;Sat May 29 16:41:11 EDT 2010;Committer;tarui;1;1;1;2;0
d0914b355289eaa0498928752466d2ec5660cf2a;Sat May 29 16:32:59 EDT 2010;Committer;tarui;3;18;0;18;0
2c1a7dc85eceb869c4c8c517b61c28335fc881f4;Sat May 29 15:10:04 EDT 2010;Committer;svn;1;2;2;4;0
264f4900123d5024141bd8d2e2210da9abc187e1;Sat May 29 15:10:01 EDT 2010;Committer;mame;2;8;1;9;0
701c70e06815d17bec02fec91327b0d12b4520b6;Sat May 29 14:32:18 EDT 2010;Committer;mame;2;6;1;7;0
2f9d0282021be64a6c0d102d2250808354059b29;Sat May 29 03:57:36 EDT 2010;Committer;naruse;2;6;1;7;0
8e9f30887c80776fa2960d684fe3d43b93dbc1c4;Sat May 29 03:05:55 EDT 2010;Committer;nobu;3;22;3;25;0
790abc5991837b59e0682388c318c32cb1628425;Sat May 29 01:12:38 EDT 2010;Committer;nobu;2;7;2;9;0
fc130468c7e062ad544797dabaf76c372419a87a;Sat May 29 00:43:09 EDT 2010;Committer;nobu;1;2;0;2;0
ab3368de8001d72bb6cf33988d3cd37110a9de66;Sat May 29 00:34:35 EDT 2010;Committer;nobu;2;5;1;6;0
089d2ddda44b5c7f7e1e6c69103b6f47716786d2;Sat May 29 00:06:17 EDT 2010;Committer;akr;3;25;1;26;0
2dce743725236e0bdfd99ed005bc6266a2c943b4;Fri May 28 23:59:55 EDT 2010;Committer;nobu;1;1;1;2;0
21fbc8f6d37abbe71dc1dd1cf78a4e3bc8bab8d8;Fri May 28 23:46:44 EDT 2010;Committer;nobu;3;8;7;15;0
827a17bdbbadc27ddcb602a761e4af1295ba60e4;Fri May 28 12:28:32 EDT 2010;Committer;kosaki;2;6;1;7;0
a51acf36898f819d5da89165d394d638e505d78b;Fri May 28 11:53:21 EDT 2010;Committer;nobu;1;4;3;7;0
ca64478089a6c43f56eef1d11a0ed8ac2d402f73;Fri May 28 11:13:42 EDT 2010;Committer;nari;4;371;167;538;0
732e40d9b07c786850f60cee022941a24d081f50;Fri May 28 09:39:41 EDT 2010;Committer;nobu;3;30;9;39;0
2138c773cce15c78ef00b4ed71ba367f11a3bc7f;Fri May 28 09:37:06 EDT 2010;Committer;nobu;3;13;1;14;0
11cef3cca3cf1a068fa2df166ffdfb7d604bc794;Fri May 28 08:51:41 EDT 2010;Committer;shyouhei;2;8;3;11;0
97b1c9edd2993d08370e89e4977e00cb25778cbd;Fri May 28 02:43:34 EDT 2010;Committer;shyouhei;2;10;1;11;0
66c8f4680f171b010c298b5cf99b19e5693c1795;Fri May 28 01:40:39 EDT 2010;Committer;nobu;2;5;1;6;0
47000e8aebb2e9355d0dc72197e95681768f2c4c;Thu May 27 15:53:42 EDT 2010;Committer;tarui;2;9;0;9;0
7e3454037a02712e99216fef8130724bf305e3e6;Thu May 27 15:39:37 EDT 2010;Committer;svn;1;2;2;4;0
b18fcd6a7c45f4726f8ee68dfac4cae662caf384;Thu May 27 15:39:34 EDT 2010;Committer;mame;3;20;0;20;0
97c175fa19d0d58eaabace94f737c4c08368b476;Thu May 27 14:47:29 EDT 2010;Committer;naruse;2;5;0;5;0
84abef0fc08f7182f9c76175ef478898612b0bdf;Thu May 27 14:47:23 EDT 2010;Committer;naruse;2;7;0;7;0
ac8346c4c3031126b455bf71e6a7381dd0378386;Thu May 27 14:47:20 EDT 2010;Committer;naruse;2;10;7;17;0
f39ad4cab2f2d1c977aa4b4356a3a42c11d1d03d;Thu May 27 14:47:16 EDT 2010;Committer;naruse;3;14;2;16;0
51077c2c223c7d17ce9e49d5329a80701d32cba3;Thu May 27 13:36:26 EDT 2010;Committer;usa;2;19;2;21;0
37f75ad0c4a5a9a669aa67fa5434a0cc615bb319;Thu May 27 05:47:21 EDT 2010;Committer;usa;1;1;0;1;0
974cd2e23e9fc8a1eeb06266b2ebf4c3655cac9e;Thu May 27 03:47:29 EDT 2010;Committer;svn;1;2;2;4;0
ce863c6143a01ba33e7e50c174987c773bd9be31;Thu May 27 03:47:26 EDT 2010;Committer;knu;2;5;504;509;0
a43852a3a41a6f228e280afb2f64cd4daf25dec7;Wed May 26 11:19:30 EDT 2010;Committer;nobu;2;7;3;10;0
fd8a1c725b876b83d8a6b835b0113be0d83befc6;Wed May 26 11:04:43 EDT 2010;Committer;usa;2;5;1;6;0
cb2161b3db989f1b6dfc381a46f52a6d58a85cc7;Wed May 26 10:06:02 EDT 2010;Committer;tarui;1;2;3;5;0
ea757670107a3143d72e4f00480a71439e211b5c;Wed May 26 09:45:49 EDT 2010;Committer;tarui;2;14;0;14;0
dd32962cba378b8762b33e8111d104a958ff296f;Wed May 26 08:25:15 EDT 2010;Committer;usa;1;1;0;1;0
97596f36bc4ce34b8cc84bc8649ca26fe0f73d66;Wed May 26 06:37:08 EDT 2010;Committer;usa;1;4;0;4;0
93bbd7869c60781094507babd761cd4fb191d58b;Wed May 26 03:08:07 EDT 2010;Committer;nobu;3;16;3;19;0
dd8d4f00751a869cf1aab0d257aedad0ebe0b627;Wed May 26 02:50:58 EDT 2010;Committer;drbrain;2;78;9;87;0
259c3a1c4c78ce155053ef5d40dc2b4f6a6bbeb5;Wed May 26 01:35:38 EDT 2010;Committer;nobu;2;11;1;12;0
56734a1901764b45b36bdf09c85b070a0eb3d279;Tue May 25 15:12:22 EDT 2010;Committer;svn;1;2;2;4;0
81c5ede3cab05e9138504c2cdc868ce976bff9ee;Tue May 25 15:12:19 EDT 2010;Committer;naruse;3;14;2;16;0
415be475933a5af3ba76a239b2883fcc661c97ef;Tue May 25 14:26:04 EDT 2010;Committer;akr;1;2;0;2;0
c3f2d17abee552b980ed6e46301e6a307180a987;Tue May 25 14:25:55 EDT 2010;Committer;akr;1;3;1;4;0
42c16a3b0711a27683abfddd6ba61595920a71b3;Tue May 25 07:37:41 EDT 2010;Committer;nobu;2;6;1;7;0
20811146004fe487b372a24445f5e8fa38ca4eeb;Tue May 25 07:03:31 EDT 2010;Committer;usa;1;2;0;2;0
847a78516958ff448bc4ec58cb6a101fcda708e1;Tue May 25 04:26:50 EDT 2010;Committer;nobu;3;33;0;33;0
75497d8a3d9c47b6d8386e13b79b05eb1cc8a63f;Mon May 24 16:48:03 EDT 2010;Committer;svn;1;2;2;4;0
948185248c8e8a48abf2e0ad5d1916aa5b1c0a7c;Mon May 24 16:48:00 EDT 2010;Committer;mame;2;13;7;20;0
0344bece9ff37e6e707c697200a5b54516cb5e9c;Mon May 24 14:05:33 EDT 2010;Committer;akr;2;7;3;10;0
c3ebf85a819f00f325a47e5b1e2f19ae227dced9;Mon May 24 14:02:07 EDT 2010;Committer;akr;1;5;5;10;0
3cea675fbef109f22edfbf4113d406579b68cffa;Mon May 24 13:50:05 EDT 2010;Committer;akr;1;1;0;1;0
bf36feb76d81001a8ef3c9b3696b01db0774678b;Mon May 24 10:00:36 EDT 2010;Committer;nobu;2;7;1;8;0
e9ff453d866e2e0afb9898a491e1f6b970f8a23d;Mon May 24 09:31:46 EDT 2010;Committer;nobu;1;2;2;4;0
bb512fddae11a5983c2375b7ff69437f5ebeb2e2;Mon May 24 06:32:53 EDT 2010;Committer;nobu;1;1;1;2;0
c5652b900823a00e1f7cccfbad62b9354e812d0f;Mon May 24 06:10:09 EDT 2010;Committer;nobu;1;16;13;29;0
e16c316b52948396eac43ee9d79383274c616256;Mon May 24 03:52:46 EDT 2010;Committer;nobu;3;35;0;35;0
ccba83feffcb68bd46e75efcadb931e5d23c6bae;Mon May 24 00:21:33 EDT 2010;Committer;usa;2;5;1;6;0
d837ce5eda1f825345160d8847698533dc0980d0;Sun May 23 23:16:09 EDT 2010;Committer;nobu;4;53;22;75;0
b4f1eaa4933185797a202e8d0486cfd15fe19457;Sun May 23 08:48:44 EDT 2010;Committer;nobu;8;13;8;21;0
39f09ca13f5f1d421fb69656e91f896371cf101b;Sun May 23 08:40:36 EDT 2010;Committer;nobu;2;7;1;8;0
14f7df242f75c32472ee1f0dc1eec142c26b2547;Sun May 23 07:56:15 EDT 2010;Committer;nobu;2;8;3;11;0
de26aaa57a5445ad2ac37ea5f60e9394d0eed522;Sat May 22 22:12:43 EDT 2010;Committer;svn;1;2;2;4;0
044d6010fd22ede84b5afd93bce7c4f0ff97adbd;Sat May 22 22:12:39 EDT 2010;Committer;tenderlove;8;140;19;159;0
eb5f96d70cfbae16fcb9c2908ddd9ff7b41d9e13;Sat May 22 08:14:02 EDT 2010;Committer;nobu;1;1;1;2;0
3885841dcef4e33f2a6cc5e3fa83fbd2099fad19;Fri May 21 18:55:54 EDT 2010;Committer;svn;1;2;2;4;0
51ba9a6b14207bd95b55727962b56b3c74855cb2;Fri May 21 18:55:50 EDT 2010;Committer;kosaki;2;6;10;16;0
6d1940fed99ae106c4bbaaf22c9d41872e9e9de0;Fri May 21 10:11:44 EDT 2010;Committer;nobu;2;8;3;11;0
ca3f208b3b63bc73f12e1dda6aad4abea1055c07;Fri May 21 09:21:58 EDT 2010;Committer;nobu;1;1;1;2;0
d6fe62e9439751f743f37ff4333366157baee5ab;Fri May 21 09:12:14 EDT 2010;Committer;nobu;2;1;4;5;0
87af442f946da3b5ab3bc8fb351824ec8c240fe7;Fri May 21 09:10:23 EDT 2010;Committer;nobu;11;37;35;72;0
c6b6293bc13b9107cad52f407810cddc4dd0b475;Fri May 21 08:39:07 EDT 2010;Committer;nobu;1;1;1;2;0
c09c6ee57962d1790cbd215fcee92f186fd52b56;Fri May 21 08:35:18 EDT 2010;Committer;nobu;3;9;1;10;0
5b6bc69fd7a4ff234bd606d35bea760d3a557641;Fri May 21 08:24:50 EDT 2010;Committer;kazu;1;13;13;26;0
2b8fb39dcbfb2d7f9c231dae5d7c3eb4e85b1bef;Fri May 21 04:55:48 EDT 2010;Committer;nobu;2;9;4;13;0
73997d38f41e05c8ebe614cc062d5355662320a1;Fri May 21 04:35:58 EDT 2010;Committer;nobu;3;13;6;19;0
b32e8a5911d35b86916386e6b40f63d437ce8e2c;Fri May 21 03:57:11 EDT 2010;Committer;nobu;2;2;2;4;0
e207a3912ccb36defa8fa18f18648365a76b273d;Fri May 21 03:26:00 EDT 2010;Committer;nobu;3;80;47;127;0
0303a1ca43bb04ae0a62f83cf69c67ffa06b69bc;Thu May 20 16:13:38 EDT 2010;Committer;svn;1;2;2;4;0
f82a6840a80e42e823a455ef3eb726a6b67e5485;Thu May 20 16:13:35 EDT 2010;Committer;usa;3;13;2;15;0
268f95bdc653552a16ee4611a4d6dd84fcfb817f;Thu May 20 13:52:18 EDT 2010;Committer;mame;2;5;0;5;0
5c94d2d423381e61169b19b1a53c78139934f41c;Thu May 20 13:09:28 EDT 2010;Committer;mame;2;10;1;11;0
9219029d3c0a3b5ceccd7d1606a1fce48d4e012d;Thu May 20 13:07:58 EDT 2010;Committer;mame;3;23;13;36;0
c3a13f6cc4e62832b8bc89bc929b1e1683087bb8;Thu May 20 11:55:10 EDT 2010;Committer;suke;3;16;2;18;0
df45be0472a8bb87e1a7fb10f19cb7f35fd6e8e2;Thu May 20 07:18:04 EDT 2010;Committer;usa;2;12;2;14;0
5256d1026505b01f75669c1087c74c04dacd05ba;Thu May 20 04:03:47 EDT 2010;Committer;tenderlove;9;150;10;160;0
f0b0dd2912b7223fe8dd62d7b2531e26870a9def;Wed May 19 17:15:30 EDT 2010;Committer;svn;1;2;2;4;0
383769068d83604f28fa56a094785a2e199ed4ca;Wed May 19 17:15:27 EDT 2010;Committer;tenderlove;4;143;2;145;0
28f9376f3ac9fc51a7ccfa6fddfe40f9c2a3f446;Wed May 19 14:54:21 EDT 2010;Committer;nagai;1;1;1;2;0
6f59b4d081468b67236214df360d2cbddb70be7c;Wed May 19 14:49:29 EDT 2010;Committer;nagai;1;2;2;4;0
3c80aa56de08e2b722ee62ace2a27371d32af4a7;Wed May 19 14:45:03 EDT 2010;Committer;nagai;2;8;3;11;0
f1ff36a331d41f1fb7712cae20cbad274ef30dea;Wed May 19 14:22:09 EDT 2010;Committer;shugo;2;10;1;11;0
92b7ae2bcc9db315eb5262da1e7245e6f317e5ab;Wed May 19 11:50:33 EDT 2010;Committer;naruse;1;7;1;8;0
56036e3514a5afa76c60b7850277da63c4de93b1;Wed May 19 11:18:12 EDT 2010;Committer;mame;3;13;2;15;0
61086883b64312d8936fde7138d195e196d514a4;Wed May 19 10:59:47 EDT 2010;Committer;usa;2;8;1;9;0
59af57e2571fbb361e425783324c6ec38670477e;Wed May 19 10:48:17 EDT 2010;Committer;mame;3;20;2;22;0
7eb7f063a4ff88ca08e2abe0d2f190cec50107dc;Wed May 19 10:15:38 EDT 2010;Committer;naruse;1;10;2;12;0
20eebb8542143ffbccbace932ca0277ee16cf6f0;Wed May 19 09:22:59 EDT 2010;Committer;naruse;2;34;2;36;0
230ffa11d70c90ae1439b8953d8e3d343dc0582b;Wed May 19 09:10:45 EDT 2010;Committer;usa;1;5;5;10;0
ec21e8438c5dcc5d77d8f353e66108aff524e987;Wed May 19 09:07:27 EDT 2010;Committer;usa;1;6;2;8;0
55400cb80f0d965e8e0b20440472e876e6fa398d;Wed May 19 09:03:51 EDT 2010;Committer;usa;1;2;2;4;0
4b1a1f77013ad49bdb4eaf4ef95757474dc863d1;Wed May 19 05:14:41 EDT 2010;Committer;usa;1;1;1;2;0
119863716b93fe22eb886e864753c872e31ae0d8;Wed May 19 05:08:17 EDT 2010;Committer;usa;1;1;1;2;0
c1b29ff5c6db8dd9a4d3508896eb3856eb9974da;Wed May 19 03:24:13 EDT 2010;Committer;tenderlove;3;19;0;19;0
15335f8aaa8282fd951935135aa04b3d938a267c;Wed May 19 03:12:03 EDT 2010;Committer;tenderlove;4;75;34;109;0
a8f8b617c0c609557c80f85de59a4472cc5d45d5;Wed May 19 03:05:05 EDT 2010;Committer;usa;1;27;10;37;0
520647325b996919dd4bbfa7c06791df0532ba09;Wed May 19 02:55:38 EDT 2010;Committer;usa;1;1;1;2;0
31fd9c1553b4fc9555ff3216bc404a0bbbc07ff9;Wed May 19 02:42:58 EDT 2010;Committer;svn;1;2;2;4;0
fa1044927f6517b33b78f9745f3883083fc3a5e8;Wed May 19 02:42:57 EDT 2010;Committer;usa;1;10;2;12;0
c5b5ab0935686dfbfb2b4037bca026426c8d96e1;Mon May 17 21:51:01 EDT 2010;Committer;marcandre;3;38;38;76;0
c1ecff1b1e2eb1c4a10e305dd6cc25d7a94436f6;Mon May 17 21:31:22 EDT 2010;Committer;marcandre;6;459;459;918;0
ef83d7a928ef9d998dc9cf9cb86649cdd9ffceea;Mon May 17 21:09:31 EDT 2010;Committer;marcandre;1;2;2;4;0
914efd0b60acc061b161faa4ebb8bce528793384;Mon May 17 21:07:46 EDT 2010;Committer;marcandre;4;11;14;25;0
410ae9d41bc12e5de6d870498ae37d142a6af673;Mon May 17 21:07:42 EDT 2010;Committer;svn;1;2;2;4;0
7729de4d91ffbf0fe8fa4f2a95b85d3406845471;Mon May 17 21:07:33 EDT 2010;Committer;marcandre;36;1335;1335;2670;0
e181ae53918c09139e7f60bf5ad32741d91339cd;Mon May 17 13:21:17 EDT 2010;Committer;mame;5;20;9;29;0
0f074e654630858aa44010065928a93d2a53c0ef;Mon May 17 12:31:21 EDT 2010;Committer;mame;2;20;0;20;0
d165fa25044b09785b57184936f8b7241be9516e;Mon May 17 12:15:47 EDT 2010;Committer;usa;2;51;52;103;0
f8d97b0026284219aca766db4fa55d6c7357dd4d;Mon May 17 06:28:16 EDT 2010;Committer;naruse;4;161;3;164;0
6b15bccfdfa74380bc8ba18f8a0071bee0879034;Mon May 17 02:07:00 EDT 2010;Committer;usa;1;46;26;72;0
fef3c0a4156b33371e39e05e9616076658d24ad7;Mon May 17 00:41:56 EDT 2010;Committer;usa;2;9;1;10;0
2f3998851148a1b95f9f4e5b6ccf48a9400c33cc;Sun May 16 23:50:23 EDT 2010;Committer;tenderlove;6;118;127;245;0
d62a9f00b87a378cdf1f52fe63e9bcfde62a853b;Sun May 16 16:23:19 EDT 2010;Committer;nobu;1;2;0;2;0
b45f04a66f65fd39b5f9521a30fc19c00143bd4c;Sun May 16 16:07:54 EDT 2010;Committer;nobu;3;7;3;10;0
db6099161bc49b447c824c79be7cd08f97f41495;Sun May 16 13:25:29 EDT 2010;Committer;mame;2;6;0;6;0
0ee8d28e9e9ac67085c5d99b9fc255bf276f5e25;Sun May 16 13:20:58 EDT 2010;Committer;mame;2;6;0;6;0
3cd67ce5053aa53133ae9903e572bd81384d8788;Sun May 16 12:54:37 EDT 2010;Committer;mame;3;11;5;16;0
11e078fb04fd6f3f1627ac46db2caaff69c303a8;Sun May 16 12:20:02 EDT 2010;Committer;yugui;2;6;1;7;0
414727ca70fad5c2e046271c53875e2cb8ebeec2;Sun May 16 09:41:43 EDT 2010;Committer;nobu;1;1;8;9;0
7e7420cc852698eeae6bf6dda96cfd95fa64905b;Sun May 16 08:18:49 EDT 2010;Committer;mame;3;16;3;19;0
6c05f91b3b12c9a52cf36fae2ad6fb7eaf9d53e3;Sun May 16 06:09:40 EDT 2010;Committer;nobu;4;65;24;89;0
fdac9a36c26b7a4240e2552e67bae450f4f36eab;Sun May 16 05:55:41 EDT 2010;Committer;nobu;2;2;2;4;0
2d8bbfa5da002107f5cd47e4340588a4e6f26690;Sun May 16 05:41:50 EDT 2010;Committer;nobu;2;5;1;6;0
40caeb6bd1e83d447ed4f6cd8d4ab430ee11f3f1;Sun May 16 04:55:29 EDT 2010;Committer;nobu;3;8;2;10;0
df54a2e6be074957bcd1c19b4b9d19766da445de;Sun May 16 02:46:16 EDT 2010;Committer;nobu;3;4;4;8;0
e2f2cf425c2802980d02f07075b1f7320bad305a;Sun May 16 02:39:18 EDT 2010;Committer;nobu;2;8;0;8;0
37910b13fbc1d6831b5623368472497629b36ae9;Sun May 16 02:33:05 EDT 2010;Committer;tenderlove;2;20;10;30;0
d9615c85a370039b3d798eb04a77a6bf278c4e9e;Sun May 16 01:49:49 EDT 2010;Committer;nobu;2;6;1;7;0
bbebd01d08c16304c4637be12f89eb4cf08f2889;Sat May 15 17:25:20 EDT 2010;Committer;svn;1;2;2;4;0
fa0bec050f2743d3e6cdfb1e5fe2c2786ee0c9ee;Sat May 15 17:25:17 EDT 2010;Committer;kanemoto;2;7;6;13;0
44c9592d62884cce649f136b2bebaf45154debb5;Sat May 15 08:16:18 EDT 2010;Committer;nobu;3;19;2;21;0
ff5c6d343cdc113d25b9bcc719e967cb9773818b;Fri May 14 04:59:15 EDT 2010;Committer;usa;1;12;2;14;0
d863f7af0c34a0e346eafa200773f6a8d5b67f3b;Fri May 14 04:34:37 EDT 2010;Committer;usa;1;17;17;34;0
4eb19660e9d736e7afb80f79a9b7cedfd6f7dabe;Thu May 13 22:27:10 EDT 2010;Committer;nobu;2;8;1;9;0
ccbdebf5a97ae0e7433f09d61f65f05e58877ba8;Thu May 13 22:09:08 EDT 2010;Committer;nobu;1;0;2;2;0
308be9c8a18923e0521170649f33793609da2174;Thu May 13 16:20:29 EDT 2010;Committer;svn;1;2;2;4;0
50587316b8c66f2d18756de6bb041bd38af8d17b;Thu May 13 16:20:26 EDT 2010;Committer;mame;5;30;12;42;0
a22df39467709c4f270f45fbdfb0b548156bd633;Thu May 13 12:41:29 EDT 2010;Committer;akr;2;7;1;8;0
cb4133c8abc7f7d20d3046bd62f862aef216c5a9;Thu May 13 12:39:45 EDT 2010;Committer;akr;1;12;0;12;0
fa086089fb591705f080eaf7a6021012dd3c6efc;Thu May 13 10:06:25 EDT 2010;Committer;nobu;1;10;7;17;0
30f637024b4a50d98d46496ca121f8d7dea946c7;Thu May 13 09:45:29 EDT 2010;Committer;nobu;3;15;1;16;0
8653bd97de97a43b6ae929cc808f850ebe7269cb;Thu May 13 09:45:12 EDT 2010;Committer;nobu;1;11;11;22;0
daac3ed0b4dea32d22728e0eb69ed5140ca6ad14;Thu May 13 09:16:32 EDT 2010;Committer;usa;2;6;5;11;0
552243aa152098835b82cddd5919585cd0b229d4;Thu May 13 08:56:11 EDT 2010;Committer;nobu;2;7;2;9;0
483ef372b1fc451ca902cae072cbd61756ee5323;Thu May 13 07:19:59 EDT 2010;Committer;nobu;1;1;1;2;0
266a9ea5f3156e0272b6d652179dd0046d2ad82d;Thu May 13 06:32:21 EDT 2010;Committer;usa;1;62;45;107;0
4afa9ed0418555ba20158e55cf3bf9ec563fbecb;Thu May 13 05:49:55 EDT 2010;Committer;marcandre;12;456;275;731;0
8092a810ff9a433e3f7d4edefc7744dfa81d8c70;Thu May 13 04:37:14 EDT 2010;Committer;usa;1;1;0;1;0
cf32125cffac638fa0cb679585767ff2990603fa;Thu May 13 04:30:07 EDT 2010;Committer;nobu;3;58;84;142;0
04daf205b6e6578017a1e107891235890f819590;Thu May 13 04:09:26 EDT 2010;Committer;nobu;3;6;1;7;0
44d8ab72037030aaa1017fa503b4dc7ee3cb11df;Thu May 13 04:03:01 EDT 2010;Committer;usa;1;4;4;8;0
6f3791f46551729339d1bec3743959d5618ef753;Thu May 13 03:56:56 EDT 2010;Committer;usa;1;1;0;1;0
ef7992801df0c91b49fff8465d19f114d9d069dc;Thu May 13 03:55:19 EDT 2010;Committer;usa;2;48;9;57;0
720151bc63b238b35803936e8c3b3eacfeaecbc3;Thu May 13 00:45:48 EDT 2010;Committer;usa;2;5;1;6;0
86fa4ec8a7b6d3fb46a815c3a5583ffad244043b;Wed May 12 22:39:15 EDT 2010;Committer;svn;1;2;2;4;0
5920d5440f36cef1b7e0ba3725679440684935de;Wed May 12 22:39:10 EDT 2010;Committer;akr;2;10;4;14;0
b6d3c5372449e77df05aedfefb7182c29f48c296;Wed May 12 14:49:13 EDT 2010;Committer;akr;2;7;2;9;0
48eb4a79239d5107922bea702b63db9099a402d6;Wed May 12 14:16:13 EDT 2010;Committer;akr;1;15;8;23;0
54c0e4b76e139af4bdc689089a663df53ae12cb2;Wed May 12 14:15:30 EDT 2010;Committer;akr;1;73;0;73;0
dd6b923bf83e4026f26f911156a31b180bbb0a32;Wed May 12 13:50:39 EDT 2010;Committer;akr;1;1;1;2;0
a00247f57a1b263d6eace43f36547766566c1de1;Wed May 12 13:23:20 EDT 2010;Committer;akr;5;63;2;65;0
d80a859d98a86e201075156a2b2cc5fa91aa4e08;Wed May 12 07:43:14 EDT 2010;Committer;nobu;2;11;2;13;0
d2a68945e6c20cf5e68ef27387b31ac102fd493f;Wed May 12 07:25:48 EDT 2010;Committer;nobu;2;7;4;11;0
16ea63ad692df3aa038178e57cb907df5d14a11b;Wed May 12 07:02:45 EDT 2010;Committer;nobu;2;8;0;8;0
db96db4285378644ad041ac34df4736035620c08;Wed May 12 06:46:53 EDT 2010;Committer;usa;2;7;0;7;0
5b20a1398befac93116d69112e12c21533667927;Wed May 12 06:04:59 EDT 2010;Committer;nobu;2;9;2;11;0
851a023843ac4db27c3fb4dc2c4e1a523e0d3831;Wed May 12 02:40:09 EDT 2010;Committer;usa;2;11;7;18;0
07b314f07b0fa45838474b4f8c7ef32c746c6536;Wed May 12 01:57:08 EDT 2010;Committer;nobu;3;54;15;69;0
7abe8a556028ba84757409bfad790b937fb0a839;Wed May 12 01:06:28 EDT 2010;Committer;svn;1;2;2;4;0
0e586b35b80985097489c68e8085457d91165696;Wed May 12 01:06:24 EDT 2010;Committer;naruse;3;10;1;11;0
01cd3467fbd3e9ea212063d0a7405642b8746b94;Tue May 11 14:10:34 EDT 2010;Committer;akr;3;23;4;27;0
709bff4f2b7564c34754feb5f33440a72f802fca;Tue May 11 14:03:53 EDT 2010;Committer;akr;1;31;31;62;0
f65aac7a904ea88dc5f84420d701d4249e059390;Tue May 11 13:06:54 EDT 2010;Committer;naruse;1;3;2;5;0
cbeafa71908cf51548be219f8bcee034a4bdbcf0;Tue May 11 12:54:33 EDT 2010;Committer;mame;2;13;2;15;0
90be970018730e6362b157df7e210e23bbfcea96;Tue May 11 06:15:53 EDT 2010;Committer;naruse;2;7;0;7;0
74365313f7db803628c75644c558ca60a64768ff;Tue May 11 05:11:59 EDT 2010;Committer;mrkn;3;10;1;11;0
3b0e399c0338a2c7570b34b805b8ced90201850b;Tue May 11 04:49:56 EDT 2010;Committer;marcandre;1;1;1;2;0
2b0fe8070b594b0c7d733e0b4f8531d6e2984722;Tue May 11 02:49:46 EDT 2010;Committer;nobu;4;14;5;19;0
fbe5ce6ca7c57cb74572395b6cc5e9f76dd3c9d8;Tue May 11 00:57:09 EDT 2010;Committer;nobu;4;5;3;8;0
c20a118c500a783388d698a8585ab25935160f98;Tue May 11 00:53:16 EDT 2010;Committer;nobu;2;17;14;31;0
60d460ead96882df9828827dd59d08ecfbd8394b;Tue May 11 00:53:11 EDT 2010;Committer;nobu;1;154;153;307;0
6f403dbf900a755e7f2b36764d009cb31e52b63e;Mon May 10 16:22:55 EDT 2010;Committer;svn;1;2;2;4;0
0de068d03e373cbc95da824c4b5a07910ea20e3f;Mon May 10 16:22:52 EDT 2010;Committer;tenderlove;3;41;10;51;0
9d3b304b0bc0f2e36b61579971dafd83798ab56b;Mon May 10 14:52:16 EDT 2010;Committer;akr;2;5;0;5;0
c76b8fcac1c52d3163219d6f55867235a9ee4740;Mon May 10 05:13:56 EDT 2010;Committer;usa;2;12;1;13;0
fe0d339c2c83943445b5f8e1136cc91587afa605;Mon May 10 05:02:44 EDT 2010;Committer;usa;3;10;2;12;0
15381196629e47e747861a5ea81409cefc8d02ae;Sun May 09 22:02:37 EDT 2010;Committer;naruse;2;6;1;7;0
b8571b4285fc222f51d2edaaa6dedde8654e0faf;Sun May 09 18:41:51 EDT 2010;Committer;mame;5;22;1;23;0
d49052b5970147a90b653f76ba18bd9af7a971ed;Sun May 09 18:23:32 EDT 2010;Committer;mame;1;1;1;2;0
80f7f8d07e2b3b48c054e5f4c5d2e16ffa9bfc67;Sun May 09 18:21:39 EDT 2010;Committer;mame;8;60;13;73;0
b664caeb785d66bb882fb014f0274eb5c7f23413;Sun May 09 17:32:45 EDT 2010;Committer;mame;3;25;3;28;0
e2ab44ac4014698da14dfd68cc0559192534db9d;Sun May 09 17:26:40 EDT 2010;Committer;nobu;3;8;0;8;0
f4053cf5554deb0051aabfc90180784236f1f25b;Sun May 09 17:10:18 EDT 2010;Committer;mame;2;9;0;9;0
cb61fcb98813b30e94b3c7507f00433b845a1e66;Sun May 09 16:32:52 EDT 2010;Committer;akr;1;2;1;3;0
64dee0063bd3eb6631c8ec62fe3b2bf86c4fee22;Sun May 09 16:00:37 EDT 2010;Committer;nobu;1;1;1;2;0
41874ab6a3e9b8659296cac61adb0acd7d886aaf;Sun May 09 15:56:58 EDT 2010;Committer;nobu;1;1;0;1;0
b44618d5e5f531beacd42d4222560981667be572;Sun May 09 15:54:17 EDT 2010;Committer;nobu;3;27;1;28;0
08bf7189f873e74e973eff7cee6540b974720a31;Sun May 09 15:35:43 EDT 2010;Committer;nobu;3;9;32;41;0
24e1be741198228456276eba08d65abb3fb6bdb3;Sun May 09 14:53:16 EDT 2010;Committer;nobu;2;7;1;8;0
1bcd74de17c1b727e10c0864a5e0e88c3ab502fb;Sun May 09 14:51:43 EDT 2010;Committer;mame;2;7;0;7;0
c4546f190a38df848ff27e68b93cd1e7faaa6d4b;Sun May 09 14:38:56 EDT 2010;Committer;nobu;1;1;1;2;0
d4fb3227f96e01e9fbea4c038e536aad449427e9;Sun May 09 07:28:17 EDT 2010;Committer;nobu;2;14;0;14;0
1b979ea7218e2fccc3f37fa12c57b56ee2f9380b;Sun May 09 01:57:54 EDT 2010;Committer;tenderlove;1;2;1;3;0
7021db80f3927faf596ee261e196656a7b5b38d9;Sun May 09 00:50:36 EDT 2010;Committer;naruse;2;6;1;7;0
c8892037c7af9f4b52a692ea7db2f7062b6969e4;Sun May 09 00:36:38 EDT 2010;Committer;akr;1;2;2;4;0
5d379991de3fa21113c64c8465fa3403e2b69a7f;Sun May 09 00:30:12 EDT 2010;Committer;nobu;6;122;114;236;0
d2a9f00eccf95edf003d6ea562011f99ab5f5279;Sun May 09 00:16:48 EDT 2010;Committer;shugo;2;22;9;31;0
e240f93f2174d80040d381ef889fcefb48e8378e;Sat May 08 23:25:54 EDT 2010;Committer;shugo;3;49;1;50;0
81f4dba3850f108dbd1c9aad5f175a8e9fbfe5f4;Sat May 08 22:13:02 EDT 2010;Committer;kazu;2;8;2;10;0
1684c2349668e6d8fb2491f209ba7eb9f875e560;Sat May 08 17:59:46 EDT 2010;Committer;tenderlove;2;6;1;7;0
69a0084541034a9b62e635091b3d489bae0fc407;Sat May 08 16:22:33 EDT 2010;Committer;nobu;1;0;1;1;0
89cc2aef81289d41de7971e84ade189140ea8672;Sat May 08 16:15:20 EDT 2010;Committer;nobu;4;33;72;105;0
ffde073b0c2875ccfc23d09d74c351000bbcb969;Sat May 08 16:05:27 EDT 2010;Committer;yugui;2;16;0;16;0
8f3e3995df3697f4fdf6ea30b9340c51947812c5;Sat May 08 16:04:22 EDT 2010;Committer;yugui;2;5;1;6;0
6aa05eba8a13e92338a7c6cd531107bc11132f19;Sat May 08 15:27:48 EDT 2010;Committer;nobu;3;7;3;10;0
9f7feadf03dde2618693ea1d25975511843376a4;Sat May 08 14:09:47 EDT 2010;Committer;nobu;2;4;3;7;0
6f3830427d22f85373a1069148201a9c69d52a5c;Sat May 08 14:07:32 EDT 2010;Committer;nobu;3;37;3;40;0
f491696f4b1320f7e26801ec189f4f874400bc52;Sat May 08 08:08:29 EDT 2010;Committer;akr;1;2;2;4;0
1dee5e34a3d397eb96db0b6bcc8e9cb9858975d0;Sat May 08 04:50:09 EDT 2010;Committer;marcandre;10;496;2;498;0
b140b77926a6e62228f1152157d0348ff5724f89;Sat May 08 04:49:53 EDT 2010;Committer;marcandre;3;19;6;25;0
adf6297ec815edc2a4270384f83f0d96e09f25a1;Sat May 08 04:11:30 EDT 2010;Committer;nobu;2;7;32;39;0
163f974208f917e3e13a307778a6b6144065cd1d;Sat May 08 04:05:39 EDT 2010;Committer;nobu;4;565;0;565;0
2c01a07bf4317605758b1242cf2f802baa117087;Sat May 08 03:25:17 EDT 2010;Committer;nobu;8;75;51;126;0
5512c9b28716df7681680e0db598f3263ad3fe44;Sat May 08 03:08:53 EDT 2010;Committer;nobu;1;4;4;8;0
66abf4ad68609d70d7a1ebe14c519c150b5957ef;Sat May 08 02:07:43 EDT 2010;Committer;nobu;3;19;2;21;0
7eb6e562e51c06e5ef8aad841b5542aebe246f01;Sat May 08 01:13:33 EDT 2010;Committer;akr;2;8;0;8;0
1926eb045f5992365b65502ea3b12cd5404a132b;Fri May 07 15:07:12 EDT 2010;Committer;svn;1;2;2;4;0
0365096bfe70ce7a78f55901dff5058dfbf46d44;Fri May 07 15:07:11 EDT 2010;Committer;akr;1;6;3;9;0
9283449812b49b5e52a24a888878838066fcf0bb;Fri May 07 14:51:41 EDT 2010;Committer;nobu;2;5;1;6;0
a0136f4f27203f6789cb9860a9d43911d4c1c167;Fri May 07 13:29:44 EDT 2010;Committer;nobu;0;0;0;0;0
44ff836e58dcfba6019ade3a4d661114434f3877;Fri May 07 08:09:37 EDT 2010;Committer;naruse;1;8;2;10;0
5cea3d2b175781402814e94134dbc8bf5dfcbd9d;Fri May 07 04:45:27 EDT 2010;Committer;tenderlove;1;6;0;6;0
f1307d27054f0e6fca5936702f71b39d854fcb0c;Fri May 07 02:30:57 EDT 2010;Committer;nobu;2;9;7;16;0
69310faab2b555c71e919fd27f711ede25cdb3a2;Fri May 07 00:16:19 EDT 2010;Committer;nobu;2;14;5;19;0
cc9333b8407ff40a6328dcf19ae739258a59d918;Thu May 06 21:47:37 EDT 2010;Committer;nagai;2;91;78;169;0
c4976411d98ec235c2780e59132aaca7438088c0;Thu May 06 19:28:15 EDT 2010;Committer;svn;1;2;2;4;0
54476a60248dbba0ee7b69b8df5b4b160e78913f;Thu May 06 19:28:12 EDT 2010;Committer;naruse;3;7;2;9;0
8db2aa121631435b68160d9d7836a77415dcb0ea;Thu May 06 13:21:42 EDT 2010;Committer;usa;2;8;1;9;0
bcd0bcc3904db4755ac6cf2b14020872ca328cc7;Thu May 06 10:13:46 EDT 2010;Committer;nobu;3;32;3;35;0
f7050e0e27322ae10b00a8fb65e20118d68e8f4f;Thu May 06 09:33:10 EDT 2010;Committer;nobu;1;0;1;1;0
106e2cc619dc80ea16846eceb757f37ce0a0f4ef;Thu May 06 09:31:28 EDT 2010;Committer;nobu;1;1;1;2;0
26c48195afc911ed45ae2db72dc68d7373e4504e;Thu May 06 09:13:54 EDT 2010;Committer;ko1;2;5;0;5;0
fadc3a8bbc83b541a7b345a757e06cfe3585b8e4;Thu May 06 08:16:45 EDT 2010;Committer;nobu;2;8;0;8;0
4bada8b864e445b6eebe1a341e30cad94dbcaf84;Thu May 06 06:59:24 EDT 2010;Committer;tenderlove;22;1084;71;1155;0
ca3c007f058f17b2f0bf3c5ccc6701f3f6d49ca5;Thu May 06 06:07:05 EDT 2010;Committer;naruse;2;11;2;13;0
3b9c00306f7213c2ac779f13845e04d29827cc06;Thu May 06 05:14:10 EDT 2010;Committer;akr;2;6;2;8;0
ec0b0144b3b9213f04b74a52f7830fba768c1716;Thu May 06 03:45:32 EDT 2010;Committer;mrkn;2;23;0;23;0
0f7321eddf0be6107e6563f83bdc9503e46da191;Thu May 06 03:12:28 EDT 2010;Committer;nobu;5;58;26;84;0
c462c50d6336a0c7823ff8cfce51f8bff22eeff6;Wed May 05 18:37:37 EDT 2010;Committer;ko1;2;371;10;381;0
833cade2dce8ee8a9dd2091fcc84880030a51d54;Wed May 05 17:51:21 EDT 2010;Committer;ko1;10;122;23;145;0
34ed81ea8948d8095389d38a4818c99b25155183;Wed May 05 14:31:10 EDT 2010;Committer;marcandre;1;1;1;2;0
0356eef426342a3305924b6438bd29914d9cc57e;Wed May 05 13:33:58 EDT 2010;Committer;wanabe;2;6;1;7;0
0882e74bf632b5003c8d02c54798f74f4c292d7e;Wed May 05 12:55:02 EDT 2010;Committer;kanemoto;2;22;39;61;0
bd21118627cbf27f678fc6386e8c7effe67f4cdd;Wed May 05 11:53:03 EDT 2010;Committer;wanabe;2;18;9;27;0
690e065bf899fa18e7d4c7fa6a645236fb328e23;Wed May 05 10:08:16 EDT 2010;Committer;nagai;3;71;300;371;0
54062a76e723e35a7cf9a6a0b250f70e893f23ed;Wed May 05 06:55:45 EDT 2010;Committer;usa;2;6;1;7;0
a6e33fd71cfcd3c9569e7fca72a0adf03d514cc2;Wed May 05 06:11:04 EDT 2010;Committer;nobu;1;2;2;4;0
a20cc16b20697fd8a4c2086a76222553e436b1a2;Wed May 05 04:31:48 EDT 2010;Committer;nobu;1;1;1;2;0
a6242670f358b55ef075f13dae325b64e9a55e5f;Wed May 05 02:43:15 EDT 2010;Committer;nobu;2;12;5;17;0
62d7a30a769e0fb90233a9b1d6ff18cc1409ead0;Tue May 04 22:27:18 EDT 2010;Committer;nobu;4;5;5;10;0
208e43b3feeece3b363af1f7426ec7df4a788e73;Tue May 04 22:24:00 EDT 2010;Committer;nobu;2;5;1;6;0
b4d7d616d9ad8d94df0563f06318c7b9a6a80269;Tue May 04 20:25:09 EDT 2010;Committer;ko1;5;34;19;53;0
7a17dca09f5390041535876d0fdb327ff6658492;Tue May 04 19:07:05 EDT 2010;Committer;naruse;1;23;6;29;0
da5b468902336de5acbbb4968f44a9d0a6f508dd;Tue May 04 16:02:18 EDT 2010;Committer;svn;1;2;2;4;0
fd328d8ea15d653130d89a9c59f977b1f4e6d6f6;Tue May 04 16:02:17 EDT 2010;Committer;usa;2;17;7;24;0
576252ae9d2b5e9601897eeca3aa2f25353068fc;Tue May 04 14:10:09 EDT 2010;Committer;wanabe;2;7;0;7;0
e8249be9fca2ebfc101f7fc3d14ee935391cd797;Tue May 04 09:51:27 EDT 2010;Committer;nobu;3;14;1;15;0
16c40ec1a5258250876b3b95a299397a79244a10;Tue May 04 09:38:21 EDT 2010;Committer;nobu;2;14;7;21;0
2a067c6cec648981fd4e9b5f466bc2a11f29c79c;Tue May 04 08:08:31 EDT 2010;Committer;naruse;1;8;0;8;0
89435793bc14e7434887b8559b993259837e161c;Tue May 04 04:27:19 EDT 2010;Committer;nobu;1;0;1;1;0
6060c3a4b69882dc9e6379556e2940a7599a90b5;Tue May 04 04:26:43 EDT 2010;Committer;nobu;1;1;0;1;0
843d4f328a3e7d7ce05b83b731e737b464cb46db;Tue May 04 04:00:20 EDT 2010;Committer;nobu;1;1;0;1;0
8ed1f433922a45b941fd58e6c3054c8e4c97dd53;Tue May 04 03:50:39 EDT 2010;Committer;ko1;2;35;7;42;0
622f45fccb5ebfdf684bb8428203307aa8d0cb89;Tue May 04 03:39:36 EDT 2010;Committer;akr;3;10;4;14;0
f1192452a9c8d07baf7b2cfee48330b1d0188490;Tue May 04 02:51:46 EDT 2010;Committer;akr;2;7;1;8;0
57c1406697134de5e6fe11f19d478472b6ac5323;Mon May 03 23:42:26 EDT 2010;Committer;mame;4;94;20;114;0
e6ccffd96619ab4c7926eaa96fbc8166024201d4;Mon May 03 22:17:49 EDT 2010;Committer;naruse;1;6;5;11;0
9526ba4ef3a2dadebac9f7e364ab2180eabe10aa;Mon May 03 19:04:29 EDT 2010;Committer;naruse;2;14;6;20;0
8517275f82f91e89c7f31a79969c5d7194836265;Mon May 03 15:40:00 EDT 2010;Committer;svn;1;2;2;4;0
23f612d7bf172e1c756b58620e90a799b165e6db;Mon May 03 15:39:59 EDT 2010;Committer;tenderlove;1;22;22;44;0
afa8f9ba5173ea8cf16339209fc3d6fa5e76dcdf;Mon May 03 12:17:04 EDT 2010;Committer;kazu;2;6;4;10;0
5f1ebd0b72cfbd20952edd4af05534c1ac85cb86;Mon May 03 12:17:00 EDT 2010;Committer;kazu;1;2;2;4;0
21c5ffc53592465390f7fae4ce47033796d6d932;Mon May 03 01:46:28 EDT 2010;Committer;nobu;1;0;1;1;0
902bd2b10698d404d15ce8cfff500519a1df4adb;Sun May 02 23:15:08 EDT 2010;Committer;nobu;4;103;26;129;0
eee581f9432b7a4d18f51bb09ca384954c91b1e9;Sun May 02 09:12:07 EDT 2010;Committer;nobu;1;2;2;4;0
24bc7af43abf6de550e8f382850ff6492bfb544e;Sun May 02 08:52:20 EDT 2010;Committer;nobu;3;8;228;236;0
765ff64b107753a67c354463aabb8144cf70f120;Sun May 02 08:25:15 EDT 2010;Committer;nobu;2;18;2;20;0
59fc499c6364fc8d8acd52302b21570cfa7577d1;Sun May 02 08:25:11 EDT 2010;Committer;nobu;2;13;13;26;0
fd1762b45be006d967008dbd784c29f9926aa01b;Sun May 02 05:56:35 EDT 2010;Committer;nobu;1;1;1;2;0
ec8b5d06257830ac277e3ea82dacd3761d6771ee;Sun May 02 05:43:29 EDT 2010;Committer;marcandre;2;114;87;201;0
c8e50abfe85fc5787b2b399ff00cf56d86dc7c50;Sun May 02 03:09:31 EDT 2010;Committer;wanabe;1;1;0;1;0
c6896436d8b84bd5a19cf9043e6a9e85dfd0e0ad;Sun May 02 03:06:44 EDT 2010;Committer;wanabe;2;6;1;7;0
6874c8d686129a0a83df3db829078e5b8af571c7;Sat May 01 23:54:39 EDT 2010;Committer;nobu;2;6;1;7;0
12d39082c52dae668db8ab145d3b134b2c1e040b;Sat May 01 22:38:45 EDT 2010;Committer;nobu;2;7;2;9;0
3046fe65af65a5b6430e64f7d81f1748dec2d0ab;Sat May 01 22:00:37 EDT 2010;Committer;nobu;2;5;5;10;0
5e02a28a8b5e6defca76c4f3ee76bc48f0ce67b2;Sat May 01 13:54:01 EDT 2010;Committer;nobu;3;14;9;23;0
9ad152e55580b497cbba4c7a15d20cba8e3ef1f5;Sat May 01 13:41:10 EDT 2010;Committer;nobu;2;5;2;7;0
865791221193129f99993a8df20196040003ce41;Sat May 01 13:27:49 EDT 2010;Committer;nobu;2;6;1;7;0
c8316e30ae6adefccbd7680e477e906e7913e8c0;Sat May 01 07:46:46 EDT 2010;Committer;nobu;2;6;1;7;0
40cd5e8a7963a392ee0b8100b271b30f1ca0ed12;Sat May 01 05:19:16 EDT 2010;Committer;drbrain;4;10;2;12;0
9111bbf8182708acb9f8d9689c441c3b6c591386;Sat May 01 05:06:21 EDT 2010;Committer;drbrain;5;13;5;18;0
9d094c7a250b55f509ff185f64aaf6a02fc226e5;Sat May 01 00:43:10 EDT 2010;Committer;nobu;2;6;1;7;0
a8209ffcc7008fa59b0e72e619a184733e47394a;Fri Apr 30 21:45:33 EDT 2010;Committer;wanabe;2;5;0;5;0
6c28f99d8894b9f9a3c1394d120115f69012f2c3;Fri Apr 30 17:56:23 EDT 2010;Committer;usa;7;603;197;800;0
bfeeb913fed701b552cb6c7331b33062b7922de3;Fri Apr 30 17:22:32 EDT 2010;Committer;nobu;1;3;2;5;0
11caac16638cce5b5346e80246045897c33b0732;Fri Apr 30 15:26:34 EDT 2010;Committer;nobu;3;23;0;23;0
b36b3067f0ed837e787753604e248085abde433c;Fri Apr 30 15:14:53 EDT 2010;Committer;nobu;3;40;11;51;0
63324cb36dc07e8759ff4148d64728dabed09fd9;Fri Apr 30 13:46:38 EDT 2010;Committer;marcandre;2;5;1;6;0
e955cff06ce266f90c32c73bc244dda3924c66e4;Fri Apr 30 12:40:40 EDT 2010;Committer;nobu;2;7;2;9;0
5d639de5d3acd7032d13b0874bc0920714401571;Fri Apr 30 06:41:01 EDT 2010;Committer;nagai;2;300;60;360;0
4d3f87718014cf13189c35c4ed8a6cfd93a91406;Fri Apr 30 04:35:16 EDT 2010;Committer;marcandre;1;4;3;7;0
c41dc085d0fdb7cce8c6eb10c40fe9c8c68c8aa1;Fri Apr 30 03:06:43 EDT 2010;Committer;akr;2;9;0;9;0
479fa407780ca01ce04dce1ef21342da4e148215;Fri Apr 30 02:48:49 EDT 2010;Committer;marcandre;2;7;0;7;0
478c3e080b0d2782ae630f87c22d1a8e36756778;Fri Apr 30 02:40:57 EDT 2010;Committer;marcandre;9;43;21;64;0
f6a5c0fae292a52e002ec9db48a749737568479c;Thu Apr 29 19:10:00 EDT 2010;Committer;usa;2;5;1;6;0
3543491916235f515f0d7c283b57263177d6b817;Thu Apr 29 18:59:18 EDT 2010;Committer;usa;2;5;1;6;0
34f182f7b28b4b4f8c69d3563cd77737867814c1;Thu Apr 29 18:39:02 EDT 2010;Committer;usa;2;9;4;13;0
0a3c78facece3e83d0e3b4f2d09d3e0730ac1905;Thu Apr 29 18:19:12 EDT 2010;Committer;marcandre;3;118;146;264;0
a3a4542fb4779a1f4f302126c5e8d7fc024ade4b;Thu Apr 29 18:18:58 EDT 2010;Committer;marcandre;1;4;4;8;0
4e6a29e083c03ccf9611120668336458160c27f9;Thu Apr 29 15:54:21 EDT 2010;Committer;svn;1;2;2;4;0
47f35969e0a08d6a1d96c1cd615ef2f0421747a9;Thu Apr 29 15:54:18 EDT 2010;Committer;usa;2;21;0;21;0
d065e56c71c70675b4e43f0f06cef1b05e11d766;Thu Apr 29 12:56:41 EDT 2010;Committer;naruse;1;1;2;3;0
6c33ace12ca7c621cf5c4fa283c44c63777aec0d;Thu Apr 29 11:10:18 EDT 2010;Committer;nobu;2;6;3;9;0
fb9e83685733715d0f55d7b9cc83d1eefb5eea78;Thu Apr 29 10:51:01 EDT 2010;Committer;wanabe;1;1;0;1;0
f88284b91ec7eedb88216f0aa9c55ca7d18cb67c;Thu Apr 29 09:39:52 EDT 2010;Committer;nobu;2;7;2;9;0
d610c8c686ac9345a47bc3019f58f6b270a7705c;Thu Apr 29 05:51:01 EDT 2010;Committer;nobu;1;1;2;3;0
921b2d1cfb67bae2941642015fbe35f7e7b81698;Thu Apr 29 05:46:04 EDT 2010;Committer;nobu;10;25;21;46;0
e1cc51407329230aab32088ed67f78b0c5c23e8b;Thu Apr 29 05:33:43 EDT 2010;Committer;nobu;8;12;10;22;0
4c205de3e6fa7da642820fe069734e6321397423;Thu Apr 29 05:24:52 EDT 2010;Committer;nobu;2;5;10;15;0
e21741e254aa051bb3dca54a54583deb29586c55;Thu Apr 29 03:33:44 EDT 2010;Committer;nobu;2;6;1;7;0
33cf9431daf2d6e2c7bf9a8a6fa2530f1f8ffa2c;Thu Apr 29 03:16:24 EDT 2010;Committer;nobu;2;15;0;15;0
55181301ae4f52678460b4eea5902b7cf15013ce;Thu Apr 29 02:20:58 EDT 2010;Committer;nobu;2;5;3;8;0
e1c34852dc66a48aff10c53971463f443548e385;Thu Apr 29 02:17:12 EDT 2010;Committer;nobu;2;8;3;11;0
9f8073c819740ff132e1e709d00c83bbf83259ba;Wed Apr 28 18:51:39 EDT 2010;Committer;svn;1;2;2;4;0
fa9da31def14a2a36ab281bd24c0c40c767800e2;Wed Apr 28 18:51:35 EDT 2010;Committer;jeg2;2;8;2;10;0
c6871cef32d7f7c30b28253cbca18ba071ffebbe;Wed Apr 28 14:53:58 EDT 2010;Committer;mame;2;14;35;49;0
dc22009c266e27cb466e1a72fac352c469ca1fe3;Wed Apr 28 14:26:30 EDT 2010;Committer;naruse;3;6;2;8;0
97cfd1869c2618ec52aa23397ded36df2a9a5d78;Wed Apr 28 13:56:32 EDT 2010;Committer;mame;2;9;7;16;0
e76a19ece3f455a47e839c924aa0e89d87a06135;Wed Apr 28 13:56:24 EDT 2010;Committer;mame;2;7;0;7;0
f510d9f3c471ffe037a2154968acd75264ae4ef6;Wed Apr 28 09:04:51 EDT 2010;Committer;nobu;2;7;6;13;0
603363369b40e991801f36e82bdc21eab819cc58;Wed Apr 28 08:54:07 EDT 2010;Committer;nobu;1;1;0;1;0
0dc145e7b2b187ca595bb45dd289fb9f8f93789d;Wed Apr 28 08:14:18 EDT 2010;Committer;nobu;2;7;1;8;0
4822d20cc55d54d0c3cb190fdcb343976db64901;Wed Apr 28 08:14:13 EDT 2010;Committer;nobu;11;86;84;170;0
790d6071c6d0d2c677b01779fecb891d64095ded;Wed Apr 28 07:45:00 EDT 2010;Committer;nobu;2;26;18;44;0
5e7101d3487846d83f8038856728ec77f931ecb6;Wed Apr 28 07:28:53 EDT 2010;Committer;nobu;2;6;3;9;0
d4840cc785e29bddb9f0567c8d63a323b6dfdd84;Wed Apr 28 07:16:30 EDT 2010;Committer;nobu;3;11;8;19;0
d4bd69441170a6a07470973640f329673fe1785e;Wed Apr 28 01:27:37 EDT 2010;Committer;nobu;2;7;2;9;0
614bc7f9f842e9385f64b32c59c79b05e2bd2f59;Wed Apr 28 00:49:25 EDT 2010;Committer;nobu;2;17;3;20;0
382085b75b80d8f6ebc2a420a7c0b59791faede4;Wed Apr 28 00:47:22 EDT 2010;Committer;nobu;2;53;54;107;0
92e2b86c3d467abe5631ca00fa30cb7d29cae213;Wed Apr 28 00:47:19 EDT 2010;Committer;nobu;1;0;1;1;0
8939436f24af0d791114cc6a596b0ddfa0f5f05d;Wed Apr 28 00:43:27 EDT 2010;Committer;nobu;2;5;1;6;0
2f40495328954002d747048e77446325e62b8403;Tue Apr 27 21:09:46 EDT 2010;Committer;naruse;3;5;5;10;0
430e0ce4913ad868d8c60ba3e5a0936d0f47af72;Tue Apr 27 20:40:12 EDT 2010;Committer;tenderlove;2;14;0;14;0
ad3c1061a78f6efe0ee3584d92b3df448da9891f;Tue Apr 27 20:19:16 EDT 2010;Committer;tenderlove;2;22;0;22;0
4d4038f575d50e564d9b26141889fb2cc248e6de;Tue Apr 27 15:00:44 EDT 2010;Committer;svn;1;2;2;4;0
f93e39261c8f44cc4dd77ac4802aa913561b5157;Tue Apr 27 15:00:41 EDT 2010;Committer;mame;2;11;1;12;0
e59b9d35fcd58331928aa1f62fe48287b0c643e2;Tue Apr 27 14:06:16 EDT 2010;Committer;mame;3;21;0;21;0
e02f7f79c23aaaf7c5878408a2b46b00f23c32ba;Tue Apr 27 13:42:29 EDT 2010;Committer;mame;3;28;1;29;0
4af243a8afa0dfefc74bb68dd08d9c5ff3ccc5d5;Tue Apr 27 12:27:13 EDT 2010;Committer;mame;4;45;10;55;0
6fd326e76cba5fecda1470c808c6d8cc61d60381;Tue Apr 27 09:00:52 EDT 2010;Committer;nobu;2;6;1;7;0
336a8301f725bd8fbf5f1e0c4fee162382a76d0f;Tue Apr 27 03:45:22 EDT 2010;Committer;drbrain;28;429;145;574;0
3a87c3c5603fce8449f78faccaff5f4be6f372e1;Tue Apr 27 03:34:45 EDT 2010;Committer;naruse;1;1;0;1;0
422efe53527f5e0a7a80478947a7b338e8b199c7;Tue Apr 27 01:54:23 EDT 2010;Committer;nobu;3;14;0;14;0
87ba383aa38dbf81b6aa3fa9c771e7ac715f3c96;Mon Apr 26 21:21:07 EDT 2010;Committer;akr;3;15;1;16;0
18abe0e8c2a5ee96f6c813eac102bd75f42fb148;Mon Apr 26 15:09:29 EDT 2010;Committer;svn;1;2;2;4;0
56a18860daa1a34094e81cb68b45756617d04eab;Mon Apr 26 15:09:26 EDT 2010;Committer;mame;2;7;3;10;0
a90469602c82fe0fe607cc6f1c8f32b223db0394;Mon Apr 26 11:14:40 EDT 2010;Committer;tadf;9;1147;2;1149;0
76b33197e245c5ad070a3da427f096a82fccf898;Mon Apr 26 06:43:36 EDT 2010;Committer;usa;2;6;1;7;0
3642494ce5a44938285677669b3e001a1af1ce47;Mon Apr 26 06:27:27 EDT 2010;Committer;naruse;22;4439;3967;8406;0
27be3056dc0e9c313f25b430ca90b240a5e44160;Mon Apr 26 04:34:36 EDT 2010;Committer;usa;22;3967;4450;8417;0
b0018f68590c8071bb0a242f75cc4fa048396e78;Mon Apr 26 04:11:59 EDT 2010;Committer;nobu;3;9;5;14;0
3cbb849bbbf6088be2c054ee89a6b47f0e39ae99;Mon Apr 26 03:42:45 EDT 2010;Committer;nobu;2;17;13;30;0
9803f4f55a9804a6ff96df10087039dc5c1d5020;Mon Apr 26 01:55:51 EDT 2010;Committer;nobu;3;24;11;35;0
6c29e97c72227a88277ac31ba343ae487d9b1fb7;Mon Apr 26 01:07:36 EDT 2010;Committer;nobu;1;0;2;2;0
cce2aa4958b65636d357e6d273977075ad4cd434;Mon Apr 26 01:07:32 EDT 2010;Committer;nobu;1;8;8;16;0
54592ad6276a17d95f2186c8631197ddb172020b;Mon Apr 26 00:06:35 EDT 2010;Committer;naruse;28;4637;4017;8654;0
9372cdb80a376f352fc55ea895f1ad688cf4a0df;Sun Apr 25 15:08:44 EDT 2010;Committer;nobu;2;3;2;5;0
8ebadc63f442e70bffa8fba2d8b23ba14bc1e71e;Sun Apr 25 14:50:10 EDT 2010;Committer;nobu;2;5;0;5;0
fcd05a98fbfca72f83ce84851ff5830817be1f59;Sun Apr 25 12:58:19 EDT 2010;Committer;shugo;2;12;1;13;0
3081e11166975ac0df1ef50fe65d319874f0b9fd;Sun Apr 25 06:59:45 EDT 2010;Committer;tadf;2;6;22;28;0
350211450714f6cbf7482e59253f851cf80a5538;Sun Apr 25 06:52:24 EDT 2010;Committer;tadf;4;4;295;299;0
21b716f9a5930e60569a900c45b6aa88f5081ca1;Sun Apr 25 06:37:18 EDT 2010;Committer;tadf;5;5;825;830;0
1e6a884a4fb20110b139cbd13db18e9c0701bdd5;Sun Apr 25 02:08:36 EDT 2010;Committer;wanabe;2;5;0;5;0
63578c725c481abf246b1c1e5b4ddf2942cb5508;Sat Apr 24 22:27:55 EDT 2010;Committer;tenderlove;2;12;0;12;0
38297f330b41702e07460d18e6fac3f989a06a9a;Sat Apr 24 22:23:37 EDT 2010;Committer;tenderlove;2;1;2;3;0
2d9c05441220ec5079925994b074380a78d50d8a;Sat Apr 24 20:35:20 EDT 2010;Committer;tenderlove;4;25;8;33;0
d69c502c9f855a0215319516c4b0f594b4eb0606;Sat Apr 24 19:58:36 EDT 2010;Committer;svn;1;2;2;4;0
b57db764b0856ddae30deed32a104c4016f0ffae;Sat Apr 24 19:58:34 EDT 2010;Committer;tenderlove;3;14;1;15;0
9ac224eb2699d528f7c3544861f02a5255605f4f;Sat Apr 24 14:41:22 EDT 2010;Committer;akr;2;5;7;12;0
0e5546df901d15381d4ec08af11971c649a7c308;Sat Apr 24 12:07:53 EDT 2010;Committer;akr;2;16;8;24;0
ba2ee2f04c72b224ea167ee2366623fa2d05f65c;Sat Apr 24 12:00:56 EDT 2010;Committer;akr;1;8;8;16;0
0757fe1242c948237d82b82043c2064abdeaf6c3;Sat Apr 24 07:27:50 EDT 2010;Committer;nobu;2;4;1;5;0
5a4f004d744a8cbc5f2ada61ac9a15fe9dd9ed8b;Sat Apr 24 07:27:18 EDT 2010;Committer;nobu;2;6;7;13;0
ee1cfc11e33f205bdbfc569414da6f388d9f58d8;Sat Apr 24 07:20:28 EDT 2010;Committer;nobu;2;18;12;30;0
02efdb484582dfc0b785a5d7f07d69333a262943;Sat Apr 24 06:05:34 EDT 2010;Committer;akr;1;1;1;2;0
78db46b31c4472291f4e45cf0374853ac3c5740a;Sat Apr 24 05:42:50 EDT 2010;Committer;akr;3;79;18;97;0
7309f9cc007f1cc05eb70967356069161d867356;Sat Apr 24 04:11:27 EDT 2010;Committer;tenderlove;4;57;7;64;0
655b2ade4984f8d0ad6c76d6eff35262ad7d2619;Sat Apr 24 04:06:59 EDT 2010;Committer;nobu;2;28;5;33;0
07311e56e20d6bcbd6272a8568468c91207c6203;Sat Apr 24 01:04:55 EDT 2010;Committer;tenderlove;1;3;0;3;0
7668e5aa9d6629e0744bd734a2f252ea104b9d02;Sat Apr 24 00:44:42 EDT 2010;Committer;nobu;2;8;2;10;0
edcaae97415aef8e34924b696570c7a28669d39d;Sat Apr 24 00:20:08 EDT 2010;Committer;tenderlove;2;11;10;21;0
8687db60a65082a2e76650e918279a2048337e5a;Fri Apr 23 15:44:19 EDT 2010;Committer;mame;3;14;29;43;0
f991d20910f0241319edf96a5dc6f2e38b93374f;Fri Apr 23 15:38:11 EDT 2010;Committer;mame;2;9;0;9;0
05209bdadd168c6adefc7eaccb9302baa1615c8d;Fri Apr 23 15:16:04 EDT 2010;Committer;svn;1;2;2;4;0
eaaef6af4046fef08c3830e10c6f967d98db3b5f;Fri Apr 23 15:16:02 EDT 2010;Committer;usa;2;6;1;7;0
5c67d206a7923e02f69aa7c4605bf1a76f6b21f8;Fri Apr 23 14:28:56 EDT 2010;Committer;akr;2;6;1;7;0
141cbdfe354790c0c097f287391e72dfc77d32a0;Fri Apr 23 08:39:58 EDT 2010;Committer;usa;1;1;0;1;0
6f7b5ffe6f5f33d841e4f8d58214b685023118fa;Fri Apr 23 08:37:55 EDT 2010;Committer;usa;5;64;9;73;0
a909ff22c8086e695ac010aa9f36723ce6674097;Fri Apr 23 06:31:24 EDT 2010;Committer;nobu;1;1;1;2;0
80db78f51c82cb1290e11810c8c0c03afcdf6996;Fri Apr 23 05:37:26 EDT 2010;Committer;nobu;3;11;8;19;0
9e67f6ecec169787bb489ccb3f71d32a141f01da;Fri Apr 23 05:07:38 EDT 2010;Committer;nobu;6;158;146;304;0
400afca88a0adb5a380925dea61220e08a04022f;Fri Apr 23 02:32:20 EDT 2010;Committer;drbrain;16;69;12;81;0
30014a61567b1b672ae46ecf5ff27c059f6c4eea;Fri Apr 23 00:14:00 EDT 2010;Committer;nobu;1;1;1;2;0
48f2a5fcc4ef40e29a7935c1f57c02aefe1995cb;Thu Apr 22 19:13:46 EDT 2010;Committer;nobu;1;12;0;12;0
2dc5fdec0130e1b6d553a843d266b53e62efe836;Thu Apr 22 19:11:28 EDT 2010;Committer;nobu;2;14;1;15;0
b6847f7acca72b135ad00793c4706df2058d1ed8;Thu Apr 22 16:49:39 EDT 2010;Committer;usa;2;5;3;8;0
1152ad658f2374ee8ded187b7e8ce9a4ebd5fc36;Thu Apr 22 16:28:30 EDT 2010;Committer;svn;1;2;2;4;0
f9e536235b3a2bf12ac12639b96296efbd016497;Thu Apr 22 16:28:27 EDT 2010;Committer;usa;2;4;1;5;0
478c65c4687f6a5a148c843f49d22e7a1b15d3f7;Thu Apr 22 14:15:29 EDT 2010;Committer;mame;2;15;1;16;0
0ffb18de451c5e4f06af9510bf7be4ae272d176d;Thu Apr 22 14:02:09 EDT 2010;Committer;mame;2;6;2;8;0
14e5c442c50e2e7fc5a526b0a93ef2e98e74a0f6;Thu Apr 22 12:54:18 EDT 2010;Committer;keiju;2;13;6;19;0
997130419662ba9c00649add570e717e18a264a8;Thu Apr 22 10:13:10 EDT 2010;Committer;naruse;1;0;1;1;0
04c651c0bd11878d25fa6f5abd21cdbca9b843f2;Thu Apr 22 08:59:57 EDT 2010;Committer;nobu;1;1;1;2;0
372dcece3f69989d133f720468f1e24aa1133cda;Thu Apr 22 08:24:42 EDT 2010;Committer;drbrain;64;758;239;997;0
d0e5a34ac7c34e70c145024a0fed8f6042814f29;Thu Apr 22 08:21:01 EDT 2010;Committer;nobu;24;123;123;246;0
3e8d63059d36fe6ba64ffba7bfce577693c98b59;Thu Apr 22 08:16:09 EDT 2010;Committer;nobu;2;2;2;4;0
87a371197e5d70dd819216b8693bf9cbe87d80c0;Thu Apr 22 08:05:15 EDT 2010;Committer;nobu;1;6;0;6;0
977267c2e0218d6b182807ddf9b7c1d929c40bed;Thu Apr 22 08:04:13 EDT 2010;Committer;nobu;92;1588;1588;3176;0
36f8540a2b024ee30092ea6a0eebfa40ccc95b07;Thu Apr 22 07:43:33 EDT 2010;Committer;nobu;2;15;1;16;0
6a77fa1d158dcbb3d66baced48334935b91d3fca;Wed Apr 21 17:22:30 EDT 2010;Committer;svn;1;2;2;4;0
5318e0f6051e8f08945ad683b1e8fb6ffc8b2d95;Wed Apr 21 17:22:27 EDT 2010;Committer;mrkn;3;62;56;118;0
c50c9f6d3ba1f9b550c68777569f7d3f8898446f;Wed Apr 21 12:25:29 EDT 2010;Committer;akr;2;7;1;8;0
4131d6176ac46da95b1e7fa045651783f0a66c65;Wed Apr 21 06:37:18 EDT 2010;Committer;naruse;3;67;43;110;0
2976ec58a48e3ff83ff3d0979041bb5694592153;Wed Apr 21 04:44:58 EDT 2010;Committer;nobu;3;80;9;89;0
82ba40b4340b01c97733561816dc8a4ee8adc081;Wed Apr 21 04:36:05 EDT 2010;Committer;nobu;3;6;5;11;0
2e1efa94993dee9b54ac4c9f4c58a06f41ed3232;Wed Apr 21 03:15:49 EDT 2010;Committer;nobu;2;23;2;25;0
a7df5ace7e13760c9c175a6de3273bffb50346d4;Wed Apr 21 03:10:03 EDT 2010;Committer;drbrain;7;32;12;44;0
f8e51f7e5958a4962d620c66af2e93cbf6f52f11;Wed Apr 21 02:31:40 EDT 2010;Committer;nobu;3;15;35;50;0
8a269f85a0e6aaaecfdadcd185df7a686b45696e;Tue Apr 20 18:19:01 EDT 2010;Committer;naruse;3;43;12;55;0
52998fa5918fdf64369ce47773c895b78032b7cd;Tue Apr 20 15:31:46 EDT 2010;Committer;mame;2;23;15;38;0
adfe4f39304f330cebe673d603b226713ce58210;Tue Apr 20 15:28:33 EDT 2010;Committer;mame;3;24;0;24;0
7c7a7c1205677e7b6e4814c7f314cb53816ab07c;Tue Apr 20 15:23:23 EDT 2010;Committer;mame;2;11;1;12;0
b61645517b82a509cac0937d94a906f019006bb6;Tue Apr 20 15:15:47 EDT 2010;Committer;svn;1;2;2;4;0
3728ec6ea36941f5d634bc2abb352ea145fb749c;Tue Apr 20 15:15:44 EDT 2010;Committer;mame;2;14;0;14;0
ef3ea2dd898e51038989f9f762daaccb34f51715;Tue Apr 20 13:53:08 EDT 2010;Committer;usa;1;6;2;8;0
57e50f7f885fe6ef51c84a0f341baaea00590218;Tue Apr 20 13:40:15 EDT 2010;Committer;usa;1;6;0;6;0
a3bd9a86e8ae56c021e6dd334fa640b53935725c;Tue Apr 20 12:34:57 EDT 2010;Committer;usa;2;6;1;7;0
f0f87d6eebfa4ef713ca150f349d9780a3d13a62;Tue Apr 20 10:25:52 EDT 2010;Committer;nobu;2;9;7;16;0
cbaf61b276492532f4348f284322c88fcfe6efb5;Tue Apr 20 10:21:42 EDT 2010;Committer;nobu;1;2;0;2;0
2b222b9b1773d8ae574c4d39b312b83615ecb700;Tue Apr 20 03:39:34 EDT 2010;Committer;xibbar;3;11;6;17;0
e63df5319855c1b4ebba0498a466c3806dedba99;Tue Apr 20 03:24:59 EDT 2010;Committer;nobu;3;40;10;50;0
85cb4ee236ee14ec00aebcd90130555ce909d3a2;Tue Apr 20 03:09:57 EDT 2010;Committer;nobu;1;3;5;8;0
8a3201dae6addec4f5c7d8717f9a34851a4d3e75;Tue Apr 20 01:46:52 EDT 2010;Committer;nobu;2;8;8;16;0
dd3bbc6005f524f685634917ea3b207643f823da;Tue Apr 20 00:29:26 EDT 2010;Committer;nobu;1;1;1;2;0
ab10ac8f12f7a903ab5d6c96983f6b9073441468;Mon Apr 19 16:03:39 EDT 2010;Committer;mame;2;25;0;25;0
cb508fe7397a6054a45cac11cf3e865f13f24aea;Mon Apr 19 15:43:05 EDT 2010;Committer;nobu;3;8;1;9;0
a91d8b8c33b834f47ab000cc3844e9b18c1becba;Mon Apr 19 15:41:27 EDT 2010;Committer;nobu;2;10;17;27;0
aef15affc7ae8dc03220efa3cc2b21906cd8e7a1;Mon Apr 19 15:34:07 EDT 2010;Committer;svn;1;2;2;4;0
59b91237c339b4743620526d60e51e49ea8ed6b8;Mon Apr 19 15:34:04 EDT 2010;Committer;mame;2;10;0;10;0
50fa45fb8933d752fbda5394d59a5cb63e810ae1;Mon Apr 19 10:46:48 EDT 2010;Committer;shyouhei;2;6;0;6;0
04247ab5b46d713941dd092f8ef1b1c7150e5272;Mon Apr 19 10:18:56 EDT 2010;Committer;nobu;2;7;5;12;0
312d5bf7f2eb48c83ede97a609ef71cb346b27a4;Mon Apr 19 09:58:09 EDT 2010;Committer;nobu;1;6;0;6;0
75ef9e79d6f872d9155cfa69d717b0c693be7fc9;Mon Apr 19 05:08:28 EDT 2010;Committer;drbrain;14;169;77;246;0
37e59f5583c781e98f41608251e094377237a133;Mon Apr 19 03:46:17 EDT 2010;Committer;nobu;2;12;2;14;0
cd08b1cbff1bc8f60c64ded8a21d57d1c58eea18;Sun Apr 18 18:00:02 EDT 2010;Committer;svn;1;2;2;4;0
61e5cf84fffb7620b849fda4cbba58302b0538ff;Sun Apr 18 17:59:56 EDT 2010;Committer;naruse;2;16;2;18;0
f25e99c55f42d23aac050594a482cd2e1807e7ac;Sun Apr 18 13:16:30 EDT 2010;Committer;nobu;1;15;19;34;0
9f8b0361233fcd4bbc5cfb45ca41847ac960de16;Sun Apr 18 13:13:23 EDT 2010;Committer;nobu;2;8;4;12;0
20a6e94e4758334209a1c3d241737c84d759daad;Sun Apr 18 09:09:46 EDT 2010;Committer;akr;3;26;1;27;0
e70a308c75072121ec780ae571fc32db3fe87737;Sun Apr 18 03:48:54 EDT 2010;Committer;nobu;3;10;1;11;0
cfab29b7db7f3ea63a339946e2959f7118eec7fd;Sun Apr 18 03:32:06 EDT 2010;Committer;nobu;3;23;8;31;0
4d82ba512c793c2c11a54a1bb1f5ead41e2f8d92;Sun Apr 18 03:28:12 EDT 2010;Committer;nobu;1;1;1;2;0
54985ad7ddbb3e7aaa7fd35686e97d3be64aa23f;Sun Apr 18 03:26:56 EDT 2010;Committer;nobu;1;1;1;2;0
2845bfa9dd648a2ea3c8e753bdeeddbcdf4f203a;Sat Apr 17 20:52:46 EDT 2010;Committer;tenderlove;3;17;2;19;0
1cae325a3504f551ad968e8562756b05ed29b682;Sat Apr 17 17:15:22 EDT 2010;Committer;svn;1;2;2;4;0
fd734e6cc63fb8b8fdced9bc5dea22ab311395b0;Sat Apr 17 17:15:20 EDT 2010;Committer;naruse;2;6;2;8;0
580677a9846733c4ec02271fe7e9484c028be06f;Sat Apr 17 14:27:54 EDT 2010;Committer;naruse;2;6;1;7;0
71104c3356e39ae012a89055e1426537af116078;Sat Apr 17 11:38:04 EDT 2010;Committer;mame;2;7;0;7;0
0b28bf2958497d0ec2d278bf251947c430190538;Sat Apr 17 11:37:56 EDT 2010;Committer;mame;2;7;2;9;0
94365e53450cbedcdb1eac8f9ba131f1cf6b5501;Sat Apr 17 03:04:03 EDT 2010;Committer;tenderlove;1;3;3;6;0
8b261b413c288d7e15851ebbb391fd98322aaeba;Sat Apr 17 00:23:28 EDT 2010;Committer;wanabe;3;43;28;71;0
2939d61f285455c7b98de2a02df32cd34d068e01;Fri Apr 16 23:57:43 EDT 2010;Committer;nobu;2;23;5;28;0
a350d0afc5c2abcd9850e9f911a856c51f15e76f;Fri Apr 16 22:45:45 EDT 2010;Committer;kazu;2;6;2;8;0
d49860bfbcdd30ffd3f3d72a057e7a506e174d65;Fri Apr 16 22:30:16 EDT 2010;Committer;kazu;2;7;1;8;0
5b5bbdbb35098e8e2dabe7af5d31526a54dc8bbd;Fri Apr 16 20:31:59 EDT 2010;Committer;tenderlove;4;31;1;32;0
2db7b7f3fe7de2b518d46ea11c26875f86d26136;Fri Apr 16 20:27:51 EDT 2010;Committer;tenderlove;5;47;7;54;0
2c6a1457b63aef507c9168e1f33b71af2ee750e7;Fri Apr 16 16:36:11 EDT 2010;Committer;svn;1;2;2;4;0
d6f289b0ff42aa0320a13b08467a70f8844bd72f;Fri Apr 16 16:36:08 EDT 2010;Committer;mame;2;11;2;13;0
de1324fb7fa3ca0e68b7732e688b169c44fea4c7;Fri Apr 16 14:55:42 EDT 2010;Committer;suke;2;19;11;30;0
fd9c3fef0b2bb1e7110b17ff4157d384438ff58d;Fri Apr 16 12:57:28 EDT 2010;Committer;mame;2;11;4;15;0
49884b5769c4fa059e448d531fd759c37380e5c5;Fri Apr 16 12:36:41 EDT 2010;Committer;mame;2;8;7;15;0
6511fec7adc1f4604b46788d651f00c9d08aad8d;Fri Apr 16 11:11:17 EDT 2010;Committer;mame;1;1;1;2;0
93c5002a7c3a157e0b3cd4192a7f26f32677562c;Fri Apr 16 11:10:08 EDT 2010;Committer;mame;3;50;20;70;0
7d26c313a12a174c27576e4c55fb76b1ff62de7e;Fri Apr 16 11:02:24 EDT 2010;Committer;mame;2;22;0;22;0
565d22756bcec472e64f76699ffe5a5194fe14dd;Fri Apr 16 07:51:18 EDT 2010;Committer;nobu;2;7;2;9;0
b62feb5e0482e2a7e8ec42f0413f5b7aff0552ba;Fri Apr 16 07:24:08 EDT 2010;Committer;svn;1;2;2;4;0
38ae9967067b7b208ecd355ac129285b2c55922f;Fri Apr 16 07:24:04 EDT 2010;Committer;matz;3;271;0;271;0
42b8a699ed4c23ff45b14a2c577a82f40fba1dfa;Thu Apr 15 13:44:52 EDT 2010;Committer;mame;2;16;3;19;0
8588e7631eeab7fe8b91d2f2f7059144b233ad0d;Thu Apr 15 13:41:19 EDT 2010;Committer;mame;3;22;2;24;0
77204d5391043a9026c8078d12d84389dbe525dd;Thu Apr 15 12:55:11 EDT 2010;Committer;akr;2;17;1;18;0
83724a77dd85d7b5428742e40c1fa74804765610;Thu Apr 15 12:14:45 EDT 2010;Committer;naruse;2;5;1;6;0
d9aab5725241759ccf4a01621d20c6ff1ecb1c9c;Thu Apr 15 11:43:09 EDT 2010;Committer;akr;2;12;2;14;0
7475244ec44103e00f7ffe0137cd88bb4a96b41d;Thu Apr 15 05:50:24 EDT 2010;Committer;nobu;2;10;2;12;0
584829aa814a1104205ab85cefcf245f8c118987;Thu Apr 15 05:38:07 EDT 2010;Committer;nobu;4;22;4;26;0
073515a6499bc2ccc6a20891c4c82a5afb91b2a7;Thu Apr 15 02:52:15 EDT 2010;Committer;svn;1;2;2;4;0
202ce4fd63fc5589e42c1db8304cca21391b5020;Thu Apr 15 02:52:12 EDT 2010;Committer;usa;2;5;1;6;0
46ff009168cfb29b473bc37d38b64719ad9e6526;Wed Apr 14 13:11:11 EDT 2010;Committer;naruse;3;44;14;58;0
55f7857a7758102eb512eaa7aca3d2855fb797da;Wed Apr 14 09:29:29 EDT 2010;Committer;mrkn;2;16;1;17;0
8e7a682be04ac9060f1957ea12a84d2aeb7374c9;Wed Apr 14 08:56:11 EDT 2010;Committer;nobu;2;6;4;10;0
95c52c8e6c2e0ac8ea690ca8ae5141a0fde49e24;Wed Apr 14 07:29:04 EDT 2010;Committer;nobu;4;14;4;18;0
92496d73eb68bcdd062251a7fb2cb994e0086780;Wed Apr 14 06:58:13 EDT 2010;Committer;nobu;2;8;1;9;0
2587316c7370a666fb94e7100176533ae38990c1;Wed Apr 14 04:00:09 EDT 2010;Committer;shugo;3;10;1;11;0
ddafeb2f2a66a25b0d024ab764b519795afa5383;Wed Apr 14 02:39:28 EDT 2010;Committer;nobu;2;5;2;7;0
eedb41a85b363e00e58de00c5b62cba5f2b3553e;Wed Apr 14 02:37:54 EDT 2010;Committer;nobu;3;104;94;198;0
bde213674c8a65bc0ae9c4c130e2c01ae63913b4;Wed Apr 14 01:55:20 EDT 2010;Committer;svn;1;2;2;4;0
b2ae25297666fd66694235e58857afc1218cb4c9;Wed Apr 14 01:55:17 EDT 2010;Committer;naruse;2;21;11;32;0
4392ea3527c595f81ae06cb7f252a3b5b43530d4;Tue Apr 13 11:37:55 EDT 2010;Committer;naruse;2;12;7;19;0
5d8c8b46bb763e2c4cdf68079b9eaede860be5b7;Tue Apr 13 06:00:49 EDT 2010;Committer;nobu;2;14;2;16;0
5ee43b0a94d2743f97cdee5e83e6093243af7559;Tue Apr 13 05:01:10 EDT 2010;Committer;keiju;2;8;3;11;0
c871aee96b0d5112ecc040cd56e84a2d7fe2e3c5;Tue Apr 13 01:26:46 EDT 2010;Committer;naruse;3;57;3;60;0
9afaef347c84e8e90312d3335c887d2c65acc86b;Mon Apr 12 20:50:45 EDT 2010;Committer;akr;1;7;0;7;0
db9119bedfed116201ed0caffac964825c7ac964;Mon Apr 12 15:16:48 EDT 2010;Committer;svn;1;2;2;4;0
19afeacb884b53949236c30afaa4ce2866c30603;Mon Apr 12 15:16:45 EDT 2010;Committer;akr;2;8;0;8;0
309077c9ae3b530052dce39ab871a04bce1b9468;Mon Apr 12 13:49:44 EDT 2010;Committer;akr;2;15;2;17;0
a698c7bf72931506c78706c2de16eb2b1343ff9d;Mon Apr 12 12:47:43 EDT 2010;Committer;nobu;2;42;1;43;0
3a2f5d9cf7f2aa1ef06036e70cbf5c0203a69e57;Mon Apr 12 00:19:52 EDT 2010;Committer;nobu;2;11;18;29;0
a3dde7df529dc459cbe4f42df2a836652b3469be;Mon Apr 12 00:18:55 EDT 2010;Committer;nobu;2;6;1;7;0
17fa2ce73a4ff6ba67dc92da5148b65ba3e3eeb5;Sun Apr 11 20:10:43 EDT 2010;Committer;marcandre;2;51;1;52;0
3a1c0be67fac516822d83c1fe628a32c7782a4a8;Sun Apr 11 19:05:53 EDT 2010;Committer;tenderlove;1;2;0;2;0
521f4a4beb1623cfc911ab07a9c5c37dd0dd8988;Sun Apr 11 18:50:51 EDT 2010;Committer;marcandre;3;6;27;33;0
3f64c83eb1b698b18ab9c71abc6815537485ef89;Sun Apr 11 18:45:58 EDT 2010;Committer;marcandre;2;10;3;13;0
e0cfb13c32979dee608812a38c16c518ab9557c7;Sun Apr 11 18:30:58 EDT 2010;Committer;marcandre;2;36;27;63;0
5469cf0f3a88e06e3c9977d71e12b904307ddf5e;Sun Apr 11 16:50:33 EDT 2010;Committer;marcandre;1;8;0;8;0
147fbbed620009ba5752763ab36ca297eb8af133;Sun Apr 11 15:56:46 EDT 2010;Committer;svn;1;2;2;4;0
0a6d09330c9b8b179be1174137e79e4075819275;Sun Apr 11 15:56:43 EDT 2010;Committer;kazu;3;32;4;36;0
78a59b37a161080473ace8d2d14f1fbf6466d025;Sun Apr 11 14:31:09 EDT 2010;Committer;kanemoto;2;6;1;7;0
8f8e4e5ab5a58b21b366780f934578d230599851;Sun Apr 11 06:56:28 EDT 2010;Committer;akr;1;6;6;12;0
748782bfc958f1ea0245cfc1fb1e893f7fe2f671;Sun Apr 11 05:47:18 EDT 2010;Committer;mame;2;6;1;7;0
5017259085e7a4147fc4e6465e5dfeefe9c48d26;Sun Apr 11 03:21:47 EDT 2010;Committer;nobu;1;3;1;4;0
9f9ace81f8cd7624f1cefb8c2b9af1fbba72af90;Sun Apr 11 03:08:51 EDT 2010;Committer;nobu;3;7;1;8;0
021e7b7f20718a31906ef2728fab73d18e42013a;Sun Apr 11 02:58:26 EDT 2010;Committer;nobu;2;6;0;6;0
1edc8d3b9ecb23fb22f929ba19b0f9bc94edceb2;Sun Apr 11 02:20:29 EDT 2010;Committer;kazu;1;1;1;2;0
f3668748149f814f29c2a32a91914672ee966699;Sun Apr 11 01:45:15 EDT 2010;Committer;tenderlove;3;20;2;22;0
ff5366a7053a2d420139e32fb3936ee85a2839fe;Sun Apr 11 01:34:28 EDT 2010;Committer;drbrain;5;134;32;166;0
48a68756f5813a078d3c69a4180a9102208f953b;Sun Apr 11 01:21:29 EDT 2010;Committer;tenderlove;5;155;155;310;0
5a7b5e70587a5b0fdd0fc1bbfa0d98d665e70970;Sun Apr 11 00:44:06 EDT 2010;Committer;tenderlove;1;1;7;8;0
a5f05e7ee9823fb04dea5219cafce5c5d879e305;Sun Apr 11 00:37:42 EDT 2010;Committer;tenderlove;31;1832;1823;3655;0
7f72d102cb30b1858ec329f44485ef734ecc6eb0;Sun Apr 11 00:00:43 EDT 2010;Committer;naruse;2;9;2;11;0
b9617bf7cb195924b47cf026d0638253b1bc02de;Sat Apr 10 23:50:50 EDT 2010;Committer;tenderlove;1;2;2;4;0
7be704b359cb4de29a3ce7599c6a6afaa399de44;Sat Apr 10 22:41:36 EDT 2010;Committer;naruse;2;5;1;6;0
e707e05fe87645e9dc6862a5875ffae5cc9cffcf;Sat Apr 10 22:09:09 EDT 2010;Committer;naruse;2;3;6;9;0
f2467cd06a45ed05ae23dc7f2b631bd39de50066;Sat Apr 10 22:05:06 EDT 2010;Committer;svn;1;2;2;4;0
9e30f60dbf26d2c628fd8601bc0cc496c8c77db0;Sat Apr 10 22:05:02 EDT 2010;Committer;naruse;3;18;11;29;0
a31507939004778e39af5da92bcd6b295b86c11d;Sat Apr 10 12:28:13 EDT 2010;Committer;naruse;2;6;1;7;0
1325437297539bf433904b64db63a3186e62177e;Sat Apr 10 06:36:13 EDT 2010;Committer;drbrain;33;395;162;557;0
ce2b574017cacc2c3f2b0e92f82a7f250639fc34;Sat Apr 10 04:16:19 EDT 2010;Committer;mame;2;6;0;6;0
7d73136d066eca26c8d9fdd1afe8a826dadd270c;Fri Apr 09 22:38:46 EDT 2010;Committer;wanabe;2;6;2;8;0
6cfcb9d936af87b8ebfad23541e13af2cf6c95ef;Fri Apr 09 20:33:21 EDT 2010;Committer;tenderlove;4;31;2;33;0
186e5758278f40e2415b5b1c7a4251900e9fe3b4;Fri Apr 09 20:33:10 EDT 2010;Committer;tenderlove;2;154;0;154;0
052f204dcbb3d02509a47e8bd559a444a3f81160;Fri Apr 09 16:09:55 EDT 2010;Committer;tenderlove;3;11;0;11;0
5869de449fe535321a1f43d3ca59c22cdf610e9e;Fri Apr 09 15:07:34 EDT 2010;Committer;mame;2;13;2;15;0
d124dcf4eb245ced006ff4a3817322d8ecdbaea9;Fri Apr 09 15:04:54 EDT 2010;Committer;mame;2;8;0;8;0
453c63c01bffcbf529689213d8b3a660928d2d3a;Fri Apr 09 15:04:43 EDT 2010;Committer;svn;1;2;2;4;0
bd623a0915ae63422463ea49651fd73e0426efaa;Fri Apr 09 15:04:40 EDT 2010;Committer;mame;2;11;0;11;0
d3e7b990dc096f71a32eb18959503328b78cf2b1;Fri Apr 09 14:55:18 EDT 2010;Committer;mame;4;21;0;21;0
79a3b7797f559d3aa41816368c8a3c1fb26f4530;Fri Apr 09 14:53:19 EDT 2010;Committer;mame;3;19;3;22;0
c13142643d846b3805296babf81f81791378122d;Fri Apr 09 12:28:00 EDT 2010;Committer;keiju;2;11;3;14;0
8a3c3b9c95955bba7f143c44136a043568d88b94;Fri Apr 09 11:58:20 EDT 2010;Committer;naruse;3;21;4;25;0
1f2def7dd84da6477df1ef9b4e8b39f6ce6f04cb;Fri Apr 09 11:32:52 EDT 2010;Committer;mame;2;7;4;11;0
5dd8daaa27e409ef1c63e70a59dcafb4a8f9775b;Fri Apr 09 11:08:06 EDT 2010;Committer;mame;2;10;2;12;0
e9cfe4770059f4ab64f84366949742274c4fe4de;Fri Apr 09 08:15:33 EDT 2010;Committer;naruse;1;5;0;5;0
2eda201bc6a521e056ea8be7f237cebd28573205;Fri Apr 09 05:22:53 EDT 2010;Committer;muraken;2;6;1;7;0
92de2ed517cea4524579092ce7962a879d33a7e9;Thu Apr 08 16:27:42 EDT 2010;Committer;nobu;2;23;4;27;0
f6b46f0779e0a720cd4d199cf88a451310ceccc5;Thu Apr 08 16:17:30 EDT 2010;Committer;svn;1;2;2;4;0
d56c6580304c4ff8268e00a8a54d69a4f4877d9f;Thu Apr 08 16:16:17 EDT 2010;Committer;mame;2;6;4;10;0
f3b9acda2155012aa982af21aa6e951b0c062209;Thu Apr 08 06:32:08 EDT 2010;Committer;nobu;0;0;0;0;0
41b267a30c820a796e73ff38bd71d1908d45a4bc;Thu Apr 08 05:40:42 EDT 2010;Committer;shyouhei;1;4;0;4;0
969041d034e833fcc5e2da0939b98e2698f61d19;Thu Apr 08 05:35:37 EDT 2010;Committer;shyouhei;1;1;0;1;0
3b86c8c4aeb9a93a34129ad61cd3df29ce634086;Thu Apr 08 05:25:10 EDT 2010;Committer;usa;2;7;0;7;0
23d104a1611f4dd442b24980d37e8c344a529c56;Thu Apr 08 02:45:23 EDT 2010;Committer;nobu;2;6;2;8;0
3a45ac8af15bf5b6074820b02ef9e50e0717fa3c;Thu Apr 08 02:32:06 EDT 2010;Committer;nobu;2;7;1;8;0
f571492922083d0a02d2dc5ee5125af52935d5cd;Wed Apr 07 22:22:36 EDT 2010;Committer;nobu;3;18;2;20;0
0f58f9dbe7bf81595b78bcee9cab49a4a546ba80;Wed Apr 07 22:16:47 EDT 2010;Committer;nobu;2;9;1;10;0
f1973fff8ad2518892adf0acb0ae7aea8b92a40c;Wed Apr 07 17:45:08 EDT 2010;Committer;svn;1;2;2;4;0
f3d2f9e4d13c6f871a5c72ebcadd1e0aeab267f3;Wed Apr 07 17:36:15 EDT 2010;Committer;marcandre;3;13;25;38;0
ceb62c31a1351422c208282a755d6eb3e0073a17;Wed Apr 07 14:39:28 EDT 2010;Committer;kosaki;2;9;1;10;0
082480dfe47a772f7edf71aba0134eff05895ea6;Wed Apr 07 12:45:02 EDT 2010;Committer;akr;2;4;6;10;0
ea925720fe1bbf4cbbf8bb6fc70373169ee144b1;Wed Apr 07 08:50:54 EDT 2010;Committer;kazu;1;8;8;16;0
4900daa4a3246f32a7d7fc7e8a38bfd5227dd649;Wed Apr 07 08:50:36 EDT 2010;Committer;kazu;1;1;0;1;0
93af285b28afde8384562a87d06f95970d8a978d;Wed Apr 07 07:45:56 EDT 2010;Committer;nobu;2;8;6;14;0
66a425c65cef32e950200ec4000724c76217014e;Wed Apr 07 02:59:33 EDT 2010;Committer;naruse;2;9;1;10;0
fed549a10437f54588e0b1e0e9bd883d59bd37a6;Wed Apr 07 02:47:07 EDT 2010;Committer;naruse;2;8;2;10;0
cbe2385792b720615cc82db50631ef7bfcca2d50;Wed Apr 07 00:45:01 EDT 2010;Committer;nobu;2;7;4;11;0
640c32ef77c03d2c927abca6f946ff332db7195d;Tue Apr 06 18:29:20 EDT 2010;Committer;nobu;2;8;3;11;0
1007748627ab21a7e397c45d6686e753687aebb2;Tue Apr 06 17:06:20 EDT 2010;Committer;nobu;2;9;4;13;0
9784c5c8f16c3c32f045c984f950c9137c42cf31;Tue Apr 06 17:06:12 EDT 2010;Committer;svn;1;2;2;4;0
7dd103822bad37ea8f8b08e38d7023fe9a261887;Tue Apr 06 17:05:50 EDT 2010;Committer;nobu;1;7;2;9;0
2e507f34e0518b13fa0aa26d3de5cac7e54ae804;Tue Apr 06 14:37:16 EDT 2010;Committer;akr;1;18;0;18;0
75ce78429ee220349e3e01aa874e918e1eb1745f;Tue Apr 06 14:07:06 EDT 2010;Committer;kosaki;3;18;11;29;0
2bbeb4c0ad49847b1f73ba6281827bf513d05884;Tue Apr 06 13:03:43 EDT 2010;Committer;akr;3;98;14;112;0
727371f88ac06fcb1e5417492f5ab17f5d58d886;Tue Apr 06 05:58:07 EDT 2010;Committer;usa;3;149;39;188;0
e41936441bf9fcab9fb4d8ceb70cc73d2a38c9c0;Tue Apr 06 03:01:52 EDT 2010;Committer;naruse;7;17;18;35;0
2ff26f22209c5b260585fcac2383ae6c91aef766;Tue Apr 06 02:21:40 EDT 2010;Committer;nobu;3;30;1;31;0
00adf578dfd8e505b59a081d4940d807c490cf6c;Tue Apr 06 00:53:34 EDT 2010;Committer;naruse;1;2;2;4;0
b3ac1c3fb8e994e34a9c5bfb79d04a61026a8a4d;Tue Apr 06 00:53:14 EDT 2010;Committer;naruse;1;0;1;1;0
75ba1d6ac49db4847877c41f50da48d18423c15b;Tue Apr 06 00:22:04 EDT 2010;Committer;naruse;2;3;2;5;0
9ea41e083c6dca6f75d1f1e8cf51686fd6784de5;Mon Apr 05 21:27:40 EDT 2010;Committer;naruse;1;1;1;2;0
8287d55340d12cef324165287c55023080586d4c;Mon Apr 05 21:21:53 EDT 2010;Committer;naruse;2;10;4;14;0
40bc864003879046de3439fd08af43567a0c574c;Mon Apr 05 21:08:12 EDT 2010;Committer;naruse;5;22;15;37;0
34fb9453488d00c6542a48e78294aceaee72c90b;Mon Apr 05 15:30:25 EDT 2010;Committer;svn;1;2;2;4;0
634616d7f36c11c7cf0bdc5f74a1fd7f54f89020;Mon Apr 05 15:30:18 EDT 2010;Committer;marcandre;1;0;5;5;0
500c78c610d9cde2f7a85755f8eb4105e5889ea4;Mon Apr 05 10:57:38 EDT 2010;Committer;naruse;2;32;2;34;0
54da3ecbcbfd6cda2451da9aceafb3ef72a1c70e;Mon Apr 05 04:26:33 EDT 2010;Committer;usa;3;10;1;11;0
10c9ed249320165a4a8ec2f70cade2f1c90f2bcd;Mon Apr 05 04:12:14 EDT 2010;Committer;naruse;4;25;33;58;0
f1c86c1bb22e7b999449cee398e0e804f21ea18f;Mon Apr 05 04:09:45 EDT 2010;Committer;usa;2;6;1;7;0
b847ca06bf3f5026a8e9ee31fd0daea4436832e6;Mon Apr 05 02:42:37 EDT 2010;Committer;naruse;1;3;1;4;0
563cd015e5c0a03cc3f343a55a18f938fd234070;Sun Apr 04 15:11:08 EDT 2010;Committer;svn;1;2;2;4;0
daad4e24338b8f567b0caf211d3337567c321934;Sun Apr 04 15:10:44 EDT 2010;Committer;marcandre;1;0;6;6;0
782e379f299ebe2d3ec46cb4779e5c37e5cf20c6;Sun Apr 04 13:20:29 EDT 2010;Committer;akr;2;54;51;105;0
0cd2058bb3db8859340d7a4a738028817e00b408;Sun Apr 04 04:41:25 EDT 2010;Committer;naruse;1;0;1;1;0
b919cb1d9359121eef893afd1b8af710ed2384bd;Sun Apr 04 01:10:53 EDT 2010;Committer;naruse;8;1287;1305;2592;0
9c50406bd5892c95d76e966c1db8b85c4b5fbe32;Sun Apr 04 00:45:02 EDT 2010;Committer;akr;2;11;6;17;0
eb71e5cd67f4ce4da5ba331f93a8e36c65457b94;Sat Apr 03 21:50:47 EDT 2010;Committer;tenderlove;41;2299;2184;4483;0
ca926ad017a804817b9a2e5389196f9acf9d9b68;Sat Apr 03 21:00:08 EDT 2010;Committer;svn;1;2;2;4;0
93f4317f89f3dc0ab9e11cea5c2d3e73841e442f;Sat Apr 03 20:59:56 EDT 2010;Committer;marcandre;2;26;16;42;0
88a4bf912dedc7e4dad244022cfd9879fc93c59b;Sat Apr 03 14:57:20 EDT 2010;Committer;kazu;1;1;1;2;0
8587c246e90f8a86b9fce5854ff8a2dc905abf91;Sat Apr 03 13:48:37 EDT 2010;Committer;akr;2;4;1;5;0
8acd03f0f7be54cfeb1b8c83b7fcc28e06a4721f;Sat Apr 03 09:15:13 EDT 2010;Committer;nobu;2;31;8;39;0
d38090cff58ee4cae40dbc1994b6d5cd615b8610;Sat Apr 03 09:09:43 EDT 2010;Committer;nobu;1;1;1;2;0
f01510d074913ac7c62843d661a905ffc265af69;Sat Apr 03 06:09:37 EDT 2010;Committer;nobu;3;8;2;10;0
6decf411c6f8fd6778d8d4326a8dd8a0e2c09dcd;Sat Apr 03 01:51:26 EDT 2010;Committer;nobu;3;10;3;13;0
a9aeb765c5b6681063682d67df75df96af5860b0;Fri Apr 02 23:18:51 EDT 2010;Committer;naruse;1;0;2;2;0
94ab139bc9df6016090596468f4139b1772ad882;Fri Apr 02 22:44:17 EDT 2010;Committer;marcandre;1;5;1;6;0
d0a98a0e90c9ff969da0c477f0f4cedb018b54b1;Fri Apr 02 22:25:49 EDT 2010;Committer;marcandre;2;20;0;20;0
7cf6ecd9de34ce5d51e9ef71d30a1ae44e6f9536;Fri Apr 02 21:56:34 EDT 2010;Committer;marcandre;3;24;9;33;0
8d8ff193b6db072ebe379d60f91e0baa17090a2c;Fri Apr 02 19:48:04 EDT 2010;Committer;akr;2;21;1;22;0
fe0aab0911594cc34a1e2faf26b6e7f5eabf2b8d;Fri Apr 02 18:22:29 EDT 2010;Committer;kazu;3;18;1;19;0
eb86567b694ed926b416debcca8e4e0ea9b889c4;Fri Apr 02 16:50:14 EDT 2010;Committer;nobu;3;10;3;13;0
e654e593a5168327b738925953dca418a429d2fd;Fri Apr 02 16:45:47 EDT 2010;Committer;nobu;1;1;1;2;0
de286af37637ab14ccaf79d72a2d0218ea993eaf;Fri Apr 02 15:03:29 EDT 2010;Committer;svn;1;2;2;4;0
58a93ce44169f20c6e9c104a26c99d51768c2eb7;Fri Apr 02 15:03:18 EDT 2010;Committer;nobu;2;7;4;11;0
232ced73424dd968aa6d3884bae00db1d5ce06b8;Fri Apr 02 13:28:10 EDT 2010;Committer;nobu;2;7;3;10;0
166fedb45d6f08f4f2eaca3de53c14180f92afbb;Fri Apr 02 13:13:45 EDT 2010;Committer;nobu;2;7;4;11;0
386962af112ca41169f37bd7a8bea9517bfb2fc8;Fri Apr 02 12:17:50 EDT 2010;Committer;nobu;2;6;0;6;0
871c693c8aa141154f804652883db43457593d68;Fri Apr 02 07:43:32 EDT 2010;Committer;nobu;1;2;2;4;0
cf25ae4551f623121b9047e1c94a872583b545aa;Fri Apr 02 06:26:24 EDT 2010;Committer;nobu;2;20;4;24;0
bb471e32687defb003d0009eba018f15bd143f7b;Fri Apr 02 05:44:42 EDT 2010;Committer;nobu;1;6;6;12;0
aae8b872d55d3d61bf32d7e3a33f32c117e8ee55;Fri Apr 02 05:43:27 EDT 2010;Committer;nobu;3;12;9;21;0
88ccbf048f591fb610bd50ce6b74e9611435e18a;Fri Apr 02 05:40:39 EDT 2010;Committer;nobu;1;1;1;2;0
104ff6089d337a33927f6e2cf3b8501e46402d37;Fri Apr 02 05:26:38 EDT 2010;Committer;nobu;2;5;6;11;0
2df7054c3035b7c75d5a5e029f7928bd39374592;Fri Apr 02 05:24:33 EDT 2010;Committer;nobu;2;7;1;8;0
30527783c73c369b915d31127d4837378ce1a457;Fri Apr 02 05:17:01 EDT 2010;Committer;nobu;2;5;2;7;0
8d3537a85c2ba24bee3b43ac8203654148289863;Fri Apr 02 05:14:39 EDT 2010;Committer;nobu;2;5;2;7;0
06adf90ab66829cc24b15ddb7be5e12a60a3141e;Fri Apr 02 05:12:31 EDT 2010;Committer;nobu;2;9;5;14;0
5bdee08c1e48c0fa731cae9469e09355c0e576f4;Fri Apr 02 04:59:27 EDT 2010;Committer;nobu;2;5;3;8;0
6a08bd96240b09a7625736e48c6ea4c68dd34b3c;Fri Apr 02 04:57:16 EDT 2010;Committer;nobu;2;4;2;6;0
6926a10297982f09312b4da3a3bb14f28e877978;Fri Apr 02 04:52:03 EDT 2010;Committer;nobu;2;6;5;11;0
2553a96f9eb29ca334d713aa1830f5cce3045f86;Fri Apr 02 04:40:47 EDT 2010;Committer;nobu;18;83;83;166;0
0c216c32dc9e5ce2554b516e821c4e94c2f05316;Fri Apr 02 04:40:34 EDT 2010;Committer;nobu;1;6;6;12;0
10547e3c412be6f4f14f818294bf456dacad1ec4;Fri Apr 02 03:53:01 EDT 2010;Committer;usa;2;5;1;6;0
c78dbcd13121cecaac64fec7956d0929867bff50;Fri Apr 02 02:57:05 EDT 2010;Committer;usa;2;7;1;8;0
4dcaa9e5aae6cc9fa3b5bfb1dc7b0d9365e10e13;Thu Apr 01 23:25:10 EDT 2010;Committer;nobu;2;18;8;26;0
893c123bfb229e3f6079a521a858bec50cf43248;Thu Apr 01 23:24:11 EDT 2010;Committer;nobu;1;2;2;4;0
04a293b966bb55d1dc53843f548337ebd08f2435;Thu Apr 01 23:23:03 EDT 2010;Committer;nobu;1;4;0;4;0
df932e66ce4990d3ce6feaa66c41a2b117e8ab39;Thu Apr 01 22:19:04 EDT 2010;Committer;naruse;1;9;0;9;0
be30c131daf56f1f3143fbc323e986c496c72e38;Thu Apr 01 22:00:42 EDT 2010;Committer;nobu;2;5;1;6;0
7271a56417bde7f0d4a60b31c66b339d18cd5d35;Thu Apr 01 21:59:57 EDT 2010;Committer;nobu;1;1;1;2;0
93164bd9d738055c00388bac76d565d844da8d4a;Thu Apr 01 21:59:41 EDT 2010;Committer;nobu;1;12;9;21;0
71cfa6ea2d19ba6420845aab3dc0fc206709efde;Thu Apr 01 21:36:17 EDT 2010;Committer;naruse;1;2;2;4;0
2f2071824952b3c341bcd8b1ad74e91e4677420f;Thu Apr 01 20:38:38 EDT 2010;Committer;nobu;2;7;0;7;0
5ef335319e925422adad386b9a3395b38c705a7b;Thu Apr 01 18:06:08 EDT 2010;Committer;marcandre;1;6;6;12;0
729941da390cb317feb6772204d1630a21705c12;Thu Apr 01 18:05:11 EDT 2010;Committer;marcandre;2;86;0;86;0
277cb36b21f8b5cb93e6b4373b23449bea917416;Thu Apr 01 18:04:14 EDT 2010;Committer;marcandre;1;39;0;39;0
af6e31b3444d090816e5c64e5827cd2271bc8bb3;Thu Apr 01 18:03:15 EDT 2010;Committer;marcandre;1;2;1;3;0
fac245828b9e354c9eeb93a029f1643031c3c62d;Thu Apr 01 18:02:27 EDT 2010;Committer;marcandre;1;10;2;12;0
39aad8fa8364d12b5888c8ae24f3b47b7d06f99c;Thu Apr 01 18:01:45 EDT 2010;Committer;marcandre;1;1;16;17;0
99179d63228ecf6301448f3f56a4a88a5ec2cc00;Thu Apr 01 17:21:30 EDT 2010;Committer;svn;1;2;2;4;0
bad1200f9d1b1082b3aaa46195ab0b332c6d00ac;Thu Apr 01 17:21:08 EDT 2010;Committer;naruse;2;4;1;5;0
1bf2b99d275da110319e498e5d28febe37e9cde1;Thu Apr 01 14:53:44 EDT 2010;Committer;marcandre;1;6;1;7;0
63a85806949106e970375938722a88e72d9f43f7;Thu Apr 01 11:29:35 EDT 2010;Committer;naruse;1;1;1;2;0
548932ce976dca3379dbf0d3fcd5a06bb75bcba3;Thu Apr 01 08:43:56 EDT 2010;Committer;naruse;1;0;10;10;0
afd64aafd1b4def1cb3f9109b470e02b09314c80;Thu Apr 01 08:18:38 EDT 2010;Committer;naruse;3;34;7;41;0
46580b51477355fece514573c88cb67030f4a502;Thu Apr 01 07:45:16 EDT 2010;Committer;drbrain;175;17725;16341;34066;0
9b40cdfe8c973a061c5683ad78c283b9ddb8b2e9;Thu Apr 01 06:44:30 EDT 2010;Committer;naruse;1;4;0;4;0
7e3e79d0833953f8243e304a86a96b7e41a310a6;Thu Apr 01 05:30:25 EDT 2010;Committer;nobu;3;8;6;14;0
3a4c2bc034a4205ac7116c69ee39de02defb6d17;Thu Apr 01 05:09:10 EDT 2010;Committer;naruse;2;22;19;41;0
12b2e16e21bbd7f0b6fd12c7e21cba4d42e284ad;Thu Apr 01 04:32:57 EDT 2010;Committer;naruse;6;242;10;252;0
4d399f12d4354c17bbb1ea2b12de4c11c6ac03ff;Thu Apr 01 04:32:43 EDT 2010;Committer;naruse;5;46;16;62;0
2067e4eb30eb78b36c252baff319c6d581700460;Thu Apr 01 04:32:22 EDT 2010;Committer;naruse;3;28;7;35;0
7b93993b20f1e1c045aa6f687ea56ae9d4ac01f7;Thu Apr 01 03:20:04 EDT 2010;Committer;usa;1;5;0;5;0
c530b9d60a2bbbd6841797f6a6f980cdbc413771;Thu Apr 01 03:06:07 EDT 2010;Committer;usa;1;10;0;10;0
171131061e65d46a746c6bb96dff3b1c2ae515aa;Thu Apr 01 02:36:33 EDT 2010;Committer;nobu;2;8;2;10;0
44e08324c7494a626c1801e4d1f6a09353928586;Thu Apr 01 00:54:37 EDT 2010;Committer;nobu;2;9;1;10;0
a4dbc2ea1020a0a393a0134cc900397a895a88e7;Wed Mar 31 21:09:58 EDT 2010;Committer;tenderlove;3;32;6;38;0
c97f5f514a63f2b5ed909aec270e89efb0c2703d;Wed Mar 31 19:56:04 EDT 2010;Committer;akr;3;7;1;8;0
e758c3fbce1b3be14660fcd0d1492ad6e91e01d6;Wed Mar 31 19:31:08 EDT 2010;Committer;akr;2;9;4;13;0
d245582dcb69922f3aa02c792e32f83f4e0743d2;Wed Mar 31 17:58:04 EDT 2010;Committer;svn;1;3;3;6;0
69c6ee0b45ad7e850dd0665c0f25d82602c49326;Wed Mar 31 17:56:55 EDT 2010;Committer;tenderlove;2;35;1;36;0
6024074540e3ea0e50f764900f94d2c641a3c1cc;Wed Mar 31 14:35:13 EDT 2010;Committer;akr;2;111;30;141;0
fbc42054e8375a532b2e0a3b82dded952c8992f7;Wed Mar 31 12:34:31 EDT 2010;Committer;akr;4;347;152;499;0
59ad28c261af83d17d65025df8aaea9214833f6d;Wed Mar 31 07:05:24 EDT 2010;Committer;nobu;4;34;1;35;0
f163275b5c3ae139e6ba273777f710e323f83b18;Wed Mar 31 06:33:45 EDT 2010;Committer;wanabe;1;1;1;2;0
35b2c59ac0078a59adce4d66e9a861fe1c82f226;Wed Mar 31 04:57:31 EDT 2010;Committer;naruse;2;22;0;22;0
0da3fc65dbf021ad224d7490c1ea0a42527f53b4;Tue Mar 30 21:57:53 EDT 2010;Committer;akr;2;5;1;6;0
8fcc8e2d67936f0ce6beddfea76c7937eaf9d656;Tue Mar 30 15:34:42 EDT 2010;Committer;svn;1;2;2;4;0
7b83aa4f3c75b70d6d1de1a7641793bb1373aed0;Tue Mar 30 15:34:33 EDT 2010;Committer;akr;2;84;31;115;0
39146c6b6b19fb284ef8e7f77a0aa2d3a398973f;Tue Mar 30 13:25:57 EDT 2010;Committer;akr;2;21;24;45;0
91616a00ba3440869972cdd9e7da7378fe9f585e;Tue Mar 30 13:13:20 EDT 2010;Committer;kazu;2;12;2;14;0
cda49a46f65f26067ad13305b3c4d419af1de7ed;Tue Mar 30 13:13:07 EDT 2010;Committer;kazu;1;1;1;2;0
c4845fdf36f7c80aab9ecff9cb6793f2ff76dc67;Tue Mar 30 13:07:48 EDT 2010;Committer;akr;2;108;103;211;0
6ca6efc246ce97e5dd47de3e0ee3a6af38a18352;Tue Mar 30 13:03:23 EDT 2010;Committer;keiju;3;9;0;9;0
08f828002b9dcfae4ff18619f68be0466bb5e725;Tue Mar 30 12:58:34 EDT 2010;Committer;akr;2;106;100;206;0
ee90d5d30ee3d483e86583d133d19f4cd77da7dd;Tue Mar 30 12:21:55 EDT 2010;Committer;naruse;3;9;2;11;0
0cf5d3fa963e084e80feac64977ca4c83afcbf22;Tue Mar 30 12:00:31 EDT 2010;Committer;akr;1;8;2;10;0
a00c1c00c174a305a935a825f16511db29d8cf1a;Tue Mar 30 11:57:03 EDT 2010;Committer;akr;2;104;89;193;0
f1330fd12403ef4d664df7619d6ce312d525721a;Tue Mar 30 10:46:06 EDT 2010;Committer;nobu;49;1884;1879;3763;0
38af94c6abaaa20aeaa1ffafbe3f6ff962f63eaa;Tue Mar 30 09:26:09 EDT 2010;Committer;nobu;4;17;4;21;0
635bdf6f13712b7bb536a469734a5b4446e1923e;Tue Mar 30 05:00:15 EDT 2010;Committer;knu;2;11;4;15;0
4a6acc26d5fb95ae9990aefdc6d590769be97935;Tue Mar 30 04:11:24 EDT 2010;Committer;nobu;2;4;11;15;0
0c6fb8ccaaa5ad94003ac0883c709948bce1cd69;Tue Mar 30 04:01:17 EDT 2010;Committer;nobu;2;20;19;39;0
6c7edcb00aefd40539bc60b29dd9e3cf23d31984;Tue Mar 30 00:12:21 EDT 2010;Committer;akr;1;15;0;15;0
9dd3af9ae7d59149adf0fc2679f04bed62d222e8;Mon Mar 29 23:57:43 EDT 2010;Committer;tenderlove;2;6;8;14;0
797f482fe89cf9af1467fc0e7f0707d8c5e4141f;Mon Mar 29 23:57:25 EDT 2010;Committer;tenderlove;3;17;2;19;0
c294fcc0abe83bae433bc08b009db1d03b39e864;Mon Mar 29 20:33:22 EDT 2010;Committer;tenderlove;4;9;4;13;0
e43b94231b76d1953b51ba36e7e7fd6399fd2851;Mon Mar 29 18:58:22 EDT 2010;Committer;naruse;4;48;43;91;0
7abf7e58e82ecd71655f85c0600a94d3f74c3018;Mon Mar 29 18:26:10 EDT 2010;Committer;svn;1;2;2;4;0
03399d900191e0cce7183a5d97f8b34e36596640;Mon Mar 29 18:25:57 EDT 2010;Committer;tenderlove;29;29;29;58;0
a828a658a421f750857e1e807d80d1a2a847c1c3;Mon Mar 29 12:48:43 EDT 2010;Committer;knu;3;21;5;26;0
cd492563f8db2a6d81a498d21cd6d46853c81496;Mon Mar 29 11:27:03 EDT 2010;Committer;keiju;2;7;0;7;0
33d16472528f36d93f82310344ac801c3a90eb3e;Mon Mar 29 10:47:00 EDT 2010;Committer;akr;2;132;122;254;0
b1b3e13570c5d3cc6f04c27fab700198678e6d1f;Mon Mar 29 09:10:12 EDT 2010;Committer;nobu;2;14;3;17;0
d0cb5c71ce3f179f14fddf5241cf0dcfe1599123;Mon Mar 29 06:11:48 EDT 2010;Committer;nobu;3;12;1;13;0
d894e1d9301e4a87a42fa57be6492a9e01e5948f;Mon Mar 29 05:59:46 EDT 2010;Committer;shyouhei;2;8;1;9;0
0a5d4d29e2404778d38410ba309443fa6e34ab03;Mon Mar 29 04:30:30 EDT 2010;Committer;tenderlove;2;5;4;9;0
6c4a07dfa77fc9017adba958cf6399c1f1e6af33;Mon Mar 29 01:40:43 EDT 2010;Committer;naruse;2;4;7;11;0
46a4000a6862cffb535e4feacad907c4296ad1cf;Mon Mar 29 00:21:20 EDT 2010;Committer;naruse;2;27;22;49;0
910a078162b6ac5f52c711c46473367828a2a05a;Sun Mar 28 21:49:49 EDT 2010;Committer;svn;1;2;2;4;0
b9b923ca942096ddb1062be2deb9e6de9a65f346;Sun Mar 28 21:49:37 EDT 2010;Committer;tenderlove;66;6056;0;6056;0
a8a99a7379fa8e07f217fc7b24e3a9208a967898;Sun Mar 28 13:34:39 EDT 2010;Committer;naruse;2;7;4;11;0
1720e7e0dff72463bd0715200ca48b0af365e7c2;Sun Mar 28 04:26:42 EDT 2010;Committer;naruse;3;8;3;11;0
1392791a9e1b046f9e14711a24e51a4e5875c100;Sun Mar 28 01:37:07 EDT 2010;Committer;ryan;6;509;107;616;0
d8cc6ccb566a4f302bd85c7a568eda0e434dd8d1;Sun Mar 28 01:13:00 EDT 2010;Committer;akr;2;16;2;18;0
63dd50961e08172bb88358d95d50efee4c6eead0;Sun Mar 28 00:56:35 EDT 2010;Committer;naruse;3;12;8;20;0
c08277c62d4d372288eb0b8f222758542d9168b6;Sun Mar 28 00:54:29 EDT 2010;Committer;akr;2;164;160;324;0
86aa8f3f0fec3992be860796bf0e968a3d54ef3b;Sat Mar 27 23:24:20 EDT 2010;Committer;akr;2;97;12;109;0
075cbd2ad6657b367ddb0919848fab4ce731ec20;Sat Mar 27 22:14:23 EDT 2010;Committer;akr;2;13;5;18;0
d5c005fd3611070f57b77f30bfeb4404e9550ea6;Sat Mar 27 17:14:21 EDT 2010;Committer;svn;1;2;2;4;0
f0aa9838a23bba3abe411df12070fddc23775a82;Sat Mar 27 17:14:13 EDT 2010;Committer;akr;3;30;6;36;0
7f9b9fbae8b0c588535af9247188d002d50ca850;Sat Mar 27 14:18:24 EDT 2010;Committer;svn;1;2;2;4;0
cea57f8fff58d933cd7a452e9ee0745d5a7c7577;Sat Mar 27 14:18:08 EDT 2010;Committer;akr;2;481;142;623;0
c31129ffb8dba79be9754af96a464ea8dc123cf0;Fri Mar 26 14:55:00 EDT 2010;Committer;wanabe;3;69;0;69;0
2b0156b6de58a3d4a04240124ce1d7ebdf84b6b1;Fri Mar 26 14:04:05 EDT 2010;Committer;mame;1;2;2;4;0
1ab5d3947c76cbd3aceb055a2d5c0a970b64ac63;Fri Mar 26 14:01:24 EDT 2010;Committer;mame;2;7;0;7;0
4685b6d9c848b6627323e4356c95a8c965d94c50;Fri Mar 26 11:19:22 EDT 2010;Committer;knu;2;8;0;8;0
4f7d401d51ff408e070fd2b5a389224da9cb56d5;Fri Mar 26 10:32:36 EDT 2010;Committer;shugo;2;9;2;11;0
1a80b5c01ff7543ee3668e1606f5bd567cdfcf3f;Fri Mar 26 04:01:11 EDT 2010;Committer;tenderlove;1;28;4;32;0
f82b8e76e8151550c4d989bddf4aa07a87930810;Fri Mar 26 03:42:21 EDT 2010;Committer;tenderlove;4;16;1;17;0
e959fda8ff3a45cb60d8fc0459e5de15df9c3c0a;Fri Mar 26 03:33:08 EDT 2010;Committer;tenderlove;4;14;0;14;0
9e415266a8f373d6752f775ea4a63bf443847d08;Thu Mar 25 19:55:32 EDT 2010;Committer;nagai;5;55;37;92;0
77891d864ffd578e7cb85f065c91ef284a4f7e46;Thu Mar 25 15:05:28 EDT 2010;Committer;svn;1;2;2;4;0
dfcf364384a8e4414d053b27a031e283ab44fa28;Thu Mar 25 15:05:21 EDT 2010;Committer;wanabe;1;1;1;2;0
0a6418d85e664cfeba79c56e3276522fc8b6cd19;Thu Mar 25 14:56:38 EDT 2010;Committer;wanabe;2;5;0;5;0
e70499732a043ddb673c9775699a7a2c8230c440;Thu Mar 25 14:22:41 EDT 2010;Committer;mame;2;9;7;16;0
9c15f6f822f5d86f2d2cdb8a7d73912b44be7c93;Thu Mar 25 09:11:47 EDT 2010;Committer;kazu;2;7;0;7;0
21f56f6de99fbd741c64b0fca46a8124194f2541;Thu Mar 25 08:23:17 EDT 2010;Committer;kazu;2;9;0;9;0
b3a039a2cb9f8a8f03665cf3d3ed7518c6b512be;Thu Mar 25 05:50:08 EDT 2010;Committer;nobu;2;7;0;7;0
98131a6da113fa60401edd62db85309acdaa5ad7;Thu Mar 25 03:39:00 EDT 2010;Committer;kazu;2;8;0;8;0
e4d8dc5c46679eeba87fff52504e290385300aed;Thu Mar 25 03:08:28 EDT 2010;Committer;muraken;5;20;14;34;0
31bc607cf183193a151584afea3a6ca8d40506e2;Thu Mar 25 02:37:22 EDT 2010;Committer;muraken;2;16;8;24;0
da8a31bc47294936806479b25d60b8d823df8c47;Wed Mar 24 20:44:45 EDT 2010;Committer;nobu;2;18;12;30;0
2ca764948cbba0c0f3917cf16e6c0917c8765836;Wed Mar 24 19:42:24 EDT 2010;Committer;nobu;2;5;1;6;0
d0cd67ef681dedae6c420bf77ed0f292d2e09c94;Wed Mar 24 19:38:22 EDT 2010;Committer;nobu;2;16;1;17;0
058b9db42122a32b5a0ca77d63e403154a7c25f7;Wed Mar 24 19:36:57 EDT 2010;Committer;nobu;2;5;1;6;0
487a267899a3e36150643286285d37541bde8af5;Wed Mar 24 18:52:50 EDT 2010;Committer;nobu;4;10;6;16;0
96ecfe9a57c1dcb7c824f41963696538e6005418;Wed Mar 24 14:47:00 EDT 2010;Committer;mame;2;17;1;18;0
30a4825aea33d5adf1ca36192f892d41aeb979df;Wed Mar 24 14:01:57 EDT 2010;Committer;mame;2;18;13;31;0
91e6d017906c53f8b73a34d0cd107f0d9fa2d0ad;Wed Mar 24 09:16:13 EDT 2010;Committer;nobu;2;17;12;29;0
e3888976d0f6507d215a536d43a73430182a4d86;Wed Mar 24 06:08:47 EDT 2010;Committer;nobu;1;1;0;1;0
cb2f56aaf48b24740fca6d24f0915d6b3cbb6db8;Wed Mar 24 05:34:05 EDT 2010;Committer;nobu;2;22;2;24;0
152934a300d8becb43d7d260b8491d162cbd83ba;Wed Mar 24 01:25:02 EDT 2010;Committer;naruse;2;11;2;13;0
064c36a04113170df97af12ed54c5e1e636a849e;Tue Mar 23 17:29:37 EDT 2010;Committer;svn;1;2;2;4;0
e4bd450dfe3c4401d8a16eccb30585ab23b18e19;Tue Mar 23 17:29:29 EDT 2010;Committer;jeg2;1;2;1;3;0
1bd1128989a339790a658c43ec3d9769b49265da;Tue Mar 23 14:59:25 EDT 2010;Committer;jeg2;5;112;86;198;0
0471422beb4d786ede528612c8486296761a59ee;Tue Mar 23 14:00:35 EDT 2010;Committer;akr;1;2;2;4;0
ab284526a4d597417286b1d1dab8f094e71f552a;Tue Mar 23 13:59:16 EDT 2010;Committer;akr;1;8;5;13;0
a3e10f380ab276cc9192418d2a19c7e0ffc86046;Tue Mar 23 09:38:54 EDT 2010;Committer;shugo;3;50;0;50;0
094d03c5d3bbbd9a68ff4f0d86bd988e29773da1;Mon Mar 22 20:18:57 EDT 2010;Committer;tenderlove;1;11;0;11;0
0899c59b4b8e5a23dbd36a9b72e001425085288a;Mon Mar 22 16:15:32 EDT 2010;Committer;svn;1;2;2;4;0
a4fa54a10a38bf7fe0d76f1b6822f1ea35d31dd8;Mon Mar 22 16:15:21 EDT 2010;Committer;akr;16;43;39;82;0
91533255f89e4e8529b2a4b59902aecc4a6c4bba;Mon Mar 22 11:44:17 EDT 2010;Committer;wanabe;1;25;0;25;0
c46f71399ae54967e7247ac4df0c26adeddbffd6;Mon Mar 22 11:44:01 EDT 2010;Committer;wanabe;8;71;12;83;0
5d8f69503299ef719c5523546cf2745de136cea9;Mon Mar 22 10:32:10 EDT 2010;Committer;tadf;2;9;2;11;0
652484598d802cd808b4b1fe4bef263b53e3119c;Mon Mar 22 09:45:57 EDT 2010;Committer;akr;11;62;36;98;0
0edceaa7c733b35b48dcad02c0303625ae73e38c;Mon Mar 22 09:01:19 EDT 2010;Committer;nobu;2;9;2;11;0
cce8bbb794385664f66d8e40115d53c2d55a1664;Mon Mar 22 08:38:10 EDT 2010;Committer;nobu;2;7;1;8;0
1561d3fb8b2eb8bfeaabd1d05ff0870b285feb4e;Mon Mar 22 03:33:14 EDT 2010;Committer;akr;4;30;1;31;0
1a40be09d635c4b35008877c3fdf10c963e08641;Mon Mar 22 01:24:28 EDT 2010;Committer;akr;1;10;10;20;0
062780c83434a54e2c0d79a0530168e3a045f872;Mon Mar 22 00:48:51 EDT 2010;Committer;akr;2;12;5;17;0
0647517bda96e267eca7153ec33aa598015522f3;Mon Mar 22 00:06:48 EDT 2010;Committer;akr;4;23;16;39;0
c9e4e4400ce01f8aa9e45283271dcf0559956140;Sun Mar 21 15:51:07 EDT 2010;Committer;akr;2;6;0;6;0
e98ffd97c7e41c947195fdf98764a7cd5971586d;Sun Mar 21 15:03:00 EDT 2010;Committer;azav;1;4;0;4;0
5befc5d5c96a5a1797e310f4ab65b5ad197b489f;Sun Mar 21 15:02:23 EDT 2010;Committer;svn;1;2;2;4;0
f0c0d98dc3d3ba63022a93003b2c7b7ffde2b809;Sun Mar 21 15:02:19 EDT 2010;Committer;azav;1;1;0;1;0
83c2f60b88c73337bcb2fa86228974bddb95f2c8;Sun Mar 21 12:36:14 EDT 2010;Committer;naruse;3;34;30;64;0
66390013a1eb01c7159412e673965093f05f8161;Sun Mar 21 12:10:53 EDT 2010;Committer;akr;3;10;4;14;0
ed2dd5e3f497448356205e5f965d55850e32bae6;Sun Mar 21 10:52:31 EDT 2010;Committer;nobu;3;108;1;109;0
daa739876f1bbd14b043a6361e9d434d324afff5;Sun Mar 21 10:50:52 EDT 2010;Committer;akr;16;66;38;104;0
cce4892c1fb4a6690e230bf90c3d7973acbf14d8;Sun Mar 21 08:57:55 EDT 2010;Committer;nobu;2;26;18;44;0
8e63c340b91f66ac3eceb864469003d12ba6000f;Sun Mar 21 08:15:16 EDT 2010;Committer;akr;2;7;2;9;0
49d993729fd9507b9ae950db5bfb419536846d40;Sun Mar 21 03:38:58 EDT 2010;Committer;akr;10;63;21;84;0
f623979f65d43a109054ada8e8f271c3bfb6a747;Sun Mar 21 00:43:07 EDT 2010;Committer;nobu;2;15;6;21;0
9a836831905757698a81a7b2d1713106217572d7;Sun Mar 21 00:24:54 EDT 2010;Committer;svn;1;2;2;4;0
82488cf2b9def045e7c9bbda6b1fe43eca174d47;Sun Mar 21 00:24:44 EDT 2010;Committer;akr;2;5;1;6;0
d0fa628d062b10a2befcfd48b33cdfd677f29241;Sat Mar 20 13:52:34 EDT 2010;Committer;akr;2;5;1;6;0
750c9916e28c0f8b97e4b4c261444d822a882c6c;Sat Mar 20 10:18:55 EDT 2010;Committer;akr;2;50;8;58;0
b7ed43e941e838dc516be3cd03c31a2d839301ec;Sat Mar 20 09:47:07 EDT 2010;Committer;wanabe;1;3;0;3;0
4b6a7a46e8f68ca77f8741cecc3108632bf34c9f;Sat Mar 20 05:17:19 EDT 2010;Committer;akr;1;41;0;41;0
9ce419a45c521d8c41773ad29cb9ccec3be05028;Sat Mar 20 04:27:32 EDT 2010;Committer;akr;3;53;0;53;0
c9dd4823d98141754842c0b356b141d94ba36604;Sat Mar 20 03:30:59 EDT 2010;Committer;nobu;21;32;28;60;0
772cc7a4f212fa3249f88c98b19645beb7f3d199;Sat Mar 20 02:32:40 EDT 2010;Committer;akr;2;39;28;67;0
7fde2619633b123bbc60543c1d1fc3d212a4916c;Fri Mar 19 16:39:16 EDT 2010;Committer;wanabe;1;1;1;2;0
7e2fa5adf46a3cfa9d6c8363e63ce1fc4d12031c;Fri Mar 19 16:20:56 EDT 2010;Committer;wanabe;2;5;1;6;0
e40c43a1bf03782eeab068b66abc7c3af64f2cc5;Fri Mar 19 16:18:05 EDT 2010;Committer;wanabe;1;9;4;13;0
faee1b6f785563c90f4f02a29e252283bcafbe23;Fri Mar 19 16:16:26 EDT 2010;Committer;svn;1;2;2;4;0
c28b2b9be263ba46058c021fa896e7678b03346f;Fri Mar 19 16:16:22 EDT 2010;Committer;wanabe;1;1;0;1;0
b5388e85387c03c133a685c5577d405ce2874b8c;Fri Mar 19 12:54:01 EDT 2010;Committer;akr;1;10;2;12;0
4f74adc503a13bbd19d451cab7e6ab6b685776bc;Thu Mar 18 23:11:12 EDT 2010;Committer;akr;1;9;0;9;0
642305dae64ab30099cc2925f7f5485c8e0128e5;Thu Mar 18 20:35:27 EDT 2010;Committer;svn;1;2;2;4;0
053d89ca2bde48126e058700799baa7ca370ca8d;Thu Mar 18 20:35:18 EDT 2010;Committer;akr;2;37;25;62;0
bd5e925cc4580517e7fa08d46768cdb690598c3e;Thu Mar 18 12:24:28 EDT 2010;Committer;nobu;2;5;1;6;0
f9d64323c8608646671923cdbb3f8870696556a4;Thu Mar 18 10:53:38 EDT 2010;Committer;akr;2;76;35;111;0
e0250f59e0a63a5b37a1106359f2e70643c67e98;Thu Mar 18 00:05:10 EDT 2010;Committer;naruse;2;12;7;19;0
43ab72099b92fed6310a8ffdf7b0f0ba0c2c74cd;Wed Mar 17 21:28:36 EDT 2010;Committer;nobu;4;27;3;30;0
ad41699b470043a5d173782988b6f446b3c32048;Wed Mar 17 20:58:34 EDT 2010;Committer;nobu;2;6;7;13;0
83b8f94f4ef67735a20cfcc4ddd3df886017ee6a;Wed Mar 17 19:41:00 EDT 2010;Committer;nobu;2;7;2;9;0
d47e0b989fd8d28095af2dc869c6e0932a6c4d85;Wed Mar 17 17:33:01 EDT 2010;Committer;mame;2;5;0;5;0
9eb68d7c44a5c19396b3bc7123d3828bb7ae1b39;Wed Mar 17 16:21:45 EDT 2010;Committer;naruse;3;52;0;52;0
5f0be51c21b3fe699c7fd6929e74ca9ade9a4339;Wed Mar 17 16:00:00 EDT 2010;Committer;akr;1;2;2;4;0
c18d939fabdc33345d1a1f69627ecc57b3779860;Wed Mar 17 15:35:49 EDT 2010;Committer;svn;1;2;2;4;0
f626a17d8c8a2c2c0ce2c2a5cc1f3b6b1fc643c3;Wed Mar 17 15:35:38 EDT 2010;Committer;naruse;3;106;33;139;0
4067fd028dfdaeaa177755e5d2ff54511da8a7fc;Wed Mar 17 07:25:58 EDT 2010;Committer;nobu;2;4;3;7;0
c9e0df64b52ce2534929ea3a4424564dfb521c26;Tue Mar 16 21:40:05 EDT 2010;Committer;nobu;2;6;1;7;0
6ff75042db1a68a23a133667b3a97c9ec23c131e;Tue Mar 16 17:40:00 EDT 2010;Committer;mame;10;89;53;142;0
c4fdd64fe03cc5fd99cd6eee10df9b660b46167d;Tue Mar 16 16:26:11 EDT 2010;Committer;svn;1;2;2;4;0
4f78e7fff4949f5c94d35bce6b610d1188fd7c27;Tue Mar 16 16:26:04 EDT 2010;Committer;mame;4;15;1;16;0
0b6a0045aaf8de72b4ce39fe117b2ba88ccdcc15;Tue Mar 16 13:52:16 EDT 2010;Committer;akr;2;66;26;92;0
04d90693dcb814ab2949a0a125fa24316061ef35;Tue Mar 16 11:18:03 EDT 2010;Committer;muraken;2;6;0;6;0
d4120b1f1d7d54736dc7f6d0747e2bf6bd2e1ccf;Tue Mar 16 08:38:14 EDT 2010;Committer;naruse;2;7;0;7;0
43025927c6629904b59130bec66fc61ebc83ac4d;Tue Mar 16 08:18:47 EDT 2010;Committer;nobu;2;5;0;5;0
3694f1dda70923b2acc66af6553c422ba87daddd;Tue Mar 16 06:20:23 EDT 2010;Committer;nobu;5;66;37;103;0
724f1f4a6e3698d1a34ca3442a6cb3e890e94a99;Tue Mar 16 05:48:07 EDT 2010;Committer;nobu;2;5;6;11;0
bf45c36d5ffc09dc1bbd70bef4bf8379c3e65362;Tue Mar 16 05:06:19 EDT 2010;Committer;nobu;2;5;1;6;0
acd2d29f2e48ef0644a14b41f74f7a380a09a135;Tue Mar 16 05:03:30 EDT 2010;Committer;nobu;2;7;2;9;0
b215b9742ecdc7c3771d305400f72bd76946277e;Tue Mar 16 02:23:51 EDT 2010;Committer;nobu;2;25;1;26;0
dcff8e84d3528af37d7540a8613f9bd247623b1a;Mon Mar 15 22:23:33 EDT 2010;Committer;akr;1;3;3;6;0
34533445c8f7ce9359d126d1fa3388a466022207;Mon Mar 15 22:21:24 EDT 2010;Committer;akr;2;9;12;21;0
32ea96f682aaf7d3e2683c5e6fbb886ccf89f3c4;Mon Mar 15 22:02:42 EDT 2010;Committer;akr;2;62;55;117;0
a9e9169752533858e82a821b46b4e49a3af4ea6b;Mon Mar 15 19:10:37 EDT 2010;Committer;svn;1;2;2;4;0
e3a231d3d0ae6719854790eb9ee952f737b7f8fb;Mon Mar 15 19:10:29 EDT 2010;Committer;akr;2;5;1;6;0
2ce0d5db9679372350f837abf54878311142bc35;Mon Mar 15 12:59:54 EDT 2010;Committer;akr;2;17;14;31;0
a73374bb5716287b82879e6ced116315aac77f7d;Mon Mar 15 12:25:20 EDT 2010;Committer;akr;4;34;19;53;0
21c7d36573736e6e3937c24dfa1cfccf6aa907ad;Mon Mar 15 09:33:39 EDT 2010;Committer;nobu;2;42;25;67;0
01657b51f8ff145e425feb5fee39481be735cb4d;Mon Mar 15 08:43:45 EDT 2010;Committer;matz;3;25;1;26;0
d188e1a8529927749c378f7c5f9e27464a686749;Mon Mar 15 05:06:11 EDT 2010;Committer;nobu;2;23;23;46;0
1bf3ca494f89e56ca267b30ce85ff100994e7b64;Mon Mar 15 03:26:29 EDT 2010;Committer;naruse;3;37;6;43;0
e03b66ef183ec828dc9422d514af750915767e77;Mon Mar 15 01:37:45 EDT 2010;Committer;naruse;2;134;61;195;0
7588f09a87a7d89404e2d6036c71e124c8c403ae;Mon Mar 15 00:42:25 EDT 2010;Committer;naruse;2;9;2;11;0
732d041dc8d0892cc0f8f3ecbd3a59a8908d4763;Mon Mar 15 00:36:26 EDT 2010;Committer;nobu;2;58;63;121;0
ae0224673eaa8694536aeae3f5f594b7b07fd624;Sun Mar 14 22:51:08 EDT 2010;Committer;nobu;2;5;1;6;0
71f4f96249e653ec65f138b52b15d777b342a6a6;Sun Mar 14 22:41:04 EDT 2010;Committer;nobu;2;7;3;10;0
6a1a02ae833a2f90e59a6400cb532e49888a80d7;Sun Mar 14 22:39:25 EDT 2010;Committer;nobu;1;4;0;4;0
0f418eaa2511d6a87178712250d619818778ba20;Sun Mar 14 22:38:32 EDT 2010;Committer;nobu;1;4;1;5;0
b24c8e4dd63b7cfc4b8c83db6552a0ed8301533d;Sun Mar 14 22:33:09 EDT 2010;Committer;nobu;1;16;5;21;0
980a954f11396afc082875684037505c846d54ab;Sun Mar 14 22:16:12 EDT 2010;Committer;nobu;2;10;3;13;0
32ed00ab188cf46d0d4bae116a48dac91731af32;Sun Mar 14 19:41:32 EDT 2010;Committer;nobu;3;23;3;26;0
ad130d3670bc9ef423ccf93c2b6988f988359b29;Sun Mar 14 19:18:49 EDT 2010;Committer;nobu;2;10;5;15;0
8aa897fc05bed40efba33c9d41c29a8e28162372;Sun Mar 14 17:45:21 EDT 2010;Committer;akr;2;16;0;16;0
1db141ed13454411acbf0e77cb91408514eacbe7;Sun Mar 14 17:01:06 EDT 2010;Committer;akr;2;249;225;474;0
f5ce5551c8404d608815e95241dd3d91c74002f2;Sun Mar 14 16:28:24 EDT 2010;Committer;azav;1;10;0;10;0
192af223ec3ebadd0bb74b185a84da82cb87ae30;Sun Mar 14 16:27:02 EDT 2010;Committer;azav;1;4;3;7;0
ebb50130d2582d000f1efea1200e690486f88c57;Sun Mar 14 16:26:06 EDT 2010;Committer;azav;1;4;1;5;0
e64193ea377eb7091f915d11ad558546fd144494;Sun Mar 14 16:24:57 EDT 2010;Committer;azav;1;15;1;16;0
f600a43d624ac03e175c8668069249aa68912370;Sun Mar 14 15:17:14 EDT 2010;Committer;svn;1;2;2;4;0
4bbc67e4cfa3296bfe30f42d5cdf05cf5490b280;Sun Mar 14 15:17:05 EDT 2010;Committer;naruse;2;11;2;13;0
760db25b55ac74c63b8349460c979ac5d9aaacff;Sun Mar 14 13:38:59 EDT 2010;Committer;akr;2;5;0;5;0
ff39d22c3317b301da48b9e427c28795596971d3;Sun Mar 14 06:49:22 EDT 2010;Committer;akr;2;5;1;6;0
a3d0a213dc662d5196682dd3b5367158e18116fa;Sun Mar 14 00:50:10 EST 2010;Committer;nobu;3;7;2;9;0
5cff0face35fe88affd4338a2ed7845a60509563;Sat Mar 13 22:23:02 EST 2010;Committer;matz;2;6;1;7;0
fa37ab769fa4adac50959b514793e8d1a39a09ce;Sat Mar 13 17:54:43 EST 2010;Committer;akr;3;27;1;28;0
bce5056cab71b0df70393a5673627c7bd7c8b4e7;Sat Mar 13 16:40:32 EST 2010;Committer;svn;1;2;2;4;0
ad690e96cf0d5276548686df8e7fac12ec598d0f;Sat Mar 13 16:40:27 EST 2010;Committer;akr;1;3;3;6;0
dc6075844d95c40001a0ec6ef4f8af19c0da58d9;Sat Mar 13 14:50:26 EST 2010;Committer;matz;2;10;2;12;0
0e9620fd38d9bad8f0857e2ac031bf7b9f50a72d;Sat Mar 13 08:48:49 EST 2010;Committer;nobu;2;81;41;122;0
05d4516145a19e2950c53cf39dd95f64f36cedae;Sat Mar 13 06:59:37 EST 2010;Committer;matz;2;7;2;9;0
8b55878d2a0a4032f8be77d60e30172369c82ec6;Sat Mar 13 05:55:46 EST 2010;Committer;matz;5;8;54;62;0
b1bf026f4893a384031654c6801b3b5cdabdcd81;Sat Mar 13 03:26:18 EST 2010;Committer;nobu;2;7;2;9;0
06fa07662b5bde275850db01f4302a669b87bb2e;Sat Mar 13 02:16:20 EST 2010;Committer;shugo;2;7;4;11;0
d9fe7ef4924d0e30a0de4ca7ee9c45638b8ebcb4;Sat Mar 13 01:34:38 EST 2010;Committer;shugo;4;24;9;33;0
fd684f1082e25f1752ba2bfcd7c3b3525261795b;Sat Mar 13 01:07:23 EST 2010;Committer;nagai;4;18;4;22;0
7553fd299eb6a4467b82c1b46154092a76b714c9;Fri Mar 12 18:25:13 EST 2010;Committer;akr;2;9;1;10;0
0884036a0a9d93bb4c3f82f56f997f32557d8159;Fri Mar 12 15:44:24 EST 2010;Committer;nobu;3;12;0;12;0
fbdabf398f397c7c68434b26556e4890133d70c4;Fri Mar 12 15:11:16 EST 2010;Committer;svn;1;2;2;4;0
04e68d0107460575a86cc427338eae436be16286;Fri Mar 12 15:11:10 EST 2010;Committer;nobu;5;17;21;38;0
614619031b6d34d12f7bf2752c24eadefb9a8f8f;Fri Mar 12 14:08:36 EST 2010;Committer;akr;1;337;337;674;0
f4f7c3db4f53ef19cdd1ba075930c3c5fa5a9681;Fri Mar 12 14:08:08 EST 2010;Committer;akr;1;12;0;12;0
73fc3b5a34edb7a681e0000d2879cb4a79772945;Fri Mar 12 14:00:49 EST 2010;Committer;akr;1;12;9;21;0
1eca24b1a5e029605241828a630ed9b83572ea0c;Fri Mar 12 12:35:39 EST 2010;Committer;muraken;2;11;0;11;0
8212cdf176a5ac5e6693d4a0284437a38d5922b4;Fri Mar 12 09:00:48 EST 2010;Committer;naruse;3;120;0;120;0
d7cc39658cd7b92b9bac8e5131cae4d79577e82c;Fri Mar 12 08:48:10 EST 2010;Committer;naruse;2;9;2;11;0
da72b1bb6e323dcc288541af1a9516027d40c905;Fri Mar 12 04:56:34 EST 2010;Committer;muraken;2;6;1;7;0
27f953bfad3b604ae9023a0b9996948c2b3b2982;Fri Mar 12 00:45:06 EST 2010;Committer;naruse;2;5;15;20;0
772acb9f1d17d603030cde5660b2ff8773297be5;Thu Mar 11 22:25:22 EST 2010;Committer;nobu;2;20;11;31;0
d6191738bce48d9a7cee17f7033a2d1a8568ca73;Thu Mar 11 22:17:20 EST 2010;Committer;nobu;2;16;4;20;0
1dcf1174ea2a803e6905a04760121fe1426035b3;Thu Mar 11 22:15:11 EST 2010;Committer;nobu;5;172;81;253;0
9a5b57f61fd9ef14b1bc6c0b540c0edbb86a409a;Thu Mar 11 22:09:25 EST 2010;Committer;nobu;2;7;1;8;0
40f89ddbf1bf9cdf6fbfbda09b6a235ab9791c4a;Thu Mar 11 21:50:56 EST 2010;Committer;nobu;1;21;0;21;0
de850442f28953081c18155fa91f7449016f4400;Thu Mar 11 21:49:02 EST 2010;Committer;nobu;2;7;2;9;0
831eb93069492c82fa997287c77ca8d9f2ad8668;Thu Mar 11 21:37:16 EST 2010;Committer;nobu;4;48;23;71;0
ebfe278914d74595a02e0bbd9bbcfb265967dcc3;Thu Mar 11 13:47:10 EST 2010;Committer;akr;1;1;0;1;0
09492b5ab251982e440de039f7afc745d1fef8cc;Thu Mar 11 13:39:42 EST 2010;Committer;akr;1;18;0;18;0
fb1d5520fa83bd34f6fde54350d2c7280d7c7a88;Thu Mar 11 13:39:29 EST 2010;Committer;akr;1;1;0;1;0
7c269e72efa9e37150831e6d5d37f4f6f5622d20;Thu Mar 11 13:39:12 EST 2010;Committer;akr;3;97;0;97;0
c2f7ed2f243840ff5e3b0e04e06efcf8a3a0cb6a;Thu Mar 11 08:32:03 EST 2010;Committer;nobu;2;5;1;6;0
5b8af7521f8c5f1c218157250d07604bf1b56101;Thu Mar 11 03:14:21 EST 2010;Committer;nobu;3;25;2;27;0
9c0119c4bdc31b90fdd236c816aa02504934f94b;Thu Mar 11 02:16:39 EST 2010;Committer;nobu;2;25;27;52;0
131f0a409b90d491d9f28741805dfc44878a8beb;Wed Mar 10 16:36:18 EST 2010;Committer;wanabe;2;4;4;8;0
4a1a3d5d1622ad478fdd3ab84fbc1e2d67d5da3d;Wed Mar 10 16:07:12 EST 2010;Committer;svn;1;2;2;4;0
e3c25091cda672ff0ebe1dec996d859888907644;Wed Mar 10 16:07:06 EST 2010;Committer;shugo;3;24;0;24;0
fec209551a1751de79b7f0257ae8533e1bdf3c7e;Wed Mar 10 12:29:50 EST 2010;Committer;mame;2;22;37;59;0
9eb49ff8d7f8f7740e012f5f1080d2dd5113ce80;Wed Mar 10 03:12:17 EST 2010;Committer;muraken;3;30;26;56;0
9da12c5850a4226b51ba5fd8fd52c45939f7757c;Tue Mar 09 19:21:37 EST 2010;Committer;ko1;4;10;4;14;0
bbcb186ae61294024cef43642a9c9ece98d22de6;Tue Mar 09 11:52:02 EST 2010;Committer;mame;2;4;11;15;0
62f8df2d3c95816028c006ecbe70bc51704eec4b;Tue Mar 09 09:15:42 EST 2010;Committer;muraken;25;15886;84;15970;0
c4636043cc2afe5a5fec48850115e8aa0aa3c2de;Tue Mar 09 06:00:58 EST 2010;Committer;naruse;2;9;2;11;0
10317605f0f1db4f7d2d8c4272c149d41cedd09c;Tue Mar 09 05:56:39 EST 2010;Committer;naruse;2;4;1;5;0
9ec530270a461127690c318a92f0cc2ce8929111;Tue Mar 09 03:21:15 EST 2010;Committer;svn;1;2;2;4;0
4400822b45c209a719f2a075fb9bda3bdf787ad9;Tue Mar 09 03:21:07 EST 2010;Committer;mame;2;16;4;20;0
6951f8f99a7561563b44f8420564d7fc2f24bdb5;Sun Mar 07 17:39:41 EST 2010;Committer;azav;1;6;0;6;0
ab442cdc39aca93f054f007840d0ef2bf9051c55;Sun Mar 07 17:38:48 EST 2010;Committer;azav;1;1;1;2;0
eed5e11d3b3216638379422a5cd1f8f684ff4e53;Sun Mar 07 17:38:17 EST 2010;Committer;svn;1;2;2;4;0
46c965c7098460bdc448d80a42adaaabed5073b5;Sun Mar 07 17:38:12 EST 2010;Committer;azav;1;2;1;3;0
70d72bf807bf50672e64d431320f2e62c98ba6aa;Sun Mar 07 14:15:24 EST 2010;Committer;akr;2;9;4;13;0
51ae7f6e9aa24a136115dae1853779055bbd9eb4;Sun Mar 07 10:22:05 EST 2010;Committer;marcandre;4;98;124;222;0
dc50480f6f2b3578c2295436850fb22614284956;Sun Mar 07 07:13:31 EST 2010;Committer;akr;1;4;0;4;0
57d414a1c7f59b0e15490bc709d6dd361ef99deb;Sun Mar 07 06:54:29 EST 2010;Committer;akr;1;39;0;39;0
785b31bed4fbe10dd8fe92a7ef52782d2d1d1123;Sun Mar 07 04:55:34 EST 2010;Committer;akr;5;102;30;132;0
8a144fdedc2df7ee87e21ad805fcbcbd18209533;Sat Mar 06 17:11:28 EST 2010;Committer;naruse;3;9;13;22;0
f6a23214da3a22284707a5a6eaa52c3b6e7d60aa;Sat Mar 06 17:03:51 EST 2010;Committer;svn;1;2;2;4;0
69fd8a9011b7a3a911b9546104ce6acb962a4a94;Sat Mar 06 17:03:48 EST 2010;Committer;marcandre;1;7;3;10;0
c3c8c1e37c6fe0c032e079d1f61ce2a00df02b4d;Sat Mar 06 13:52:03 EST 2010;Committer;akr;1;0;2;2;0
9ff10a20b5b28cb1f44e19ce5a32b07fb2382b7a;Sat Mar 06 13:12:24 EST 2010;Committer;akr;2;5;1;6;0
e796e95ec84b85c4885a15b6b6b46c6689d31444;Sat Mar 06 04:52:31 EST 2010;Committer;mame;3;17;175;192;0
127cfd117400b84ff5ab9102f6c9a57895c375b5;Sat Mar 06 01:06:57 EST 2010;Committer;mame;3;16;9;25;0
61337683b38fa28490b9d209ee3e8821f6a77050;Fri Mar 05 16:09:43 EST 2010;Committer;svn;1;2;2;4;0
de1cd22816424c0c9f63a05782143968be87e62a;Fri Mar 05 16:09:35 EST 2010;Committer;usa;2;4;2;6;0
f453c3c0dadd093518335f75a2bb8ec50a283afb;Fri Mar 05 10:39:56 EST 2010;Committer;naruse;2;10;0;10;0
4bcae18e375dcfc880be52f7b89ef2d45f75b57b;Fri Mar 05 08:51:12 EST 2010;Committer;nobu;3;14;5;19;0
29b94d77529fe7190eabef0b393753e361724408;Fri Mar 05 02:59:40 EST 2010;Committer;svn;1;2;2;4;0
ee48a9199384d13a2743b6c2860b18af5c759ad4;Fri Mar 05 02:59:33 EST 2010;Committer;nobu;2;6;0;6;0
ef7d0431a0c59839f555123ccd5ad06418209c0c;Thu Mar 04 14:20:49 EST 2010;Committer;akr;1;14;0;14;0
6bec06674c2a51af865a5d8d7c31d93799f98d59;Thu Mar 04 13:54:13 EST 2010;Committer;mame;2;11;1;12;0
ae2065a285b8ba32e7323ecf5875100ba546c2d9;Thu Mar 04 13:48:20 EST 2010;Committer;mame;3;182;8;190;0
323e4f1cf06b70216b529013817010bfa666e99a;Thu Mar 04 05:13:22 EST 2010;Committer;wanabe;1;1;0;1;0
4d8d6d9d6319be436cdc0fb1da81502d9b0c3abd;Thu Mar 04 04:51:43 EST 2010;Committer;wanabe;3;33;0;33;0
e09838c691805ae2bf6b46fa66abaa626f70e9d3;Thu Mar 04 02:29:07 EST 2010;Committer;marcandre;1;1;0;1;0
556152ada3c56b53ff4fa0e82a6ccd83a0967fc7;Thu Mar 04 01:16:37 EST 2010;Committer;naruse;2;4;24;28;0
4e637b320f39ac4ce2f27327b5451f7720ba2454;Thu Mar 04 01:05:00 EST 2010;Committer;nobu;0;0;0;0;0
9a026aec0adf6aaf10a606670ad826f7c50b5654;Wed Mar 03 17:36:39 EST 2010;Committer;mame;2;22;0;22;0
43ad8929dffa798953ac11e7dd4531d2d45376be;Wed Mar 03 17:33:45 EST 2010;Committer;kazu;2;6;2;8;0
373ed885c69c521d025af632da41b05dce3faa7f;Wed Mar 03 15:14:21 EST 2010;Committer;akr;1;1;1;2;0
27942ec2c3a8cc6d65d103abb03ddb8e3044a99a;Wed Mar 03 15:12:02 EST 2010;Committer;svn;1;2;2;4;0
5521b78fc31efffb45f2e904df59bd86c96345f3;Wed Mar 03 15:11:56 EST 2010;Committer;akr;2;18;11;29;0
215b8092a7821700baa8b89bac010db721891f99;Wed Mar 03 14:18:26 EST 2010;Committer;marcandre;3;10;2;12;0
b81e04571299a8e98d3931be9c10b9b63da375a8;Wed Mar 03 14:07:53 EST 2010;Committer;marcandre;2;8;4;12;0
871e9d175e07e364802f00c945cec56ef42084df;Wed Mar 03 09:44:44 EST 2010;Committer;matz;3;107;0;107;0
800dda6c28aad062d1d3c3342fb3dcd23ae790f3;Wed Mar 03 07:21:21 EST 2010;Committer;matz;2;5;1;6;0
2cfb894d2a376becbc05938c4b67fc17ad8c26dd;Wed Mar 03 07:19:21 EST 2010;Committer;matz;2;16;0;16;0
006a8ba77f6c5e27201760dfe560eb0c63e4d70b;Wed Mar 03 05:35:08 EST 2010;Committer;matz;3;76;0;76;0
35345f1c09b6e08e674fb7cbad3258cd1acdd91d;Tue Mar 02 21:19:33 EST 2010;Committer;nobu;3;15;1;16;0
d20440ab6fae8590d7eeb0da5614b86e3eaa5228;Tue Mar 02 20:49:02 EST 2010;Committer;nobu;5;35;6;41;0
a0ff5cae7c778e3c8b2b1e387c0c0163010d6c00;Tue Mar 02 12:19:24 EST 2010;Committer;mame;2;63;81;144;0
76a5c00be6ee10310571f6dac5147c212f5be5d9;Tue Mar 02 09:40:27 EST 2010;Committer;naruse;2;39;1;40;0
1c0dfeef41dd0386e9b1ab479b58eaf7d4eccab4;Tue Mar 02 05:48:05 EST 2010;Committer;muraken;2;4;130;134;0
9c45868b4191209978033c823c116b0baeed602d;Tue Mar 02 05:29:27 EST 2010;Committer;nobu;2;25;7;32;0
b25434f6a94babe6b3e09d70aff8d8b76771ad82;Tue Mar 02 04:55:04 EST 2010;Committer;marcandre;2;4;1;5;0
4f19ce8376c664cb673a2728e48da0291aae2612;Mon Mar 01 21:55:05 EST 2010;Committer;svn;1;2;2;4;0
db37773e13fba8ccb28612361220638e702d4deb;Mon Mar 01 21:54:59 EST 2010;Committer;matz;16;118;173;291;0
e1c33162cf821b5251559564242e0d91ad29a79c;Mon Mar 01 14:28:04 EST 2010;Committer;akr;2;14;2;16;0
f14133782b12c3f3998261a736b143b07acd237d;Mon Mar 01 11:11:08 EST 2010;Committer;takano32;2;7;3;10;0
cf2c9d7d960f001b218fec0a7ec75e6813a658b8;Mon Mar 01 08:45:26 EST 2010;Committer;svn;1;3;3;6;0
e2e46bebcfbf28566d1b70e5b17a435f1b025bed;Mon Mar 01 08:45:18 EST 2010;Committer;wanabe;2;8;1;9;0
deaba5567df978937dd1e9f8453ca66f5d65021c;Sun Feb 28 12:32:39 EST 2010;Committer;nobu;2;7;2;9;0
5073155a178a9f478950afef4f148e44fd14b5d6;Sun Feb 28 10:08:22 EST 2010;Committer;muraken;4;103;83;186;0
58e8688f69776eb891abf9980d204015c3fddb1d;Sun Feb 28 06:08:50 EST 2010;Committer;akr;2;92;54;146;0
48e861ddfbdda7189401c4e1d901e0317b34fb30;Sun Feb 28 02:56:26 EST 2010;Committer;naruse;7;61;19;80;0
663a7488cee42453219f81cf56ff0652959815bb;Sun Feb 28 02:47:19 EST 2010;Committer;naruse;4;50;17;67;0
bd7326c383b44fa78c1eec832dd47cf2370b5eca;Sun Feb 28 02:40:31 EST 2010;Committer;naruse;3;7;6;13;0
334244eb5d45e263874c739490213f4b87ab8e5b;Sun Feb 28 02:32:09 EST 2010;Committer;akr;2;67;52;119;0
f828d53066ef30db67b167aad25919e34ed1571a;Sun Feb 28 01:50:49 EST 2010;Committer;akr;1;6;6;12;0
95fd5f33c08b1d8f6645d7739a1268dc8c6fa5de;Sat Feb 27 22:00:15 EST 2010;Committer;akr;2;17;1;18;0
81b7329d0b967653230af16bfac8a2c37c201c52;Sat Feb 27 15:39:25 EST 2010;Committer;svn;1;2;2;4;0
68691ab2ddfa8b2a85be1b00fea6291b3b76547e;Sat Feb 27 15:39:20 EST 2010;Committer;akr;2;81;106;187;0
a971778b399ae42cc694a207cb0a5e3f3ae74d74;Sat Feb 27 06:56:46 EST 2010;Committer;akr;3;16;0;16;0
daaa605b798e969e880176bb5ac38cf52d29bd99;Fri Feb 26 18:51:09 EST 2010;Committer;svn;1;2;2;4;0
8c9024763f6340d0fc64e21dd6ee052af8c6748b;Fri Feb 26 18:51:02 EST 2010;Committer;akr;4;140;23;163;0
069d271eb5b237b2274c382c5da011b43b0fa1d9;Fri Feb 26 12:41:02 EST 2010;Committer;akr;2;29;12;41;0
d5a16d80be29f9aa39efe8854c324a9b6a43cc07;Fri Feb 26 12:30:56 EST 2010;Committer;akr;2;6;2;8;0
785f417270a7cb8f815514e63a7f4d4e8d1d377c;Fri Feb 26 12:06:17 EST 2010;Committer;mame;3;17;2;19;0
07298aba22284e3eadc7d250205f365e3ff20d37;Fri Feb 26 11:09:29 EST 2010;Committer;akr;3;11;8;19;0
d191b742bd0c1c9145023768ffd6e6d93f2b6077;Fri Feb 26 07:49:21 EST 2010;Committer;nobu;2;16;16;32;0
aec58680ecaa5fbfac0e2219fb6df422ce48b124;Fri Feb 26 05:17:13 EST 2010;Committer;nobu;2;18;11;29;0
59e4e93ef7b6b7f1536e3c56374cc6b8d74b5d28;Thu Feb 25 22:49:20 EST 2010;Committer;naruse;19;394;662;1056;0
9d818a221ec86fb15bfe696995829807be49a1da;Thu Feb 25 17:27:59 EST 2010;Committer;svn;1;2;2;4;0
b1196bb3d86bcef80dd8cf07873febf10f12f0bf;Thu Feb 25 17:27:56 EST 2010;Committer;akr;1;124;163;287;0
e599c936d85719bb54a42d3fc52e0b67ec044dea;Thu Feb 25 14:00:48 EST 2010;Committer;akr;4;479;438;917;0
c942417791e74428fce1ed2a722c679fca5f131e;Thu Feb 25 02:26:22 EST 2010;Committer;naruse;3;9;11;20;0
d3f73f45d8342e37a814eeb8c98e1d04f451a3b4;Wed Feb 24 17:06:15 EST 2010;Committer;ko1;6;94;90;184;0
ee43611393834f0e10aa982831698a11c3c9ced4;Wed Feb 24 16:52:57 EST 2010;Committer;akr;1;0;1;1;0
d255503f3bce9f41740f36ea5f167b8ae2fbc59f;Wed Feb 24 16:52:09 EST 2010;Committer;akr;1;2;2;4;0
10226f650594c310c6d0062aae055516837a8c4a;Wed Feb 24 16:29:53 EST 2010;Committer;akr;1;0;1;1;0
d3d57663a30a8c00381bb4e435c0182be73c9488;Wed Feb 24 16:01:00 EST 2010;Committer;akr;2;5;2;7;0
4f41b82de23a7274640a6235706968cf38737627;Wed Feb 24 15:32:10 EST 2010;Committer;svn;1;2;2;4;0
e53e5edab2dd2e38d50577e6b6c5fba0dadd064a;Wed Feb 24 15:32:06 EST 2010;Committer;akr;3;254;127;381;0
7e5f20c842486e1f3c99efaa6d49ed5559573b46;Wed Feb 24 14:28:18 EST 2010;Committer;matz;2;6;2;8;0
6f828a2437d8e5146e44a59108abf8c0f5207ffd;Wed Feb 24 14:16:59 EST 2010;Committer;matz;2;12;5;17;0
aba5263254440c57ec11ccb398f77693129f0e88;Wed Feb 24 13:44:08 EST 2010;Committer;akr;2;11;1;12;0
b2623d9bb894656cc88c7207fdee210876055aae;Wed Feb 24 05:39:27 EST 2010;Committer;drbrain;6;4;244;248;0
37e11f3cce5dc533379117d216c09120b6546c26;Wed Feb 24 02:52:08 EST 2010;Committer;nobu;4;18;12;30;0
9afa9ba9673370d98d433ba24c06282ca8f1e5e8;Wed Feb 24 00:55:03 EST 2010;Committer;nobu;5;317;239;556;0
5fe5eb264d79e4ffa7c77b1a09d1de69469fffb9;Wed Feb 24 00:31:37 EST 2010;Committer;nobu;3;8;2;10;0
fdb57d043d96821a79d52750a761b43e8676cc61;Tue Feb 23 17:36:12 EST 2010;Committer;knu;1;12;10;22;0
d22373455532e99c0adf1a1e5d0b3a864691e2f9;Tue Feb 23 17:33:39 EST 2010;Committer;knu;5;56;79;135;0
28501bb6e5a31d6ddb8b5167f2f2a87a623bf818;Tue Feb 23 17:01:08 EST 2010;Committer;knu;1;14;2;16;0
497a5f8d0820f5be35d30b61951abbaf40bc4f79;Tue Feb 23 15:56:45 EST 2010;Committer;knu;2;6;1;7;0
55a7a836dd3af58349761545ed827b8a5afb56d9;Tue Feb 23 15:52:19 EST 2010;Committer;knu;2;36;47;83;0
eb845bea4c320d6037103ea1d107bbdefdc0bde7;Tue Feb 23 15:51:01 EST 2010;Committer;knu;2;23;6;29;0
3cd6a6585fd742d9890f814f19ba6491812d6ad5;Tue Feb 23 15:41:39 EST 2010;Committer;svn;1;2;2;4;0
24684a8a348b9d182b40f77e0fe8a4e245671949;Tue Feb 23 15:41:34 EST 2010;Committer;mame;2;18;5;23;0
7fbf88960518a4b15f99279cd490f22e4eff3558;Tue Feb 23 11:41:55 EST 2010;Committer;akr;1;1;1;2;0
6b11ee7288c83c3cd06273a156993369ebdb3f51;Tue Feb 23 11:41:44 EST 2010;Committer;akr;1;1;1;2;0
a3aec76e7cb8f70c0b992a14f84778fee302c5db;Mon Feb 22 16:13:02 EST 2010;Committer;svn;1;2;2;4;0
c5f11b65935420042f8c915ccb5e6da3530e6dcb;Mon Feb 22 16:12:58 EST 2010;Committer;akr;1;1;1;2;0
508ca62a6c9deb20603a8b2678bd5db35c4e6de1;Mon Feb 22 12:36:11 EST 2010;Committer;akr;2;5;1;6;0
29860b0bbbaba0175d552846575c0784bb4e1fcb;Mon Feb 22 12:34:54 EST 2010;Committer;akr;1;2;2;4;0
b551e8c8b36766651be4e782e09e3b02e7d14a10;Mon Feb 22 02:52:35 EST 2010;Committer;nobu;119;2691;2569;5260;0
65544f575b25b18dc27f9364f973556ddb48538f;Mon Feb 22 02:42:11 EST 2010;Committer;nobu;1;0;4;4;0
e6dde8be4d2538464372fd0c7499d625239a3b08;Mon Feb 22 02:21:22 EST 2010;Committer;nobu;8;85;96;181;0
034acb5806a718e3ec361af43b902c1ec3591ff3;Sun Feb 21 17:17:44 EST 2010;Committer;svn;1;2;2;4;0
9d8bf3b9ee784de6cb54a210a601cf2dc662f8a9;Sun Feb 21 17:17:41 EST 2010;Committer;akr;1;4;1;5;0
3ef72aebef3ec06295bc3f14c2a09da91a44ff31;Sun Feb 21 12:20:21 EST 2010;Committer;nobu;2;7;2;9;0
33dd3c94bdd0bfa440b07f6f5a7eb7828b95aabe;Sun Feb 21 04:30:02 EST 2010;Committer;nobu;2;4;19;23;0
2a3c459d5b252e1bcd13b91307fcce53f38a9cd8;Sat Feb 20 21:28:49 EST 2010;Committer;azav;1;5;0;5;0
b3611d2b5b4130c496d838b622106e3808f04dc2;Sat Feb 20 21:27:41 EST 2010;Committer;azav;1;4;0;4;0
0c2588596e7ab3a2d8f968b3096844b548530056;Sat Feb 20 16:27:02 EST 2010;Committer;svn;1;2;2;4;0
1b99a27b11b816e20a8cf86d5ee09098f4eba965;Sat Feb 20 16:26:58 EST 2010;Committer;matz;2;12;1;13;0
69286031afc1c4108f3013ed0796ec471de5d963;Sat Feb 20 03:17:48 EST 2010;Committer;svn;1;2;2;4;0
960beaac86e05a89601b9d685750202c7346a43b;Sat Feb 20 03:17:44 EST 2010;Committer;akr;1;6;6;12;0
54a61d3e2a130b4db054112b33e4fb4cb8818889;Fri Feb 19 12:52:03 EST 2010;Committer;akr;1;9;2;11;0
a39e9e0745d5883b67cb84ab53e53d295e68e7b4;Fri Feb 19 07:43:35 EST 2010;Committer;nobu;1;2;1;3;0
6b9c2e9d77cc2c9003dec9eac890e48af7dbc732;Fri Feb 19 07:01:11 EST 2010;Committer;naruse;1;2;2;4;0
c840e4578f49df89840a3aed3102ca201fb13f57;Thu Feb 18 15:06:10 EST 2010;Committer;svn;1;2;2;4;0
5a55683bc62b827b3a0bb7d39587ce68dd993520;Thu Feb 18 15:06:06 EST 2010;Committer;mame;2;6;1;7;0
54380d99f833eaac517c5be4f6753f015dcaed2d;Thu Feb 18 13:39:11 EST 2010;Committer;mame;2;15;0;15;0
a8fcae0858458eeed0504a0f91071146bac8fb74;Thu Feb 18 13:33:25 EST 2010;Committer;muraken;3;15;1;16;0
e8665a6bc271654de993e8cfca08164717236cd1;Thu Feb 18 12:53:31 EST 2010;Committer;akr;3;14;0;14;0
713e99cec284a7bfdfdc6b598102028e0f844b8f;Wed Feb 17 17:19:53 EST 2010;Committer;mame;3;21;17;38;0
f3d952335d45772d4c5f3eb86da27c0981321527;Wed Feb 17 16:27:06 EST 2010;Committer;svn;1;2;2;4;0
6dda216da1356099bb9021592d29c4fa7d16f84b;Wed Feb 17 16:27:02 EST 2010;Committer;akr;1;13;0;13;0
457c2c4a55b5896b30510ff8b39256b61b46cdf4;Wed Feb 17 12:36:41 EST 2010;Committer;mame;3;32;2;34;0
24421c835d85bdff2a8878cab1befc3255685b67;Wed Feb 17 12:27:34 EST 2010;Committer;akr;3;30;7;37;0
50c8982ea8e4c25e154084af1864617e7bd330ae;Wed Feb 17 08:05:42 EST 2010;Committer;nobu;4;13;2;15;0
711ed72b7967b6dc9cc0375a4e331aa24f7b2c0f;Wed Feb 17 06:34:48 EST 2010;Committer;nobu;2;30;25;55;0
f95348378770d8d0967690ae0de492a1444187a3;Wed Feb 17 05:26:33 EST 2010;Committer;nobu;5;15;5;20;0
074836aacac05113acf7fd96d4a9cdb144b57368;Wed Feb 17 05:21:10 EST 2010;Committer;nobu;1;1;1;2;0
68408702917a4f93fea7da9a90d60d9d2a0719c9;Wed Feb 17 05:18:39 EST 2010;Committer;nobu;1;6;0;6;0
676cf9b5274d789f5e040a63115487a16c9987fe;Wed Feb 17 00:19:29 EST 2010;Committer;naruse;1;1;1;2;0
d1925e649f31f01a61a2766b9aac1dc6420ffcd1;Tue Feb 16 16:45:22 EST 2010;Committer;akr;1;1;1;2;0
17ecdd2ff8dc43097d7b5f2fea8663b40d0b9882;Tue Feb 16 16:20:21 EST 2010;Committer;svn;1;2;2;4;0
79afabe0c5f5aa1df305fac7708f1d5ef278bc83;Tue Feb 16 16:20:18 EST 2010;Committer;mame;2;18;0;18;0
4651910af145c2b52c100385fbc7245f01846f72;Tue Feb 16 13:25:54 EST 2010;Committer;akr;1;11;0;11;0
a9f6a9553033169c636beaebc61ae2fc610f3426;Tue Feb 16 13:10:39 EST 2010;Committer;mame;2;5;1;6;0
2236f6a682ae39e49706f515d2e41bed6b4b1d12;Tue Feb 16 12:34:09 EST 2010;Committer;mame;2;63;26;89;0
792b3efa62bf7c876cba8a6c376057923ce175fa;Tue Feb 16 12:00:24 EST 2010;Committer;akr;3;14;10;24;0
4d71618c3888f841b3f2242e95f9b2a702807f03;Tue Feb 16 10:19:24 EST 2010;Committer;nobu;2;18;4;22;0
da2497745e207c20b632ec14731397fb48a52fd2;Tue Feb 16 10:03:02 EST 2010;Committer;nobu;6;30;23;53;0
53dddcf88e6f522d120e9b7df8c249f945eec556;Tue Feb 16 09:54:10 EST 2010;Committer;nobu;1;3;3;6;0
8f8947a260891f265d4f3881f6ebac7fbbc96d7a;Tue Feb 16 02:05:46 EST 2010;Committer;tenderlove;7;270;254;524;0
1e7d74f39ed82dc0f1044d30f51237592f1a6131;Mon Feb 15 23:52:11 EST 2010;Committer;svn;1;2;2;4;0
e5657a6584cd7a3dcff9e954d71d69552bddc08d;Mon Feb 15 23:52:08 EST 2010;Committer;tenderlove;1;1;1;2;0
76678bb526a8a4e6d4af3dffb1ebe6da6d5f9ccf;Mon Feb 15 14:37:52 EST 2010;Committer;akr;2;18;9;27;0
9dbffb49fa69da2252028c8c9fbf0f5ad8c1c320;Mon Feb 15 14:09:19 EST 2010;Committer;akr;2;6;0;6;0
8fd5bf07581d683b32b2d24e5deedcb7e4997bbb;Mon Feb 15 13:45:52 EST 2010;Committer;akr;2;6;1;7;0
8d532a868933f574ac9fe31ee11ead9a459b0914;Mon Feb 15 13:26:51 EST 2010;Committer;akr;2;25;1;26;0
795b03c71c7949c0c260139d6f8a3e289826fdca;Mon Feb 15 13:21:10 EST 2010;Committer;akr;3;19;0;19;0
3360a65ba7fc04f12fd470aaa6c91a0b94013abd;Mon Feb 15 09:03:33 EST 2010;Committer;naruse;1;1;1;2;0
d9c31a67875f5c892a156f2fd80fe4ad2f9f0f2c;Mon Feb 15 09:00:34 EST 2010;Committer;naruse;1;5;2;7;0
c0eb5bb6f2f5d7ef282c44b80f36fe7168aa4628;Mon Feb 15 08:49:51 EST 2010;Committer;naruse;2;8;2;10;0
c3a51e3ce1810a77bdf337c50e381f4d1ceca94c;Mon Feb 15 04:13:47 EST 2010;Committer;svn;1;2;2;4;0
6b6a41d1e78ef3deabbe63a77e8e335d8bb684cb;Mon Feb 15 04:13:43 EST 2010;Committer;naruse;2;6;1;7;0
05270882aefe8cf9206e4e6dc2d537a7e91dcf86;Sun Feb 14 03:54:47 EST 2010;Committer;nobu;2;6;1;7;0
47b8a0e7e4a04a28e57c3f9bb712a1f88d9e27bb;Sun Feb 14 03:09:53 EST 2010;Committer;akr;6;7;7;14;0
0fd75b46b755dac01f6bc6ccdf40c8abf8e7d23d;Sun Feb 14 02:40:52 EST 2010;Committer;akr;1;19;4;23;0
27e492bec76b039f69678c42942d113e1f48d811;Sat Feb 13 19:45:35 EST 2010;Committer;nobu;4;25;4;29;0
be0197054c8c9634f413bc472425a1a8650c77cd;Sat Feb 13 19:31:42 EST 2010;Committer;nobu;2;29;29;58;0
5d325e6a9e3d01a07191875b55f98496efb75e6e;Sat Feb 13 08:08:19 EST 2010;Committer;matz;2;13;3;16;0
c1ad9a5fd1a4d468a4c941e0cf5a6f5b9f90d2df;Sat Feb 13 06:03:06 EST 2010;Committer;matz;2;5;1;6;0
2ce744032b38771dd1a6aa87b9118621bea3b3aa;Sat Feb 13 04:30:18 EST 2010;Committer;akr;1;7;0;7;0
d6fb854ecbf48111a746009f559d642446b8d1c1;Sat Feb 13 03:20:52 EST 2010;Committer;akr;2;28;17;45;0
3f9bc1fd88554a7ebacba2246ed51a147103c3b7;Fri Feb 12 16:18:54 EST 2010;Committer;svn;1;2;2;4;0
3c529cf5f50376c72a526925338ed998e241202f;Fri Feb 12 16:18:52 EST 2010;Committer;akr;1;1;1;2;0
49f62d73b8a8428cf6349ad83c2632ba7a44b59a;Fri Feb 12 08:55:24 EST 2010;Committer;nobu;2;5;1;6;0
0d10b774035c56a7f14ae2582e29b9e7604029d8;Thu Feb 11 17:38:09 EST 2010;Committer;svn;1;2;2;4;0
e1d9adcc84624fd056142c9d079d16a217cf5b58;Thu Feb 11 17:38:05 EST 2010;Committer;knu;2;25;10;35;0
36ff32040e6dceb8c3a6a67b11e663db6dcd6f06;Thu Feb 11 13:59:34 EST 2010;Committer;akr;1;2;2;4;0
1ad8521d44de917e759ff9d77d39f6f3f55215f5;Thu Feb 11 13:30:55 EST 2010;Committer;akr;1;18;0;18;0
c09bcd351af03eaadd44552f47a0fc85bf64075a;Thu Feb 11 11:45:22 EST 2010;Committer;akr;2;10;2;12;0
e95a439c6dbe863c431eed51fb5591f38e73fba3;Thu Feb 11 10:20:43 EST 2010;Committer;kazu;2;5;1;6;0
485c571bf1c95875c33a3309cf1ce58d3518f167;Thu Feb 11 08:52:16 EST 2010;Committer;nobu;2;6;0;6;0
aeed74a61a8bde71d5787fa960a62b388f6fea4d;Thu Feb 11 07:31:03 EST 2010;Committer;akr;1;1;1;2;0
87fb6fbcc9558255dc87cf22dd34e0b094ba4f35;Thu Feb 11 05:43:19 EST 2010;Committer;nobu;2;20;8;28;0
50bf2e550a6fb7cfa197d8429cf4a1e4f5e3e9c7;Thu Feb 11 05:37:43 EST 2010;Committer;nobu;3;26;34;60;0
d61a305270246ddc050e7b165b8242629957a25f;Thu Feb 11 01:31:49 EST 2010;Committer;akr;1;1;1;2;0
d3004ccff3615f756fca8562dfad64b23f7e2454;Thu Feb 11 01:29:38 EST 2010;Committer;akr;2;82;33;115;0
9f782768ab86cb51d4172c30f28d25ea5ab47fef;Wed Feb 10 16:46:43 EST 2010;Committer;svn;1;2;2;4;0
e79ad682daaea5d61d1f1fac29784374f14be257;Wed Feb 10 16:46:39 EST 2010;Committer;mame;2;10;2;12;0
f3f43cdbee1703afd92f9f6dbb471642bcede9f5;Wed Feb 10 07:31:06 EST 2010;Committer;nobu;7;79;10;89;0
6942afef5f8eb829b85b05bbea59c9eb9214739c;Tue Feb 09 19:06:43 EST 2010;Committer;svn;1;2;2;4;0
09205cf2c3334b078677c430d83b42352d929a26;Tue Feb 09 19:06:39 EST 2010;Committer;nobu;3;28;5;33;0
520053232e76b03952b7e80be2c5a906132de195;Tue Feb 09 14:49:41 EST 2010;Committer;mame;2;7;1;8;0
03ad923cdd130bd522e7b25e6f3958b3118aae01;Tue Feb 09 14:30:30 EST 2010;Committer;mame;2;8;2;10;0
b4f90b236c56601a1d112af7c116fc9ef80703d6;Tue Feb 09 13:27:04 EST 2010;Committer;mame;2;16;9;25;0
f2bd994409bb6a8fb96eeadcbc12cbc3e30fb80e;Tue Feb 09 12:30:31 EST 2010;Committer;mame;2;8;2;10;0
b3b3223e586c91bf806a4092b22f07cf4b0a54bf;Mon Feb 08 15:08:19 EST 2010;Committer;svn;1;2;2;4;0
bba5e1126b62b24388a19e27f5002d15e15cdae3;Mon Feb 08 15:08:15 EST 2010;Committer;matz;3;12;3;15;0
7e833da5feab7c68924280e4e183784504e664ba;Mon Feb 08 12:08:45 EST 2010;Committer;akr;2;17;3;20;0
a7926befe0e9eeb5a1ccc76e05e4f4aebb5f8caf;Mon Feb 08 07:43:54 EST 2010;Committer;matz;4;39;6;45;0
26051e1d06f128fa2201d01936761634e8925c8e;Mon Feb 08 07:28:00 EST 2010;Committer;nobu;4;10;3;13;0
ecc775772ae08fbcf0015b33f2687bbbad051a93;Mon Feb 08 07:23:13 EST 2010;Committer;nobu;5;11;4;15;0
922f3d0bed4d48bc34a9e3ac7daf59a64852de65;Mon Feb 08 01:32:48 EST 2010;Committer;svn;1;2;2;4;0
41ec00e0193313f8bc989b0d5efb0220bc77c82a;Mon Feb 08 01:32:43 EST 2010;Committer;matz;2;6;1;7;0
fe0598ac828ffa93e960fc7f5a6c86a6bc2572c2;Sun Feb 07 14:13:19 EST 2010;Committer;akr;2;5;1;6;0
dd4537ad99716a106d99d624bdb97a1d66ba8721;Sun Feb 07 14:09:43 EST 2010;Committer;akr;2;6;2;8;0
bd0a3dfd65a164f422e7e2e92bfc3fddb084cde5;Sun Feb 07 10:29:39 EST 2010;Committer;naruse;1;29;2;31;0
666409ba5011a86267d7a54541ce6e69b9e59550;Sun Feb 07 03:55:21 EST 2010;Committer;akr;2;6;1;7;0
fcd2fb4e871f3787f34b05cffeb7e5df7b04f29f;Sat Feb 06 18:02:59 EST 2010;Committer;akr;2;6;1;7;0
b09eabd430d92cdae011bb7ad08a3300049a4392;Sat Feb 06 15:26:34 EST 2010;Committer;shugo;3;10;0;10;0
141179186bd28a712cd771fb60fa9a5d5b275e7b;Sat Feb 06 15:26:24 EST 2010;Committer;svn;1;2;2;4;0
0381cec5073031afd6843a096dcec405f93b24aa;Sat Feb 06 15:26:20 EST 2010;Committer;shugo;2;15;2;17;0
e432a4c4230bcf834ddc0fb61861cd8ae49116f9;Sat Feb 06 14:26:19 EST 2010;Committer;shugo;1;5;0;5;0
5fe1f62633fb71f6e2450acc77605d1102a24e6e;Sat Feb 06 14:26:07 EST 2010;Committer;shugo;1;131;97;228;0
3b21e88faa2d894054f3a0ca4c4e052c4ab7c24d;Sat Feb 06 14:11:21 EST 2010;Committer;shugo;1;1;1;2;0
d724d5e771cc5bd64311e40e478cf2f4b8977747;Sat Feb 06 14:09:13 EST 2010;Committer;shugo;1;15;3;18;0
b44070175a1e3888e11ae37eb627979bec25c979;Sat Feb 06 13:57:23 EST 2010;Committer;shugo;1;6;0;6;0
69c3348b7997cb5efc2bf55bb11ea32dc976dcba;Sat Feb 06 13:57:10 EST 2010;Committer;shugo;2;31;2;33;0
bc885aeae60d6e00a4de3852640221c30c685ed1;Sat Feb 06 12:32:12 EST 2010;Committer;shugo;1;6;0;6;0
237c2211e6e62c069bef97ef99179a2d765441eb;Sat Feb 06 12:31:59 EST 2010;Committer;shugo;1;10;1;11;0
332e8fe51f0ba4107c6fef4957ddeb15a0681dec;Sat Feb 06 12:31:52 EST 2010;Committer;shugo;2;23;11;34;0
cef8a996bebd0a6102f92fc6c4976f282e1f64fa;Sat Feb 06 11:47:00 EST 2010;Committer;akr;1;3;1;4;0
cd2a49f3c7e585b871cbac949be36d4bee7c0e31;Sat Feb 06 10:36:32 EST 2010;Committer;mame;2;5;1;6;0
a6569ad637e46eeb93bd28fe1ffe3c173dc43903;Sat Feb 06 03:02:40 EST 2010;Committer;nobu;2;14;16;30;0
26b8c0890f4177f004b40adaad1a412e3f22cb72;Sat Feb 06 02:41:04 EST 2010;Committer;nobu;1;2;0;2;0
af2f1bf4f9fa58aee5a1333c8701eff80071d267;Sat Feb 06 02:35:11 EST 2010;Committer;nobu;3;82;16;98;0
e5757042f94830dd3f5c019ab5ec2838ea794cd8;Fri Feb 05 16:57:54 EST 2010;Committer;mame;2;24;10;34;0
63cbe555b7c040efd335392f31dd99d45e8134db;Fri Feb 05 16:21:56 EST 2010;Committer;mame;3;7;2;9;0
a68c79f7166097daa2a5cd037c04859465c23257;Fri Feb 05 15:29:19 EST 2010;Committer;akr;1;4;4;8;0
a2d51931f6c057f6b74a81ba137e56b8060b76e4;Fri Feb 05 15:04:43 EST 2010;Committer;svn;1;2;2;4;0
19b2909ee87c67fae96f77637b3245b81cbce722;Fri Feb 05 15:04:38 EST 2010;Committer;akr;3;7;4;11;0
7873c05684839a88b1b9fd61272f3e70af8e3ac4;Fri Feb 05 07:38:10 EST 2010;Committer;nobu;3;65;17;82;0
1c4fe5395db05b45014734126ae448d40989db80;Fri Feb 05 00:28:22 EST 2010;Committer;naruse;2;4;2;6;0
510cde74a6c5c810fb96980ac0d1a9d806d562c3;Thu Feb 04 17:11:00 EST 2010;Committer;tenderlove;4;26;17;43;0
f6b75e30d8b7f1adfefc506fcb23768c2276fa32;Thu Feb 04 15:36:31 EST 2010;Committer;svn;1;2;2;4;0
f574df443ad6b65bb1d44cb39b5ebef5db32c448;Thu Feb 04 15:36:29 EST 2010;Committer;mame;2;116;0;116;0
b323b86b6b3a7283617b72b45521c554dba930c9;Thu Feb 04 07:17:03 EST 2010;Committer;naruse;3;32;24;56;0
669862a416ce92dfee6b677e35144e7b8db1cb19;Thu Feb 04 01:00:30 EST 2010;Committer;naruse;2;8;0;8;0
10e8419da621fb4e6a9dd8346a6df8c707f962ba;Wed Feb 03 23:15:55 EST 2010;Committer;nobu;3;38;16;54;0
7a4621eecff07d1d82c0f17442491198749223c3;Wed Feb 03 18:02:47 EST 2010;Committer;mame;2;5;1;6;0
6c1c35db17e55adc479db493cd85e1ad8afa8e31;Wed Feb 03 16:34:24 EST 2010;Committer;mame;2;21;1;22;0
b3085ba508b9582ff279c2ddf59a44885e22c074;Wed Feb 03 15:37:45 EST 2010;Committer;nobu;3;42;3;45;0
572c266e055e517896accfee55672fa1352a36db;Wed Feb 03 15:29:15 EST 2010;Committer;nobu;2;6;6;12;0
e916ccc5cd20e9edbdc6e2b47ca2cd995eebd8d8;Wed Feb 03 14:52:23 EST 2010;Committer;nobu;1;2;0;2;0
85518db978445c7b0dc700dbc10219860ff9ac3b;Wed Feb 03 14:51:39 EST 2010;Committer;akr;1;1;1;2;0
ec7872aff7027a88dba1844ed080d5a8a1f9799c;Wed Feb 03 13:22:32 EST 2010;Committer;nobu;2;8;1;9;0
f9994ada30ebe19a350ee79229968a206481d4c2;Wed Feb 03 13:20:43 EST 2010;Committer;nobu;1;28;33;61;0
e7d267c42a13ca83c8c2ca1718e0fd92a83957ed;Wed Feb 03 11:12:04 EST 2010;Committer;akr;3;9;3;12;0
688ca71c13c46ef7df022845266eb4549b98f38c;Wed Feb 03 11:08:44 EST 2010;Committer;akr;2;6;1;7;0
44b5a74a9ae22aa08f226b7f1d555fad928a8cf7;Wed Feb 03 04:17:19 EST 2010;Committer;naruse;2;8;3;11;0
fb15c0f16c8b1f6a9a9edd9aa9f81e61b0f5ba92;Wed Feb 03 03:35:11 EST 2010;Committer;naruse;2;23;7;30;0
22ba8368ae2a4eadccc87c8de394662ce74003b9;Wed Feb 03 02:39:18 EST 2010;Committer;nobu;3;172;161;333;0
78a59da8bc242413c58723203aa007d0f3beecf0;Wed Feb 03 01:29:44 EST 2010;Committer;matz;4;167;150;317;0
b386fe21eca01e03a5ca447792354632e549c94e;Wed Feb 03 01:23:48 EST 2010;Committer;tenderlove;21;802;378;1180;0
b378bda47c3960acd983890efd01ac08794f6fd3;Tue Feb 02 15:14:35 EST 2010;Committer;svn;1;2;2;4;0
f7d5887fdb6c74856dcc390aebe61b1a7d8e6fd9;Tue Feb 02 15:14:34 EST 2010;Committer;akr;1;0;2;2;0
48d402db88caa3e3d908a8691c421cf66f65a1de;Tue Feb 02 13:58:56 EST 2010;Committer;akr;27;27;29;56;0
4dfd71005cf4ee14db965cd155417f8657ed2c24;Tue Feb 02 09:15:19 EST 2010;Committer;nobu;2;7;1;8;0
970e90dd1572994d3d9229725e12d47b3674fcbf;Tue Feb 02 08:54:52 EST 2010;Committer;matz;4;80;15;95;0
bafb881c1f22781aac347cdabb845798a7753180;Tue Feb 02 02:14:00 EST 2010;Committer;nobu;3;9;4;13;0
9f714e35ec70fe7eec4b2810af7a66c936a64df1;Mon Feb 01 12:27:46 EST 2010;Committer;mame;2;5;0;5;0
b8acb1cc2d9ece124108bfd583855c20aa52d0a5;Mon Feb 01 08:09:54 EST 2010;Committer;matz;2;6;1;7;0
317fea44af35491697d4c497813db0c7bb832bb2;Sun Jan 31 22:50:49 EST 2010;Committer;svn;1;3;3;6;0
023a34526bed14f11d66b1e0998de061e34e8a3b;Sun Jan 31 22:50:43 EST 2010;Committer;nagai;5;51;16;67;0
8d33d0a5609455a334e53e1530409530a3a5ceed;Sun Jan 31 14:24:40 EST 2010;Committer;wanabe;2;6;2;8;0
ddf72817b05464508d2c89add72babca99a50820;Sun Jan 31 14:08:19 EST 2010;Committer;mame;2;5;1;6;0
f26bb91386403a8f8be1370442bac41cc24e2d37;Sun Jan 31 13:44:19 EST 2010;Committer;mame;1;2;1;3;0
d4f75667f437d3dde0323f75c85028c40f7bf55a;Sun Jan 31 13:42:26 EST 2010;Committer;mame;1;4;0;4;0
21523e3a98264ae6c936a4f3b9a07c4b3dc1d066;Sun Jan 31 12:46:36 EST 2010;Committer;mame;2;6;7;13;0
3a9ce187de26c805d1f266666572689d2947cf37;Sun Jan 31 12:41:47 EST 2010;Committer;mame;3;17;5;22;0
323d23c44b58ab5f9d6ddd177d54d6fc7f1f4217;Sun Jan 31 12:36:27 EST 2010;Committer;mame;2;7;1;8;0
a497f3a52de7843bbae0a418155bc03d166e18cf;Sun Jan 31 12:11:39 EST 2010;Committer;mame;1;4;0;4;0
8458c38590e80b3057f9361804405bbb2fe4a10c;Sun Jan 31 09:03:08 EST 2010;Committer;akr;1;14;16;30;0
d784451678c248b69bced992d9d74f83cfef9995;Sun Jan 31 08:41:13 EST 2010;Committer;akr;1;3;2;5;0
29d994d33d3fdc0fe8fa1c1b002c32a22c8d52d5;Sun Jan 31 08:39:05 EST 2010;Committer;akr;1;27;1;28;0
a9770c8058088ea9d7a2af1279e2c184cd763bb1;Sun Jan 31 06:55:17 EST 2010;Committer;mame;2;8;3;11;0
8129a8dfbdac69ac5879aedeec45ff7c444954ee;Sun Jan 31 06:55:06 EST 2010;Committer;mame;2;8;1;9;0
ae0b6068308814274903466ef0788161798b3265;Sun Jan 31 05:34:17 EST 2010;Committer;jeg2;3;16;4;20;0
bcbfa7a97bdf46b534666f6195f8c9a441a044a4;Sun Jan 31 04:33:33 EST 2010;Committer;wanabe;2;5;0;5;0
4916ce4641daa68d528d06fc44b280a95dd6903b;Sun Jan 31 04:03:19 EST 2010;Committer;svn;1;2;2;4;0
6425b4ba561cc5e3efe7f7c56896ea3edb1427ea;Sun Jan 31 04:03:14 EST 2010;Committer;mame;2;16;8;24;0
1b1b5c2bc36a009b143c9fb67fc418aa47e616eb;Sat Jan 30 07:56:50 EST 2010;Committer;nobu;2;2;3;5;0
147a09f86ea0e420789d4127f5c1498bde3a4686;Fri Jan 29 14:46:45 EST 2010;Committer;akr;1;1;1;2;0
bc7ae41e0f8770000b38dd4be81cf331d58f6d1c;Fri Jan 29 13:53:57 EST 2010;Committer;mame;2;11;2;13;0
9433d94cff528bfd169cb0eaa4d664a4bc0a5111;Fri Jan 29 05:21:55 EST 2010;Committer;nobu;3;40;0;40;0
e8e41b217c788f04bedfe5d629fefc9340db187a;Fri Jan 29 03:59:39 EST 2010;Committer;nobu;2;7;0;7;0
896d7682903c3d402129420f9f025bd527857cb4;Fri Jan 29 03:22:55 EST 2010;Committer;nobu;1;1;1;2;0
a0248a2ba1c5599845d0a0a370f5c8418d442dd6;Fri Jan 29 02:09:51 EST 2010;Committer;nobu;2;21;8;29;0
6899b6ff8065daea6f87bfda1ab157738a60f09d;Fri Jan 29 00:56:10 EST 2010;Committer;naruse;2;8;3;11;0
796931aa09fc14fc03abba3691e7a214206adf49;Fri Jan 29 00:50:13 EST 2010;Committer;nobu;1;6;3;9;0
d9e84f2327f09bbc356871c6e72e5816654cff72;Thu Jan 28 16:47:21 EST 2010;Committer;matz;2;9;11;20;0
d1499525d5ea9d0b2d372406d414ea3679a939fb;Thu Jan 28 16:34:11 EST 2010;Committer;matz;3;31;26;57;0
a715d95a8221ae80015ced9d80bf96c4d8b5b6e9;Thu Jan 28 15:19:55 EST 2010;Committer;svn;1;2;2;4;0
266ee3bc7a6b4d664973876884b17ea04969b420;Thu Jan 28 15:19:52 EST 2010;Committer;mame;2;5;0;5;0
62f8c207b223887dccb860e9cc8739d77b045724;Thu Jan 28 00:50:17 EST 2010;Committer;naruse;3;9;1;10;0
15ae29a714316f8ea800bca3363f0cdd80a59ade;Wed Jan 27 16:59:06 EST 2010;Committer;svn;1;2;2;4;0
d42641db665453695cc6b1fce2e6f1e2963bce36;Wed Jan 27 16:59:03 EST 2010;Committer;kazu;1;1;0;1;0
5f7f5098a64f7651d8e120b54f00f3b0be1ad66a;Wed Jan 27 14:34:03 EST 2010;Committer;mame;3;409;0;409;0
0aafb0b4b645bf41540bc2f625d040d63bd06baf;Wed Jan 27 14:30:37 EST 2010;Committer;mame;2;9;1;10;0
afc9fce01f0557751d38376ed56221e6d5e99488;Wed Jan 27 14:28:47 EST 2010;Committer;keiju;2;40;14;54;0
606f59bbffe149112efeb5322cb4f6d22362589a;Wed Jan 27 14:25:27 EST 2010;Committer;kazu;3;13;3;16;0
9c8f53c10d3002fa97382403d1c8021247807d82;Wed Jan 27 14:25:19 EST 2010;Committer;kazu;2;7;1;8;0
ea379a7f8d35c5fde110a941f786ae22e8a03b3a;Wed Jan 27 14:25:13 EST 2010;Committer;kazu;1;2;2;4;0
a817c0b0891ac321b5a95b5fe0f426388b41f282;Wed Jan 27 13:49:58 EST 2010;Committer;mame;2;6;2;8;0
69eb602b026e483230b391f2cd4e72490fc436df;Wed Jan 27 13:29:01 EST 2010;Committer;mame;2;7;1;8;0
bf4a6a0557355a2945dedabe1e494417deaf7073;Wed Jan 27 12:04:17 EST 2010;Committer;akr;2;26;10;36;0
1d3c2678e2e23484098260df337f383c2f5b2c60;Tue Jan 26 15:25:04 EST 2010;Committer;mame;2;24;16;40;0
671c165b6dfab36e2f15d179dc32ea23b93e7442;Tue Jan 26 15:21:28 EST 2010;Committer;svn;1;2;2;4;0
48b4d8c528696a03b8a924c084f24bdc263262dc;Tue Jan 26 15:21:25 EST 2010;Committer;mame;2;9;2;11;0
6ce499423142f45c3524a611e3b7da09eea8154e;Tue Jan 26 14:54:02 EST 2010;Committer;akr;2;2;2;4;0
bddadeeae4a5b40461c4f111038015f8c3ca8ada;Tue Jan 26 13:31:12 EST 2010;Committer;naruse;2;7;5;12;0
05d80e2fc68675be7339a7b5a909c90680ed23bc;Tue Jan 26 12:52:49 EST 2010;Committer;mame;3;22;7;29;0
96542c36786fb4dd6a94d0b83834f267478f2241;Tue Jan 26 12:41:43 EST 2010;Committer;akr;3;22;0;22;0
fe98a03c532936b80199e84fc5d94bbe295bdaf0;Tue Jan 26 12:34:51 EST 2010;Committer;akr;7;41;27;68;0
b71cab7fa071bc2ed369526e7c579f4928c04ed4;Tue Jan 26 11:28:38 EST 2010;Committer;mame;2;5;15;20;0
e92661e647eeeeb0c8f5a8a56c66e21f72950468;Tue Jan 26 11:22:20 EST 2010;Committer;seki;2;6;2;8;0
0ba192d72990fe34961c02227ece331be74dbc84;Tue Jan 26 11:18:17 EST 2010;Committer;naruse;3;15;920;935;0
6dc1a46323aee433bacc98d2050db9b70fa82eb1;Tue Jan 26 07:56:36 EST 2010;Committer;naruse;2;8;3;11;0
46c8b826fde1093c5b41e987ac8b0c8ea3eaaf40;Tue Jan 26 00:00:38 EST 2010;Committer;akr;1;3;1;4;0
37679ee584e409088a2f083594e3c4ccba486e13;Mon Jan 25 23:12:50 EST 2010;Committer;akr;20;77;77;154;0
a967f738c83b960f23f5b04403a17ca37f049e25;Mon Jan 25 22:08:29 EST 2010;Committer;akr;9;46;34;80;0
7123baaf140e58e1292553dca9650ac23a2b5da3;Mon Jan 25 18:23:02 EST 2010;Committer;svn;1;2;2;4;0
f53d8254474628f0c3710950ee342ecf941f2fd1;Mon Jan 25 18:22:58 EST 2010;Committer;mame;4;24;0;24;0
6ebdbb30add7acc3edc49bc910c4931e5125fb10;Mon Jan 25 14:09:46 EST 2010;Committer;usa;2;7;3;10;0
e090c62277bfd6730d799dbe7094e70013dbbdf7;Mon Jan 25 13:33:02 EST 2010;Committer;mame;2;6;1;7;0
24f5161c39d225e4bbe5d05362a582c01a366a9a;Mon Jan 25 13:22:16 EST 2010;Committer;mame;4;7;17;24;0
1d415019bd993eda34c205c3628945f9d3e6865a;Mon Jan 25 12:44:28 EST 2010;Committer;mame;2;6;1;7;0
34bcba57a9c432917799d59649f311eb0794a362;Mon Jan 25 12:18:50 EST 2010;Committer;mame;2;26;0;26;0
54e45b30cc0dde9af781113efc18bd9a964a0a49;Mon Jan 25 09:47:11 EST 2010;Committer;nobu;1;7;7;14;0
57d4faec1bfe66496821b534ae5de66b1ecc04dc;Mon Jan 25 09:16:14 EST 2010;Committer;nobu;1;0;7;7;0
b1489489826fa6fee533ee9344736766410daabd;Mon Jan 25 08:47:04 EST 2010;Committer;nobu;2;8;3;11;0
ccf67667b8e07471a3463394574944f78c1adf7b;Mon Jan 25 08:36:14 EST 2010;Committer;nobu;8;36;30;66;0
695c32a028a58222e1d6c726334e1b6c7c911c47;Mon Jan 25 05:02:26 EST 2010;Committer;nobu;1;1;1;2;0
423657b42c4baca7282e0de96c968e3d31ae235e;Mon Jan 25 03:11:46 EST 2010;Committer;nobu;2;10;4;14;0
d5b0c4b1f3367b76f1b7af934f99cf1e1cb35b82;Mon Jan 25 03:06:06 EST 2010;Committer;naruse;5;15;10;25;0
0fdbdfbbda2e3d223d299b9df819402c3de82ecf;Mon Jan 25 02:51:16 EST 2010;Committer;naruse;2;12;1;13;0
68e111176ffb1d3f88e5605a5e3eeb8c200cce13;Mon Jan 25 02:50:05 EST 2010;Committer;nobu;2;3;3;6;0
618445576faa94fcd6d3957ea3fb59f6372b64ba;Sun Jan 24 13:52:32 EST 2010;Committer;ko1;6;120;39;159;0
2979842520060311909874e300ef943cca2d215c;Sun Jan 24 13:20:04 EST 2010;Committer;akr;1;2;0;2;0
83d9e9f42e1f704dd5a412b32d9264403d0b488a;Sun Jan 24 05:22:51 EST 2010;Committer;akr;2;10;4;14;0
4b8e14c978bf1300b6528430c28aab21865a21f4;Sun Jan 24 04:59:31 EST 2010;Committer;akr;2;9;1;10;0
cb9da52cdedfd71d326ac83f72bd553373c7f815;Sat Jan 23 20:47:23 EST 2010;Committer;nobu;1;2;2;4;0
a1d416425796d192a7d30b89493971cfe9c4990e;Sat Jan 23 20:18:36 EST 2010;Committer;nobu;4;43;7;50;0
ce35c0c650dc058bd123be36c28fccef5a920823;Sat Jan 23 15:34:47 EST 2010;Committer;naruse;2;7;2;9;0
75acf8795928c10c7e5ac50c90a146400eac010e;Sat Jan 23 15:11:23 EST 2010;Committer;svn;1;2;2;4;0
ad3880549038c18235538054fb8224ae7e0c80ee;Sat Jan 23 15:11:20 EST 2010;Committer;naruse;2;6;1;7;0
155e42c50e14c03c07763d0b4ede1633c420c164;Sat Jan 23 14:28:38 EST 2010;Committer;naruse;2;7;0;7;0
eaa9ca76537fbf0a9b69353b00832b65e6ca828c;Sat Jan 23 14:16:04 EST 2010;Committer;naruse;2;10;0;10;0
4b18062808a3731e5ffabb82e0b5dcbe207d5672;Sat Jan 23 11:02:17 EST 2010;Committer;suke;3;74;1;75;0
0f29696f9d38642962766ecee2c2f9008675e7dd;Fri Jan 22 15:26:52 EST 2010;Committer;mame;2;6;0;6;0
0f078cbfc445cf079b2d3e3fb3eb0c85f9c2318b;Fri Jan 22 15:24:22 EST 2010;Committer;mame;3;9;9;18;0
b1a0dc709b561971f01fd878dc56d668ddfe399a;Fri Jan 22 15:03:36 EST 2010;Committer;svn;1;2;2;4;0
bebd7e4511aca3141532d95ee5bd0237f621c059;Fri Jan 22 15:03:32 EST 2010;Committer;mame;13;205;5;210;0
d8d5e67184e0647f56576a500993c064e60fc26a;Fri Jan 22 14:53:12 EST 2010;Committer;mame;4;19;0;19;0
1d674dc54730b7ffe900146139cbac13fe967f50;Fri Jan 22 12:08:02 EST 2010;Committer;akr;3;13;0;13;0
0f02abb31bcb2da501845b945eea191a5bdadb4d;Fri Jan 22 05:26:38 EST 2010;Committer;nobu;2;5;1;6;0
e243aabc0c27bb55506551df91e56a2aec9a77c5;Fri Jan 22 05:17:16 EST 2010;Committer;naruse;2;5;1;6;0
45c2671e370a67686e0a64a7364baa00b628cceb;Thu Jan 21 16:08:40 EST 2010;Committer;mame;7;38;0;38;0
c758a9069377ed672d5e82a29e5c0555818d9928;Thu Jan 21 16:06:42 EST 2010;Committer;svn;1;2;2;4;0
f3448ded9d79c9418a761ce8d5187351810107d9;Thu Jan 21 16:06:39 EST 2010;Committer;mame;2;6;1;7;0
ff575c7eb7760830692fe627993aa4948a57385b;Thu Jan 21 06:10:16 EST 2010;Committer;shyouhei;2;47;127;174;0
8a4c9b0b77c1796deefeb41bbd5a79ef8c3bd63d;Thu Jan 21 02:15:48 EST 2010;Committer;nobu;4;163;8;171;0
2cb9f63bab44a99a8fe58c9005cd65af9c91ce1d;Thu Jan 21 02:12:07 EST 2010;Committer;nobu;2;22;4;26;0
bb8f1415e840c0de26a3aa693cb885598d429649;Thu Jan 21 00:38:03 EST 2010;Committer;nobu;2;445;504;949;0
03a284b8bdd3d4dbf9c6b0bc2cabd047148c8038;Wed Jan 20 23:45:05 EST 2010;Committer;nobu;3;11;6;17;0
34271a335edeb5d1789438fb0840971f8f561ac1;Wed Jan 20 07:12:20 EST 2010;Committer;svn;1;2;2;4;0
0d3de66006d8d7af99f551018f1fb1d39164d7ee;Wed Jan 20 07:12:16 EST 2010;Committer;shyouhei;4;16;6;22;0
926fd9a939e82e22302a95769fac0dacd294f134;Tue Jan 19 11:00:33 EST 2010;Committer;nobu;2;5;2;7;0
596154321886b1936de2cfe42e46743fdbd0eefc;Tue Jan 19 10:58:28 EST 2010;Committer;nobu;2;6;1;7;0
1b26041724a9b74eaa7364a6693a2a1040042fb3;Tue Jan 19 05:29:18 EST 2010;Committer;nobu;3;32;29;61;0
281825d48d3a0cf7281d5b42501d7191a821d21b;Tue Jan 19 05:20:01 EST 2010;Committer;usa;1;5;0;5;0
d842fce66e99f008f1119c82693120569a82c107;Tue Jan 19 05:14:29 EST 2010;Committer;usa;2;11;0;11;0
439575890301d6649797002bc5e0739b1be25328;Tue Jan 19 00:06:04 EST 2010;Committer;tenderlove;3;51;0;51;0
77f3fc305491dab95b02d9d60c5f883f9e5b05df;Mon Jan 18 17:03:16 EST 2010;Committer;mame;3;59;0;59;0
34b93543fcac01b1342a9eb084a4ef16f86b5a16;Mon Jan 18 17:00:55 EST 2010;Committer;mame;2;10;4;14;0
7f418222b15a4c5d6a403a1edbeeab0ee97cbdbb;Mon Jan 18 16:55:15 EST 2010;Committer;mame;2;4;2;6;0
98fb593998f6329d1d5a7d108242693bb7e6abfb;Mon Jan 18 16:43:33 EST 2010;Committer;svn;1;2;2;4;0
6b438bee0447e723f27835ded85df80c4c43d5a5;Mon Jan 18 16:43:29 EST 2010;Committer;mame;3;83;20;103;0
f00951bb25c5a2a1508a7ff6e09a299700030f0a;Mon Jan 18 08:16:07 EST 2010;Committer;nobu;3;73;2;75;0
9c54d38d60f0cfad7df287a05116b28488498819;Mon Jan 18 07:50:08 EST 2010;Committer;nobu;1;1;1;2;0
67244d1a7007a9802ae4568426aae4fdd9309d60;Mon Jan 18 06:49:46 EST 2010;Committer;nobu;2;7;2;9;0
5ed5439af406426b0ab983825f2aa1dcfa9e31b3;Mon Jan 18 06:32:14 EST 2010;Committer;naruse;1;4;0;4;0
5b92feaa9360c40b1eaf0b796cabea6283ef9998;Sun Jan 17 19:12:14 EST 2010;Committer;svn;1;2;2;4;0
d8f265b332506dcb7b9738247f0d895e51477ea6;Sun Jan 17 19:12:10 EST 2010;Committer;knu;5;54;6;60;0
7bfdad3b62eb19c216baed90d4da5c6a6545fe8c;Sun Jan 17 13:57:17 EST 2010;Committer;knu;2;8;8;16;0
441619b73c171bbd808d2bf9125c6bed29fddc74;Sun Jan 17 10:24:27 EST 2010;Committer;nobu;2;8;4;12;0
12278f0b70e2a395817653e8b40dbcef0f94bed6;Sun Jan 17 05:31:52 EST 2010;Committer;nobu;2;3;2;5;0
9b58e8454a9f5f24a454e0d0a3f8dc56e214f67e;Sun Jan 17 05:24:36 EST 2010;Committer;nobu;2;6;4;10;0
bb6e6903ca7ab0d833c2c243287be6123c8b15bd;Sun Jan 17 05:23:25 EST 2010;Committer;nobu;4;48;6;54;0
37db97c0e12b39c912d37b6adccbcf1112ce75ba;Sun Jan 17 05:18:03 EST 2010;Committer;nobu;2;6;2;8;0
8eacd6d930649ea43f116f66f575995636720b83;Sat Jan 16 16:53:22 EST 2010;Committer;naruse;1;1;0;1;0
b18927745aa891b5587d2fdb2368a53776abb383;Sat Jan 16 16:53:20 EST 2010;Committer;svn;1;2;2;4;0
8a73c0ec5fc84478e0e3845ac5e1ea9430c1f9f5;Sat Jan 16 16:53:17 EST 2010;Committer;naruse;1;2;1;3;0
41d8e49dc5a9d1a06e7cfeb938a470fb06ff2efe;Thu Jan 14 04:07:00 EST 2010;Committer;nobu;2;9;5;14;0
441dbecf4306864fe1bc01211e2ee047fb2eb501;Thu Jan 14 03:50:39 EST 2010;Committer;nobu;3;26;3;29;0
b3d8a4060cb9ab86b28f85ff32c5b4bebd3b6830;Thu Jan 14 00:39:40 EST 2010;Committer;naruse;2;17;2;19;0
4bf4ddb693b885a5ce9b9ad983c4743627ae29cc;Wed Jan 13 23:51:16 EST 2010;Committer;akr;3;16;1;17;0
49ab7b42383ecd1d8194e17f52c8e3f9273e1459;Wed Jan 13 19:49:39 EST 2010;Committer;akr;1;14;0;14;0
d5a96ece8548020e5c27059f924e11e9d4c2f90e;Wed Jan 13 19:04:17 EST 2010;Committer;akr;3;44;18;62;0
17f04eb438f8390398aff3a9347c7c0298794b39;Wed Jan 13 17:00:49 EST 2010;Committer;svn;1;2;2;4;0
55a4c972dffeab1589b44a9eeb69e8a17b87cd1d;Wed Jan 13 17:00:48 EST 2010;Committer;akr;1;18;0;18;0
aac3a6bd97b3556d5c4e161024c3206fde978c5e;Wed Jan 13 11:23:04 EST 2010;Committer;akr;1;5;5;10;0
cce8e77760e876d4d36c4231505cd33e3221c155;Wed Jan 13 06:26:11 EST 2010;Committer;naruse;1;8;0;8;0
fb2941a4ec60cd396982f15e990696f733703e37;Wed Jan 13 02:57:48 EST 2010;Committer;marcandre;3;9;2;11;0
187a32495b0b2bf5c850ee0a6b70bf5e37070227;Wed Jan 13 02:54:05 EST 2010;Committer;usa;1;1;1;2;0
93fb4aaed9da5be79c4b82cb8170b9eb2dfcdf66;Wed Jan 13 02:38:07 EST 2010;Committer;nobu;1;1;0;1;0
23a4f81625f2d950f8045145f22d2680b0d96b02;Tue Jan 12 21:54:47 EST 2010;Committer;nobu;4;25;4;29;0
12d782749fb6627750b4e6df69fdf3466857c709;Tue Jan 12 15:35:11 EST 2010;Committer;svn;1;2;2;4;0
19f6839c0c5c7c901a3142e35f4b5abcd6ac6913;Tue Jan 12 15:35:08 EST 2010;Committer;naruse;2;7;2;9;0
06dfb68d5465a42857842e549349d243b66205c2;Tue Jan 12 14:52:11 EST 2010;Committer;kou;3;64;5;69;0
f6f3d1bc0e24cca8e369b09c68c26813a414248a;Tue Jan 12 12:56:15 EST 2010;Committer;akr;3;8;1;9;0
d60d63ef804cad17387f8726fa6bdfec288300ce;Tue Jan 12 11:47:03 EST 2010;Committer;akr;2;7;0;7;0
3b42acc8c10d95f09792e8b1ab3d237a827e98fa;Tue Jan 12 07:48:48 EST 2010;Committer;nobu;2;12;6;18;0
0d354933c5ec267ef66f012a721a9ac6343fe279;Tue Jan 12 07:48:06 EST 2010;Committer;nobu;2;12;2;14;0
8f3f9d715f39ccafaa576b245865b70c272fc047;Tue Jan 12 07:41:40 EST 2010;Committer;nobu;2;20;4;24;0
a6b81a6b6ef32cce224bff019e11bbe8118daee9;Tue Jan 12 07:12:12 EST 2010;Committer;wanabe;2;6;1;7;0
b5227ae183ca7cf1a32d7daeafc2b7249f656a39;Tue Jan 12 05:56:28 EST 2010;Committer;naruse;2;39;3;42;0
4301bbbe0f115b7d7389d0b37e8c8bfcc9b2ab49;Tue Jan 12 05:54:47 EST 2010;Committer;usa;2;17;3;20;0
37ce3f6e0d7cbd97a82078beef12f68438cbdc86;Tue Jan 12 04:35:53 EST 2010;Committer;usa;2;9;1;10;0
33ede4d01ced3789d2c83bf82364389635c26a3c;Tue Jan 12 03:49:42 EST 2010;Committer;nobu;2;10;3;13;0
ca52e3be5cbfe5a78576028813784b1790411dc2;Tue Jan 12 01:00:34 EST 2010;Committer;usa;2;8;1;9;0
8001de14343b275b26470203f05f43cb9ede1d94;Tue Jan 12 00:59:27 EST 2010;Committer;akr;1;1;1;2;0
e1b928c59857f976efe421130f7c2e9ab6b746ef;Tue Jan 12 00:39:06 EST 2010;Committer;akr;1;1;1;2;0
853dd6cabe692251376271421be433d68bea2865;Tue Jan 12 00:32:22 EST 2010;Committer;akr;8;198;69;267;0
f86cca6f55ce0e9ec50bc1cb61718d02ebe31e10;Mon Jan 11 18:21:47 EST 2010;Committer;akr;1;1;1;2;0
05c4d8b9f46d1f6aad28ac97d89a043f2cefe4c8;Mon Jan 11 18:15:27 EST 2010;Committer;svn;1;2;2;4;0
7c6df6dc170a7e44c749518b06b0a4877f48c6ca;Mon Jan 11 18:15:25 EST 2010;Committer;akr;1;16;0;16;0
217a4bd2838f2daab8ec9b812317a40ae7a16ab4;Mon Jan 11 13:58:59 EST 2010;Committer;knu;2;22;2;24;0
8c801be9bf3ad71e2f24f665978bd209a45f13c0;Mon Jan 11 13:42:56 EST 2010;Committer;knu;1;1;0;1;0
f60a5d6f46544539e3b228fc86f13aca03abdc5d;Mon Jan 11 09:39:14 EST 2010;Committer;wanabe;1;1;0;1;0
760f0b06476729184aec1715d8da21788e9c8be1;Mon Jan 11 09:33:37 EST 2010;Committer;wanabe;2;6;1;7;0
a3973ab1ba9fe5b836553ba39522307e29929976;Mon Jan 11 07:58:26 EST 2010;Committer;naruse;3;13;0;13;0
6dcd551a4b74f82102f1ce0689b0ef9e12b03f9d;Mon Jan 11 04:30:37 EST 2010;Committer;nobu;3;12;4;16;0
19c6e24021814d01acab93680069694f9f6829b4;Mon Jan 11 03:58:43 EST 2010;Committer;svn;1;2;2;4;0
af23025d77b112a2c5db1735b674b87e81965569;Mon Jan 11 03:58:39 EST 2010;Committer;knu;3;15;5;20;0
73cd7b6697849b563a0154907b8a61c43e4ba209;Sun Jan 10 09:33:47 EST 2010;Committer;shyouhei;6;75;22;97;0
8d3498f94b4c8fe8620d023563abc606dddaca55;Sat Jan 09 22:11:35 EST 2010;Committer;tenderlove;1;33;0;33;0
655cb34f17c2dc4b84aaf3fa99cceabb830138b8;Sat Jan 09 20:35:28 EST 2010;Committer;nobu;2;10;1;11;0
b4da2534005f65087ddd0607963fdb4dbc71ce61;Sat Jan 09 19:54:38 EST 2010;Committer;nobu;2;6;1;7;0
01629be72989a4082ef66c2becf1ff215eb46230;Sat Jan 09 19:41:22 EST 2010;Committer;nobu;3;8;4;12;0
f3833630340c20575adcaeb5ef81b4ebc4f088b0;Sat Jan 09 05:21:26 EST 2010;Committer;usa;2;5;1;6;0
f01d580142aba329f10e713e5828bff45edcf8ac;Sat Jan 09 05:03:26 EST 2010;Committer;usa;2;5;1;6;0
dfa27de35e54e481c8e5f530df483ace102c4ab0;Sat Jan 09 04:37:53 EST 2010;Committer;naruse;1;3;0;3;0
9e72f9792775db5961106c9cb0125db9f10a1f96;Fri Jan 08 23:40:57 EST 2010;Committer;nobu;3;7;3;10;0
8e8bb6c17390e949d4a51c96aa901651a679458d;Fri Jan 08 14:40:38 EST 2010;Committer;mame;3;30;2;32;0
479a3c4c8b4d6c612a50a6cabab04921378a6f4b;Fri Jan 08 14:10:58 EST 2010;Committer;mame;3;35;1;36;0
e0cdab5fff0e57bdea2cb3237e5031dd69fbada5;Fri Jan 08 12:17:15 EST 2010;Committer;naruse;3;34;46;80;0
ef6e53635ab580214694a72f60133452f66a8827;Fri Jan 08 07:47:12 EST 2010;Committer;usa;2;28;2;30;0
902b1094655145946e6432f24d0f275123d59c26;Fri Jan 08 04:12:29 EST 2010;Committer;nobu;4;13;4;17;0
59a56629b5c6ebaca9bb9d0c24e841de4e4739b6;Wed Jan 06 22:58:13 EST 2010;Committer;svn;1;2;2;4;0
06925a095259693cb3850617e8e01cd1cb3b05d8;Wed Jan 06 22:58:07 EST 2010;Committer;ryan;4;106;42;148;0
74972dcc6f51c9eec9a8c7ffb39ba3f86346a33c;Tue Jan 05 17:58:54 EST 2010;Committer;svn;1;2;2;4;0
4aa0d9f5c3fc97864201c0436eb3b67ee3a59060;Tue Jan 05 17:58:52 EST 2010;Committer;akr;1;4;0;4;0
84c25ece867cb8f1688e2845db183e1eb9c123f9;Tue Jan 05 10:34:00 EST 2010;Committer;kazu;2;17;0;17;0
295bc2fe2577336807db6e2c30bd642bdb6482bc;Tue Jan 05 05:59:23 EST 2010;Committer;yugui;23;31;521;552;0
623a79c376fec2f76cc33819807f1903b40c3dea;Tue Jan 05 05:51:47 EST 2010;Committer;naruse;1;6;1;7;0
e0c3908d2b0f381645c3fe4d85e92f51a1b456ae;Mon Jan 04 17:08:05 EST 2010;Committer;svn;1;2;2;4;0
07146f375b3d8ce2d424f9f66ead0ab49c009914;Mon Jan 04 17:08:02 EST 2010;Committer;naruse;2;7;0;7;0
b80814c339bb90b01605f7d7753d12c2e0f8b615;Mon Jan 04 12:36:46 EST 2010;Committer;yugui;4;19;11;30;0
7e22f102a630b69a0ee6e54fd40b03878f6a8be1;Mon Jan 04 00:31:37 EST 2010;Committer;usa;2;5;0;5;0
dfc07e8aa705886baa9f8cf1eac628e5ff75b7be;Mon Jan 04 00:30:52 EST 2010;Committer;usa;2;8;0;8;0
9c9eb1e0ff2231038033766385163b9e9f1f61c9;Sun Jan 03 15:36:23 EST 2010;Committer;svn;1;2;2;4;0
72b199940d8a19d869bb9f0bb6065d15bbb030d7;Sun Jan 03 15:36:17 EST 2010;Committer;yugui;23;612;31;643;0
0e8fae89ab921e1be06ee7285c5e919e386a1b26;Sun Jan 03 06:37:40 EST 2010;Committer;yugui;2;6;1;7;0
2a2626406427b38abf85b01bda2805fa381689b4;Sat Jan 02 18:10:47 EST 2010;Committer;akr;1;2;2;4;0
7df00c688161931e53dd280b3a676b98969663f2;Sat Jan 02 16:31:04 EST 2010;Committer;svn;1;2;2;4;0
50b8893d56c33c74191039ca39d0e96cfd89302d;Sat Jan 02 16:31:00 EST 2010;Committer;akr;3;121;2;123;0
1dc1bf28abca649f1bf575982a12838593506d71;Sat Jan 02 07:03:24 EST 2010;Committer;akr;2;51;17;68;0
7aab2aad6e1858788a6b844298db5bd7465a0e73;Fri Jan 01 16:00:46 EST 2010;Committer;naruse;2;10;2;12;0
b7b82c25641dd52727368e21b8c4e348f0e787d8;Fri Jan 01 16:00:41 EST 2010;Committer;svn;1;2;2;4;0
17ff65205c1fe9634fea7b7ec5ddb767f3bf7235;Fri Jan 01 16:00:37 EST 2010;Committer;naruse;2;8;0;8;0
5ca2182b364dd094b1a769ac823f870dad40b547;Thu Dec 31 15:51:19 EST 2009;Committer;knu;1;1;1;2;0
ae563f61add39ce68850c66a233674b2b71852d9;Thu Dec 31 15:49:07 EST 2009;Committer;knu;2;7;2;9;0
35d90a7d3f9be82af19162325baee2379ce4dd7c;Thu Dec 31 15:00:08 EST 2009;Committer;svn;1;4;4;8;0
c0b4e90f08a188430c17e5668603704906292088;Thu Dec 31 15:00:04 EST 2009;Committer;akr;7;27;16;43;0
070489975d3a61aeebeedbc5a53d9a99197ca984;Thu Dec 31 09:19:05 EST 2009;Committer;usa;2;7;0;7;0
96abe7f35e3e03a861ea2b1bf7cc6e62a0615b3c;Thu Dec 31 05:22:11 EST 2009;Committer;usa;2;7;0;7;0
0ad3bee01fdf9eef74936dc159919945e268f3fa;Wed Dec 30 21:03:51 EST 2009;Committer;nobu;2;21;16;37;0
815fccb4dc075c44253b4b6d9d9114abfc0fba68;Wed Dec 30 21:01:13 EST 2009;Committer;nobu;2;5;8;13;0
1069e0f33569071d43dff77bdca1064a8acb1a0f;Wed Dec 30 20:56:41 EST 2009;Committer;nobu;8;67;56;123;0
6e4df2896f6b5ca801e330954e4a6dc1eb0fd571;Wed Dec 30 19:54:44 EST 2009;Committer;kazu;1;9;9;18;0
9f90682c4b60bf9788b94ccb107ac6b8a5cc5f7e;Wed Dec 30 18:30:36 EST 2009;Committer;usa;2;7;2;9;0
5bc85d62649d3484cab1adca0edbc514fa92aa6d;Wed Dec 30 17:36:20 EST 2009;Committer;usa;2;11;7;18;0
8de8d8b56249413ffb3a47a8b4cea6b69c125490;Wed Dec 30 16:58:51 EST 2009;Committer;nobu;3;13;7;20;0
b7a59cd17875f344b912b983eee876e2f6093e0f;Wed Dec 30 11:45:32 EST 2009;Committer;naruse;1;4;2;6;0
f9bef8b94490d8ab88d817ae3534bf516ce8429c;Wed Dec 30 10:44:10 EST 2009;Committer;naruse;2;5;0;5;0
9db87ea5b9c10b80f3e9f1bc83c78527ad137ef0;Wed Dec 30 10:44:02 EST 2009;Committer;naruse;3;18;6;24;0
499bf746da00eab7b0fc365bec0e791f1ca2b203;Wed Dec 30 08:59:16 EST 2009;Committer;nobu;4;16;34;50;0
270ece8441b26dbfbd0ca3fdcb70efec263791a8;Wed Dec 30 08:49:48 EST 2009;Committer;nobu;2;8;4;12;0
9004431714f2aec1fe3cbcf096f9424e87ca5429;Wed Dec 30 08:45:55 EST 2009;Committer;nobu;3;13;2;15;0
45b750149ae262f51f4376230a5746ea9d0859a2;Wed Dec 30 05:13:09 EST 2009;Committer;nobu;3;9;24;33;0
7ed0640ffb938fcf246f5167c7062fbf2a46dcd3;Tue Dec 29 07:05:39 EST 2009;Committer;naruse;7;67;27;94;0
92ab16fac66eeb9baba090af2976b27956ac56d4;Tue Dec 29 01:56:55 EST 2009;Committer;marcandre;1;9;4;13;0
cff7d0c80ed36a8e592ee4f596bbf1700eb8dca6;Tue Dec 29 01:36:26 EST 2009;Committer;nobu;5;20;4;24;0
3fb4d27a8d818508ab07cd3e74f1f5b89a3c2d55;Mon Dec 28 14:01:12 EST 2009;Committer;usa;2;24;20;44;0
26269cbd5d7827ecfba3df54e167a11076d6c59f;Mon Dec 28 13:01:28 EST 2009;Committer;nahi;2;69;0;69;0
7844ea1c64a008983f03d76d96ea6c061cbf7cb6;Mon Dec 28 09:14:14 EST 2009;Committer;yugui;2;8;7;15;0
55a70a94b4eab152a9a0c3b43ebee6b02aca3a38;Mon Dec 28 08:21:30 EST 2009;Committer;yugui;2;10;5;15;0
fbc79104a2a6c59d4a52d2f8123be7962e6b8851;Mon Dec 28 04:20:23 EST 2009;Committer;svn;1;2;2;4;0
d4c2172e02ddda417ee3679e97e88827e70fd00c;Mon Dec 28 04:20:19 EST 2009;Committer;yugui;2;21;0;21;0
b3c318bffd951d7ea4b35bbc2a3c8d6c6d190716;Sun Dec 27 01:51:54 EST 2009;Committer;suke;3;99;2;101;0
4d4ed5640c73f5be7920778b009b168beb10061e;Sun Dec 27 01:37:23 EST 2009;Committer;akr;1;11;0;11;0
568595b30f009902ba2af6ecc4776a652868169f;Sun Dec 27 00:44:11 EST 2009;Committer;yugui;2;18;12;30;0
fb15e010c03a66d3b2fa6d01e7b553cf35f46e30;Sun Dec 27 00:14:45 EST 2009;Committer;svn;1;2;2;4;0
f9f54fb5eb778093f6c0d4f8db83f467261ec5ec;Sun Dec 27 00:14:41 EST 2009;Committer;yugui;2;5;1;6;0
e9e2d5fffff9547e4d33538bf48ab574624c591d;Fri Dec 25 12:38:18 EST 2009;Committer;svn;1;2;2;4;0
cbfdacdd36159981544edaf540aa1611e2cc6a3a;Fri Dec 25 12:38:16 EST 2009;Committer;akr;1;4;0;4;0
dbb14e218a7c9dd9ad64fec0ae969cbb2d262f4c;Thu Dec 24 07:33:24 EST 2009;Committer;marcandre;2;6;0;6;0
c80535e50d9ad833d4027dd7bf1a1fc4708bc123;Thu Dec 24 06:21:14 EST 2009;Committer;naruse;2;6;2;8;0
ab2a02348b0c361644292906edc1573e4d44b0d9;Thu Dec 24 03:08:15 EST 2009;Committer;marcandre;2;12;1;13;0
cc58ec90b8739f7353e59fd4acebc3d79e949ce1;Thu Dec 24 01:32:04 EST 2009;Committer;svn;1;2;2;4;0
b3c3dda3f45e4354fc4cd2cfb55084a6b026cb61;Thu Dec 24 01:32:01 EST 2009;Committer;marcandre;2;6;1;7;0
e6a8408c2cc1639e9ca448d90372d4854947346c;Wed Dec 23 06:22:48 EST 2009;Committer;nobu;4;3;2;5;0
d3fc1d3e3a42d3105175eed71861cfa56b163ced;Wed Dec 23 01:31:37 EST 2009;Committer;nobu;1;3;2;5;0
99bf251b69fb05ecd139c1bab43f256b138aab73;Wed Dec 23 01:24:33 EST 2009;Committer;nobu;1;1;1;2;0
738515d12b8a0544bb6de9809b3edc9e2d9277f8;Wed Dec 23 00:14:48 EST 2009;Committer;nobu;5;16;19;35;0
da861d79b701ed24aa3a4e2f303fd00096359341;Wed Dec 23 00:12:33 EST 2009;Committer;nobu;3;9;7;16;0
833afaa2cc9c08b5a7ef314575301d4a9abd23a9;Tue Dec 22 14:02:14 EST 2009;Committer;svn;1;2;2;4;0
8d7677b49838726b724a6c72e30ae082b311872e;Tue Dec 22 14:02:13 EST 2009;Committer;akr;1;16;0;16;0
3da3230f0cb85bec3f62e13e8679e2255563b1c7;Mon Dec 21 10:12:21 EST 2009;Committer;naruse;3;11;0;11;0
35230b1a783b1d8655055e118fcaefaea3f53b52;Mon Dec 21 09:17:55 EST 2009;Committer;naruse;1;4;0;4;0
ebc695063134cca11629bb7bee1a689f0002d5b1;Mon Dec 21 09:13:28 EST 2009;Committer;naruse;2;6;1;7;0
de341005c80a43684e3704c8462de62c8d4bf431;Mon Dec 21 01:11:15 EST 2009;Committer;naruse;3;15;5;20;0
dbf07b09fda09f31fb5cbc43088c05a56b847ef7;Sun Dec 20 23:05:07 EST 2009;Committer;marcandre;2;14;1;15;0
4ea2a8f1d228f33462e7038e480b8ec3fa39ebe8;Sun Dec 20 17:47:05 EST 2009;Committer;svn;1;2;2;4;0
052f7f27f2ba3415162d5068958e46a3988e5e08;Sun Dec 20 17:47:02 EST 2009;Committer;mame;2;5;1;6;0
c8b20d0877a1c47c726f6128d98557ee6da09060;Sun Dec 20 14:20:46 EST 2009;Committer;mame;2;18;11;29;0
ff26cb82522398e09f13a6a1397c73d7d73f83d2;Sun Dec 20 12:31:31 EST 2009;Committer;svn;1;2;2;4;0
ae8dc9b72204679e78d6993f5cef8c5189b8b8d8;Sun Dec 20 12:31:26 EST 2009;Committer;mame;4;26;17;43;0
0208837f083422a68ff5df14d34fb1e4bcb82d2c;Sat Dec 19 08:02:51 EST 2009;Committer;matz;2;6;1;7;0
b85f2868330a0ef32ee0b5dcc5b71730ffac2fb0;Sat Dec 19 08:01:19 EST 2009;Committer;matz;2;6;1;7;0
fad1e8c7618153063abcbcdb44b045c68ea8d2e6;Sat Dec 19 02:07:00 EST 2009;Committer;marcandre;2;8;3;11;0
93278f2387fb2f9fe8157dd3ba537f248c558e46;Sat Dec 19 00:58:13 EST 2009;Committer;nobu;3;17;0;17;0
6a875fc7248724756aa0748889d6b40dc5b6f76c;Sat Dec 19 00:29:57 EST 2009;Committer;svn;1;2;2;4;0
a88cc058f00df2df4fc12bc245a936521015b2fe;Sat Dec 19 00:29:54 EST 2009;Committer;marcandre;2;14;2;16;0
25bccc44d4710f839fb257d21ce2ca59249e4ba0;Thu Dec 17 19:37:59 EST 2009;Committer;svn;1;2;2;4;0
eadda0002ab439520dd2af85a4cdbcb3df702eb4;Thu Dec 17 19:37:54 EST 2009;Committer;tenderlove;1;1;1;2;0
412da9c039b1234005ab575c7212a207fbc1767a;Wed Dec 16 21:08:27 EST 2009;Committer;svn;1;2;2;4;0
08c7cde986e23fc84bd9a7ff503f5ace347b4f01;Wed Dec 16 21:08:25 EST 2009;Committer;tenderlove;1;31;0;31;0
f4109ec1c71308a2aa80a92fdf28be2f75c4d75c;Wed Dec 16 11:29:54 EST 2009;Committer;kazu;2;5;1;6;0
6547a2bcbb5aa462984774854e8e8aa4268bec1e;Wed Dec 16 07:58:01 EST 2009;Committer;nobu;2;5;0;5;0
db9e8351f3502651b40de1215367d32498412054;Wed Dec 16 02:21:59 EST 2009;Committer;eban;2;6;1;7;0
6aafca91dba6ef3bfe1de2bedadf77fe75b17ef4;Tue Dec 15 17:21:09 EST 2009;Committer;akr;1;46;0;46;0
79933d6669b0afe72b12a948193b7350bfa06fa6;Tue Dec 15 15:54:37 EST 2009;Committer;svn;1;2;2;4;0
9ab779aad1484a25ab1b9b0d16b35ff8064a7f53;Tue Dec 15 15:54:34 EST 2009;Committer;akr;2;8;3;11;0
d698bd8ad04fb7a56a777e8494ed9eb76a1c7ddf;Tue Dec 15 00:16:48 EST 2009;Committer;usa;1;35;23;58;0
36863793fd53818c84b91128a642a3d81566dbd7;Tue Dec 15 00:06:41 EST 2009;Committer;svn;1;2;2;4;0
0d9340f2236f54a89e795569f19bb6d6468eed81;Tue Dec 15 00:06:36 EST 2009;Committer;nobu;2;5;1;6;0
779aba2d01f0cdef77fb34db0199397b67f5088b;Mon Dec 14 13:34:09 EST 2009;Committer;akr;2;5;1;6;0
92e9bf7a59acf3b625b6ae7e2020a49336213856;Mon Dec 14 12:50:13 EST 2009;Committer;akr;3;25;11;36;0
4df4a7430865257795938c3dd791e3c0afee8778;Mon Dec 14 11:56:03 EST 2009;Committer;akr;1;52;0;52;0
315cab1249095a228482d57bc30bea2aabf4ca0f;Mon Dec 14 03:19:51 EST 2009;Committer;naruse;1;1;1;2;0
cc744ef9b8637e053a8cc6254ee123aea39780b0;Mon Dec 14 00:20:56 EST 2009;Committer;nobu;2;5;7;12;0
b3ea5a1789bdb9b52aaa7e37bfbab89094ef0f06;Sun Dec 13 22:48:13 EST 2009;Committer;akr;1;13;0;13;0
3f07a79c9cd88a50d5ba7ec5b4299e2482258016;Sun Dec 13 16:00:34 EST 2009;Committer;svn;1;2;2;4;0
8dc14638eaab3f03a9ad504af4c6ea96b91181a1;Sun Dec 13 16:00:33 EST 2009;Committer;akr;1;92;0;92;0
c48a4c293650efe407049e6aceed53fcd35a741b;Sun Dec 13 14:48:54 EST 2009;Committer;akr;2;17;16;33;0
f62310ac626f8fd729a066ba5f31619bf3d15f56;Sun Dec 13 14:08:37 EST 2009;Committer;naruse;1;1;1;2;0
71ab182911602baa7facb1ffc71146ce8d376938;Sun Dec 13 11:56:37 EST 2009;Committer;akr;4;9;4;13;0
77088d667223ceb5b964324300d8c9a979ac8076;Sun Dec 13 11:29:33 EST 2009;Committer;naruse;2;8;3;11;0
42933da428a94f55fb4ad75effb31dd8306b06b2;Sat Dec 12 16:35:12 EST 2009;Committer;svn;1;2;2;4;0
07f81c06ca565a25044276bb10833ab15eacf8e0;Sat Dec 12 16:35:10 EST 2009;Committer;naruse;2;14;0;14;0
190507ce0cae7fc6f7f41d1a8bae737abb4c1445;Fri Dec 11 07:47:31 EST 2009;Committer;svn;1;2;2;4;0
0676ac37bee1d66d6e06fe4cf8d0362b42d0bf97;Fri Dec 11 07:47:29 EST 2009;Committer;usa;1;5;1;6;0
b32ee85f97597e1cb13b568dff15ee9a6d9de1ba;Thu Dec 10 11:59:12 EST 2009;Committer;duerst;6;149;8;157;0
136c25ebf035c62933c248b5f833463466021541;Thu Dec 10 10:26:55 EST 2009;Committer;akr;1;1;1;2;0
e82e2beb7c2a10a0f9dc73f0356f2cc2a02bfd66;Thu Dec 10 10:13:03 EST 2009;Committer;akr;1;1;1;2;0
9071538179bf318ffb6f112b40e4f4fd17704cec;Thu Dec 10 08:24:11 EST 2009;Committer;shugo;3;5;6;11;0
4ba0fe5fd3d12f9918cc84302239bf0e978844a2;Thu Dec 10 06:49:15 EST 2009;Committer;nobu;3;14;2;16;0
9689308994d3d5537dfc8b798a76c757c283d6ad;Thu Dec 10 05:19:11 EST 2009;Committer;nobu;1;38;1;39;0
614a8427ce87a16844a8c4f961085877ebfcfe20;Thu Dec 10 03:59:34 EST 2009;Committer;naruse;2;36;13;49;0
ae76a2323e062869f9235c7a23627d427127a9f2;Thu Dec 10 03:46:08 EST 2009;Committer;naruse;1;2;8;10;0
e5dc8988af97526c5831bd347358ad2795a0834e;Thu Dec 10 00:26:41 EST 2009;Committer;naruse;3;6;2;8;0
770b05dd9b4cbe434c4d29aba28a66ed79e4d0b1;Wed Dec 09 16:12:57 EST 2009;Committer;nobu;3;26;4;30;0
7cd9a5d363a74800a5043586e7fc908aaa3e6025;Wed Dec 09 15:46:45 EST 2009;Committer;nobu;3;14;8;22;0
38828fa8d1d0a072885da81f866e5f5146355a6f;Wed Dec 09 14:05:59 EST 2009;Committer;mame;4;942;1;943;0
c9c095fc7b56c40e4857c1554932a078eb7a316e;Wed Dec 09 00:50:37 EST 2009;Committer;nobu;4;16;4;20;0
0f406d278fce4909940ed52df2009b18fee2c22a;Tue Dec 08 14:53:55 EST 2009;Committer;usa;3;25;3;28;0
dd00d45244fd58fc1f5bf9c110bf48fb4ccf37b8;Tue Dec 08 14:41:17 EST 2009;Committer;usa;2;5;1;6;0
ed5d5c5829ccd91261b27438e2aa146f7aec755e;Tue Dec 08 07:19:09 EST 2009;Committer;nobu;33;6649;135;6784;0
6c0f2b097edabefd7ab8dfa1c36128de8febbe99;Tue Dec 08 07:16:49 EST 2009;Committer;nobu;2;6;5;11;0
1963713205b4421c06baa1fc198332f896c219a9;Tue Dec 08 01:01:04 EST 2009;Committer;nobu;5;560;101;661;0
507f700dd446d6e20d4859308a67ab77a5821e53;Mon Dec 07 19:06:11 EST 2009;Committer;akr;1;5;6;11;0
3512a38d3be382aa4be162251ceb9222a7f66a83;Mon Dec 07 18:51:42 EST 2009;Committer;akr;2;36;31;67;0
f3b8aa1a60ac3e2049152c9a8da3635dc1361ee1;Mon Dec 07 16:53:35 EST 2009;Committer;svn;1;2;2;4;0
785191b12d23830480a75635275dadf30f4724d9;Mon Dec 07 16:53:34 EST 2009;Committer;akr;1;22;0;22;0
1d10aa8bfc98a42522716f71aae60cb70498a6e6;Mon Dec 07 05:11:10 EST 2009;Committer;nobu;4;25;13;38;0
1c2ef610358af33f9ded3086aa2d70aac03dcac5;Mon Dec 07 04:11:26 EST 2009;Committer;yugui;2;40;28;68;0
753de85e40bf400f4cabeee07ab6923bb6e466b9;Mon Dec 07 00:49:09 EST 2009;Committer;tenderlove;2;23;0;23;0
241cd8c72bae01e042743b53d421412c2cbc8ac3;Sun Dec 06 22:35:46 EST 2009;Committer;svn;1;2;2;4;0
553b55f6e641862e541ca26b69c846fb9608d1fe;Sun Dec 06 22:35:45 EST 2009;Committer;marcandre;1;24;28;52;0
c121f78b9a5e264c4817fe99320a18d58c007bb7;Sun Dec 06 14:55:22 EST 2009;Committer;naruse;2;5;1;6;0
5e795ef8f6bf38d97188b989b0f6e46a66b63c57;Sun Dec 06 14:17:33 EST 2009;Committer;akr;2;10;2;12;0
89214aac7a140878bae93c183040c56d62158fe4;Sun Dec 06 09:01:50 EST 2009;Committer;akr;1;1;1;2;0
604f01f2b87d9f75464e5705fa94def5aec18b03;Sun Dec 06 07:04:50 EST 2009;Committer;naruse;2;6;1;7;0
ee68e2685935c15684379df67b202d3a8f2f1c59;Sat Dec 05 15:38:24 EST 2009;Committer;azav;1;5;0;5;0
fdf5d6dad4d79da92ae1abfa3598cd12f20ebbed;Sat Dec 05 15:37:47 EST 2009;Committer;svn;1;2;2;4;0
0a457ee0b7f50af0f1a8bb30f1474066201064a8;Sat Dec 05 15:37:46 EST 2009;Committer;azav;1;1;0;1;0
11aa6c4107390e581f7a6d9bcc74072fc717f13f;Sat Dec 05 10:25:28 EST 2009;Committer;nobu;1;1;0;1;0
1cc1ea378a0912bfcbe55399369da47a724427aa;Sat Dec 05 06:35:07 EST 2009;Committer;nobu;4;75;1;76;0
7b154ee93e66ab894e68080a6fa3b5ae6f14f93e;Sat Dec 05 05:45:29 EST 2009;Committer;nobu;1;6;4;10;0
276653a6f5731942db7bd9b4f1220781aa24301e;Sat Dec 05 04:19:31 EST 2009;Committer;nobu;2;5;0;5;0
b271ca8c62f7f8a81c9b1d05dbf710b9ca0828a4;Sat Dec 05 01:18:28 EST 2009;Committer;nobu;2;16;11;27;0
8237d170eec6daedbf8651bc44709612369cee6e;Fri Dec 04 23:21:03 EST 2009;Committer;svn;1;2;2;4;0
6a1aebaabf9653e2178e8d887632c4c5802189d8;Fri Dec 04 23:21:01 EST 2009;Committer;tenderlove;2;6;0;6;0
beb486d55e90328a825b7dee7dec39b87182fa10;Fri Dec 04 10:53:21 EST 2009;Committer;matz;2;7;0;7;0
826aa8c376adabddf012b0858d12398a95a262db;Fri Dec 04 08:34:16 EST 2009;Committer;nobu;1;32;32;64;0
9ad065375f171ea37979d31ef725323b3b7414e9;Fri Dec 04 07:50:15 EST 2009;Committer;nobu;3;15;5;20;0
2c2cf71b048e42950d5d5f79fe78bc9fea0df158;Fri Dec 04 07:37:10 EST 2009;Committer;matz;2;12;2;14;0
4cec4edd0bf2361a1769d108c910c4710e3c290b;Fri Dec 04 07:09:21 EST 2009;Committer;shugo;2;2;2;4;0
6ac5764dd5f48dc7ee7abb88eb3eba3378d839cf;Fri Dec 04 07:09:19 EST 2009;Committer;shugo;1;5;0;5;0
78b2714b609ade53f5d1054f89289aef1a77a74b;Fri Dec 04 07:09:17 EST 2009;Committer;shugo;1;6;1;7;0
39802186b2135cce68882770aa36dc09ad6cb311;Fri Dec 04 04:14:37 EST 2009;Committer;nahi;3;9;5;14;0
d5e1b514f9113ac0f706bb46b8a20a1dd5ec7390;Fri Dec 04 00:15:26 EST 2009;Committer;tenderlove;1;5;3;8;0
3e3f66e4822905d15787d02ebbe80bb7015d96f2;Thu Dec 03 18:26:01 EST 2009;Committer;svn;1;2;2;4;0
7dbfe89630f429255ae346cd02d7ca7d2d109650;Thu Dec 03 18:25:57 EST 2009;Committer;shugo;10;105;22;127;0
9998481d4efaf86dde652617ed3b2777924c3373;Thu Dec 03 11:29:33 EST 2009;Committer;duerst;3;48;2;50;0
342ed0ab03b951916cf77058f2e09c0e887cfdc2;Thu Dec 03 03:04:29 EST 2009;Committer;svn;1;2;2;4;0
f28a0b6b98592eba4bfc6a7c80e12be6d8c1a93e;Thu Dec 03 03:04:27 EST 2009;Committer;tenderlove;1;23;0;23;0
0f0a744ed6db1d0fb7069a24860ff86b60b9fa79;Wed Dec 02 14:54:53 EST 2009;Committer;svn;1;2;2;4;0
46e086910e8d8d5a344e80034344ebbba1433cff;Wed Dec 02 14:54:50 EST 2009;Committer;nahi;2;8;0;8;0
115fa14f28b164e5ea557b36fb3a4072f52c654d;Tue Dec 01 09:03:29 EST 2009;Committer;nahi;2;84;2;86;0
8f6cdd79274a40ffb4e59d7dbc95e8aeedd3f357;Tue Dec 01 03:01:15 EST 2009;Committer;nobu;2;49;28;77;0
79446bfb70fdbfb20ea63ce4d817f1d7c4812c0a;Mon Nov 30 21:51:08 EST 2009;Committer;nobu;2;5;2;7;0
9b02e165d3a0618fb5f0cefd55a30fb327ad3a5f;Mon Nov 30 21:16:31 EST 2009;Committer;nobu;4;77;41;118;0
53e884f32d47739185fc98ab0f150394bd906beb;Mon Nov 30 07:57:47 EST 2009;Committer;nobu;2;5;1;6;0
7b5ea0ec2f6c4f016e14cf6b61544f9e58d07beb;Mon Nov 30 07:54:26 EST 2009;Committer;nobu;5;25;4;29;0
9713d84b5b0f248cdc9147a3b05d6749c28bfef8;Mon Nov 30 05:12:48 EST 2009;Committer;tenderlove;3;113;0;113;0
b19b496248cc71f6454dd153bc84a0b86e62de89;Mon Nov 30 02:00:14 EST 2009;Committer;nobu;3;21;4;25;0
c52a8112b21557bbfe6cde831062f3ad4085774b;Sun Nov 29 18:28:02 EST 2009;Committer;svn;1;2;2;4;0
d9d01d03e7f8175ad52b2c5000610de1ab6889b4;Sun Nov 29 18:27:57 EST 2009;Committer;tenderlove;1;1;1;2;0
dd7264ac697ddb305780d7aa51908db392214906;Sun Nov 29 07:56:25 EST 2009;Committer;nobu;2;5;1;6;0
060f16e2fac4c63838a586854df742e0de4b4c32;Sat Nov 28 21:41:02 EST 2009;Committer;svn;1;2;2;4;0
197eea3404169141abd79d6edcd38291d8aa983b;Sat Nov 28 21:40:59 EST 2009;Committer;tenderlove;3;28;1;29;0
d05112b942c5bbdcbb71201e6c209676f2da7915;Sat Nov 28 00:26:30 EST 2009;Committer;svn;1;2;2;4;0
be21eb5d0f362bd9ec2922b590c84b7e87592a6c;Sat Nov 28 00:26:27 EST 2009;Committer;matz;2;8;3;11;0
3f664b30fc72dde0197d29dde7ad31d9a0e1535a;Thu Nov 26 14:32:15 EST 2009;Committer;akr;1;28;0;28;0
25caa12d1d456746da2e8c2ee61e398dba9c135b;Thu Nov 26 12:18:40 EST 2009;Committer;yugui;3;12;2;14;0
cdecafff8dde562debf8cf8a8f9e0e0a9752b6f8;Thu Nov 26 12:18:22 EST 2009;Committer;yugui;2;15;0;15;0
2c3a48614a49e5021cbe5cccff00e6464a1d4e21;Thu Nov 26 12:18:04 EST 2009;Committer;yugui;2;20;0;20;0
21c32a3c7a64bed2379b3c2d31e832748467df0f;Thu Nov 26 12:17:47 EST 2009;Committer;yugui;3;72;0;72;0
303b1d7fad17f3b8a1816eea12e04d72f044b0ce;Thu Nov 26 11:22:44 EST 2009;Committer;naruse;2;33;26;59;0
39e457b4e7896bf857b88b361dc0202ba3327961;Thu Nov 26 08:55:34 EST 2009;Committer;usa;4;20;1;21;0
4d786d21e3e80a70554c3fed7aa39e8ec7922b44;Thu Nov 26 05:25:08 EST 2009;Committer;nobu;15;35;35;70;0
f1be083f0964ca59c1d38c4b145313e51ca09a90;Thu Nov 26 02:42:24 EST 2009;Committer;nobu;2;5;2;7;0
12b637a65d95b6134930bb0f9df0a3979a6a34bb;Wed Nov 25 22:27:44 EST 2009;Committer;wanabe;2;5;0;5;0
c5dd8feb296b83d6040fff6057006bc22ffe4785;Wed Nov 25 15:08:09 EST 2009;Committer;svn;1;2;2;4;0
c7b0dbd002b3f5fcf3f6a5cf45f4cc877830da15;Wed Nov 25 15:08:06 EST 2009;Committer;nahi;2;72;0;72;0
fe976467437ade210d7b405614f8b8ac37aa31d7;Wed Nov 25 11:47:19 EST 2009;Committer;akr;2;18;9;27;0
e6f670242ce1ea6ebb56aa65b2b5631d9aaff0da;Wed Nov 25 10:31:58 EST 2009;Committer;knu;2;19;4;23;0
80b54214b288a7442d93a7b1e39311c3ce8b9f56;Wed Nov 25 10:28:45 EST 2009;Committer;duerst;2;7;0;7;0
1adc3d1c4f6d06b55382d8313812119a9db60427;Wed Nov 25 04:10:00 EST 2009;Committer;svn;1;2;2;4;0
d3eb0057379ec1c5467dd6bdc006e4f4176e065f;Wed Nov 25 04:09:59 EST 2009;Committer;usa;1;2;1;3;0
9585749e8eee4bb5bb0a52e0aea2716746f9d90c;Tue Nov 24 13:59:10 EST 2009;Committer;akr;2;6;1;7;0
b317738edc3072bd0d4f92992c93267bb00abb93;Tue Nov 24 13:33:44 EST 2009;Committer;mame;2;8;4;12;0
8f5865e25163ca82b9608af58498e72f038f593f;Tue Nov 24 12:26:06 EST 2009;Committer;akr;2;6;2;8;0
54370de9f4c01ba43752057b602bafc5be293665;Tue Nov 24 11:34:45 EST 2009;Committer;akr;4;28;7;35;0
db1564ec1d48dd2e898c7ca11eed523e92c78f46;Tue Nov 24 11:06:53 EST 2009;Committer;akr;2;27;0;27;0
ff9d9088329fc8270d1d9b89faf9187c33a854ac;Tue Nov 24 11:03:51 EST 2009;Committer;akr;6;52;25;77;0
f6fbdf261e30763a6eb23ede963d555f16806b15;Tue Nov 24 01:30:00 EST 2009;Committer;usa;1;6;1;7;0
c796b348c6b4ce35a1dc4808881cd6177f3dfa96;Tue Nov 24 01:20:18 EST 2009;Committer;naruse;2;6;2;8;0
d7ffefb4059f95279f084d26ab04d92c7eb89975;Tue Nov 24 01:00:02 EST 2009;Committer;nobu;3;6;2;8;0
3861ba9f499af64f0677cae0e84c7c00dd70e484;Tue Nov 24 00:50:26 EST 2009;Committer;akr;2;7;1;8;0
612c9cd8e3a040d88507b9ae060e668693538a4c;Tue Nov 24 00:26:55 EST 2009;Committer;svn;1;2;2;4;0
3302b8fff571bfac2ac26376586d257f29fa44b3;Tue Nov 24 00:26:52 EST 2009;Committer;akr;5;45;14;59;0
a80eb26a188db79decadb82a459754c344dcf5a5;Mon Nov 23 07:06:54 EST 2009;Committer;nobu;2;15;7;22;0
5a7c9df5b5af15a1dff214af787a4dbfbd96b3c5;Mon Nov 23 02:26:47 EST 2009;Committer;nobu;2;5;4;9;0
be8326b2e0e8702100d4c667ee749c8d28aed6f4;Mon Nov 23 01:55:17 EST 2009;Committer;nobu;1;1;1;2;0
5f9a6d1dee33e015f8750f38c46844047d9768b9;Mon Nov 23 01:52:21 EST 2009;Committer;nobu;2;10;7;17;0
cd4a0ce764b6b2f378deb17cf69a13eddea85563;Sun Nov 22 19:15:58 EST 2009;Committer;svn;1;2;2;4;0
cc128e3ecfba3a2eae56fcd5e4bccc16b27551b3;Sun Nov 22 19:15:55 EST 2009;Committer;akr;4;37;15;52;0
5181fa2a558ca99fc2185475d540b36f9680532d;Sat Nov 21 09:49:30 EST 2009;Committer;akr;2;26;10;36;0
75090a663baed0c88d905ed1f45feefc301c2e55;Sat Nov 21 07:38:51 EST 2009;Committer;nobu;3;16;2;18;0
8f05568afb57e733196408a500cfd9c48fb88fac;Sat Nov 21 07:03:06 EST 2009;Committer;naruse;3;13;1;14;0
10aaddb811afb5501178eb64c0cefbcd95cd0635;Sat Nov 21 05:45:51 EST 2009;Committer;svn;1;2;2;4;0
07ae16d18cd08c77b163f23d8fd4ffe52b1cc769;Sat Nov 21 05:45:48 EST 2009;Committer;naruse;2;13;7;20;0
0089bfe4ddf38e517e8e76cc3f721ed53c66d76d;Fri Nov 20 12:17:29 EST 2009;Committer;akr;2;5;1;6;0
c9fc0ff39acdb336074cc21f33b947f83d94c2a2;Thu Nov 19 22:47:54 EST 2009;Committer;svn;1;2;2;4;0
34286de2e28f9dd7665897904f92a1883ac3c2b9;Thu Nov 19 22:47:53 EST 2009;Committer;akr;1;53;54;107;0
64e6f141fa676483b7dceb793d784d242d3def1f;Thu Nov 19 14:21:05 EST 2009;Committer;shugo;2;11;2;13;0
62f1364742aa08859813e940c7647663936a4f77;Thu Nov 19 13:56:34 EST 2009;Committer;shugo;1;8;0;8;0
718ceb5476117f6280e428d28658296f808f90fe;Thu Nov 19 13:56:23 EST 2009;Committer;shugo;2;87;1;88;0
ffffc0ce7d21756729f3b2690e39a4f2ff6300f4;Thu Nov 19 11:44:29 EST 2009;Committer;usa;2;8;0;8;0
e569adce47b97c12e3cae67efd76121fa5a0c437;Thu Nov 19 08:04:11 EST 2009;Committer;usa;2;7;2;9;0
19687171365b09d5fce7e5a993334924731e4d98;Thu Nov 19 00:56:44 EST 2009;Committer;usa;1;8;5;13;0
2038c0f360f3fcae967f3966a54dc51e49013469;Wed Nov 18 17:52:12 EST 2009;Committer;akr;2;58;6;64;0
8d6b4e18075d970aec3d25b1d7fcdf6c19eb68b2;Wed Nov 18 15:47:44 EST 2009;Committer;svn;1;2;2;4;0
973841cb73ae6bb41f15325400493ad7680bb67a;Wed Nov 18 15:47:41 EST 2009;Committer;akr;2;9;5;14;0
1e7f2caa1f4f823d128261df4441c9e30236bc4a;Wed Nov 18 13:02:28 EST 2009;Committer;akr;1;31;0;31;0
4c6eda226aeee4896c3dfc1ca6c2cacfc9788d27;Wed Nov 18 13:02:14 EST 2009;Committer;akr;2;48;25;73;0
817f503001e1e802f8129a5a52cf378f2042c24d;Wed Nov 18 09:39:59 EST 2009;Committer;nobu;1;1;1;2;0
a000201fee156c783a85c5daa92bce0a721fb522;Wed Nov 18 09:25:46 EST 2009;Committer;nobu;2;4;0;4;0
748fe216c26cd7d7d7f4125339c26bf93aff690e;Wed Nov 18 09:25:11 EST 2009;Committer;nobu;3;26;0;26;0
e8c17f1a59e298b336728de8f6b3497c9b13885a;Wed Nov 18 08:48:24 EST 2009;Committer;nobu;2;23;0;23;0
4bfd1339935961b957e08634b623c5080458f678;Wed Nov 18 06:28:19 EST 2009;Committer;usa;2;8;3;11;0
a7db2c1efdbf8fc96d06f4b5692d93941ccec606;Wed Nov 18 03:38:20 EST 2009;Committer;naruse;4;37;5;42;0
a1c4d60560e76e49a5825d35a40b8a6c32438afa;Wed Nov 18 03:06:32 EST 2009;Committer;takano32;2;8;4;12;0
6c2373ea6758040ecc2607395adad03f98d01308;Wed Nov 18 02:41:25 EST 2009;Committer;naruse;3;39;21;60;0
612b74343e353799fb4ac2a33b202ae55665306f;Wed Nov 18 01:17:11 EST 2009;Committer;nobu;2;8;3;11;0
4e073fbb93ea74a14c617127eeee928634aa875d;Wed Nov 18 01:14:54 EST 2009;Committer;shugo;1;37;0;37;0
63c3b2d283a482b96b20fa8d78f3098786123a68;Wed Nov 18 01:13:54 EST 2009;Committer;shugo;2;10;0;10;0
e43c0bde5323c9dcd27ba284c1bdc7f11fa313ac;Tue Nov 17 23:41:44 EST 2009;Committer;nobu;3;10;0;10;0
932591003708aac785a1e71ed6beb83e91554320;Tue Nov 17 23:41:09 EST 2009;Committer;nobu;1;43;43;86;0
8d84e28c0ef99b97ce0143ebd80290c6dc71c305;Tue Nov 17 22:52:05 EST 2009;Committer;svn;1;2;2;4;0
cde9a50b7528d3b400b9f966b28919ec3ab6ea86;Tue Nov 17 22:52:02 EST 2009;Committer;akr;2;8;1;9;0
86d46b5459cda15a616e29934b1ddfe4ec788735;Tue Nov 17 14:53:32 EST 2009;Committer;shugo;3;22;1;23;0
10b7e0e4adc7c2beb13b30a53ac2bdc03ab50d22;Tue Nov 17 13:24:53 EST 2009;Committer;akr;1;1;1;2;0
85bf0a2eb62e17640644c42c5d37dee90a75ad29;Tue Nov 17 13:24:44 EST 2009;Committer;akr;1;1;1;2;0
e0436c54c21343580d5fa6b9334fbfa20e10c646;Tue Nov 17 08:56:11 EST 2009;Committer;duerst;5;19852;1;19853;0
fab47c96c50ad7c679e77e4ac86f6fb9137a427f;Tue Nov 17 08:18:52 EST 2009;Committer;nobu;1;2;5;7;0
9e68d0dc03456fe6c074143c3b14aef3d4a7b565;Tue Nov 17 07:26:26 EST 2009;Committer;nobu;3;12;5;17;0
5a8c6a5c93a79bedb1b859461396ef2037aef18b;Mon Nov 16 17:27:07 EST 2009;Committer;svn;1;2;2;4;0
8f90252c5250b086309be9c613cc231fe2475706;Mon Nov 16 17:27:05 EST 2009;Committer;tenderlove;7;231;0;231;0
31ee9fd9666986451a7709e77978efb1b3f063f6;Mon Nov 16 13:45:59 EST 2009;Committer;akr;2;152;84;236;0
3dc8a69df7617377bbece579c6e1abf87df85299;Mon Nov 16 07:01:44 EST 2009;Committer;shugo;4;36;2;38;0
98cf9c43fa18bf0874af47b9d1b4933981ea456d;Mon Nov 16 05:06:16 EST 2009;Committer;wanabe;2;13;1;14;0
ca7b32630c7c884fb057916e488a146476768f37;Mon Nov 16 04:02:20 EST 2009;Committer;ryan;1;4;3;7;0
36ed53ff93d728a31764ebb0e553d5b8432eba3b;Mon Nov 16 03:01:59 EST 2009;Committer;ryan;1;3;4;7;0
8c3f13f98d8d2280f1799d5e2e58260bb9eb71c1;Sun Nov 15 23:57:00 EST 2009;Committer;akr;1;4;4;8;0
d8a754cc12bcf43361608d117e21dd1cc942b671;Sun Nov 15 23:11:26 EST 2009;Committer;wanabe;2;17;2;19;0
5f221c31edaa2dc6bc23b7d7d2cff1393cc4ad6a;Sun Nov 15 17:58:14 EST 2009;Committer;akr;1;17;1;18;0
e88009f40e93cbd33610266aa433dec6a8794f1b;Sun Nov 15 17:14:43 EST 2009;Committer;akr;1;10;0;10;0
453890a97296d9e342384832bffad5af031d0bca;Sun Nov 15 17:11:54 EST 2009;Committer;akr;3;38;11;49;0
9ea0bed1a35df2458990ab4daf2cb4982d7c2a83;Sun Nov 15 16:59:31 EST 2009;Committer;mame;2;5;0;5;0
1aba3f9d76110311ac538a56203f035559643953;Sun Nov 15 16:37:38 EST 2009;Committer;akr;3;10;2;12;0
43bd807c43d25b31b29c6225b7d0f8ca6e67e40d;Sun Nov 15 16:24:45 EST 2009;Committer;akr;2;83;22;105;0
f5936bc8351bda72ee852456c4565384969fe688;Sun Nov 15 15:10:52 EST 2009;Committer;svn;1;2;2;4;0
31c0e3385f6b46390b4a44618d443819550467b7;Sun Nov 15 15:10:49 EST 2009;Committer;mame;3;32;0;32;0
4a761c320932ee03b5386d68411737f7fa7bd3e2;Sat Nov 14 12:56:16 EST 2009;Committer;mame;3;16;3;19;0
85ca612b135c1ed47cc01be48e21f20fc7bd9ffc;Sat Nov 14 08:09:41 EST 2009;Committer;nobu;2;8;0;8;0
de13a30d32943b2aa3eb45c2b84eaa8902c09f4b;Sat Nov 14 07:43:26 EST 2009;Committer;nobu;2;32;1;33;0
c07e7d167d57492ff5dfaa495537d6bb9776062e;Sat Nov 14 00:17:07 EST 2009;Committer;marcandre;3;25;9;34;0
d71eab14fb5a711f43957aeb27ebad06af050193;Fri Nov 13 19:11:32 EST 2009;Committer;nagai;2;7;4;11;0
9a875d3aa1bc6a52d35cfade4cf34ed6a02b9ed6;Fri Nov 13 18:36:41 EST 2009;Committer;svn;1;2;2;4;0
cbad6bc357cf51a3f42115b8dd66db13068f3602;Fri Nov 13 18:36:38 EST 2009;Committer;nagai;2;7;2;9;0
f22a307d7e137e8fd43e202a7ad731b8505e5f2a;Fri Nov 13 12:19:08 EST 2009;Committer;mame;2;5;1;6;0
9ba317f1575bba7d21b4644fa0bee85e2a57c4f4;Fri Nov 13 07:22:04 EST 2009;Committer;nobu;2;6;3;9;0
9a9cc65035b7b6c06e4990fe2563580ceeb92a1b;Fri Nov 13 07:19:59 EST 2009;Committer;tenderlove;2;5;5;10;0
29f982738e0703c316ff124f66e92791c13f2376;Fri Nov 13 02:09:33 EST 2009;Committer;nobu;2;6;2;8;0
17ccd5d013fa7ffd612aea4c9babdfb37fec213d;Thu Nov 12 22:41:07 EST 2009;Committer;tenderlove;2;2;1;3;0
d109e9a67fde86e1b3dc1cebdea318355c5c8a1b;Thu Nov 12 15:48:48 EST 2009;Committer;svn;1;2;2;4;0
5de99652bd368ea2876357b626428f66dd193e14;Thu Nov 12 15:48:46 EST 2009;Committer;xibbar;2;6;1;7;0
f97d8eec10ff0843522dc37467e209b6f27c7c6b;Thu Nov 12 14:53:35 EST 2009;Committer;xibbar;1;1;5;6;0
64486dfd8e8161e6864f039a0089c4a79bf4e2d2;Thu Nov 12 14:19:53 EST 2009;Committer;xibbar;2;6;5;11;0
bed9e8e297f2ba77b8a8ce45748804697fd9bfe1;Thu Nov 12 14:03:03 EST 2009;Committer;xibbar;2;6;3;9;0
9e0f3e0db9579d4271981f0804ebfac7c4e4486b;Thu Nov 12 05:33:23 EST 2009;Committer;nobu;2;6;2;8;0
a7d63dfd2872cc0e80cb1d698d15778744fc58c7;Thu Nov 12 05:00:47 EST 2009;Committer;nobu;1;1;1;2;0
1d4183030db5824e745a901d625ad93af9ff2ec3;Thu Nov 12 04:57:39 EST 2009;Committer;nobu;4;12;9;21;0
a360a8ce853ac66b822ceaf4453128891f7f2f62;Thu Nov 12 04:31:02 EST 2009;Committer;nobu;2;22;13;35;0
5e5b4c08fcf0729aa0342dd3a002c38047ea1418;Thu Nov 12 01:26:13 EST 2009;Committer;naruse;2;6;14;20;0
55179696b20fade5a994d711b6fba9901eeb839d;Wed Nov 11 21:42:40 EST 2009;Committer;nobu;3;31;6;37;0
9a751c21e7151511762c81e78e5e2a39b30ff33e;Wed Nov 11 16:32:36 EST 2009;Committer;svn;1;2;2;4;0
61ec62386062c3e5010209b098938485b4d4d482;Wed Nov 11 16:32:34 EST 2009;Committer;mame;2;13;1;14;0
d9eae8001157b255307b6754737968db12b9c9ba;Wed Nov 11 10:17:36 EST 2009;Committer;nobu;3;10;2;12;0
3f5fbc6c34fa9a4e63e3892b7962692dff8d9159;Wed Nov 11 03:54:04 EST 2009;Committer;nobu;2;2;2;4;0
30de9f68eb9748a66aef6573af268fd512b86fe2;Wed Nov 11 03:53:27 EST 2009;Committer;nobu;1;4;0;4;0
dc9112dd7ae5ebc10f0a975b35baba4e83051bb2;Wed Nov 11 03:20:21 EST 2009;Committer;usa;2;22;18;40;0
914b36e3f9a9d3da7f5739518e8b0f814599daca;Wed Nov 11 00:36:04 EST 2009;Committer;nobu;2;9;4;13;0
6ebdf24500f845b76e42d9f2b715773ad51730d5;Tue Nov 10 23:34:03 EST 2009;Committer;akr;2;16;10;26;0
145f07fac22726cc4d11b35047ac44853a21d27b;Tue Nov 10 23:23:15 EST 2009;Committer;akr;2;14;10;24;0
f0e0b77864d3222b838d3e3074e728bd0d3f75f6;Tue Nov 10 22:51:24 EST 2009;Committer;tenderlove;1;2;2;4;0
b2a34a1ecfba129b2eadd532ccc857c6d49db538;Tue Nov 10 17:18:34 EST 2009;Committer;svn;1;2;2;4;0
c33d5a80c7ee0a4e42acb0dd54ac89d68c229a67;Tue Nov 10 17:18:31 EST 2009;Committer;yugui;2;103;0;103;0
561fbde4351ed7fb4dc0193c2a9fe361053555f2;Tue Nov 10 00:01:28 EST 2009;Committer;nobu;1;1;1;2;0
ade7714d20c5fe1cee55ed7a9b939de5dfefdbc7;Mon Nov 09 23:23:23 EST 2009;Committer;nobu;3;18;5;23;0
d6f5da84e3ec73e439ba602b32d7fcc958d6bd59;Mon Nov 09 11:18:17 EST 2009;Committer;akr;2;30;17;47;0
54b5ac56635a5bb3329f00a78296ac504eefca7d;Mon Nov 09 06:50:29 EST 2009;Committer;marcandre;2;7;5;12;0
68eb919442aaedf33484e40f2c023987ab847ef8;Mon Nov 09 02:28:31 EST 2009;Committer;nobu;3;7;3;10;0
5b0faff44cc00ceb18186b5ce5a55aea88207c07;Sun Nov 08 09:13:17 EST 2009;Committer;nobu;2;19;14;33;0
6ef3d123dd8c0defbe56db17926faac10b2085ae;Sun Nov 08 03:59:42 EST 2009;Committer;nobu;1;22;16;38;0
912c42bebf80601377dcb9c2f8036445dbebe203;Sun Nov 08 00:21:50 EST 2009;Committer;tenderlove;1;32;0;32;0
5de564634df7b97c4004b152f40008938c638dcc;Sun Nov 08 00:21:41 EST 2009;Committer;tenderlove;2;46;6;52;0
355a7bc3a552fda0fb1d1988bc3b2d600685f831;Sat Nov 07 21:37:28 EST 2009;Committer;svn;1;2;2;4;0
a56bd8c31aa536b122b07d7f7f04e427f3fc6a4e;Sat Nov 07 21:37:27 EST 2009;Committer;tenderlove;2;3;3;6;0
4319b48ab6aef267f1ff3e1e0a68b8d63a193765;Sat Nov 07 12:05:38 EST 2009;Committer;akr;3;7;4;11;0
52ebc24487f3d1553c436c3ab9fbf8784379961d;Sat Nov 07 11:59:16 EST 2009;Committer;nobu;4;10;2;12;0
ddc4143af021817d7b37ee6979c2af3e07f7871f;Sat Nov 07 03:51:39 EST 2009;Committer;matz;2;15;21;36;0
1e2dcdbd19005e147a754dcd72d1d27dcbeed1ce;Sat Nov 07 02:45:08 EST 2009;Committer;matz;4;38;14;52;0
35da6fdcf1103df9f0dcdd57cb2f913f4c593740;Fri Nov 06 22:50:40 EST 2009;Committer;tenderlove;2;53;9;62;0
bc52ea0fde16d2a5c209fb09a8e341d2905d2705;Fri Nov 06 22:50:05 EST 2009;Committer;tenderlove;2;35;0;35;0
5296367cf4d22222aad08acaa65eb369de65241b;Fri Nov 06 18:29:31 EST 2009;Committer;tenderlove;2;51;4;55;0
c970682f022f3933162116808af114494eeedc0c;Fri Nov 06 18:02:31 EST 2009;Committer;svn;1;2;2;4;0
c2d7621d8d379980afd0b74870588c1438418fed;Fri Nov 06 18:02:30 EST 2009;Committer;tenderlove;2;43;3;46;0
32acedd2867d9577b824d0ab255e533d4ff14ea9;Fri Nov 06 08:13:47 EST 2009;Committer;nobu;2;5;1;6;0
420c0430899ee0fa49f0fa84112a8eb025373cee;Fri Nov 06 03:07:52 EST 2009;Committer;naruse;2;6;4;10;0
0859e7cb87a23a0e80e26d3942730d19db26834d;Fri Nov 06 00:33:56 EST 2009;Committer;naruse;2;6;0;6;0
e83d7c4ecaf9e254f6e651c1ce8d4c27bb5ede4e;Thu Nov 05 22:48:53 EST 2009;Committer;kazu;2;11;0;11;0
401ce469beebf983557b9bb000749413c8bf43e3;Thu Nov 05 22:48:51 EST 2009;Committer;svn;1;2;2;4;0
9cfcc3c9c92b6908e639cfdae32fe1748ba71d36;Thu Nov 05 22:48:48 EST 2009;Committer;kazu;1;4;4;8;0
02a15031b14ec56d0776b14c8e4351d09b3b2671;Thu Nov 05 13:14:52 EST 2009;Committer;akr;1;1;1;2;0
e5b75da1fe3a9a92ba018dd21fb3a462a7568b60;Thu Nov 05 03:29:20 EST 2009;Committer;naruse;2;6;1;7;0
c47c38de93db16ae2f24b7c6f45aa6700f62eb08;Thu Nov 05 02:03:18 EST 2009;Committer;naruse;1;4;1;5;0
a07b764f9e1e6c36f77b2101184cf63b7513f8f4;Thu Nov 05 00:57:57 EST 2009;Committer;naruse;1;1;1;2;0
746eb4a45b4721d5cbe2abcdc99458c52b99bbee;Wed Nov 04 22:47:33 EST 2009;Committer;nobu;2;6;4;10;0
d778abf534fede5e6d52555cfdaf3d139d53f1b6;Wed Nov 04 19:01:42 EST 2009;Committer;svn;1;2;2;4;0
c5b4aedab6b34ed064a1476c42fe0fe65b38631f;Wed Nov 04 19:01:41 EST 2009;Committer;naruse;2;8;4;12;0
88175d1779ed5475b3c4ec483670c8b15ae79a2f;Wed Nov 04 13:42:03 EST 2009;Committer;naruse;1;6;0;6;0
716c2074bcd294a3a462930bb30f208845247652;Wed Nov 04 12:40:39 EST 2009;Committer;naruse;2;19;1;20;0
9c4ac94a8ec63cfa477e6aa0bcc2cc790f3a5808;Wed Nov 04 12:02:37 EST 2009;Committer;akr;7;33;33;66;0
ebd3a0e80b017f05c1e15da9b90df9d34b61622a;Wed Nov 04 07:12:07 EST 2009;Committer;nobu;1;8;0;8;0
255578c7b573959d0d8d142864d36d9e6fa6da03;Wed Nov 04 07:06:13 EST 2009;Committer;nobu;3;8;3;11;0
632aa7a0fc1416481c3d8934689f2d61be1c843d;Wed Nov 04 06:54:42 EST 2009;Committer;shyouhei;2;6;1;7;0
ab4e003969321c167ce326420ac153afb1ebf27e;Wed Nov 04 06:46:32 EST 2009;Committer;nobu;2;6;2;8;0
559e573cdde317fbd2b15b96cdb16812e2374c7b;Wed Nov 04 03:49:54 EST 2009;Committer;marcandre;2;5;1;6;0
f41eaf8431d4ed41f6024aeabc5f21a27f6b7223;Tue Nov 03 23:50:51 EST 2009;Committer;nobu;2;37;35;72;0
252168ed1b78534af4d4cec3a1f0ba8f3348f9f3;Tue Nov 03 23:26:02 EST 2009;Committer;nobu;2;9;7;16;0
22ec8c664a04bbb851731ff8144b9f7d11d9b8da;Tue Nov 03 23:21:02 EST 2009;Committer;nobu;2;5;1;6;0
fec2ed5f4d760d55aa6b123a55972e9d08c3beda;Tue Nov 03 23:19:33 EST 2009;Committer;nobu;2;5;1;6;0
02d55ac989bf29d6a87d63e93dc49941438f495b;Tue Nov 03 20:28:20 EST 2009;Committer;tenderlove;2;61;7;68;0
b9e0294edaceecb177401902f3809a45af666d7e;Tue Nov 03 17:46:28 EST 2009;Committer;akr;26;71;71;142;0
c30e32d075478c62580c7d3f5699c2c477503b41;Tue Nov 03 17:12:46 EST 2009;Committer;tenderlove;3;43;1;44;0
89f1c60cba94d286e8a72b0f278ab5903ad6031c;Tue Nov 03 15:16:59 EST 2009;Committer;svn;1;2;2;4;0
a1fc9cd5829d6c00f6cc4afd57f2a9b09a185046;Tue Nov 03 15:16:55 EST 2009;Committer;naruse;3;23;3;26;0
2c2fb9c5ec1dff9b1dc4d53a78502fef2132e39d;Mon Nov 02 09:35:43 EST 2009;Committer;wanabe;2;19;2;21;0
9c173cd5884de39d5d1416a4c1af4f7bc6fc82b1;Mon Nov 02 05:52:55 EST 2009;Committer;nobu;2;8;3;11;0
409033efcac2d6d81b228b12e335bc75f7ae16a1;Mon Nov 02 05:45:35 EST 2009;Committer;usa;2;8;1;9;0
12fadc102208853bd291d063204fdc2a1fcc0c40;Mon Nov 02 04:32:28 EST 2009;Committer;usa;2;6;1;7;0
9ee5e613b596202d719c22fadd700da2d8fd3a55;Mon Nov 02 03:58:25 EST 2009;Committer;usa;4;30;3;33;0
7539e11a7f742e11fdfe051798cf07b951384df9;Mon Nov 02 02:24:11 EST 2009;Committer;naruse;2;246;236;482;0
71f0685fe360a87af23bdeed92b0ebeea0d4690e;Mon Nov 02 01:04:31 EST 2009;Committer;wanabe;2;4;17;21;0
3e364a0c8bcb5aadb09acc929f8a0ca79cbabbfb;Sun Nov 01 23:27:15 EST 2009;Committer;svn;1;2;2;4;0
b23461b5dcfa8faf827e3f1a85bfedd12ebdc17b;Sun Nov 01 23:27:12 EST 2009;Committer;wanabe;2;17;4;21;0
74d16cd0a4558504cdd9b8be243ed536aba2e186;Sun Nov 01 11:16:53 EST 2009;Committer;naruse;2;158;162;320;0
f6f49eb0b8b36b82f848b38acc3e743dd2cdf111;Sun Nov 01 08:11:49 EST 2009;Committer;nobu;1;3;1;4;0
2eb5e70de3a0d3357f35896853872add1e6e5334;Sun Nov 01 07:24:18 EST 2009;Committer;nobu;2;43;9;52;0
f6ea31420e970ba799644317ed2e2473c8d4b0e8;Sun Nov 01 07:23:05 EST 2009;Committer;nobu;2;7;3;10;0
754462d4f144e48813c7d8fe705f6c46858b8d9d;Sun Nov 01 04:36:33 EST 2009;Committer;wanabe;2;8;3;11;0
24a6752f54bffd98dca09174a11bd1cf600050a0;Sun Nov 01 04:24:47 EST 2009;Committer;wanabe;2;9;4;13;0
68b23a0de763a50c6caf4933a512137b08310801;Sun Nov 01 04:06:00 EST 2009;Committer;marcandre;1;0;5;5;0
a9e662ac7aebe26c927dfdc1ef2a35eccffc470c;Sun Nov 01 01:47:08 EST 2009;Committer;tenderlove;2;20;0;20;0
4b76900a55b4159888dd2edc6a8828e2964318d2;Sun Nov 01 01:46:56 EST 2009;Committer;tenderlove;2;11;0;11;0
6cf6d8556c1df4962ae5775538690e4957e2ac1a;Sun Nov 01 01:46:44 EST 2009;Committer;tenderlove;4;110;34;144;0
5f3d0f523328be8197fd3d410a1b3bd3febfcbc2;Sun Nov 01 01:46:27 EST 2009;Committer;tenderlove;2;60;0;60;0
0243c024f8c3e0d229f160ad6fa0db96a70cb8ab;Sat Oct 31 23:17:52 EDT 2009;Committer;nobu;2;21;28;49;0
c0a0aa0c47f2cd5c97a35effb8b073eeb84b7d2d;Sat Oct 31 16:14:38 EDT 2009;Committer;matz;3;10;21;31;0
2097f56d32d6ab79cb9773fcdb203ed49339f4ac;Sat Oct 31 15:32:25 EDT 2009;Committer;svn;1;3;3;6;0
ab32fe26d9c9c4aad7a8953e3c83cb3b29e935d6;Sat Oct 31 15:32:22 EDT 2009;Committer;matz;2;68;16;84;0
a28cd28c043b0b4357d7658ed0ed78c4c8ffaff8;Sat Oct 31 08:18:32 EDT 2009;Committer;nahi;2;6;1;7;0
9d93bc2b0bd01d47d9fd9dbc0c92abc71db33497;Sat Oct 31 01:17:27 EDT 2009;Committer;nobu;2;3;3;6;0
d1cb4a5ba7d39af6c793d069903a3fe24dbaa8d3;Fri Oct 30 13:09:03 EDT 2009;Committer;nahi;3;58;3;61;0
104c5f6b555de908191b70a565579b99402a707f;Fri Oct 30 09:58:25 EDT 2009;Committer;matz;2;16;1;17;0
db196eef2409f618f30b6ced4b652c463e8574cf;Fri Oct 30 08:05:31 EDT 2009;Committer;nobu;1;10;8;18;0
1932c5909700c07d39320afc31c59da1158ac5e1;Fri Oct 30 08:01:48 EDT 2009;Committer;nobu;2;4;1;5;0
166a53c560aa24a1e16a9e1cb505bab5dff0462d;Fri Oct 30 07:57:21 EDT 2009;Committer;nobu;3;37;8;45;0
35b88be02b246357368dbcd5cdc83bf1dabef425;Fri Oct 30 07:42:04 EDT 2009;Committer;nobu;5;103;75;178;0
bb385e23866f047b1dbbcc3f79fb9020c1fb6a5b;Fri Oct 30 07:28:03 EDT 2009;Committer;nobu;1;9;0;9;0
6116f52f6132ed65c003ed42726bba1298aab8f2;Fri Oct 30 04:36:40 EDT 2009;Committer;nobu;2;11;34;45;0
b16e6a93ca4746d301c7f66b5407c05e44f1cc91;Fri Oct 30 04:15:54 EDT 2009;Committer;usa;2;29;5;34;0
1730092f1c8c2e5405ac4d33f3f1e92485c6022a;Fri Oct 30 04:01:56 EDT 2009;Committer;usa;1;5;0;5;0
de6d21a3818a7fac384f1912ee3813d77cba1370;Fri Oct 30 04:01:46 EDT 2009;Committer;usa;1;4;2;6;0
411b74709163708d46843970e6acdde85de4ae14;Fri Oct 30 01:55:38 EDT 2009;Committer;nobu;2;34;1;35;0
22bd95ded46f7163bde16e4782648de2ce5e87a1;Thu Oct 29 19:47:28 EDT 2009;Committer;nobu;2;9;2;11;0
2aa4d69d78405faf543da65969a17988799a1bba;Thu Oct 29 19:44:58 EDT 2009;Committer;nobu;1;17;14;31;0
5e74593701bc049d7c31882e5a6391b7100ccdce;Thu Oct 29 19:44:03 EDT 2009;Committer;nobu;1;4;0;4;0
0afb3e381d0e7f769d2be2fadba117be1317060c;Thu Oct 29 19:28:49 EDT 2009;Committer;nobu;1;27;26;53;0
ec2c82ba7f1083cf959aef7b7a5c89b9b14ffb53;Thu Oct 29 17:16:08 EDT 2009;Committer;svn;1;2;2;4;0
7f2ef1a96e3ae57b578bbb4d996fce3ddefc81fa;Thu Oct 29 17:16:05 EDT 2009;Committer;matz;4;56;34;90;0
2f2e8455e3644385e517299163bb538cd4f07030;Thu Oct 29 09:40:25 EDT 2009;Committer;naruse;3;28;19;47;0
06346d5849d70ebfcd26e8886dfd6b4303154f0b;Thu Oct 29 08:14:09 EDT 2009;Committer;naruse;3;26;22;48;0
0d9386d123c4331e970c2c60eb8ba2500a39d529;Thu Oct 29 06:43:28 EDT 2009;Committer;nobu;2;5;0;5;0
0580ba06110f7998fdaead724907a4c8d6540107;Thu Oct 29 04:55:10 EDT 2009;Committer;matz;11;129;39;168;0
2bb26c118d9e52a52940f73c9cb1fc26e07003d6;Wed Oct 28 19:42:59 EDT 2009;Committer;naruse;2;5;0;5;0
ee15e6ee3b08b3348cc813a4f82abebc58fcbc31;Wed Oct 28 19:42:53 EDT 2009;Committer;naruse;2;5;1;6;0
bc97306ed425f5d018ec8f73a75c20a9600324ca;Wed Oct 28 16:41:35 EDT 2009;Committer;svn;1;2;2;4;0
501e9360dd16fd34db8e829a206ed5484628caa3;Wed Oct 28 16:41:33 EDT 2009;Committer;kanemoto;2;9;1;10;0
feb34709fe96f4841d79e5547963d4650da5afc7;Wed Oct 28 08:02:02 EDT 2009;Committer;nobu;1;7;6;13;0
7a884fe4660746a085bc999c9c35e2e1833ae136;Wed Oct 28 07:34:24 EDT 2009;Committer;naruse;4;51;26;77;0
e2e09b812541c629f52ae89ae7de7bb1945f3420;Wed Oct 28 06:11:32 EDT 2009;Committer;naruse;1;1;1;2;0
6790c040df493afe4e6ca485e73447e3efa857ce;Wed Oct 28 06:06:17 EDT 2009;Committer;naruse;2;10;1;11;0
8d9e64fb38a58b5d9bac0342ef642054c5dd8b3f;Wed Oct 28 06:06:10 EDT 2009;Committer;naruse;2;24;0;24;0
9f5f7b87bafc1e47cc00237020e6bdb7e8fc37be;Wed Oct 28 05:51:33 EDT 2009;Committer;nobu;2;5;1;6;0
705c567194281322a0a2a38df090384a32124e18;Wed Oct 28 04:50:09 EDT 2009;Committer;marcandre;6;11;9;20;0
2e868a3442cec49813bab8a0be780cb42f79afcf;Wed Oct 28 04:20:35 EDT 2009;Committer;matz;2;32;10;42;0
db115a545f33569c2a23c24a32d65e85abb81f2a;Wed Oct 28 04:09:23 EDT 2009;Committer;svn;1;2;2;4;0
91c84cda9b4c12be09424202f0ea30b7d4a91e0b;Wed Oct 28 04:09:20 EDT 2009;Committer;shugo;2;28;3;31;0
249569fd8e6ba2c10082ab3eaaff6d1230998f01;Tue Oct 27 13:50:42 EDT 2009;Committer;naruse;2;9;1;10;0
8252adfd5a6020a8b3dad173f71e9012ba5c6acf;Tue Oct 27 13:22:40 EDT 2009;Committer;nobu;3;46;1;47;0
0d76affdf905a72a6bcb25530ca13468bc36a0bc;Tue Oct 27 13:14:52 EDT 2009;Committer;nobu;2;25;15;40;0
aacc33649a3629c890363d90bbdbcbb7809a44fc;Tue Oct 27 12:22:42 EDT 2009;Committer;nagai;2;11;0;11;0
121d15dddab92307984c55165e2fc0ae01f5ff50;Tue Oct 27 07:36:54 EDT 2009;Committer;nobu;3;7;11;18;0
ed58a66fa8bf2af5e085529887e16c2a9498bb1e;Tue Oct 27 06:54:03 EDT 2009;Committer;akr;2;8;1;9;0
613a324f6156f3dc3b666ceef23ad7e54df59a37;Tue Oct 27 06:47:41 EDT 2009;Committer;shugo;2;7;2;9;0
718a78b76a8ef3508b38d035afb683ebe6e900b2;Tue Oct 27 03:56:31 EDT 2009;Committer;kazu;1;6;0;6;0
206a9281301212d1daf02703cbf85dc1efc146e2;Tue Oct 27 03:30:18 EDT 2009;Committer;nobu;2;9;4;13;0
be6ff254038b7fd08b0e95fc44d803ed89a003ae;Tue Oct 27 01:29:22 EDT 2009;Committer;naruse;2;8;2;10;0
70b881b5cdfcbe8b043024b8cb532062f8ab393b;Tue Oct 27 01:08:09 EDT 2009;Committer;usa;1;1;1;2;0
404ed4f8d44ccd849a4d3a37450ba2f95ad317bb;Tue Oct 27 00:29:06 EDT 2009;Committer;naruse;2;6;2;8;0
609030816bd613a4cae397227cadbfa0ae7c6c57;Mon Oct 26 23:56:13 EDT 2009;Committer;nobu;2;5;1;6;0
226c12d4e99e52bcf78f74812479b52cf24338d3;Mon Oct 26 23:21:18 EDT 2009;Committer;nagai;1;1;1;2;0
3c981342b662ac31947456fcecc692191604f641;Mon Oct 26 23:12:04 EDT 2009;Committer;kazu;1;5;5;10;0
ab77f00b04999a857382462d40dfaef3262cbe84;Mon Oct 26 23:11:59 EDT 2009;Committer;kazu;2;54;6;60;0
33c5abbefae97178001f1ba8c95205b99209a313;Mon Oct 26 23:06:39 EDT 2009;Committer;matz;2;6;0;6;0
435f18f513fdaa77c9922f564df577110641a0a2;Mon Oct 26 22:40:22 EDT 2009;Committer;nagai;4;40;2;42;0
1fe610b5885217a9bac6d9a5ef74c79589c5fbca;Mon Oct 26 20:58:25 EDT 2009;Committer;naruse;2;8;1;9;0
2215293a6607e8777b8201cdfe22589b3001c592;Mon Oct 26 20:14:16 EDT 2009;Committer;naruse;2;7;2;9;0
c21350f902fba58ccbbbd42d004ee1731be6a4d9;Mon Oct 26 18:45:34 EDT 2009;Committer;nobu;4;10;3;13;0
8d446fe1eb85af0397640fff791499c2fca470e0;Mon Oct 26 11:06:17 EDT 2009;Committer;marcandre;2;8;2;10;0
327d58f72057395a3f3960a14117be801575ec5a;Mon Oct 26 10:30:15 EDT 2009;Committer;matz;2;22;7;29;0
66f5c5eb30feefcd2fbfce771ae206e14a9354fc;Mon Oct 26 06:44:31 EDT 2009;Committer;nobu;5;59;60;119;0
dc28ce1b0b6cfc531ac2c3d19745d7c7301ed45d;Mon Oct 26 04:26:57 EDT 2009;Committer;nagai;2;6;2;8;0
1996a4af6930e9376099df8d41f1bb9b2de7a90a;Mon Oct 26 03:41:01 EDT 2009;Committer;mame;3;11;4;15;0
9350a57463472993535bbd42b5ac1828d233dde2;Mon Oct 26 03:06:29 EDT 2009;Committer;nobu;3;22;2;24;0
475e705b2f0d757d7b6eb9698735931a68ae8f6b;Sun Oct 25 06:44:26 EDT 2009;Committer;nobu;2;9;4;13;0
d64d462f7ad6fd1f8f182b8a9ceb2a63e26adf37;Sun Oct 25 04:34:00 EDT 2009;Committer;nobu;2;6;0;6;0
b6c007ac856be8756e2b6fb6f4403232a0e04618;Sun Oct 25 01:19:11 EDT 2009;Committer;nobu;2;6;1;7;0
3f6f9f87ca248d66d6ba87a2bcea321d1c90661f;Sun Oct 25 00:11:56 EDT 2009;Committer;tenderlove;2;16;0;16;0
1578edbafc8d641a1829cb1949318aa754fc5485;Sun Oct 25 00:11:41 EDT 2009;Committer;tenderlove;2;45;0;45;0
159e6439c0d94d0f2c0dffdfe0d76aad631eb876;Sun Oct 25 00:11:29 EDT 2009;Committer;tenderlove;2;27;0;27;0
60f86b2edbabb25cdce5ae0898a50f8edfc8a143;Sun Oct 25 00:11:15 EDT 2009;Committer;tenderlove;2;40;3;43;0
c30de1e38e8d5ff633ebe90e110c5acdaa79f583;Sun Oct 25 00:11:02 EDT 2009;Committer;tenderlove;2;33;3;36;0
a631b5df366f0e7b1c6f16b53281df3822b9e833;Sat Oct 24 21:56:50 EDT 2009;Committer;tenderlove;2;30;2;32;0
c038e9003ce249d4f1346fef5b21883978a780ab;Sat Oct 24 20:55:40 EDT 2009;Committer;marcandre;2;9;11;20;0
55bf7f9d40bae8671476b576a2c8e98bed27b1a6;Sat Oct 24 17:01:38 EDT 2009;Committer;matz;2;49;0;49;0
ba3bfda7a2c58a5eb9b6dacdd109a97492cc906f;Sat Oct 24 16:53:11 EDT 2009;Committer;matz;4;16;4;20;0
5f01ed26f2b9199ff9eb56ca3b00d850b27b79e7;Sat Oct 24 16:48:08 EDT 2009;Committer;svn;1;2;2;4;0
51f033f85354cdd22f7c39b77bf6c39afaec09f9;Sat Oct 24 16:48:05 EDT 2009;Committer;matz;3;15;1;16;0
66ed25f6336fddb036fb2408e4e4c4316b427330;Sat Oct 24 06:05:10 EDT 2009;Committer;marcandre;1;1;0;1;0
90d244aded4c1cbc0289b910a0e062e033ee791f;Sat Oct 24 06:04:56 EDT 2009;Committer;marcandre;1;2;2;4;0
e5af8e940b2f399d6eb157c96146f6f6bd950793;Sat Oct 24 06:04:41 EDT 2009;Committer;marcandre;1;18;5;23;0
5d6440c74847135962d87323bbdc71fe342c4c51;Fri Oct 23 23:37:14 EDT 2009;Committer;matz;3;11;5;16;0
5ee251bdad423b244b7127e609a0bf2fec81e7a3;Fri Oct 23 16:44:41 EDT 2009;Committer;tenderlove;3;29;1;30;0
1eef1cdc563144049d1c7d48c322fd3a4d1a7747;Fri Oct 23 15:38:09 EDT 2009;Committer;svn;1;2;2;4;0
843acddbe167ff9d47a71b27eb4264c0d88b6cae;Fri Oct 23 15:38:06 EDT 2009;Committer;akr;2;8;0;8;0
525be7f048c6463c0b40c35a76f72cd73bcd25fc;Fri Oct 23 13:30:29 EDT 2009;Committer;akr;1;1;1;2;0
32df7768b8475c0339be6b2ef6a077edd488d4e1;Fri Oct 23 05:25:56 EDT 2009;Committer;nobu;3;16;5;21;0
a56b1bc27b70d2ce609a456043b05161a20a1082;Fri Oct 23 05:22:53 EDT 2009;Committer;nobu;2;26;11;37;0
9a8d0e83c0bb5501185ecb3f080f448a908fc874;Fri Oct 23 05:06:12 EDT 2009;Committer;nobu;2;8;4;12;0
d645c25a7f9fded298d17cde37705791c740d2a2;Fri Oct 23 00:13:02 EDT 2009;Committer;nobu;2;6;1;7;0
01be019547288e708ad3427a3a58295badad92f9;Thu Oct 22 22:35:45 EDT 2009;Committer;nobu;1;2;1;3;0
e9af789d3552724b1d0b67fa0b4e990afdbfbf38;Thu Oct 22 22:32:39 EDT 2009;Committer;nobu;5;17;1;18;0
2e5e8fd89540bc4301e6a94df022c41b44eca31a;Thu Oct 22 22:28:52 EDT 2009;Committer;nobu;4;13;6;19;0
359d93233200a4425f9d560cf519d32e5f47576d;Thu Oct 22 12:12:24 EDT 2009;Committer;usa;2;6;1;7;0
4079c46912da9608dd5cc933d94a29baa99dd2e5;Thu Oct 22 11:22:11 EDT 2009;Committer;akr;3;11;3;14;0
da54a4589af5cbe9a53f8baf3f9474c91e673b4c;Thu Oct 22 08:51:40 EDT 2009;Committer;knu;2;19;8;27;0
6221d16ffbcc601a88342f35dee9c539709cf900;Thu Oct 22 08:29:53 EDT 2009;Committer;nobu;2;5;1;6;0
1f6936384acd15da394a2c87911c96e80816dfee;Wed Oct 21 20:17:30 EDT 2009;Committer;svn;1;2;2;4;0
7eac66b9c6a79a89900945e68e3eff457cf1cb7e;Wed Oct 21 20:17:27 EDT 2009;Committer;matz;3;23;2;25;0
b20521ddc595cfbf9b0d95c54da42151bcef4d96;Wed Oct 21 10:32:53 EDT 2009;Committer;nobu;2;7;3;10;0
d9f27b56096a7aeb48cb6b7baedacb36f52d8c23;Wed Oct 21 03:44:56 EDT 2009;Committer;nobu;1;4;3;7;0
4e786ee1629b799a4af03ee935ede263cdcde05e;Wed Oct 21 03:37:40 EDT 2009;Committer;nobu;2;4;4;8;0
f04debed3b82ea6c76455cbd2abf848439809bfb;Tue Oct 20 23:17:19 EDT 2009;Committer;nobu;2;11;0;11;0
86a81951b1f695db07e9d2a760c3fd196ee58224;Tue Oct 20 19:01:44 EDT 2009;Committer;marcandre;1;1;2;3;0
439a1e64d17d31ba53ed097a432ecc0df522a0fb;Tue Oct 20 19:01:31 EDT 2009;Committer;marcandre;1;9;2;11;0
80a756bbc9f67a60c36f331e5a88ea7fb94ef524;Tue Oct 20 19:01:18 EDT 2009;Committer;marcandre;1;10;0;10;0
b32bae3fbb41c9766e12ccfe2f64ffc333129a5b;Tue Oct 20 15:59:43 EDT 2009;Committer;naruse;1;14;21;35;0
070cbd942e6f6013ad4b9908f1dffe8dc156f5d0;Tue Oct 20 15:57:39 EDT 2009;Committer;nahi;1;27;0;27;0
9cf0cf92f2fa1a660585ead88c9057cfa8697cf7;Tue Oct 20 15:17:37 EDT 2009;Committer;nahi;2;6;2;8;0
71025b8ab00eccac181eb0e61de4d40e4705aaa4;Tue Oct 20 15:08:41 EDT 2009;Committer;svn;1;2;2;4;0
8906bf2c1bc860efcd17e25c5a9428bdc7a2fb69;Tue Oct 20 15:08:38 EDT 2009;Committer;nahi;3;205;55;260;0
9eebf6bf48ef705f970f22881792762ff4632c9e;Tue Oct 20 13:35:15 EDT 2009;Committer;keiju;2;123;96;219;0
f25fd72a0a9e880b87d037b87d0554aa405eeef7;Tue Oct 20 08:57:33 EDT 2009;Committer;nobu;2;10;2;12;0
a07dbf0ee912e9f93878a022cf6083d341e95aa9;Tue Oct 20 07:43:17 EDT 2009;Committer;usa;2;18;9;27;0
7bf521122082784eab07b1dcd1303ddf09f62497;Tue Oct 20 06:38:03 EDT 2009;Committer;nobu;2;4;8;12;0
28d97e63d64494b1f74e340b40ffe49f84e38af3;Tue Oct 20 06:35:26 EDT 2009;Committer;nobu;4;26;31;57;0
e3e93bb53e6407869cce1149ab27bd7f27034a7a;Tue Oct 20 06:28:51 EDT 2009;Committer;nobu;3;26;9;35;0
14f13abb85df5861bd5fb684da88ccba22651e79;Tue Oct 20 06:07:39 EDT 2009;Committer;nobu;3;46;22;68;0
02ddc9a8935669703141668a3777d9bce1f42509;Tue Oct 20 05:50:56 EDT 2009;Committer;svn;1;2;2;4;0
b907ee320dc58436e0c75519db20f051824cef04;Tue Oct 20 05:50:53 EDT 2009;Committer;nobu;5;74;26;100;0
80eda69d26f901abc39ba6ef617315d50ae96e3d;Mon Oct 19 06:17:31 EDT 2009;Committer;nobu;2;65;1;66;0
55cc90b7e260d6fc5af71c07db48b676753ff195;Mon Oct 19 06:04:10 EDT 2009;Committer;usa;2;6;1;7;0
4aa1cfc2c3e196a9434e8415c680638d914b35e1;Mon Oct 19 02:34:40 EDT 2009;Committer;nobu;2;43;0;43;0
321c94af8e43fa199c74673b37b8205b6508ee8d;Mon Oct 19 01:59:38 EDT 2009;Committer;nobu;3;12;1;13;0
afd50701c5b13ddbbd7e73c527f723b6e496dee9;Sun Oct 18 20:54:33 EDT 2009;Committer;svn;1;2;2;4;0
5498b5a4c79cf806390c601f44c74d1cfb3c77b9;Sun Oct 18 20:54:29 EDT 2009;Committer;marcandre;2;6;1;7;0
a542b9248e8cfda87a73d57cf7438c9e86d41c1f;Sun Oct 18 13:38:55 EDT 2009;Committer;tadf;3;38;8;46;0
a07cef02a959f735538f3194a094b2346603664a;Sun Oct 18 11:19:33 EDT 2009;Committer;naruse;1;4;1;5;0
7db062cdc0b6650882c1ba3b1e014a25b4afacf4;Sun Oct 18 10:19:45 EDT 2009;Committer;akr;2;5;1;6;0
d68e5dce35ae300f7ea9ce7a0083f2b61392b997;Sun Oct 18 09:32:02 EDT 2009;Committer;nobu;2;9;7;16;0
d08d73b47de238e4136889cf096c58c69be9f760;Sun Oct 18 00:55:37 EDT 2009;Committer;svn;1;2;2;4;0
c0b42eedeafd49c867ffd776d95a6aeb1d7b732a;Sun Oct 18 00:55:34 EDT 2009;Committer;yugui;3;80;19;99;0
79a8955f8d99d6e603a90a8038da461687d275ec;Sat Oct 17 13:11:05 EDT 2009;Committer;nobu;3;78;18;96;0
775174bb76cfb5e33097ba886c28d139bc4e90d1;Sat Oct 17 11:12:05 EDT 2009;Committer;akr;1;1;1;2;0
9cf06279443ae08fe23e7f7a4b8303f343a4d57a;Sat Oct 17 09:04:16 EDT 2009;Committer;yugui;2;16;6;22;0
984177a0004ea3bd5e5149f0030ab3ce1b20bd6a;Sat Oct 17 09:02:40 EDT 2009;Committer;yugui;1;2;0;2;0
8c01a3765e2e76364d366d5aebf06477a4c0ad2d;Sat Oct 17 08:31:07 EDT 2009;Committer;mame;2;8;4;12;0
859a9857156e19c54d9569a24387154d87ec5006;Sat Oct 17 07:35:39 EDT 2009;Committer;akr;2;5;1;6;0
eccb700286af9428a402dc9fd0139e75d36c31f0;Sat Oct 17 05:34:51 EDT 2009;Committer;matz;3;10;5;15;0
c02e47c4e06f06e059bd70737082a8940c960b93;Sat Oct 17 04:22:58 EDT 2009;Committer;matz;2;10;3;13;0
b73be705db243ef43f1938e00bd1c6e71bff58aa;Fri Oct 16 19:20:35 EDT 2009;Committer;marcandre;1;1;1;2;0
f5233326522d0f6dc2814a0e1c6afe45d467acf0;Fri Oct 16 15:12:34 EDT 2009;Committer;svn;1;2;2;4;0
3e946fe3013339bb71fe448efd2b9e597d1902c6;Fri Oct 16 15:12:31 EDT 2009;Committer;wanabe;2;16;8;24;0
02689d147d46776a379b8e31cf0c817bf153da9d;Fri Oct 16 13:23:15 EDT 2009;Committer;akr;2;16;8;24;0
78fea697769ce47a87c92f9baee8621f48f8ace3;Fri Oct 16 11:20:06 EDT 2009;Committer;matz;2;8;1;9;0
749b3aa7949b3717f33fee037e12c82bf4917026;Fri Oct 16 11:11:00 EDT 2009;Committer;matz;2;11;0;11;0
71689efdd034f792cb92ccbc9ad78e2139441caf;Fri Oct 16 11:06:26 EDT 2009;Committer;matz;1;1;1;2;0
fbf15be35fcf26919c0709e0cd971fe68835e762;Fri Oct 16 11:04:15 EDT 2009;Committer;matz;2;14;3;17;0
9bcccca47a8a8800a1ac09eeb35dfe5135ca079f;Fri Oct 16 09:42:20 EDT 2009;Committer;nobu;2;39;0;39;0
dd5c77f0c97ed15536302f8b3c0b230d5988682b;Fri Oct 16 07:10:08 EDT 2009;Committer;usa;2;5;1;6;0
aaa01efb958a17b89b2e347faf765bc0fe1ad479;Fri Oct 16 04:40:11 EDT 2009;Committer;nobu;3;12;6;18;0
438b8706a7b4353a2208debaaf2fa2335ea94b1a;Fri Oct 16 04:36:31 EDT 2009;Committer;naruse;9;34;13;47;0
b4a9962e85b8b58090f579b9cd9c0f593460f70c;Fri Oct 16 03:10:31 EDT 2009;Committer;nobu;1;2;4;6;0
585f8fcf0d514d381f9f98cf4d1db5d16d5d1aae;Fri Oct 16 03:07:21 EDT 2009;Committer;nobu;1;1;1;2;0
ee2512496cedaca3207d0ab0e7b12e81ac0ff27b;Fri Oct 16 03:04:38 EDT 2009;Committer;naruse;2;8;1;9;0
e0eb17f887c75abecdcceb2f1262646914708b29;Fri Oct 16 00:53:18 EDT 2009;Committer;nobu;1;20;0;20;0
be8bebb151da30f83628bcf1f2a512d0d54ed3d0;Thu Oct 15 18:19:18 EDT 2009;Committer;svn;1;2;2;4;0
e3c75483635634b560de6736af03f121aeb09e68;Thu Oct 15 18:19:15 EDT 2009;Committer;naruse;2;29;9;38;0
e5e49b3a2797249708eb3fa4754c58f718da50c9;Thu Oct 15 09:26:15 EDT 2009;Committer;nobu;2;4;4;8;0
37531934e6e39c4863db87134c04efa3d3d63f61;Thu Oct 15 07:57:40 EDT 2009;Committer;nobu;3;17;17;34;0
9fff5f0fabb50ab0d46034d6c1b9dcc4447a8a66;Thu Oct 15 06:14:16 EDT 2009;Committer;nobu;3;27;26;53;0
6069202867ab9016aaf66301468d5f4c64b3b028;Thu Oct 15 05:58:00 EDT 2009;Committer;nobu;3;21;7;28;0
c7afd1aef49c0dc459b3d9dda6ddc51e301f5473;Thu Oct 15 05:21:00 EDT 2009;Committer;nobu;5;23;8;31;0
1af93d6a495efcf06889f29b362467c7cb53d378;Thu Oct 15 05:17:06 EDT 2009;Committer;nobu;1;1;1;2;0
e4d1745717744eec8800d5b39a5b22c796889b8d;Thu Oct 15 00:29:10 EDT 2009;Committer;usa;2;11;0;11;0
d5537936ab39dea835fb6e8fd440321ceabd4bb2;Wed Oct 14 16:51:52 EDT 2009;Committer;naruse;6;21528;29001;50529;0
6dd93ff60d4d7e1ea4b2a2d854273719d7d1715e;Wed Oct 14 15:26:43 EDT 2009;Committer;svn;1;2;2;4;0
05eb30494760d1723d8fe18d902cdb9f8b9a5ab1;Wed Oct 14 15:26:40 EDT 2009;Committer;akr;2;10;0;10;0
b97494f3cb8032433039adff3d9bc45bc83256c3;Wed Oct 14 14:08:26 EDT 2009;Committer;marcandre;1;4;5;9;0
499a59d543ba5e0c50a544fbc499db06d0400931;Wed Oct 14 13:41:33 EDT 2009;Committer;marcandre;1;1;1;2;0
0e4121aa5ba9875f3b2d3b130cc4f63a1f50fc26;Wed Oct 14 04:24:16 EDT 2009;Committer;nobu;3;16;2;18;0
fe01a3434da6ea3e3f2bf0bc0b0ad1447f12f4b8;Wed Oct 14 01:34:46 EDT 2009;Committer;nobu;1;0;6;6;0
e53e556bd5a772ef938963d70a9f2a57f4e2969b;Wed Oct 14 00:06:42 EDT 2009;Committer;nobu;2;9;1;10;0
72838c28bd2690693f0e326eee595d54aba6459c;Tue Oct 13 23:12:59 EDT 2009;Committer;marcandre;1;3;3;6;0
3c5d4bb28d715614060ec21f9d89e42f7bb88ed1;Tue Oct 13 23:08:30 EDT 2009;Committer;svn;1;2;2;4;0
6615b9a1d22d2080ed7784e4703cf5d9d07c9e50;Tue Oct 13 23:08:27 EDT 2009;Committer;marcandre;2;7;1;8;0
181eb7d5c11571c811c6d57bfd99332334b6e1e8;Tue Oct 13 12:27:00 EDT 2009;Committer;naruse;6;40090;4796;44886;0
391e5df571e8f5bcef3ee0cd227002056cbcbe5c;Tue Oct 13 11:43:01 EDT 2009;Committer;akr;1;2;1;3;0
ba3abf209dde890878039ba03420cfd928cf8fc9;Tue Oct 13 09:55:55 EDT 2009;Committer;nagai;2;7;2;9;0
475bdfee7c7f0d78baca68781128239476053177;Tue Oct 13 09:23:19 EDT 2009;Committer;nobu;2;21;34;55;0
525f6818fa01c3602637adcbdb1f2672ab704bda;Tue Oct 13 09:20:59 EDT 2009;Committer;nobu;2;5;1;6;0
243f42fce18892aadb86e763971bf27c03648fa5;Tue Oct 13 00:06:59 EDT 2009;Committer;marcandre;1;7;0;7;0
a77a9bb20cf4d8fc08a7a6c9dfedefbb9f585c98;Mon Oct 12 23:53:48 EDT 2009;Committer;marcandre;3;2;13;15;0
bc59a8574086c8659e51fa6cc35d4dfec08cdf22;Mon Oct 12 17:49:18 EDT 2009;Committer;svn;1;2;2;4;0
5d372d0c4023c283765e5eee3b653048dbf06fb0;Mon Oct 12 17:49:15 EDT 2009;Committer;akr;1;2;2;4;0
b83a7c1076648ec372b8da18930af0d3ea9b8150;Mon Oct 12 14:29:05 EDT 2009;Committer;shugo;2;6;17;23;0
9994d05b7e9b1977637bdf2e4c12883132c76d09;Mon Oct 12 13:52:37 EDT 2009;Committer;shugo;2;13;10;23;0
7a063b7416509b9f8e7ba3cfc5169a04fe021c32;Mon Oct 12 10:55:40 EDT 2009;Committer;nobu;1;1;1;2;0
511e757cd868a4207bddeffbdf127ad483fcfa80;Mon Oct 12 10:48:35 EDT 2009;Committer;nobu;2;24;9;33;0
bd2a1db5af92ffc53d0125611b18ad0df7d8fa72;Mon Oct 12 02:28:48 EDT 2009;Committer;nobu;1;2;2;4;0
4aa531ead478b9f0ba2eba31125bfac1bf1f4d18;Sun Oct 11 22:08:51 EDT 2009;Committer;marcandre;1;3;1;4;0
67e11229ecf10efeb1b7eb15b114bc783453b8a6;Sun Oct 11 20:52:51 EDT 2009;Committer;naruse;2;13;4;17;0
5e4d54a98dc8f61e4de1e24da74407751d99e437;Sun Oct 11 18:49:45 EDT 2009;Committer;svn;1;2;2;4;0
8ab0220352de7d4acfcbb45a25ef3de54233c8c5;Sun Oct 11 18:49:41 EDT 2009;Committer;naruse;3;51;15;66;0
334241e3ed0fdd8d654aab56129c50008e797b7f;Sun Oct 11 09:34:25 EDT 2009;Committer;akr;1;3;3;6;0
3e54f0ee1ff1081a0576a141d27616d29b527393;Sun Oct 11 07:39:17 EDT 2009;Committer;akr;1;4;3;7;0
bffae00241c5a2a56a4c6e6186c1652418f47378;Sun Oct 11 06:54:54 EDT 2009;Committer;nobu;2;7;2;9;0
433073cf7c072136901889de1aeff499ac104d9e;Sun Oct 11 04:54:31 EDT 2009;Committer;nobu;0;0;0;0;0
bbaf5966786095015b4332087b9e612845480944;Sun Oct 11 04:53:47 EDT 2009;Committer;nobu;0;0;0;0;0
7af356461a37225fe8f50892620b6d08e3fa1717;Sun Oct 11 01:27:11 EDT 2009;Committer;nobu;3;9;3;12;0
e0e3d15f12d795ff00a7926283fbee81f7f7a5cc;Sun Oct 11 01:06:30 EDT 2009;Committer;naruse;2;13;0;13;0
c506f190e142ad8cda2be386180c51d428a937fc;Sun Oct 11 00:48:35 EDT 2009;Committer;naruse;3;37;20;57;0
2503de61fc96c932c4172d7c4b48d2dded5679e6;Sun Oct 11 00:04:10 EDT 2009;Committer;nobu;2;11;2;13;0
eac0bd97145056be0db3284d935d04b83eead301;Sat Oct 10 23:48:15 EDT 2009;Committer;nobu;2;5;0;5;0
8e9fb2e14c4773cb9fd006133bd38f8bc851ff0f;Sat Oct 10 18:12:26 EDT 2009;Committer;naruse;2;28;30;58;0
95b3da63f1daa29666c3ee1d703e9ad944f34b25;Sat Oct 10 15:14:40 EDT 2009;Committer;nobu;3;9;4;13;0
89afd642aa8a28915f224bba8b475140268b7a64;Sat Oct 10 14:57:46 EDT 2009;Committer;nobu;2;12;10;22;0
5d4b63d2fdc13816ff540669f9014baaea715698;Sat Oct 10 14:51:25 EDT 2009;Committer;nobu;2;37;34;71;0
89154445fb39b69958d1dde3fcb1db47b4ed4c66;Sat Oct 10 12:11:11 EDT 2009;Committer;nobu;1;29;32;61;0
6b7e6f08b00b178e4df23096c5a6ba3873b5bba8;Sat Oct 10 11:38:47 EDT 2009;Committer;yugui;2;5;0;5;0
f65dbbd24ad8c550575c661223008ea491a3a777;Sat Oct 10 10:49:47 EDT 2009;Committer;akr;3;82;20;102;0
7c669071c4755496a4dcdd0243783adbecc03f95;Sat Oct 10 09:59:19 EDT 2009;Committer;nobu;2;13;0;13;0
66150a89a69ed16953d40af8383206f339dcd5ac;Sat Oct 10 09:19:05 EDT 2009;Committer;nobu;5;11;4;15;0
478d3535efa17927f872549d3a5affcbc668e585;Sat Oct 10 08:57:02 EDT 2009;Committer;nobu;2;2;2;4;0
d45189ba5b336e50e39b8190cfa01a17d6331db5;Sat Oct 10 08:55:58 EDT 2009;Committer;nobu;2;5;1;6;0
aa963d33576f593d1472bd5f297abf58b88d3ad0;Sat Oct 10 08:03:24 EDT 2009;Committer;nobu;2;13;3;16;0
f87132b45fa3916e968c80546db4f78882a160e8;Sat Oct 10 07:28:15 EDT 2009;Committer;nobu;1;0;1;1;0
243400fbedab5b1701451f5a92c2453e400547bc;Sat Oct 10 05:56:07 EDT 2009;Committer;marcandre;2;5;1;6;0
8571bdbd6766147ece7b9045bcdf019510a71210;Sat Oct 10 05:13:08 EDT 2009;Committer;marcandre;4;37;7;44;0
c4ff156d912d8bc0d1ffd9da64665aae6317f2e3;Sat Oct 10 03:21:33 EDT 2009;Committer;nobu;2;37;29;66;0
589d54f4b1c3a234e503c4746de187e4b5b78b43;Sat Oct 10 03:20:51 EDT 2009;Committer;svn;1;2;2;4;0
7081875aa874f4d30d7c75ead3bfe61f050c2a05;Sat Oct 10 03:20:49 EDT 2009;Committer;nobu;1;5;3;8;0
4631523baf082ed6d1224e5e39fc90979c02be8d;Fri Oct 09 14:52:02 EDT 2009;Committer;matz;2;6;1;7;0
2ea82d336d5aadf0ec679300a1b6585bd69a48fe;Fri Oct 09 12:17:38 EDT 2009;Committer;akr;2;9;1;10;0
696eec1e4f9ff82e0331c1198bf2c8983b30e8e4;Fri Oct 09 01:14:02 EDT 2009;Committer;naruse;2;7;1;8;0
5a4ce608e28068ffc149e869a4bcf6d8c48ca45d;Thu Oct 08 18:07:08 EDT 2009;Committer;naruse;5;41;20;61;0
f0cdcf6f4e5b18f386fcee033b5cc35042bc4289;Thu Oct 08 17:12:36 EDT 2009;Committer;marcandre;2;47;0;47;0
4b62641c130017e7d871fb3ee0d2c219844a6701;Thu Oct 08 16:11:30 EDT 2009;Committer;mame;4;11;1;12;0
c2c679bc385f8d1067e218a3c96de570daa48117;Thu Oct 08 15:34:15 EDT 2009;Committer;marcandre;2;9;2;11;0
98bcdc60ab88542e9e473d0310ad0220ae760924;Thu Oct 08 15:01:59 EDT 2009;Committer;svn;1;2;2;4;0
abd31dc2ad9e11e71ff512b46a606ccbb207925f;Thu Oct 08 15:01:57 EDT 2009;Committer;akr;2;47;19;66;0
866c79e2de4567d71f432652c58b48fe50916f37;Thu Oct 08 02:49:11 EDT 2009;Committer;naruse;7;272;529;801;0
ec0e370eb5451a1e597bf528f8f9a2dcc46880f0;Wed Oct 07 17:46:34 EDT 2009;Committer;nobu;2;36;29;65;0
0f408e10bab2a3831560beedb4e4424869330d88;Wed Oct 07 16:23:20 EDT 2009;Committer;nobu;3;15;2;17;0
8d79d61202b16dcc5594f24fdb2ff20893c51311;Wed Oct 07 13:35:07 EDT 2009;Committer;akr;1;1;0;1;0
90ce6d2323981caab47b86bdf6f4656cf046c73b;Wed Oct 07 07:42:30 EDT 2009;Committer;nobu;2;13;2;15;0
d167cfd196c410cbab11e1c3b8cce14297e4a085;Wed Oct 07 07:06:32 EDT 2009;Committer;nobu;3;9;2;11;0
be9766c37e614ca0a9286613f7b0a676f0c0adaf;Wed Oct 07 00:35:24 EDT 2009;Committer;naruse;2;16;19;35;0
a120569068621fce972506db53c3cce1cdac8939;Tue Oct 06 15:58:12 EDT 2009;Committer;matz;2;13;0;13;0
69c63f76f46936fb7099fee4e32508b1b9bd24b3;Tue Oct 06 15:31:26 EDT 2009;Committer;svn;1;2;2;4;0
230411caa2cf512a9f82d917c10d2785e936bf16;Tue Oct 06 15:31:22 EDT 2009;Committer;akr;2;12;4;16;0
e1797bc7dd2178550cf15d7a6af4f7f0eae003b4;Tue Oct 06 13:07:12 EDT 2009;Committer;matz;3;50;1;51;0
1c544fccd27d399a444353905c8d921b1d1c5186;Tue Oct 06 12:31:53 EDT 2009;Committer;akr;2;9;8;17;0
d1521f4bb267875c9fa9eb6b5a23a81bc4a57002;Tue Oct 06 10:07:24 EDT 2009;Committer;matz;2;6;0;6;0
fd36be89fea323e0b579beb639183efd21717623;Mon Oct 05 21:29:36 EDT 2009;Committer;svn;1;2;2;4;0
cb732bbbdc94d2a969f5f727d6018b9d7d3e291c;Mon Oct 05 21:29:32 EDT 2009;Committer;nagai;4;24;8;32;0
40229f892c6877ecd0d45f24b662b05c74c7774a;Mon Oct 05 14:35:39 EDT 2009;Committer;matz;4;111;59;170;0
c984f7712230ffbbcb702923e421c306ca98f40b;Mon Oct 05 11:27:06 EDT 2009;Committer;akr;1;10;4;14;0
c03265d8786e041ba99992435334278e2d0b3070;Sun Oct 04 17:06:02 EDT 2009;Committer;svn;1;2;2;4;0
e3fc29a71baf7282f6cb9c197ea4beb4e91ad670;Sun Oct 04 17:05:59 EDT 2009;Committer;matz;3;26;10;36;0
0e260ef1223038c55f819b49e7d7dd8a7be4c9a6;Sun Oct 04 13:25:49 EDT 2009;Committer;xibbar;3;9;0;9;0
f6f89b880a80c1f47e6fcb6caf46d6ed35da3089;Sun Oct 04 10:30:56 EDT 2009;Committer;nobu;3;147;76;223;0
f517fb54c76e2510b9bc0167ad64a5726bd3926c;Sun Oct 04 06:00:33 EDT 2009;Committer;nobu;2;7;3;10;0
45306441865722cb1ea2a08c514b743ce5d512aa;Sun Oct 04 05:44:27 EDT 2009;Committer;akr;1;4;0;4;0
c3721fdcfc72e63610f074f396422bdbae8a45da;Sun Oct 04 05:01:12 EDT 2009;Committer;nobu;2;8;2;10;0
47dfb32c43ad463bf62912613dde191594772816;Sun Oct 04 04:59:11 EDT 2009;Committer;nobu;1;1;1;2;0
da63c5ca4bc47a48d373aadaece69863f8b775eb;Sun Oct 04 04:55:23 EDT 2009;Committer;nobu;1;9;0;9;0
57940c032366f25ff118bb5b6c305fe103431e29;Sun Oct 04 04:53:57 EDT 2009;Committer;nobu;1;5;1;6;0
ea56a70eb81e8f7a859f854821481f1cfc18083d;Sun Oct 04 00:00:18 EDT 2009;Committer;akr;1;3;2;5;0
31959b52ef5e10ec94e692f976b91ea6e416db0e;Sat Oct 03 23:29:03 EDT 2009;Committer;akr;2;5;1;6;0
bd2eff81d8f6c96a8c709033717a8aa11cf2bfef;Sat Oct 03 20:43:45 EDT 2009;Committer;azav;1;4;0;4;0
85b326ac4207698bbab25c3679661cfe6e0b4e3d;Sat Oct 03 20:39:54 EDT 2009;Committer;nagai;2;26;0;26;0
7f80452c218d4a07f168c78e1dbce0e07091109d;Sat Oct 03 20:35:09 EDT 2009;Committer;azav;1;2;0;2;0
ae8ad5ae270e06b251d3ef412c9337919e9d6933;Sat Oct 03 16:15:23 EDT 2009;Committer;xibbar;2;17;3;20;0
19bad26c5a6af53ba792cc4ef153488a917254d6;Sat Oct 03 15:59:29 EDT 2009;Committer;nobu;67;70;80;150;0
78eaef0f8e8005b95c4931bd2eb0c48d52a74f1c;Sat Oct 03 15:40:20 EDT 2009;Committer;nobu;7;311;2;313;0
041fc407b0cd9c38f3b445e4be1db5beeeb3c016;Sat Oct 03 14:57:12 EDT 2009;Committer;nobu;2;55;55;110;0
74b58251362a5f991ed2e6f7af70dedf1df06bbe;Sat Oct 03 14:54:18 EDT 2009;Committer;nobu;3;14;15;29;0
746fe8af5a829061640e976039b7d905ed43bc98;Sat Oct 03 14:47:46 EDT 2009;Committer;nobu;27;38;38;76;0
664c7ef4f6de8b4f8a24021fb99da137ae18590b;Sat Oct 03 13:37:52 EDT 2009;Committer;nobu;1;2;2;4;0
72ad8595f2032cfcf73084083306eef909eb42a5;Sat Oct 03 13:14:19 EDT 2009;Committer;nobu;3;18;3;21;0
7b26a97142577b71b4ceb1ffe7ec640d55bdaaec;Sat Oct 03 12:57:54 EDT 2009;Committer;nobu;1;7;7;14;0
2957020491557bbf4c4aba2432f1b11581b0f4ab;Sat Oct 03 12:25:32 EDT 2009;Committer;nobu;1;6;7;13;0
9603cd2f627013d50a40419e2283752346a15c99;Sat Oct 03 12:19:19 EDT 2009;Committer;nobu;4;23;1;24;0
74926fefb7de9ade12ef1dbc4994efe981aaa55a;Sat Oct 03 10:18:14 EDT 2009;Committer;matz;3;67;12;79;0
51b89eeb03414636ed144841626f358ba6788303;Sat Oct 03 04:55:00 EDT 2009;Committer;marcandre;1;2;0;2;0
a21b7ddf26ed73dbb72c6403bd0c96d76f7410f0;Fri Oct 02 23:10:38 EDT 2009;Committer;akr;1;14;13;27;0
5bdef2f9849d8a6c3dd24cf3542d5296eff5c752;Fri Oct 02 23:02:04 EDT 2009;Committer;akr;1;1;1;2;0
b3525ae1e792e12e69f25d32962e8146d0b93f9b;Fri Oct 02 19:34:28 EDT 2009;Committer;nobu;2;12;8;20;0
719b0f8e3037e1033726b6487d7b0d9fc1412e7d;Fri Oct 02 19:07:55 EDT 2009;Committer;nobu;71;6679;72;6751;0
a0f667c33e24928374d494c9c33d0082355785e1;Fri Oct 02 17:59:25 EDT 2009;Committer;nobu;2;28;25;53;0
1a7825686111ac49e2a8ef020e0eceb4f8f4258d;Fri Oct 02 17:49:52 EDT 2009;Committer;nobu;2;3;3;6;0
c305c808e6cddd6b18aa8d164350cf59832781df;Fri Oct 02 17:48:20 EDT 2009;Committer;nobu;1;4;0;4;0
8d4ebdc8fe9225f8b4ad4e20fda2206756d2d664;Fri Oct 02 16:03:20 EDT 2009;Committer;naruse;2;1578;821;2399;0
8a99a39592a7cdea708183ee6b96f8d7f595eb1d;Fri Oct 02 16:01:05 EDT 2009;Committer;nobu;2;6;1;7;0
1457dca5d89487270554d7e90db8840780f2489f;Fri Oct 02 15:47:54 EDT 2009;Committer;nobu;3;59;448;507;0
7054856938ad771b32e612f480e4767977dcab3f;Fri Oct 02 15:45:09 EDT 2009;Committer;naruse;2;6;1;7;0
e66470a106108a591b52e708e95d36ab13e83b25;Fri Oct 02 15:31:05 EDT 2009;Committer;nobu;3;10;6;16;0
48eafcbc49cc216cd624530b4b7a721a2d768bdc;Fri Oct 02 13:37:41 EDT 2009;Committer;naruse;6;3766;22660;26426;0
2e70b9e70db553890d7f8f864c0c66b294c3c845;Fri Oct 02 11:50:11 EDT 2009;Committer;akr;3;48;18;66;0
aec8a4b0a4eb332140d363d5c81d00eae382ff6a;Fri Oct 02 11:37:44 EDT 2009;Committer;nobu;4;331;173;504;0
e9c728fea305bce19e712eeff9cc43d1994f069a;Fri Oct 02 10:54:31 EDT 2009;Committer;akr;1;12;0;12;0
56e358d5f96d30b31f27c0c39b8e2cc41c1f249d;Fri Oct 02 06:34:18 EDT 2009;Committer;nobu;2;7;1;8;0
c4b17fc135d1026a54caa9481150a0836bcd79de;Fri Oct 02 00:21:38 EDT 2009;Committer;svn;1;2;2;4;0
651a207d0919800aa8a4e83ccdfa0cc5ac9200e1;Fri Oct 02 00:21:34 EDT 2009;Committer;usa;2;5;9;14;0
4e389756ec95c11df4fba273aaf4b7967596bb68;Thu Oct 01 05:19:19 EDT 2009;Committer;usa;5;25;16;41;0
ceca5abce0f3645eec52335c0ac4b46e43801f06;Thu Oct 01 04:24:02 EDT 2009;Committer;svn;1;3;3;6;0
a93b36b3e5b71413112c6b06daf6664372b051bf;Thu Oct 01 04:23:59 EDT 2009;Committer;usa;2;6;2;8;0
9b192302ec9449d6374f681c005210c5a62d79ef;Wed Sep 30 08:32:43 EDT 2009;Committer;matz;3;26;9;35;0
a71d47a380026de99aa64e84684e556937aae521;Wed Sep 30 04:15:46 EDT 2009;Committer;nobu;5;37;3;40;0
331fdbe822046382c51eeddbd13ed81f90472402;Wed Sep 30 01:08:44 EDT 2009;Committer;naruse;1;1;1;2;0
b59109a84493f08ab1c8e5e8637597b5ac93270b;Tue Sep 29 16:38:00 EDT 2009;Committer;marcandre;1;3;0;3;0
40e50764f40f2020acae5c649fd02a1e86abef76;Tue Sep 29 15:37:28 EDT 2009;Committer;nobu;2;26;36;62;0
5b2d54be66528c659d8a29256d51f17e9955bc56;Tue Sep 29 15:02:59 EDT 2009;Committer;naruse;3;24;10;34;0
e8f007e6b84d4db4c547da1d4b96d163380a78f6;Tue Sep 29 15:00:32 EDT 2009;Committer;nobu;3;10;2;12;0
46313c96c7a3d081df9eb477f1ffc8a1bc8afc80;Tue Sep 29 14:17:34 EDT 2009;Committer;nobu;2;5;1;6;0
6ab0a7912513e6f6aab723ec4461135ff7100eca;Tue Sep 29 13:45:28 EDT 2009;Committer;akr;1;3;3;6;0
18a07e9d4b91e7ddd3b21d906ca2ab880cd01d64;Tue Sep 29 13:25:54 EDT 2009;Committer;akr;2;6;1;7;0
0eddab8404d3bd70d6542c800ff2a565b52ae8ad;Tue Sep 29 13:22:27 EDT 2009;Committer;akr;2;15;2;17;0
ad8978fdb171a6614375b7bd873b02b909485a31;Tue Sep 29 12:31:43 EDT 2009;Committer;naruse;2;9;3;12;0
42f0ea8c612015dfb57d53fd41bf7e0e4b7427bf;Tue Sep 29 12:21:16 EDT 2009;Committer;nobu;2;8;5;13;0
54bf027c91b1aff3a3e2a905ced202963023ec78;Tue Sep 29 12:13:26 EDT 2009;Committer;mame;1;1;0;1;0
c979cbfcf64e6ab8972eef0e733b7e6a346726dd;Tue Sep 29 12:11:29 EDT 2009;Committer;mame;2;6;2;8;0
dc087bf85da49b20ecb89e7806bb790f72c489a7;Tue Sep 29 08:02:47 EDT 2009;Committer;nobu;2;5;1;6;0
aed9218981a7f135801784dcf1187a1a30027e11;Tue Sep 29 07:03:11 EDT 2009;Committer;nobu;1;1;1;2;0
811c2d510066cc0b2021072b1e5c5853ce24a714;Tue Sep 29 06:59:42 EDT 2009;Committer;nobu;2;32;2;34;0
e6fb96e691aae4d004fa9a492048365876f68d64;Tue Sep 29 06:26:46 EDT 2009;Committer;nobu;3;71;20;91;0
f5654b4dfc881aba56535281a0979586afdf4aad;Tue Sep 29 05:47:21 EDT 2009;Committer;nobu;1;4;4;8;0
16969412b3def3661b7da4104609a770b1fbf898;Tue Sep 29 04:49:00 EDT 2009;Committer;nobu;2;6;4;10;0
1fe57a4b5d4d8673e9841f99b23d1935537a855a;Tue Sep 29 04:37:52 EDT 2009;Committer;nobu;3;22;2;24;0
5e4d04c36e33dc23a06cd6e5b53f5e7bef4394f7;Tue Sep 29 04:33:17 EDT 2009;Committer;nobu;1;1;1;2;0
00be97da7e260f3d801fe64c01c13dd820f6b1a8;Tue Sep 29 03:53:44 EDT 2009;Committer;nobu;1;27;0;27;0
b3854e7162a67aa9493d3ba7f6f552fda91f5b77;Tue Sep 29 02:19:58 EDT 2009;Committer;naruse;1;12;35;47;0
3058eec581ecfc3aba561b63913fa30ac4c94c6c;Tue Sep 29 00:34:06 EDT 2009;Committer;naruse;3;59;33;92;0
f7554133b2dd050585f0714cc2729edf6d9291f9;Tue Sep 29 00:34:00 EDT 2009;Committer;naruse;3;16;0;16;0
5d6696c90959600927e229c3b3fd3f9ffb9444d7;Mon Sep 28 23:27:17 EDT 2009;Committer;nobu;1;0;50;50;0
5f5706c38f3b9c727c55ea081e5110f423bcabda;Mon Sep 28 19:24:24 EDT 2009;Committer;naruse;2;7;1;8;0
e0af046ad04127f419b2b9696694eb2efca130fc;Mon Sep 28 19:24:18 EDT 2009;Committer;naruse;4;34;2;36;0
ff504d3cc96bf315b06c988c080ab47121ce3c41;Mon Sep 28 19:24:10 EDT 2009;Committer;naruse;2;11;0;11;0
9ebc378e9a60bea64ebe8173c5c46a8866f9e34e;Mon Sep 28 15:07:08 EDT 2009;Committer;nobu;3;20;5;25;0
4097c096e816580f77589d2ae0d2e6263c1ffa7d;Mon Sep 28 14:31:01 EDT 2009;Committer;nobu;2;13;3;16;0
fc831f638a3da7c0e6785197e7c35f8d30c2f128;Mon Sep 28 13:46:18 EDT 2009;Committer;nobu;2;44;19;63;0
b957eb25ff289133d278519dd4182510d1de14c1;Mon Sep 28 13:33:13 EDT 2009;Committer;nobu;2;5;1;6;0
51cefa387c187aaa01c1023d4017fb48f5a4e361;Mon Sep 28 10:37:41 EDT 2009;Committer;usa;2;6;1;7;0
9d7e47114cca19a355f1410f2b7b48f150f0858c;Mon Sep 28 10:08:46 EDT 2009;Committer;duerst;2;6;1;7;0
78070bd28ea17887c17f04514af97fff08caf0ba;Mon Sep 28 05:54:42 EDT 2009;Committer;nobu;1;2;2;4;0
bb3addfec48ecd394849ab0804d7d0805f9778d1;Mon Sep 28 03:15:53 EDT 2009;Committer;matz;1;18;0;18;0
102918a3ee06b30023e1b7c7fe1103179049c1d9;Mon Sep 28 03:09:16 EDT 2009;Committer;matz;6;43;18;61;0
438b28d3f7a3989cc01020d2f14f9b2cfb859e7c;Mon Sep 28 02:40:30 EDT 2009;Committer;usa;2;7;0;7;0
b07650769e112ecb33d1738eef4d61727183d9c7;Mon Sep 28 01:08:24 EDT 2009;Committer;naruse;3;12;4;16;0
ea229a855f3d12271aea16913ba3c2d78f0cc3ea;Sun Sep 27 16:32:53 EDT 2009;Committer;kanemoto;2;5;1;6;0
162862780e6da9092745776f927a3f2d9d1f4369;Sun Sep 27 16:26:33 EDT 2009;Committer;svn;1;2;2;4;0
10806f146fbed2a5c2204abe8a08729af1cbf907;Sun Sep 27 16:26:31 EDT 2009;Committer;kanemoto;2;9;1;10;0
9278fab680e2bbbe9e443ad8ef2cec631800de2e;Sun Sep 27 14:44:43 EDT 2009;Committer;akr;1;8;0;8;0
4319c0235d129e9a535432703e38a032fcf33e8f;Sun Sep 27 04:08:31 EDT 2009;Committer;akr;3;34;2;36;0
37c552e550f5fa51435f7f6f1efcd4d3479b5df4;Sun Sep 27 03:01:44 EDT 2009;Committer;nobu;2;9;6;15;0
fd58dba97ff5f14dc3455fbea20a7a47dfde5983;Sun Sep 27 02:58:37 EDT 2009;Committer;nobu;2;4;8;12;0
59358185161c3c96cf9bcca75b522efb910dedeb;Sun Sep 27 02:58:24 EDT 2009;Committer;nobu;2;5;1;6;0
50bbca9d5c04f682f9146cef4602a03967d6238e;Sun Sep 27 02:28:57 EDT 2009;Committer;akr;2;97;73;170;0
0ff9cf362531322c10312a5df5d709a91a601c2b;Sun Sep 27 01:58:07 EDT 2009;Committer;akr;1;2;2;4;0
810775bb203c3a7f1cac0e71f33be69e0556f674;Sun Sep 27 01:21:18 EDT 2009;Committer;nobu;2;6;2;8;0
6bf6f3d4c4a256a01f365481c71579afc4d0aa17;Sun Sep 27 00:17:48 EDT 2009;Committer;nobu;1;1;1;2;0
e662770dc990a29c0182e8d043b6a5d72cc53f9c;Sat Sep 26 20:37:06 EDT 2009;Committer;naruse;2;9;3;12;0
036c701bad168a86fd834c2b1a6ec102556963a0;Sat Sep 26 20:17:52 EDT 2009;Committer;naruse;2;45;31;76;0
45dc99aea48338b59be903cf22376959886f8155;Sat Sep 26 19:39:23 EDT 2009;Committer;azav;1;8;0;8;0
7150182237c2b80b059adc5570b38ddaf7a481bd;Sat Sep 26 19:35:12 EDT 2009;Committer;azav;1;2;1;3;0
6b2942688ce5ab85c1278a845c652009ef0b66f4;Sat Sep 26 19:34:53 EDT 2009;Committer;azav;1;2;2;4;0
92d4a6d5166a78dcee21292ecbdd128130694612;Sat Sep 26 19:34:27 EDT 2009;Committer;azav;1;0;41;41;0
6ed425d55b45cfbca9f03e6083ac35622e694653;Sat Sep 26 17:02:43 EDT 2009;Committer;ko1;3;11;11;22;0
3ca245a54c7d4a65ada9dfdff46b8875f6a4ee39;Sat Sep 26 14:59:09 EDT 2009;Committer;matz;2;6;1;7;0
f2103ee4a99c8a6ad7498dc500e214406ee47472;Sat Sep 26 14:29:13 EDT 2009;Committer;nobu;5;284;241;525;0
e860f30bf172866c347263b8d0e29342c83f56a4;Sat Sep 26 14:27:25 EDT 2009;Committer;azav;1;4;0;4;0
38473866bfdf771a62ccc948e7abee5248bdf843;Sat Sep 26 14:26:54 EDT 2009;Committer;azav;1;0;1;1;0
0ed8771a4400f005f084c92d1779bd306abd1c73;Sat Sep 26 13:42:56 EDT 2009;Committer;yugui;3;9;2;11;0
25f43f4ab11d3ad8e6a999605a8d8a25b6441dc4;Sat Sep 26 08:53:15 EDT 2009;Committer;nobu;2;53;10;63;0
bf4ab7f61041165b6de5100c814b6ef1f9107d83;Sat Sep 26 07:48:33 EDT 2009;Committer;nobu;2;91;70;161;0
836724583916b503e1b84dbd96903daeee6ef2ab;Sat Sep 26 07:32:03 EDT 2009;Committer;nobu;2;6;4;10;0
f23486592ab9dd3b29dcf6f4f924cd7306e4fc65;Sat Sep 26 07:26:46 EDT 2009;Committer;nobu;2;9;4;13;0
3a4e1d768d67f10c75178730b28d59d6cca732c4;Sat Sep 26 04:27:07 EDT 2009;Committer;marcandre;2;9;0;9;0
dd7490d50d77d4f58a5282106accc676d2dfe25a;Fri Sep 25 23:45:52 EDT 2009;Committer;nobu;2;3;3;6;0
f833dd2e24b821c083385863dc552bd847ce85c9;Fri Sep 25 23:36:34 EDT 2009;Committer;ko1;2;7;2;9;0
5cc06ae864c19f5b1d8fd6a3fa3544db688f5e36;Fri Sep 25 18:29:55 EDT 2009;Committer;svn;1;2;2;4;0
fdb3e278f52e0375c9eaa75df0a12c8e17f5fe58;Fri Sep 25 18:29:53 EDT 2009;Committer;akr;1;18;15;33;0
d70e9a5568f9e5c9bb16b521b44bb558b96893b1;Fri Sep 25 07:04:25 EDT 2009;Committer;usa;4;24;3;27;0
9d72cb269cfc3765d30e67c36a4eb1e40e7f570d;Fri Sep 25 04:48:54 EDT 2009;Committer;nobu;3;5;5;10;0
a943745a4234ef774f28ac9b87c5e4fe94ee96bb;Fri Sep 25 04:05:51 EDT 2009;Committer;nobu;2;5;4;9;0
66a97945e30119503b43d0d2b8dde62c961c3c17;Fri Sep 25 04:04:48 EDT 2009;Committer;nobu;3;21;3;24;0
8be423f51d56f92cf8a16fab02bcfebda5c409c0;Fri Sep 25 03:36:26 EDT 2009;Committer;nobu;1;1;1;2;0
44f7a34031fd02bcb740c7ca6afa19274531c7c1;Fri Sep 25 03:33:26 EDT 2009;Committer;nobu;1;12;0;12;0
2c549ad5d348980b97e80e82492511262a9c6308;Fri Sep 25 02:56:52 EDT 2009;Committer;nobu;2;3;3;6;0
bc7123e4346c373dcf428fa67caef4dc07a199c9;Fri Sep 25 02:51:36 EDT 2009;Committer;nobu;2;11;3;14;0
ff54193c835c97bebe5e6026a05a622ca5852071;Thu Sep 24 21:05:35 EDT 2009;Committer;ryan;1;3;2;5;0
608267e04c11f4fc9b7823d95317a71be33a614c;Thu Sep 24 20:59:19 EDT 2009;Committer;marcandre;1;2;2;4;0
0618ca3d8de58c05a16b459cc4c65b9116655e63;Thu Sep 24 18:56:22 EDT 2009;Committer;marcandre;1;2;3;5;0
64588c64167ad8d6c3f4c2fff16b6f1fc5dd79d2;Thu Sep 24 18:36:53 EDT 2009;Committer;svn;1;2;2;4;0
fc01d426001698de73d311ecfdac81657e0bc237;Thu Sep 24 18:36:52 EDT 2009;Committer;marcandre;1;6;6;12;0
e6f4473316c528d4db8d131e6c08fc61cb478e69;Thu Sep 24 10:35:35 EDT 2009;Committer;akr;1;48;18;66;0
c4b0b4c91c54b58b02cf94b25d6127b9c3777996;Thu Sep 24 04:42:28 EDT 2009;Committer;matz;3;62;0;62;0
399dace5edc9380b66d709108195c71fc418f1ab;Thu Sep 24 00:42:23 EDT 2009;Committer;marcandre;3;10;4;14;0
089494fcd12497e872008a711a189f2f55fc0206;Wed Sep 23 19:45:37 EDT 2009;Committer;marcandre;1;18;2;20;0
39ea1c8c7c68e2b09c5d2b8641f049f702ca9805;Wed Sep 23 17:21:26 EDT 2009;Committer;nobu;3;13;15;28;0
1ef3ac47384e27817f45864f65162fbc04a5d12f;Wed Sep 23 17:08:37 EDT 2009;Committer;nobu;2;11;1;12;0
12fcef8829b9f514a517c606bd783eaffb401318;Wed Sep 23 16:18:59 EDT 2009;Committer;kanemoto;2;8;3;11;0
8a52a566fe28487cd7c23fa989c5332fe93fbc98;Wed Sep 23 15:19:16 EDT 2009;Committer;svn;1;2;2;4;0
fc58a6c5bd4b5cc73ca9525c0707d041acf86e2b;Wed Sep 23 15:19:13 EDT 2009;Committer;akr;2;140;36;176;0
7728a17a27f9b9eeac9bc2ec04e54dd6fd3b3160;Wed Sep 23 14:01:07 EDT 2009;Committer;akr;3;14;2;16;0
8c3926aea0d782d28fc42ca8d391ce7ec9533e31;Wed Sep 23 12:25:20 EDT 2009;Committer;nobu;2;15;0;15;0
98b0d9f9224bdf4aaf9487ca9a0af216bc6f9cc1;Wed Sep 23 11:30:09 EDT 2009;Committer;akr;1;2;1;3;0
d3c6462788dc69c74f29e76007448cd4e4e787d2;Wed Sep 23 11:24:51 EDT 2009;Committer;akr;1;2;0;2;0
945f4df6a8c9eadd9b17558b2b374110b5ac3128;Wed Sep 23 08:46:44 EDT 2009;Committer;matz;2;36;10;46;0
bda0b012a8ced5b7db0fa5225b5da2a2ebb86aee;Wed Sep 23 08:08:32 EDT 2009;Committer;nobu;3;28;2;30;0
eb5692ab32a7c4dc41de16e6d37b2e69c44ef402;Wed Sep 23 04:17:16 EDT 2009;Committer;nobu;1;8;7;15;0
bb099046911374a63d73fb9d7bac04ee096f4253;Wed Sep 23 04:16:41 EDT 2009;Committer;nobu;1;52;51;103;0
1b541acd691d517fa5a09b4a5bbca129cc7a1e74;Wed Sep 23 04:14:23 EDT 2009;Committer;nobu;4;28;4;32;0
5a993c5d220bca6eb8b5a8a3afe842f28140508c;Wed Sep 23 03:39:44 EDT 2009;Committer;nobu;1;9;9;18;0
a97e80ba74c98853c71ea9efc258487987057867;Wed Sep 23 02:28:08 EDT 2009;Committer;nobu;3;35;4;39;0
92304aa3cd52a390383661c69622195247098deb;Tue Sep 22 20:04:59 EDT 2009;Committer;marcandre;2;13;4;17;0
78ddb4f60306152a3f72971eb49177f3e9665734;Tue Sep 22 19:02:42 EDT 2009;Committer;marcandre;1;1;1;2;0
e12b255cfc0e7bf42debdbd57e21fd04e115a089;Tue Sep 22 18:53:27 EDT 2009;Committer;svn;1;2;2;4;0
8b871e67c159dd7baefd951e82c50ae9d03393e6;Tue Sep 22 18:53:25 EDT 2009;Committer;marcandre;1;1;1;2;0
aa78c979e1ec80372c6389b0be124461412aba30;Tue Sep 22 13:11:21 EDT 2009;Committer;nobu;1;13;13;26;0
7fd7e4a98b3b2deb221a7ab4833d7bd855bc01f8;Tue Sep 22 12:16:19 EDT 2009;Committer;nobu;1;1;1;2;0
fe92b9a75bfc4fab595fc31b6a57f2765ddb85c6;Tue Sep 22 07:34:35 EDT 2009;Committer;nobu;2;6;2;8;0
46970b2d1d716c21784987f3a6daae181cb10b6a;Tue Sep 22 07:28:43 EDT 2009;Committer;nobu;3;23;19;42;0
01f3f86472c02fcf1ac456549de440361553e9c0;Tue Sep 22 07:27:51 EDT 2009;Committer;nobu;2;6;3;9;0
62f073a3864ab89cbb0a1995100b85a1686ddfb8;Tue Sep 22 07:26:22 EDT 2009;Committer;nobu;2;17;10;27;0
476b3d8f3fb238ebea44f65e4b544c06ee8690d2;Tue Sep 22 07:14:09 EDT 2009;Committer;nobu;1;2;2;4;0
bf3edb979f48529322a8bcf94d4f0b9a702e9cc3;Tue Sep 22 07:11:45 EDT 2009;Committer;nobu;2;5;1;6;0
475074d5daca27d3cfd2e475d90fa91246c1f25c;Tue Sep 22 01:35:53 EDT 2009;Committer;akr;3;401;0;401;0
089beb67bd92bd974091bf9cfbbdf4d7151ebd6e;Mon Sep 21 21:08:23 EDT 2009;Committer;nobu;1;1;1;2;0
fe1ce93f52827f59c069247a6e5998c3a5f907b8;Mon Sep 21 20:58:26 EDT 2009;Committer;nobu;17;132;118;250;0
2c34b66e24f1992e2ceca0b8a8f3d710f05f21ae;Mon Sep 21 20:04:10 EDT 2009;Committer;nobu;3;8;1;9;0
51132a8ad9b207d3f4e17671339885aa3a932692;Mon Sep 21 20:00:21 EDT 2009;Committer;nobu;1;3;3;6;0
c1f1b452cb5ec2fadf693817c930ff2741bcd477;Mon Sep 21 19:56:20 EDT 2009;Committer;nobu;5;10;0;10;0
178dafefa9057ea0eb16e89d5f703e6077b2ddab;Mon Sep 21 19:49:32 EDT 2009;Committer;nobu;3;42;42;84;0
d9bfa822ea7e23dcc0dd1572773495419d89e145;Mon Sep 21 19:47:39 EDT 2009;Committer;nobu;3;24;0;24;0
92fd1940fee3870c89b2e0424a55cdb0f95c3a71;Mon Sep 21 19:43:43 EDT 2009;Committer;nobu;3;10;2;12;0
c3cd2816aec210d9ff6cd5f16e409925c17649ad;Mon Sep 21 19:42:26 EDT 2009;Committer;nobu;1;2;2;4;0
52999632d78f6ee8d30496e04a595ceaf9ed3ff0;Mon Sep 21 17:42:37 EDT 2009;Committer;marcandre;1;1;4;5;0
ae86e1523007a271a8099ab8fdb06b3eb522a1bc;Mon Sep 21 16:13:35 EDT 2009;Committer;marcandre;2;6;1;7;0
3eb37951b6322bd87bf3ad2ebe0498ff05595cc8;Mon Sep 21 16:12:49 EDT 2009;Committer;svn;1;2;2;4;0
cf69eeab9cb15220d73d371bbadb9bde1681af47;Mon Sep 21 16:12:46 EDT 2009;Committer;marcandre;2;15;0;15;0
2d8a79fa473151d5972c8f72d6b73de98081a14a;Mon Sep 21 11:06:32 EDT 2009;Committer;nobu;2;19;0;19;0
f331b5584edbf106ab85f4663ddbe55031176b3a;Mon Sep 21 08:12:12 EDT 2009;Committer;nobu;4;31;13;44;0
3a7c1e25c4f88d6cdfc6c9978aa6811dc548119b;Mon Sep 21 01:13:24 EDT 2009;Committer;nobu;2;18;6;24;0
cd4f59bc5e32c71fcef679ebdbd750c7d2ed5f5e;Sun Sep 20 15:07:38 EDT 2009;Committer;nobu;4;116;7;123;0
970ec9c02d683b86ca90dc6e63f3c1b4d8226960;Sun Sep 20 07:27:41 EDT 2009;Committer;nobu;1;33;33;66;0
7e41fabc7e3da12af251c23e408be4bd05a1314d;Sun Sep 20 02:14:05 EDT 2009;Committer;svn;1;2;2;4;0
0ebfc1348bdf3f571e15438fb6cea1c4e71aae29;Sun Sep 20 02:14:02 EDT 2009;Committer;marcandre;3;63;31;94;0
8892dd725744f2b58afefedb6640e28a6ff83872;Sat Sep 19 08:46:48 EDT 2009;Committer;nobu;2;16;0;16;0
a1485dbea0024a5a263b40843f7af95e9c72925c;Sat Sep 19 08:33:01 EDT 2009;Committer;nobu;5;29;1;30;0
bdde51172cbf2754f6bbaa9e1678fbcc3d689dba;Fri Sep 18 15:42:59 EDT 2009;Committer;nobu;1;88;0;88;0
ffcd041c7ae83d7844c0f485c49e1183903ecf29;Fri Sep 18 15:17:17 EDT 2009;Committer;nobu;1;45;40;85;0
01826ed8d554406ddb24f67629016ca13ff66174;Fri Sep 18 15:02:23 EDT 2009;Committer;svn;1;2;2;4;0
21367ae07716096ba4a9263b0d9aee22d15ebffa;Fri Sep 18 15:02:21 EDT 2009;Committer;nobu;2;6;0;6;0
06e52ba57b62d2661b4cab842b583fb4137e44de;Fri Sep 18 14:59:29 EDT 2009;Committer;nobu;2;6;1;7;0
1aa21e630faab9d1d99f686d98e9b951c0b39488;Fri Sep 18 14:51:18 EDT 2009;Committer;nobu;3;19;4;23;0
d36c76dc71b47b201707185b8a0b4264e83de205;Fri Sep 18 07:29:17 EDT 2009;Committer;nobu;7;97;14;111;0
868684096079f3e786df517714fe6d795c4647b6;Fri Sep 18 07:15:06 EDT 2009;Committer;nobu;4;19;6;25;0
6200f424a721981d739410ea3937990e3831bc7d;Fri Sep 18 07:06:29 EDT 2009;Committer;nobu;2;13;3;16;0
f2b68df43ef25133dcc954a802a9b41ad2897552;Fri Sep 18 02:20:39 EDT 2009;Committer;nobu;1;75;55;130;0
d7f76f84d923ac8c7ef585e1f43fc0d691625377;Fri Sep 18 01:11:55 EDT 2009;Committer;nobu;2;586;583;1169;0
96ac19481183e11bd12ca0a704d90e415c4b3954;Fri Sep 18 01:11:30 EDT 2009;Committer;nobu;2;86;0;86;0
2f2d213f7ee95493386442a538bd1190c1aad410;Fri Sep 18 00:03:18 EDT 2009;Committer;nobu;1;2;5;7;0
0e62186da2f49a6ef1351a7c5aa61e941589c1bf;Fri Sep 18 00:02:51 EDT 2009;Committer;nobu;1;4;1;5;0
70f03998c098c430f489b71b8bd59f5ebc0974f8;Fri Sep 18 00:02:35 EDT 2009;Committer;nobu;2;7;2;9;0
263abf2963fe089db9a7870be72f30edec13448e;Thu Sep 17 22:08:32 EDT 2009;Committer;kazu;2;9;0;9;0
44cbd89f7cd99770a1b5cea5408fc42a7597f871;Thu Sep 17 22:08:27 EDT 2009;Committer;kazu;1;3;3;6;0
12fc299a84aa96e5efd1f77e81b28631ba988ee5;Thu Sep 17 21:47:14 EDT 2009;Committer;nobu;2;10;3;13;0
80464f8f2ad91003c05a3ea84e2c1ab824ec2662;Thu Sep 17 21:36:53 EDT 2009;Committer;nobu;2;8;5;13;0
9312426c1ea240c4a2e938976d3f4c8f2f155e6a;Thu Sep 17 21:34:24 EDT 2009;Committer;nobu;3;7;3;10;0
0cb17717fe3ce324376255efb759fdf8f94e0929;Thu Sep 17 09:34:20 EDT 2009;Committer;nobu;2;10;1;11;0
c8c6fde56f84c4fd26ade4268376279c65266949;Thu Sep 17 06:44:28 EDT 2009;Committer;ko1;2;5;1;6;0
554e9a83e02b00d97870432c82267fc63c469c5f;Thu Sep 17 06:03:39 EDT 2009;Committer;ko1;4;9;467;476;0
76fa0d6615c4d3fbfa3eddc7aab7a94bb08d827f;Thu Sep 17 04:51:33 EDT 2009;Committer;nobu;1;50;0;50;0
a289f7a4b143fd227b503f85af939ecd47491167;Thu Sep 17 04:50:52 EDT 2009;Committer;nobu;2;12;1;13;0
c922e508049ebd8a36be0b86d512375c26b19ee7;Thu Sep 17 04:12:38 EDT 2009;Committer;nobu;4;586;585;1171;0
5a45c08ef25cc41d7c6889edc38529a74cc4280d;Thu Sep 17 04:06:18 EDT 2009;Committer;nobu;1;2;3;5;0
63c7ca40d8320a5b4ecb373de69d65db49bc1122;Thu Sep 17 00:40:49 EDT 2009;Committer;naruse;4;598;0;598;0
6023a79deb6a9833542ee1a15666a0589b05fa1c;Wed Sep 16 21:04:07 EDT 2009;Committer;marcandre;2;8;2;10;0
d09cde1861e2aecec2bed10895adab489e3d5f99;Wed Sep 16 21:02:54 EDT 2009;Committer;marcandre;2;29;46;75;0
56070dbb561509e3ee98a6abb187a5b061594fc7;Wed Sep 16 15:36:33 EDT 2009;Committer;svn;1;2;2;4;0
87105a7da42714b6999246ae2e5c152d9f5ae333;Wed Sep 16 15:36:30 EDT 2009;Committer;akr;2;5;1;6;0
5529a03271d1b4dffb04388e573f8173aa653f4e;Wed Sep 16 10:33:14 EDT 2009;Committer;matz;2;5;9;14;0
89c3fbd1ab6b656ccae3e18612a65fb7aaac80e7;Wed Sep 16 08:43:07 EDT 2009;Committer;usa;1;5;0;5;0
2b222204a3369c7f52ac4dbba7dfab9819fa4838;Wed Sep 16 08:42:48 EDT 2009;Committer;usa;1;4;3;7;0
405cfda0d225cca0a87ee51d8380a11b336b0b8c;Wed Sep 16 08:24:15 EDT 2009;Committer;marcandre;2;5;1;6;0
e353346e14fd765b9ecab512025e25471ba1d762;Wed Sep 16 08:06:24 EDT 2009;Committer;usa;1;1;1;2;0
8b70b92841e5d59c22fba0ee0754b0b71d8dc9c2;Wed Sep 16 08:00:07 EDT 2009;Committer;usa;2;6;2;8;0
4a21a410d60014079be85f074d64624402a10016;Wed Sep 16 07:27:58 EDT 2009;Committer;usa;2;5;0;5;0
99b41f385825f48d81195ebe19ddd189472c98c3;Wed Sep 16 07:20:19 EDT 2009;Committer;nobu;5;60;13;73;0
193a7db4e25beeb1b7932581323848258400cc34;Wed Sep 16 07:17:22 EDT 2009;Committer;marcandre;1;3;3;6;0
52c3721af3bcb194d9525699342e143b969296b5;Wed Sep 16 04:39:51 EDT 2009;Committer;marcandre;2;6;1;7;0
c3db24a4dcb96ccf2adc33da51b58e476bbf450d;Wed Sep 16 04:39:37 EDT 2009;Committer;marcandre;1;8;10;18;0
9d3638448e0d11ba9e4bd1941934c21cf09edc91;Wed Sep 16 04:36:37 EDT 2009;Committer;marcandre;2;55;77;132;0
af424b17a07b3d78cd7ee8b01edcf1e7a6077d8e;Wed Sep 16 04:16:19 EDT 2009;Committer;usa;2;5;1;6;0
43be7b67c88c35f2de822a54ada0e75dfdea6f2d;Wed Sep 16 01:14:56 EDT 2009;Committer;nobu;3;30;1;31;0
e0976d1a6d3b6ce7c24d66831124e0a166d34de5;Wed Sep 16 01:12:58 EDT 2009;Committer;nobu;2;5;1;6;0
1796522f10e4bee3db8df77fa66f749084592285;Tue Sep 15 21:30:50 EDT 2009;Committer;marcandre;9;133;45;178;0
6a54d4b6fe2cc397716080a01394f75c6b6cfb4a;Tue Sep 15 21:18:04 EDT 2009;Committer;marcandre;2;29;32;61;0
dad5135d269217d1cfca35cd16d51c93e3565423;Tue Sep 15 15:42:42 EDT 2009;Committer;svn;1;2;2;4;0
1e69e441cd58fcef1e190015caddba20171a5902;Tue Sep 15 15:42:41 EDT 2009;Committer;marcandre;1;13;10;23;0
2c7d6b50e479d47643356a3a99f68d0914b1a237;Tue Sep 15 12:48:54 EDT 2009;Committer;akr;2;4;14;18;0
840fd72f33fc24f7e6f89f1acf699587903e360b;Tue Sep 15 06:30:07 EDT 2009;Committer;usa;2;6;1;7;0
4d3dac97ad54527e5cd150ff74865523ef614020;Tue Sep 15 06:16:16 EDT 2009;Committer;nobu;3;7;1;8;0
e455e85f720d87f6cdac0eff22ca21b0536c736a;Tue Sep 15 06:11:13 EDT 2009;Committer;usa;2;8;3;11;0
a8154060ab975888988607aad0ea6e9eceb120a9;Tue Sep 15 05:27:29 EDT 2009;Committer;naruse;3;18;4;22;0
c59abe419d77c6e9346467f47d9b2e60bd45d7fc;Tue Sep 15 03:12:28 EDT 2009;Committer;nobu;2;7;1;8;0
f9b71b888ca77739cbffd79709bef1289cccaf3f;Tue Sep 15 03:01:28 EDT 2009;Committer;nobu;2;9;0;9;0
3c4380ad25c26a8b4349df4f1296286517aa3118;Mon Sep 14 21:43:00 EDT 2009;Committer;nobu;2;18;5;23;0
68d8a2a47460c488a778d904d6a1591190efe064;Mon Sep 14 21:24:39 EDT 2009;Committer;nobu;3;45;37;82;0
6b34fa44aa3962c8d34f838b13602772cb384968;Mon Sep 14 19:25:05 EDT 2009;Committer;nobu;2;5;1;6;0
4fadea5aa467a23795152f66ba561d11ab8e08db;Mon Sep 14 18:10:04 EDT 2009;Committer;svn;1;2;2;4;0
5860ba548efab9a6561eab7209dac2fd54e18fb3;Mon Sep 14 18:10:00 EDT 2009;Committer;matz;3;13;7;20;0
9f5870b23ef473801d1390ff43adf5d275b8f485;Mon Sep 14 07:57:36 EDT 2009;Committer;nobu;1;2;0;2;0
4f041dafbef3cbc3c5891cb142b00901f90b827b;Mon Sep 14 07:39:16 EDT 2009;Committer;nobu;5;81;78;159;0
3ab03a234df4964ac02a2b9e462b6cb18b423865;Mon Sep 14 02:23:47 EDT 2009;Committer;nobu;4;13;5;18;0
d937bbe9cecd6fe294f21210a5c77e57c2af3e62;Mon Sep 14 02:05:17 EDT 2009;Committer;nobu;1;4;1;5;0
976c4de36300b4efa1252cef42d1fa80c9a59d7b;Mon Sep 14 01:56:41 EDT 2009;Committer;nobu;2;10;0;10;0
e4259b7cc5e8993483da4ff9785db47e41e73bba;Mon Sep 14 01:44:48 EDT 2009;Committer;nobu;2;6;1;7;0
011776b4a63f665858522b5e35493e74ac65ef94;Mon Sep 14 01:11:05 EDT 2009;Committer;naruse;2;6;2;8;0
d8e8849e352b7b208c071e63acceb9131fe84969;Mon Sep 14 01:01:19 EDT 2009;Committer;usa;2;68;62;130;0
b09845fa70a1ddbb62d454e4b385bdcdc2438a31;Sun Sep 13 23:35:09 EDT 2009;Committer;marcandre;2;11;1;12;0
5904f64dbf9b8d78c8431e6ac19663624cbe599e;Sun Sep 13 22:36:45 EDT 2009;Committer;marcandre;2;18;6;24;0
a0c569a378389e58b5f54389acf3a83a78ea51ed;Sun Sep 13 20:30:46 EDT 2009;Committer;marcandre;2;6;1;7;0
8ef3af646f42384cbbd0de83415b1e405ae2393a;Sun Sep 13 19:09:36 EDT 2009;Committer;marcandre;2;14;7;21;0
242e2aaec2d0e755a54c3cc4c99d2c4d9046f4db;Sun Sep 13 17:59:49 EDT 2009;Committer;akr;1;2;1;3;0
119e97479df5970090031589b53909165ea19b8f;Sun Sep 13 17:37:51 EDT 2009;Committer;azav;1;7;0;7;0
b2f8eaa444731eb3cafe4a7fb4e486ffb89a2666;Sun Sep 13 17:37:14 EDT 2009;Committer;azav;1;7;2;9;0
367ec2f8c93a98714d2953704c3ecc769d0f301d;Sun Sep 13 17:36:46 EDT 2009;Committer;svn;1;2;2;4;0
2cd7b07fdc0d03b15ae7fbff71a35161b51d3f88;Sun Sep 13 17:36:44 EDT 2009;Committer;azav;1;1;1;2;0
283189807cc0f384fa235de7f70a1536d830aff7;Sun Sep 13 13:18:35 EDT 2009;Committer;nobu;2;19;14;33;0
476a0355db8eb2e80dfd0cae6fcfd9c0a4490409;Sun Sep 13 12:28:00 EDT 2009;Committer;suke;2;24;31;55;0
6f0b0701d018de38b975a2651953819eb9176185;Sun Sep 13 11:58:52 EDT 2009;Committer;suke;2;27;31;58;0
a39f4e5cf6555d635815336e1b4fc467b0a4c6b9;Sun Sep 13 11:18:51 EDT 2009;Committer;nobu;2;14;9;23;0
1c75c0e28c58dcd4575798a5ba9789c15899b440;Sun Sep 13 10:42:24 EDT 2009;Committer;suke;2;10;48;58;0
bc832b8e5bdf394e7de631102e9bf27668c19b1a;Sun Sep 13 10:38:36 EDT 2009;Committer;nobu;2;5;1;6;0
04d1998ff875a0c2400b221098f44505ecef7d9b;Sun Sep 13 10:34:35 EDT 2009;Committer;nobu;1;1;0;1;0
6b607921355deb6bd7e99aadedbb29856571b4c8;Sun Sep 13 09:51:04 EDT 2009;Committer;nobu;1;10;0;10;0
231fdd86aebdda64101574614451db4fa7853633;Sun Sep 13 09:48:45 EDT 2009;Committer;nobu;3;6;2;8;0
98697d36171a97854458caa78417ab26dc1af83e;Sun Sep 13 05:46:38 EDT 2009;Committer;akr;1;6;6;12;0
60f545e2ac740677ceab64cf897acb09bbd48caf;Sun Sep 13 05:09:15 EDT 2009;Committer;nobu;2;6;4;10;0
8b0cb325f5185df80e6ef3a80683144e6e052380;Sun Sep 13 04:45:54 EDT 2009;Committer;marcandre;2;89;59;148;0
b516046d8e610e37186023fed109c05d51650a2e;Sun Sep 13 04:15:06 EDT 2009;Committer;nobu;1;1;1;2;0
df3ae4e2b57431a6d2e85e97c997d9b96b4dcb41;Sun Sep 13 03:10:24 EDT 2009;Committer;nobu;1;1;1;2;0
8d0bcdb016eddecde0852b3336dbab7011b62dcf;Sun Sep 13 03:07:51 EDT 2009;Committer;nobu;2;4;2;6;0
73b86a9be902cb89bbf63e0ccd974922a3a39309;Sun Sep 13 03:04:53 EDT 2009;Committer;nobu;2;76;13;89;0
35e17cbe214a6cd81122aa1a8dfa8c0d832f093d;Sun Sep 13 02:43:52 EDT 2009;Committer;nobu;1;4;4;8;0
0cde80d36a498655f3a6cdc792130e7f39fbe776;Sun Sep 13 02:29:47 EDT 2009;Committer;akr;3;119;16;135;0
a8998030fbabc0f604f82350a0767002a86f6068;Sun Sep 13 00:38:07 EDT 2009;Committer;nobu;2;10;2;12;0
63b231cea0389dd9c8b9ae471b89ab0c1395d4d4;Sun Sep 13 00:34:11 EDT 2009;Committer;nobu;2;7;1;8;0
831396217aab4e28f441085495ffb8e10d6e9828;Sat Sep 12 23:36:29 EDT 2009;Committer;suke;2;195;64;259;0
6f817b6dd2d0c749a6657077845331130a1fa4da;Sat Sep 12 17:16:27 EDT 2009;Committer;ko1;4;25;14;39;0
6bbed0e31b1d32808443b3dd3e451aad28d46096;Sat Sep 12 17:00:51 EDT 2009;Committer;naruse;7;7;35;42;0
945b604e3adc16aaf421a6df80d40a00a70a9226;Sat Sep 12 16:33:44 EDT 2009;Committer;akr;1;2;2;4;0
0466f33486635fe69c9ce1eeb900079bf0a3c0a4;Sat Sep 12 16:26:05 EDT 2009;Committer;akr;1;25;0;25;0
db2be749b470c28f1feee7d33d5774a3ed6cb36b;Sat Sep 12 16:18:03 EDT 2009;Committer;akr;3;66;2;68;0
c8f61740086a69ccff5af780c0fd884a15cb35cc;Sat Sep 12 15:52:03 EDT 2009;Committer;nobu;1;6;0;6;0
97c3bad4782be995863b778afe189aea42b8afc6;Sat Sep 12 15:46:42 EDT 2009;Committer;nobu;2;21;22;43;0
33d5c137751b8dba342beb8b9f7e200a6531df35;Sat Sep 12 15:34:35 EDT 2009;Committer;akr;1;29;0;29;0
a5971a12822f3de95ba975acbe3774a8fbabe589;Sat Sep 12 15:31:43 EDT 2009;Committer;nobu;1;1;1;2;0
2fcdd7e080dffb39ad472a491e34be84099bc7b5;Sat Sep 12 15:27:59 EDT 2009;Committer;nobu;2;15;14;29;0
0ab4b21d8159bd09d211652f8cb9e884613f8ff2;Sat Sep 12 15:22:44 EDT 2009;Committer;akr;1;61;28;89;0
efa4ed8cce22b7b8e5b347b8f7e624a11e1d885f;Sat Sep 12 15:21:03 EDT 2009;Committer;nobu;3;16;17;33;0
d7feab06ccaacff4e673f22e55a9b8f537fa89ba;Sat Sep 12 15:03:02 EDT 2009;Committer;nobu;4;36;5;41;0
797749c21938b27098d758a2d837b42996c0c310;Sat Sep 12 14:19:58 EDT 2009;Committer;akr;1;55;0;55;0
188e9667dc10a922a827bcf3cfe9f62aec0bcc5c;Sat Sep 12 13:49:07 EDT 2009;Committer;akr;3;46;1;47;0
c35f659524131bfd04be93d1cd9e4508f687ec8c;Sat Sep 12 11:56:12 EDT 2009;Committer;akr;1;11;0;11;0
5ee445bc0c978076946de998e62193ccaa9b29dd;Sat Sep 12 11:07:05 EDT 2009;Committer;akr;2;44;6;50;0
f34cf072a4bcb135e2cc099d6f9f5dd2cecda269;Sat Sep 12 09:50:57 EDT 2009;Committer;akr;3;654;378;1032;0
a4fbd748e24ff25af354d7e993adf5e8a6bacf0f;Sat Sep 12 08:31:44 EDT 2009;Committer;nobu;6;9;4;13;0
ffad7d737c0cec88ccb5c3ce59e59a2b7d6647ac;Sat Sep 12 03:47:18 EDT 2009;Committer;akr;1;15;7;22;0
8933356469fb87136f3df28c6ad9e3cf31959cce;Sat Sep 12 03:11:49 EDT 2009;Committer;akr;1;54;0;54;0
433219bced8ff7a0f20c11371ffa7f32b76c5dcf;Fri Sep 11 22:55:51 EDT 2009;Committer;svn;1;2;2;4;0
488aa8307d06ce9cc64841122c59c019c3d7f087;Fri Sep 11 22:55:47 EDT 2009;Committer;suke;2;7;1;8;0
126d6acc503adcbb2480cc04fd7ef0a53ad33827;Fri Sep 11 12:52:20 EDT 2009;Committer;nobu;2;48;6;54;0
726caa59a96e3d6068e0ad1c0d8c7b9b2649f6c6;Fri Sep 11 12:49:14 EDT 2009;Committer;akr;1;173;8;181;0
175bba395d6e34d8cfa78a0393fa50a3ff199462;Fri Sep 11 12:47:22 EDT 2009;Committer;nobu;1;1;1;2;0
1ce66c6203b8f62ba0d8328c5b4433f57c093b21;Fri Sep 11 12:38:15 EDT 2009;Committer;nobu;2;27;0;27;0
2620a840702c1b109f20706276d0c8b00d3a7204;Fri Sep 11 12:06:34 EDT 2009;Committer;nobu;1;3;3;6;0
f20d759cd05d5ce12724acce8a2a5689bee7547c;Fri Sep 11 09:53:50 EDT 2009;Committer;naruse;3;6;2;8;0
50ef1b0676867e6d558e5edb0ff40c0faebe16fa;Fri Sep 11 09:46:53 EDT 2009;Committer;nobu;1;1;1;2;0
d328ffff91a99a267e5bc1f31b08903dc1e193c9;Fri Sep 11 05:22:46 EDT 2009;Committer;nobu;2;9;2;11;0
c1dff9b357881025fc1784573205becd135ce7d6;Fri Sep 11 05:19:28 EDT 2009;Committer;nobu;2;4;2;6;0
8e295d4c1799d637080bfd10a99d08574a357acf;Fri Sep 11 05:17:34 EDT 2009;Committer;nobu;2;7;1;8;0
9ad26a3d24d359bb9a07eb8926df933f0a622f99;Fri Sep 11 04:57:40 EDT 2009;Committer;nobu;2;7;1;8;0
8b04569c6edf2da4630a51e9d0b8115560f771cd;Fri Sep 11 02:33:32 EDT 2009;Committer;nobu;3;88;27;115;0
9edcd5d16bbde5f07022fff25bb68b536b2fcd21;Fri Sep 11 01:47:12 EDT 2009;Committer;shyouhei;1;6;0;6;0
607b8e0732f6aaa83cf807ba22034968d40f0ea6;Fri Sep 11 01:44:05 EDT 2009;Committer;shyouhei;1;1;1;2;0
0966635873d0237c615aced5860802a8a953ff64;Fri Sep 11 00:45:13 EDT 2009;Committer;nobu;2;13;6;19;0
8f0b4e49ca01216823f5941794ee309412c4c638;Thu Sep 10 23:42:49 EDT 2009;Committer;akr;2;151;151;302;0
ee4b59a4191ecabc1a9d396e234f20be5e5e9f8c;Thu Sep 10 22:54:01 EDT 2009;Committer;naruse;7;1306;1217;2523;0
e519c9d960549163c17571689cc977f7ca45073e;Thu Sep 10 20:02:11 EDT 2009;Committer;ko1;2;10;1;11;0
717b5a5f2d4761ccf2775ccb6c9931008773ad6c;Thu Sep 10 17:59:48 EDT 2009;Committer;akr;1;151;0;151;0
3ce642f5af3bff519102185538133cd620237c2c;Thu Sep 10 17:14:53 EDT 2009;Committer;akr;7;10;6;16;0
e13ca981984c161ccf93eca0273d732be20d815a;Thu Sep 10 17:07:38 EDT 2009;Committer;naruse;3;17;4;21;0
9e77c428ede98bd74f3dcefc96ae383398ba3645;Thu Sep 10 16:28:55 EDT 2009;Committer;svn;1;2;2;4;0
8cdbe2ab6f98a8a6356b736ff0348a209351ae5d;Thu Sep 10 16:28:52 EDT 2009;Committer;marcandre;2;8;2;10;0
3a224dbf45c2bcd8db9c881d671a3080ba16f5c3;Thu Sep 10 14:00:47 EDT 2009;Committer;nobu;2;10;4;14;0
3707fd4941f4eed6c442180a0ae19d92e6d39b08;Thu Sep 10 12:22:59 EDT 2009;Committer;akr;2;20;0;20;0
5ced9a4395b2eca37662df20f5a35abbede58898;Thu Sep 10 12:21:48 EDT 2009;Committer;akr;2;11;7;18;0
a87ce30453898db7f6caa135be86465ea4c2a111;Thu Sep 10 07:00:47 EDT 2009;Committer;svn;1;2;2;4;0
83b76913d86935640344664e682656bf8f379119;Thu Sep 10 07:00:44 EDT 2009;Committer;naruse;2;27;0;27;0
ee647e1b96982c7ff459d7af1a6109f7d54f61c1;Wed Sep 09 13:02:04 EDT 2009;Committer;nobu;3;14;2;16;0
7bac09fc2616f0207e400b06868e3dee8a9403b7;Wed Sep 09 12:20:51 EDT 2009;Committer;nobu;2;20;6;26;0
c754c0b23796be43fb7b4d8d4cc1d44af3ebd793;Wed Sep 09 12:19:28 EDT 2009;Committer;nobu;4;91;47;138;0
098d8d11e180e49493004685a46389bc91a75250;Wed Sep 09 12:04:29 EDT 2009;Committer;nobu;1;7;6;13;0
ba6e61d6f568401c8527861f560b42954c7fa05a;Wed Sep 09 08:19:06 EDT 2009;Committer;naruse;2;8;1;9;0
481a6476ce0b2669f98e0bcdaa9e210c411b166b;Wed Sep 09 07:21:49 EDT 2009;Committer;nobu;1;19;1;20;0
31a6d508635815d24ced07c5a65273cb0fcf54de;Wed Sep 09 06:46:31 EDT 2009;Committer;nobu;3;20;2;22;0
bc664b878c9992462f92e7f08fdd534dd08c69b3;Wed Sep 09 06:27:35 EDT 2009;Committer;takano32;3;681;1;682;0
103b471075c5e26ee5f06367dbd438a7ddd0ca7d;Wed Sep 09 05:08:45 EDT 2009;Committer;takano32;2;4;676;680;0
ed02d584a3d581454d852cbb89b9bec38f02f591;Wed Sep 09 04:33:13 EDT 2009;Committer;nobu;2;5;1;6;0
78ab4258ff3836ac40a8d5df00156bfe3bb1d638;Wed Sep 09 04:10:42 EDT 2009;Committer;nobu;3;6;2;8;0
fb532ac7a99c7b7360921595f45b9f478c13637e;Wed Sep 09 04:09:09 EDT 2009;Committer;nobu;2;28;11;39;0
fe963a451086d705c14da39fcf687b5e68f34e62;Wed Sep 09 04:06:37 EDT 2009;Committer;nobu;1;2;2;4;0
913fdf25bcd724ba3f5dbd77e05bf10c3ebd5b96;Wed Sep 09 03:56:58 EDT 2009;Committer;nobu;2;25;14;39;0
5c0a8e947a6291baf2b14f31e2d281b3f99dd309;Wed Sep 09 03:43:48 EDT 2009;Committer;nobu;2;23;11;34;0
1a7221035a71558885954a28cda12c520a89c750;Wed Sep 09 03:21:14 EDT 2009;Committer;nobu;2;52;13;65;0
23c95ef6c7c283bca8e3b2b8e670ec99ef07ca32;Wed Sep 09 03:01:37 EDT 2009;Committer;nobu;2;17;4;21;0
355047fb4948d00c4e3cd6cdcc8c8a52368673d2;Wed Sep 09 02:55:09 EDT 2009;Committer;nobu;2;32;12;44;0
9c1e2b4fb7050d5faa7eedc252639872abc626b6;Wed Sep 09 02:46:00 EDT 2009;Committer;nobu;2;60;27;87;0
44110c88e7b1b26dd5edff4fd318c1bd85298bfd;Wed Sep 09 02:28:21 EDT 2009;Committer;nobu;2;27;13;40;0
af4a989a987e1f7a116ee7726be4b9d0e0fac125;Wed Sep 09 02:26:06 EDT 2009;Committer;nobu;1;2;2;4;0
cd4fc5be39d86196d529f9c464d9c87e0b73d66d;Wed Sep 09 02:22:08 EDT 2009;Committer;nobu;1;2;2;4;0
b46cd0e400ff278897908479acc9163419341b07;Wed Sep 09 02:11:35 EDT 2009;Committer;nobu;8;18;14;32;0
85cc4ff62a95500ee748f9d5d987a0003d43b4e5;Wed Sep 09 02:07:50 EDT 2009;Committer;nobu;2;5;2;7;0
f7f3f9bf76467190c34fc598fd48ebedf3db9f42;Wed Sep 09 01:51:49 EDT 2009;Committer;nobu;2;10;6;16;0
055fb067007a211f6cbfb3daa060c403d2fd80c4;Tue Sep 08 15:27:31 EDT 2009;Committer;nobu;3;66;7;73;0
032a314c5025d2d87e5ea11c58162e698fff0168;Tue Sep 08 13:38:01 EDT 2009;Committer;nobu;3;84;92;176;0
e6dd856d73d084371c0b916cdfabf5775c1d0375;Tue Sep 08 13:18:13 EDT 2009;Committer;nobu;3;34;32;66;0
bbd9c406d6f34d028a844a16a04634f9a02217c0;Tue Sep 08 13:11:32 EDT 2009;Committer;nobu;1;1;1;2;0
31b7ae00c05aef76416c767df92be45d62e9d06a;Tue Sep 08 13:10:04 EDT 2009;Committer;nobu;21;92;79;171;0
034414741e4616f7a305f12fe36e1f9a6b0ff074;Tue Sep 08 12:50:13 EDT 2009;Committer;nobu;1;4;2;6;0
4fb9d7ffeeb71dd5d09288b9bd24de2925c0bb89;Tue Sep 08 12:48:17 EDT 2009;Committer;nobu;2;6;0;6;0
488024dfcf9bb56fb22ef4ba58cc8a800190ba42;Tue Sep 08 12:41:05 EDT 2009;Committer;nobu;2;1;6;7;0
c6b3a96fbb34cad869c66a452e13a115e1710358;Tue Sep 08 09:10:49 EDT 2009;Committer;nobu;2;6;1;7;0
a31c632299b72cd9e4ff53cec6d7b56f1f8a54f7;Tue Sep 08 02:57:39 EDT 2009;Committer;ko1;3;11;11;22;0
922bc54adb2b1cbcc14edc93a37f626c7a784a02;Mon Sep 07 23:32:32 EDT 2009;Committer;nobu;3;82;0;82;0
c95cbc0cc5f9c5d11438c3fd7258ef98dda9399e;Mon Sep 07 22:32:31 EDT 2009;Committer;nobu;2;4;2;6;0
a5c2f8843f0fb022e1bc33cad8d6d475958d2f83;Mon Sep 07 08:23:00 EDT 2009;Committer;nobu;3;11;0;11;0
5a12fb5fb87fe373ad251d68752388148c1363a3;Mon Sep 07 08:13:55 EDT 2009;Committer;nobu;2;8;2;10;0
f64949e2764a95e86a3851c07273f88aaac2fc7b;Mon Sep 07 08:12:32 EDT 2009;Committer;nobu;1;21;8;29;0
f69dff0ed11bea690e4b60f1ce9f7221a363fa46;Mon Sep 07 03:28:41 EDT 2009;Committer;matz;2;13;1;14;0
b82db5251c2c39f8a10cd21b595cc1cad8155cdc;Sun Sep 06 20:42:50 EDT 2009;Committer;ko1;4;44;22;66;0
cea5aeb795149cead9a9cb151a4754c6ce185d13;Sun Sep 06 20:22:18 EDT 2009;Committer;ko1;3;8;3;11;0
dd7f5639a989ecec4aa8a30f36e89ef40a51e284;Sun Sep 06 20:08:57 EDT 2009;Committer;ko1;2;4;2;6;0
3463db3068924d4671d7cb982658eae202b40eb6;Sun Sep 06 20:08:00 EDT 2009;Committer;ko1;2;9;4;13;0
e5e04d45deb545d2a0103d9ffbbdacdc3cce10a9;Sun Sep 06 18:24:56 EDT 2009;Committer;svn;1;2;2;4;0
238b979f1789f95262a267d8df6239806f2859cc;Sun Sep 06 18:24:53 EDT 2009;Committer;naruse;2;8;0;8;0
f1e98086f218f1d5de247f1670f94bfcdff2bf33;Sun Sep 06 09:16:23 EDT 2009;Committer;ko1;3;16;4;20;0
55cfc1e4098cf742758dd6f4d5c96a30b0e187fa;Sun Sep 06 08:50:19 EDT 2009;Committer;ko1;3;8;170;178;0
f825d848986177d779e8018a1083f88b8799ae5f;Sun Sep 06 08:39:57 EDT 2009;Committer;ko1;7;50;2;52;0
bd8da69e9b5df785cc3fa0871332257e09335a78;Sun Sep 06 07:40:24 EDT 2009;Committer;ko1;3;55;4;59;0
33ff31149464168cfe1d137bff436b6a7d19c357;Sun Sep 06 01:34:21 EDT 2009;Committer;nobu;2;5;1;6;0
c06c77091bcdc7e4aff08b0d1d23c41d119491bb;Sat Sep 05 23:11:03 EDT 2009;Committer;nobu;1;2;2;4;0
233cda0405a1ef3443b9d2e040c0688ddc453610;Sat Sep 05 20:24:00 EDT 2009;Committer;svn;1;2;2;4;0
a535975bcb43eb5c9afb2bff8f8211fb974246de;Sat Sep 05 20:23:56 EDT 2009;Committer;naruse;2;648;6;654;0
ef2c92ddf0c008c9bd785491d505afd3c7a73af9;Sat Sep 05 06:41:40 EDT 2009;Committer;nobu;1;22;2;24;0
c76e698fd8c086930f2b3092b1685d1521d148f4;Sat Sep 05 06:21:15 EDT 2009;Committer;nobu;3;56;16;72;0
7a05e1ead3088b1b5be3cd497432cdc93c8f5352;Sat Sep 05 05:37:11 EDT 2009;Committer;nobu;1;1;1;2;0
47b31a44c75cf2dc7a0d1bc1763762e2f72a7765;Sat Sep 05 05:34:56 EDT 2009;Committer;nobu;1;12;10;22;0
8a9960a37412d4508b003bf0c4c5a8329ba1d6c3;Sat Sep 05 01:50:18 EDT 2009;Committer;nobu;1;8;2;10;0
96c50e47c56fede4ef4d33c31fb30baf4df6a2e2;Sat Sep 05 01:38:47 EDT 2009;Committer;nobu;3;64;28;92;0
78a54607b6cc856e43099d3d8c92a78382d4192b;Sat Sep 05 00:40:13 EDT 2009;Committer;akr;1;2;1;3;0
7b9024f74055febffbe3bc8741e086b7a35b86c7;Sat Sep 05 00:33:54 EDT 2009;Committer;nobu;1;3;0;3;0
605e7d4a603adcdbe1c2bde969c5f95938873ee2;Fri Sep 04 23:51:44 EDT 2009;Committer;nobu;3;65;9;74;0
7633eb4c51fd088ad1f85109929b0a93c4d7e3fb;Fri Sep 04 23:49:18 EDT 2009;Committer;nobu;2;15;5;20;0
15ec8e6548e237c76c40286259cc684d90919da3;Fri Sep 04 21:30:52 EDT 2009;Committer;nobu;2;8;2;10;0
0cf0b0eed4442fe7ed07d0c0bffe8bd7acbbe166;Fri Sep 04 11:40:58 EDT 2009;Committer;nobu;2;6;3;9;0
6da90f39c6a1874edbf02d0274e5187789152db9;Fri Sep 04 08:06:12 EDT 2009;Committer;nobu;1;10;1;11;0
e825a2c0301e4bf84f936d9ad4daf833048a8a3d;Fri Sep 04 05:40:52 EDT 2009;Committer;nobu;1;2;2;4;0
7a426e029aacb7868a7bf39f7c21877c90b68319;Thu Sep 03 23:07:13 EDT 2009;Committer;matz;2;5;0;5;0
299d8fb1b7c10eb1b6a5961856addbe61149b549;Thu Sep 03 19:49:43 EDT 2009;Committer;nobu;2;5;1;6;0
c0a09d9594564df9d5b7d6992dfe25c0a616d1fb;Thu Sep 03 19:46:18 EDT 2009;Committer;nobu;3;8;4;12;0
fb03cb8275d6028d082fedeaa29e237cbe66399a;Thu Sep 03 08:57:28 EDT 2009;Committer;nobu;3;16;1;17;0
468c258d3c0ebe448076ff3586ffc6e4b39830b8;Thu Sep 03 08:47:40 EDT 2009;Committer;svn;1;2;2;4;0
9691894b86ce8775362beeb3eb36ae7186694d5f;Thu Sep 03 08:47:11 EDT 2009;Committer;nobu;1;0;4;4;0
3fe5402dfa4b16fe586baee9c6f7187c3a00268d;Wed Sep 02 07:50:16 EDT 2009;Committer;nobu;3;22;3;25;0
274fa77e3f3620cbd496952f622e930ea6951f02;Wed Sep 02 04:47:39 EDT 2009;Committer;nobu;2;10;9;19;0
dc697b1905966c164ecf88a737c9c90ca95c87a8;Wed Sep 02 04:32:18 EDT 2009;Committer;nobu;1;1;1;2;0
a4b94c4443953b61ecdbb764e4a544c0e7208c7e;Wed Sep 02 02:37:46 EDT 2009;Committer;ko1;2;5;0;5;0
cb3c0b4a10d662075beed8afd1182be519b0ed62;Wed Sep 02 00:30:29 EDT 2009;Committer;nobu;0;0;0;0;0
61d983df58c65adfdfce252c8a25561fec33601c;Tue Sep 01 22:48:51 EDT 2009;Committer;nobu;2;8;8;16;0
d17fe8a46722912e9904982f89b3949b41acc68f;Tue Sep 01 17:35:30 EDT 2009;Committer;naruse;2;6;1;7;0
d99ac4f829dd0903f20e02de5dbba0ddc175c1f3;Tue Sep 01 17:34:50 EDT 2009;Committer;naruse;6;153;70;223;0
596b68cc6b6333a3939ebca3ae09fecc491e5718;Tue Sep 01 16:18:09 EDT 2009;Committer;svn;1;2;2;4;0
c719ecb535a99defb45d6029d21d3134bec7c5ae;Tue Sep 01 16:17:56 EDT 2009;Committer;naruse;18;144;2181;2325;0
d2d0d733c168916d356e088ed14b6e5a47766766;Tue Sep 01 10:58:31 EDT 2009;Committer;ko1;2;6;1;7;0
907680b52bb52629e54e09b6309a87b4d0f61fd2;Tue Sep 01 01:11:03 EDT 2009;Committer;svn;1;3;3;6;0
9055042fa44e0890953f96b53f94b8dc7385564e;Tue Sep 01 01:09:31 EDT 2009;Committer;nobu;0;0;0;0;0
9b062c96857f2a9118268270dec500f8a037f5b8;Mon Aug 31 07:21:54 EDT 2009;Committer;yugui;2;8;8;16;0
e056ac59a776f87b7043d6c3d14e321ad5cd32d5;Mon Aug 31 05:55:57 EDT 2009;Committer;yugui;3;184;108;292;0
7fed54570fe5e31c3b42c947c8bce4c9dd1dea38;Mon Aug 31 01:41:35 EDT 2009;Committer;nobu;2;31;55;86;0
44320bc32c34ed0b330c647258f623af6d1dd17a;Sun Aug 30 14:44:54 EDT 2009;Committer;akr;2;14;0;14;0
18b17dcd19ddde322b96002cac583e664696ae3a;Sun Aug 30 08:06:24 EDT 2009;Committer;naruse;1;1;1;2;0
6ab36c6e191001316bf94c884e5f0fefc43499ef;Sun Aug 30 08:00:31 EDT 2009;Committer;naruse;6;34;21;55;0
2a12798d5896788a6032a9eb9efbe236e3713881;Sun Aug 30 08:00:14 EDT 2009;Committer;naruse;1;1;1;2;0
4119b5485447dda2ca84807f6a200e5cb04ee307;Sun Aug 30 07:39:10 EDT 2009;Committer;nobu;2;5;1;6;0
ab0d1d27920d10c71a9216490d929e351be32e69;Sun Aug 30 05:13:42 EDT 2009;Committer;akr;2;26;20;46;0
dcf2aad3a588f75e21bc22c269d652e5b8255672;Sun Aug 30 04:01:42 EDT 2009;Committer;akr;2;33;9;42;0
570d8f55b225dce01008c8fa879e85ad874ce18b;Sun Aug 30 01:26:56 EDT 2009;Committer;akr;2;49;6;55;0
fc6be8cdeb2efa3ef9498b728f5d6c27881f29fc;Sun Aug 30 00:46:32 EDT 2009;Committer;akr;2;25;0;25;0
8b32a1de29b09e4bbd9671db7172dac245611105;Sat Aug 29 19:06:29 EDT 2009;Committer;akr;3;177;146;323;0
4a9bca2496f66b44b9fff0377443715a03c6ddc7;Sat Aug 29 18:18:37 EDT 2009;Committer;akr;2;10;11;21;0
752027c174fe9b53c319a107a3b84eb3ff659d6f;Sat Aug 29 16:17:36 EDT 2009;Committer;svn;1;2;2;4;0
80918e2ac941b262b4e3be644292676e6c5d5277;Sat Aug 29 16:17:26 EDT 2009;Committer;naruse;3;10;3;13;0
ebabbc6cb92f818021f85275130f3c96fdb4f0fb;Sat Aug 29 13:39:44 EDT 2009;Committer;yugui;2;255;0;255;0
3c65e0262b6b14b0a6dc901128df4c45bd547c2f;Sat Aug 29 11:42:53 EDT 2009;Committer;yugui;3;10;1;11;0
be41711465807d07521d5f71ffdfee18dcab33b5;Sat Aug 29 03:16:56 EDT 2009;Committer;nobu;2;5;2;7;0
2235d504b735a952a6067443bc927815ecbe4317;Fri Aug 28 18:27:30 EDT 2009;Committer;nobu;2;5;2;7;0
f6bed8442535c7e04f5ac06aaecf27a5a7b94e1d;Fri Aug 28 18:11:53 EDT 2009;Committer;svn;1;2;2;4;0
c2a81f31efb709d34141aa2bdbf530969b3c012c;Fri Aug 28 18:11:37 EDT 2009;Committer;nobu;2;9;7;16;0
c6c6ab873e8eb3cb87b593f99ea78c50e97442dc;Fri Aug 28 11:41:13 EDT 2009;Committer;knu;2;8;2;10;0
83c5ebaecb2778562b35032677c1c1498999e0f9;Fri Aug 28 11:38:57 EDT 2009;Committer;suke;2;16;11;27;0
12a4e27f17d5170d2bee6af6408495864679ec3e;Fri Aug 28 04:35:29 EDT 2009;Committer;usa;2;6;1;7;0
fcf88c1b8df49ba0c4db026f2b17066ea66d3de2;Fri Aug 28 02:45:41 EDT 2009;Committer;nobu;11;233;193;426;0
a2f378737fc70cdfce65a3d08eda1c9a99d89b4d;Fri Aug 28 01:21:45 EDT 2009;Committer;nobu;3;9;6;15;0
afb957b129b76050a5f8d241a3a9c030ae9799b5;Fri Aug 28 00:45:27 EDT 2009;Committer;nobu;1;13;13;26;0
1612ad9d326b18d3a2fd354be9af73f3d005311a;Fri Aug 28 00:34:12 EDT 2009;Committer;nobu;2;5;0;5;0
b587368d712a71053b792f6bff9132e8b145b14c;Fri Aug 28 00:31:01 EDT 2009;Committer;nobu;1;9;7;16;0
5a59808e46a7b8b3b4d7225bab4de2a3975e9ade;Thu Aug 27 22:29:19 EDT 2009;Committer;svn;1;2;2;4;0
c9775b03823c63e1c1a711330dd147a5b30f1fb0;Thu Aug 27 22:28:15 EDT 2009;Committer;matz;2;6;1;7;0
84255e0485b1d7b6eef6d82f330f4f671b3f23fc;Thu Aug 27 09:31:11 EDT 2009;Committer;nobu;5;19;7;26;0
a20bd463a809aff8707acdeb90e8569b144e01d3;Thu Aug 27 06:10:30 EDT 2009;Committer;naruse;3;11;3;14;0
f9be12fb14e57794d2edb53a141b00be47c7f010;Thu Aug 27 04:55:55 EDT 2009;Committer;nobu;1;4;1;5;0
9460fd0ee0d7b8eae7861406b592a0f0977d0e15;Thu Aug 27 04:51:19 EDT 2009;Committer;nobu;2;6;1;7;0
fec3877e8dd3955f7e9b30a1af5a59bf71330ff3;Wed Aug 26 23:18:49 EDT 2009;Committer;nobu;1;1;1;2;0
2ef382231fffd049fce83d742c26084ac8bb959c;Wed Aug 26 23:16:40 EDT 2009;Committer;nobu;3;28;2;30;0
6cd8f907cf4ab2ea84a90cbb338fd7bd3704a360;Wed Aug 26 17:08:34 EDT 2009;Committer;naruse;2;7;2;9;0
6e6a28183ac0732fa2b31d54bb69222c5d152573;Wed Aug 26 17:01:10 EDT 2009;Committer;naruse;2;5;1;6;0
782fec1de4e6a7fbbcc1b426067fb8212c06fd3e;Wed Aug 26 15:00:07 EDT 2009;Committer;svn;1;2;2;4;0
2981448f33894323c7a896d351041a4224277c5a;Wed Aug 26 15:00:00 EDT 2009;Committer;nobu;2;23;10;33;0
31875e97b4e11493da07f34096bb4b89180a62b5;Wed Aug 26 14:58:44 EDT 2009;Committer;nobu;3;20;3;23;0
0170c2fc4df2002568c896176b4c7868dee3e6c3;Wed Aug 26 13:36:28 EDT 2009;Committer;nobu;1;7;7;14;0
addd2cb06e93352c817f7a2e674721b5f2597525;Wed Aug 26 12:50:57 EDT 2009;Committer;naruse;2;180;26;206;0
232978b0319ebb6235bdfc5a8c8dae58c6be1442;Wed Aug 26 10:56:55 EDT 2009;Committer;naruse;3;9;2;11;0
96760236079b15674a6322a2ca41b1528b51afbd;Wed Aug 26 10:20:30 EDT 2009;Committer;nobu;5;223;116;339;0
47a1a7b67d272596860c8969f8581c175f7d5704;Wed Aug 26 10:00:03 EDT 2009;Committer;nobu;2;262;4;266;0
ffd0da0333dd413d041ce25e4066c97890343a0c;Wed Aug 26 09:49:28 EDT 2009;Committer;nobu;2;6;1;7;0
c6defbf3108a0cd1d16184dafe5fba9e2542cf39;Wed Aug 26 08:00:37 EDT 2009;Committer;nobu;2;7;2;9;0
0c86e8b70b277ab5179d13839b9496dce55f51df;Wed Aug 26 06:26:08 EDT 2009;Committer;nobu;2;3;2;5;0
ba7a870a8924fdd0fe1612ef4b74024ae0e3fe32;Wed Aug 26 05:34:47 EDT 2009;Committer;nobu;2;20;7;27;0
d4e85c416d1ad24fb6dd7c639260ef0c457d3816;Wed Aug 26 04:48:38 EDT 2009;Committer;nobu;2;5;1;6;0
b6cf78511962ba901ca4a86ffdeb6624afe8dfb1;Wed Aug 26 03:37:08 EDT 2009;Committer;nobu;3;16;2;18;0
1af43ae867807010d1fc37b440cbc79215de34b9;Wed Aug 26 00:48:49 EDT 2009;Committer;nobu;1;3;2;5;0
1fd7f2e57d2e4ae4f37700570a3bdf5963650744;Tue Aug 25 21:54:03 EDT 2009;Committer;nobu;1;9744;365;10109;0
781da600a98486e5fb28a0db363e845e3a4acc97;Tue Aug 25 16:15:49 EDT 2009;Committer;svn;1;2;2;4;0
f1eff957452f55c7382beee92fd11b979a61e101;Tue Aug 25 16:15:38 EDT 2009;Committer;naruse;9;49875;9062;58937;0
649f648ec1ebc166dc37aeed7c0be50e8bfd85d2;Tue Aug 25 14:33:11 EDT 2009;Committer;naruse;1;7;6;13;0
0fd1688bf5acd207a81a1600eb0b43a7a059e356;Tue Aug 25 13:36:32 EDT 2009;Committer;naruse;2;14;8;22;0
ebbe19e1ad98167417ffff29048c83e1aaa8b547;Tue Aug 25 09:21:39 EDT 2009;Committer;nobu;1;7;7;14;0
8e6ea3712bc1db351146e35c7d538a9867469ebc;Tue Aug 25 08:38:28 EDT 2009;Committer;nobu;2;37;26;63;0
7734d1784906f7eec333dbe52654eb2fa186a3db;Tue Aug 25 03:22:30 EDT 2009;Committer;nobu;2;4;6;10;0
b55c4210ef178af98ddd3ba7fc2f4be117dbafb4;Tue Aug 25 02:42:55 EDT 2009;Committer;nobu;2;6;1;7;0
24dc34e3f4c9d7746d222ca80cf875225dbd9789;Mon Aug 24 17:16:40 EDT 2009;Committer;nobu;3;11;5;16;0
b0947c5e04cbc5bb9cde351200575d8da2036eb1;Mon Aug 24 12:31:22 EDT 2009;Committer;kou;3;27;1;28;0
9096abd36a13bcabe0dc6ad344f01a189c6c3293;Mon Aug 24 10:00:18 EDT 2009;Committer;usa;2;12;1;13;0
355e0f4efd94526c6de4afed0c5b2bd6992b19ac;Mon Aug 24 07:36:02 EDT 2009;Committer;nobu;2;35;0;35;0
16fc2951b1a52c35a81662cd4380f7b022c525a9;Mon Aug 24 04:24:24 EDT 2009;Committer;usa;1;6;0;6;0
012a13180a63248746827ca267520122f0cde642;Mon Aug 24 04:23:56 EDT 2009;Committer;usa;2;2;1;3;0
4f867dddc4408a6f3a192ddb726fae283cfe48df;Mon Aug 24 04:14:12 EDT 2009;Committer;nobu;2;9;4;13;0
d93cb9e058d3ebab2ad38885fcc4880700d807d1;Mon Aug 24 03:55:40 EDT 2009;Committer;svn;1;2;2;4;0
3bf1ea2217478ca8512bdd8e12dfa05442f7402d;Mon Aug 24 03:55:26 EDT 2009;Committer;nobu;2;6;1;7;0
7c2d363baed3fd43a1b29bab1f177a514e0b785c;Sun Aug 23 06:24:33 EDT 2009;Committer;akr;2;5;1;6;0
0ebb7c1c9bd4d87599e948b8af6ed9d12409681a;Sun Aug 23 06:15:00 EDT 2009;Committer;akr;2;22;2;24;0
e709b204869f13b4b546f1cc362422cad463b0a8;Sat Aug 22 16:19:29 EDT 2009;Committer;svn;1;2;2;4;0
832fd6825ce0878688cb60946fccd8a5289224b2;Sat Aug 22 16:19:18 EDT 2009;Committer;akr;2;29;7;36;0
00b8444c930c3b9ce8c422c97496dd15bbf050e5;Sat Aug 22 06:42:05 EDT 2009;Committer;akr;1;19;19;38;0
97ed18f1da96c99e0482141d9331c6743352f33f;Sat Aug 22 06:23:48 EDT 2009;Committer;akr;2;13;15;28;0
dfc3fccef31ace6f26ac96388a441b668abf092d;Sat Aug 22 04:52:09 EDT 2009;Committer;akr;3;23;7;30;0
0570b9969bf2e43c96346471116f5eb0a4806c88;Sat Aug 22 04:17:38 EDT 2009;Committer;naruse;2;13;9;22;0
c89714924c368ebb053cd3a0db079183e1468daf;Sat Aug 22 03:40:35 EDT 2009;Committer;akr;1;1;1;2;0
b2a83ef6f2bcd154dd10fab9fce840d501e55b45;Sat Aug 22 03:19:53 EDT 2009;Committer;akr;1;40;11;51;0
7e97b9af8050bf121a81b82609870b24178a7d10;Fri Aug 21 16:29:33 EDT 2009;Committer;nobu;2;9;2;11;0
461bd62fec54d1026ef2496fbc9b9fd676f4d9d9;Fri Aug 21 15:51:35 EDT 2009;Committer;akr;3;50;11;61;0
7609494ffdd74aad9fe9aa4ce6da55e8e50300fb;Fri Aug 21 15:18:57 EDT 2009;Committer;akr;1;3;2;5;0
72ef81730f59163d2b9278cbed675d321c6d5cc0;Fri Aug 21 15:14:37 EDT 2009;Committer;svn;1;2;2;4;0
f72b854c7d232e0bcbeade4fd44a63130aa6143b;Fri Aug 21 15:14:29 EDT 2009;Committer;mame;2;7;0;7;0
3a855da47b867e24428582b0a20aa1ea7e4dc2af;Fri Aug 21 13:39:35 EDT 2009;Committer;akr;2;39;29;68;0
a7b920686af51c7f54a2b1bd9e53c657db41d360;Fri Aug 21 08:01:09 EDT 2009;Committer;nobu;9;1483;152;1635;0
a606038c6abf31740e38448a164f872d3c94c83f;Fri Aug 21 06:37:36 EDT 2009;Committer;nobu;1;1;1;2;0
7fa73456098b5554896f3637bacbbf695f801250;Fri Aug 21 06:17:06 EDT 2009;Committer;naruse;3;10;5;15;0
f7207fa2fcbbe7aebeed9a08f6092ea59d05cdcf;Fri Aug 21 06:16:53 EDT 2009;Committer;naruse;3;15;14;29;0
7510468707b8e2f05258afb4147210162a812444;Fri Aug 21 06:04:21 EDT 2009;Committer;naruse;2;8;1;9;0
09cbac3f868afd26a2aa73c45fb0765d5f116f4e;Thu Aug 20 22:25:52 EDT 2009;Committer;nobu;3;41;27;68;0
7439c06ab7d1adc1ffce82ff39ba60ee78dd0996;Thu Aug 20 22:14:58 EDT 2009;Committer;nobu;2;6;2;8;0
e22b92dce4dc7723cf95849edf9beb7126c63960;Thu Aug 20 15:08:07 EDT 2009;Committer;nobu;2;5;2;7;0
cb5fdf4e92616cee841f9c778f0fe62b072ec856;Thu Aug 20 15:06:42 EDT 2009;Committer;svn;1;2;2;4;0
4b82d3b6b8734049d916d0f7fb0eee9ef29f6324;Thu Aug 20 15:06:36 EDT 2009;Committer;nobu;1;1;1;2;0
36c9cddf6cc5306b792669ce31825a6e2d065a5c;Thu Aug 20 14:56:23 EDT 2009;Committer;nobu;2;48;30;78;0
4c5d7d53b210017ac71ccb958155ba2dc241e220;Thu Aug 20 14:42:16 EDT 2009;Committer;mame;2;9;0;9;0
681754c29d4ae02983c61b467f764b036df8f656;Thu Aug 20 05:44:28 EDT 2009;Committer;naruse;2;6;0;6;0
bfc94fde253a255d329cfdec32398f4154be225f;Thu Aug 20 03:11:01 EDT 2009;Committer;nobu;1;4;0;4;0
4a7cf7638c15f644177ec5383148dea58e6565d6;Thu Aug 20 03:09:08 EDT 2009;Committer;nobu;2;10;0;10;0
ec5e3c551d8d4df0b091f4e6bcadfa99a0e5cefe;Thu Aug 20 00:42:16 EDT 2009;Committer;matz;2;13;4;17;0
ce46bc63456390a66c7589d3591dab1e55e27561;Wed Aug 19 20:26:38 EDT 2009;Committer;akr;1;6;7;13;0
fb99416115e8e48e6ac8aefefa6221cf572024ad;Wed Aug 19 20:21:19 EDT 2009;Committer;akr;1;1;0;1;0
0c0f75440092adc29c5b6edac00ded1899c67805;Wed Aug 19 17:32:56 EDT 2009;Committer;akr;3;38;1;39;0
3b4949ffa8602bf5b8fb4be880b9c73c9375d8fa;Wed Aug 19 16:36:00 EDT 2009;Committer;akr;4;424;27;451;0
b307bd9847b548f0f80621b2c4097a7be28de411;Wed Aug 19 16:10:15 EDT 2009;Committer;svn;1;2;2;4;0
529f149bfeb4ded03d64240becad21e8c8f0b8b2;Wed Aug 19 16:10:06 EDT 2009;Committer;matz;3;53;6;59;0
e1c9ac6bd91e9a96e40077cc16afa1fcabc8436f;Wed Aug 19 02:32:49 EDT 2009;Committer;nobu;2;137;163;300;0
43d0c7263b70a0405f685dba330bae5f2c94f4ae;Tue Aug 18 17:55:26 EDT 2009;Committer;mame;2;88;0;88;0
db09f6e84e10670866105888697bb1e8630d0030;Tue Aug 18 16:15:40 EDT 2009;Committer;svn;1;2;2;4;0
74dc18c9532d8e399b37ad3fb272cc9cbd8bd7e3;Tue Aug 18 16:15:29 EDT 2009;Committer;mame;2;6;0;6;0
2772c80ce01d097df86336ce27b30610d6bfcc29;Tue Aug 18 12:02:53 EDT 2009;Committer;akr;3;74;3;77;0
ec490ab2c49260f1238e64f1a3db526f00745559;Tue Aug 18 11:18:25 EDT 2009;Committer;nobu;1;2;2;4;0
7e41da2cdf3dc93e93fc62ed5d81979b415b6347;Tue Aug 18 04:52:41 EDT 2009;Committer;takano32;1;4;0;4;0
38a22404db6722fc61def0600d015a3dbc4a35c9;Tue Aug 18 02:44:10 EDT 2009;Committer;wanabe;3;11;1;12;0
95e77269a9495c9f72b361a148fa45312c5a609c;Mon Aug 17 17:00:47 EDT 2009;Committer;matz;3;52;0;52;0
0ff29a4fc1074fd9cef7dbc6b63ff91c55131140;Mon Aug 17 16:41:12 EDT 2009;Committer;svn;1;2;2;4;0
554786aedce15c2eb492e7d278dcf55959fc909f;Mon Aug 17 16:41:00 EDT 2009;Committer;matz;3;22;11;33;0
a5aefa661e5007b73db9525efb0e94172cddd541;Mon Aug 17 14:46:55 EDT 2009;Committer;tadf;2;5;1;6;0
b5e6b46e90101dbd092469e183070635634d9394;Mon Aug 17 05:35:10 EDT 2009;Committer;nobu;3;48;15;63;0
9d7ff244c35119c9d9c0014bfb7ece8b3c689be6;Mon Aug 17 01:46:34 EDT 2009;Committer;naruse;2;35;9;44;0
ae3a58e8c53a8966f3bcc53395878593e137e3bf;Sun Aug 16 23:35:28 EDT 2009;Committer;tadf;5;810;1;811;0
cfed2cefb2de1762b50c8345b5048246d7cd7c7f;Sun Aug 16 23:22:13 EDT 2009;Committer;tadf;3;22;3;25;0
df21038777f9b8339429f4427bf6d25f690b7eb5;Sun Aug 16 23:17:14 EDT 2009;Committer;tadf;4;301;0;301;0
01971cad759a43c0d4358f2fb28c7d2811673de4;Sun Aug 16 23:12:41 EDT 2009;Committer;tadf;2;8;4;12;0
02a7cbec822ba2f2c1b830a9f1747e84822aaddf;Sun Aug 16 23:03:45 EDT 2009;Committer;tadf;3;21;4;25;0
b21088b431e03d15032caad160888e16b8f2198b;Sun Aug 16 22:43:48 EDT 2009;Committer;matz;3;56;3;59;0
9166dd9ec7189376a9c1cb3dda2e40628096d015;Sun Aug 16 22:28:48 EDT 2009;Committer;matz;3;24;0;24;0
3041f600563df6a3b401ee44d0c31b690d2f82fc;Sun Aug 16 15:34:35 EDT 2009;Committer;tadf;2;2;2;4;0
530be6ed155ba19ce578929ac8341d4e930976c2;Sun Aug 16 15:19:09 EDT 2009;Committer;svn;1;2;2;4;0
7710478bdc2cfdd43d7950e2013f30d2ed557a50;Sun Aug 16 15:18:58 EDT 2009;Committer;tadf;4;11;3;14;0
114f01bd9d1a9dc28d62a1a25b31a210bf871bbc;Sun Aug 16 14:58:27 EDT 2009;Committer;nobu;3;10;1;11;0
aa3c6d4dd28366b3d51f3a126267f58387f6dbe7;Sun Aug 16 13:20:50 EDT 2009;Committer;tadf;2;11;7;18;0
5e4f23d600435fa5373cb40ff3c736c008caef52;Sun Aug 16 12:32:35 EDT 2009;Committer;naruse;3;15;9;24;0
066b30245bea02bf217ea6b49fd2e906781e67c1;Sun Aug 16 06:31:31 EDT 2009;Committer;naruse;1;6;2;8;0
2ac5cdd07a2ce703750d69e0cbdc90b2f2572a5b;Sun Aug 16 06:31:13 EDT 2009;Committer;naruse;2;6;1;7;0
95c5a63d2d4f607aa74cd2ac3787a81fa9dfbf05;Sun Aug 16 02:20:00 EDT 2009;Committer;nobu;1;18;23;41;0
2a8ff72f3049877f377ea328c195b1f9244516c0;Sun Aug 16 02:15:13 EDT 2009;Committer;nobu;1;19;10;29;0
2318bef1de1ba3cd9e0b6a88fed9bd39be6a3ea9;Sun Aug 16 01:45:18 EDT 2009;Committer;nobu;2;41;25;66;0
cd48eb8fd5a687b58b994fb39316c9aa2da8f9cc;Sun Aug 16 01:38:32 EDT 2009;Committer;nobu;4;20;13;33;0
232836ea5aaa0e06954b24044ace818aececbf9f;Sun Aug 16 00:47:40 EDT 2009;Committer;nobu;2;7;2;9;0
a174dbcd4fc33a0355b92b646ec3a412b1ebbb14;Sat Aug 15 18:18:07 EDT 2009;Committer;ko1;2;18;23;41;0
c0ec326b7b9508f5d8f710c9e8c3904722df5dce;Sat Aug 15 16:27:13 EDT 2009;Committer;naruse;3;15;2;17;0
c6fcb8ab9a7a0cc725c67ab7e2af6e8c94984307;Sat Aug 15 16:01:44 EDT 2009;Committer;svn;1;2;2;4;0
249697855e1676ecb29ee2604134d717aa5bd214;Sat Aug 15 16:01:33 EDT 2009;Committer;naruse;4;80;12;92;0
fefb793f655b6b0540ccdb9d9e6d192d611cb5a9;Sat Aug 15 01:40:31 EDT 2009;Committer;svn;1;2;2;4;0
f93bdaed628eb51e849d2e082a20385edea3ef19;Sat Aug 15 01:40:10 EDT 2009;Committer;nobu;2;12;13;25;0
19b24f499b00917c924b7e63049311de85a0a3fd;Fri Aug 14 11:03:22 EDT 2009;Committer;nobu;4;11;4;15;0
4155811dc15e2868edf7cb6a7fefd8645c8337a0;Fri Aug 14 09:05:44 EDT 2009;Committer;naruse;3;17;8;25;0
2b91cbbf112f6f7c628a8927f2f336ae31e81a38;Fri Aug 14 08:20:13 EDT 2009;Committer;naruse;2;5;1;6;0
69f1e595bfd768433a55528819691c41c78c962f;Fri Aug 14 07:28:26 EDT 2009;Committer;nobu;2;10;5;15;0
0ff3bf4f44b7c634afcbcc08eb1cbe74f04ac37c;Fri Aug 14 05:31:39 EDT 2009;Committer;nobu;2;5;1;6;0
ace43dc72128e314ef36bc5c00019818b229192e;Thu Aug 13 15:30:57 EDT 2009;Committer;matz;2;10;0;10;0
9cfb62700dd13c9d0dd0b2761883b06ceda3ac52;Thu Aug 13 15:21:43 EDT 2009;Committer;svn;1;2;2;4;0
eadc3604c023d04770b81b02651c6f7c3107b3dd;Thu Aug 13 15:21:32 EDT 2009;Committer;matz;2;6;1;7;0
c8909ba6016524f1a857e8b1528471a3fd7aab76;Thu Aug 13 12:06:14 EDT 2009;Committer;wanabe;2;22;4;26;0
c29206461f2d0c610eafed50e6658202aeb050ec;Thu Aug 13 09:40:12 EDT 2009;Committer;nobu;2;13;4;17;0
c9e7e6617ba2f76f0ff8b69501825018b21f9520;Thu Aug 13 09:22:12 EDT 2009;Committer;nobu;2;10;3;13;0
72072e6343bf0f12b4f6ca5a4f953b46fe2db709;Thu Aug 13 07:31:23 EDT 2009;Committer;nobu;3;10;2;12;0
117c384560bf40fa062f2cac14fc510184a4006a;Thu Aug 13 07:30:41 EDT 2009;Committer;knu;1;1;1;2;0
24c783e95eab89e73da7d56cb6e83f6c938046ae;Thu Aug 13 07:20:16 EDT 2009;Committer;nobu;4;13;5;18;0
5aff5e79b8bcf55f90997711f019eae3f18eef45;Thu Aug 13 07:12:47 EDT 2009;Committer;knu;1;15;2;17;0
3711c63b6a2513348a4dc991ec25198244636d2a;Thu Aug 13 06:37:39 EDT 2009;Committer;nobu;2;10;2;12;0
579edea3c91f5f5ca1475b845729c0a63a99cfd7;Thu Aug 13 03:03:29 EDT 2009;Committer;svn;1;2;2;4;0
f7020b1b423ed50c9c56bed991fa0115618f2d27;Thu Aug 13 03:03:20 EDT 2009;Committer;matz;2;1;6;7;0
54b61b8da5ba7fbc0d5a605a19dd66b75dd7b600;Wed Aug 12 12:10:33 EDT 2009;Committer;usa;1;1;1;2;0
f73eaeb3a662f7d8ca3d2c18ce48915437187afe;Wed Aug 12 12:10:10 EDT 2009;Committer;usa;2;9;0;9;0
87bb97ceb53e19d2ab458c71cd83060a42222137;Wed Aug 12 07:00:37 EDT 2009;Committer;usa;2;5;1;6;0
054770068a69dea492a2702533556f42fe1fdcc7;Wed Aug 12 06:54:45 EDT 2009;Committer;naruse;2;8;2;10;0
be245c09e68d8990b20566ad5438140a0d651f42;Wed Aug 12 06:34:59 EDT 2009;Committer;nobu;1;6;0;6;0
31f4a829421d2c5ecc21f42d14f5b38ac9e846de;Wed Aug 12 06:32:21 EDT 2009;Committer;nobu;5;46;18;64;0
c00428ed9ec5f54c6245642650c8d7c463607248;Wed Aug 12 06:15:30 EDT 2009;Committer;nobu;1;1;1;2;0
8e8e34319ba6d9457b3ffa374738baa41a96be05;Wed Aug 12 05:55:06 EDT 2009;Committer;ko1;8;50;4;54;0
56e69d71092e8bf41b94036f51c3a07575194f74;Wed Aug 12 05:16:56 EDT 2009;Committer;usa;2;9;2;11;0
265bd9e661061d364568f78b3c2649377bfe96b1;Wed Aug 12 04:00:03 EDT 2009;Committer;nobu;3;22;3;25;0
df9f51338766ca090aaa2ed9818213eb7e2b8d8c;Wed Aug 12 02:52:00 EDT 2009;Committer;nobu;2;20;3;23;0
5703c1756cd8a191ecfa62e70fa5d4fb38dedee2;Tue Aug 11 23:53:21 EDT 2009;Committer;matz;2;10;5;15;0
e666111955d0f48f2bc0283c2867da938b98982c;Tue Aug 11 22:52:39 EDT 2009;Committer;naruse;3;10;2;12;0
8b83fc27048ff1c30e6f55355874d16ba7544c2d;Tue Aug 11 22:39:54 EDT 2009;Committer;naruse;2;8;2;10;0
9a28cb243cd346acbb63e71fea177ded328d8654;Tue Aug 11 15:07:00 EDT 2009;Committer;svn;1;2;2;4;0
d26cfd565da30c8eb92a48c6d1ab8ab8a8bdcd82;Tue Aug 11 15:06:51 EDT 2009;Committer;nobu;1;2;2;4;0
8e6a754b5db75eda8be13a4b08c998d4f36551cd;Tue Aug 11 14:14:41 EDT 2009;Committer;tadf;3;8;3;11;0
3aabcaa3dab84018b9dfd7edf7ad5c48f007e6f3;Tue Aug 11 13:27:46 EDT 2009;Committer;akr;1;8;1;9;0
8dfd78fc1c1bd4a19de2ce3276bf3ed5670ad1e1;Tue Aug 11 12:42:53 EDT 2009;Committer;nobu;2;5;1;6;0
7e30520ac29615cbe2c02d6dfbad67f561a7e1f2;Tue Aug 11 00:13:51 EDT 2009;Committer;svn;1;2;2;4;0
915fe3d78465182f8bd9e3b16644d90f30e95e7b;Tue Aug 11 00:13:35 EDT 2009;Committer;nari;1;2;2;4;0
60d1320326a7a58153b7dd76797512b8b2f566ba;Mon Aug 10 12:45:33 EDT 2009;Committer;nobu;2;5;1;6;0
2915bc4dc282f9e4166ebc562ebd7e85ae5bf643;Mon Aug 10 09:10:18 EDT 2009;Committer;kazu;1;10;10;20;0
51b7ec84a2d183bf726d200f1111753ddc9c9dc3;Mon Aug 10 07:13:56 EDT 2009;Committer;nari;1;3;1;4;0
de5f15bbe4bf2c8038f265df061233f3aa709477;Mon Aug 10 02:40:34 EDT 2009;Committer;nari;9;47;254;301;0
a8cf451714d1794f4bd95c422391ca5574735d41;Sun Aug 09 22:02:31 EDT 2009;Committer;nobu;1;5;3;8;0
3ece38366080f6c862e243d152476572ba15268a;Sun Aug 09 21:55:55 EDT 2009;Committer;nobu;6;70;41;111;0
979ac967a9d0437e698d3e555098c77e495baee8;Sun Aug 09 12:24:55 EDT 2009;Committer;nagai;3;12;5;17;0
83c5dfb7ea60474722fd53382e8f9c31e35258de;Sun Aug 09 07:37:22 EDT 2009;Committer;nobu;2;11;4;15;0
20d6525a6f826f0cc28ed097ca4207b65808f94f;Sun Aug 09 05:55:00 EDT 2009;Committer;mame;2;38;16;54;0
e56bf07b166f9b209745e3343f3f80f5e4d87a93;Sat Aug 08 23:25:32 EDT 2009;Committer;naruse;3;28;0;28;0
28f00681ca11e8df208fceadd74433f82cd9b533;Sat Aug 08 22:25:11 EDT 2009;Committer;nobu;2;6;0;6;0
d0e62a5509c3e562ef0503d6e31634d69113af61;Sat Aug 08 17:11:49 EDT 2009;Committer;svn;1;2;2;4;0
b1c4052fdf7f77388d4292fe362d970a7305076e;Sat Aug 08 17:11:39 EDT 2009;Committer;yugui;2;7;2;9;0
0ecfb5f6251a0f97c52a1d24b47d83988e4128c2;Sat Aug 08 05:34:09 EDT 2009;Committer;matz;1;1;1;2;0
4307340208f8b406708bcfb8d5583f6c4dfa7bc0;Sat Aug 08 02:47:02 EDT 2009;Committer;matz;2;9;1;10;0
ac2557e09fab847d48718222d351c16fff9432d0;Fri Aug 07 21:18:33 EDT 2009;Committer;nobu;4;80;19;99;0
5414f008d79a8721dc92b449f613f7e9d7bed806;Thu Aug 06 18:25:11 EDT 2009;Committer;nobu;2;5;1;6;0
b07df3826502b589e2c874e5ab8ee02ea549f3ac;Thu Aug 06 18:22:57 EDT 2009;Committer;nobu;2;10;2;12;0
b7aa5a41d38fe86c61cd9e69c4e60a59135de4f1;Thu Aug 06 16:56:12 EDT 2009;Committer;knu;1;1;1;2;0
04cad34c2f2678a0654469f49109f41aeead68a5;Thu Aug 06 16:51:37 EDT 2009;Committer;knu;2;71;60;131;0
43b2e3be9a4ef2bb8f30fc7b6a321298dd2796d3;Thu Aug 06 16:36:54 EDT 2009;Committer;knu;5;5;16;21;0
eb6c13bd089abaaccf0c205cc42c423959a3f3f3;Thu Aug 06 16:07:18 EDT 2009;Committer;svn;1;2;2;4;0
833b354578f20162aa28fe8fe5cda38caa13b48f;Thu Aug 06 16:07:11 EDT 2009;Committer;nagai;2;6;3;9;0
e97f1270b5332a5705f4999402fa97dc005097a2;Thu Aug 06 12:18:38 EDT 2009;Committer;usa;2;5;0;5;0
2bfa64d0b86e87e2cc63368f9a5fecbaba8add89;Thu Aug 06 12:12:32 EDT 2009;Committer;usa;2;10;6;16;0
7fdaba27ca72294fd12f8cc8a8a2a1d4db25948d;Thu Aug 06 10:49:05 EDT 2009;Committer;knu;2;15;1;16;0
a809077956248ce3c6c1038872ad184d06445ae5;Thu Aug 06 07:36:29 EDT 2009;Committer;nobu;2;7;1;8;0
a2393c3e53340a8a05855a9ef0d5222901b68a14;Thu Aug 06 07:26:49 EDT 2009;Committer;nobu;2;16;3;19;0
30995c6594c5df7017dc3649ac7f3d1f2b7c40d4;Thu Aug 06 07:25:13 EDT 2009;Committer;nobu;2;25;8;33;0
87c1a07d6a8f16949c44625924120cb0e5c707ab;Thu Aug 06 07:08:42 EDT 2009;Committer;nobu;1;25;25;50;0
efb909735211142ebab458e608f1af4fb6ad2abb;Thu Aug 06 06:44:10 EDT 2009;Committer;nobu;2;12;0;12;0
f86f669cf3242fe825c9b12a4e7b50769f822113;Thu Aug 06 04:30:15 EDT 2009;Committer;nobu;2;10;5;15;0
a032b1bdb868f4239fb209ef3006fe843c3ada74;Thu Aug 06 04:14:50 EDT 2009;Committer;nobu;2;34;19;53;0
c6ada1e7e044d584e30359c8783a5bf9eb019d60;Thu Aug 06 04:00:38 EDT 2009;Committer;nobu;3;44;7;51;0
d04b691b96fa1c4c0c55a30e711309f7d5301042;Thu Aug 06 03:05:16 EDT 2009;Committer;nobu;2;8;0;8;0
d427b8a8ee7882fd3d77d3a761a2b8adcfa27d5b;Wed Aug 05 16:40:33 EDT 2009;Committer;knu;3;452;137;589;0
c7b5cecb36487df4efe2ec1c24a4f9601b979dd4;Wed Aug 05 15:13:15 EDT 2009;Committer;svn;1;2;2;4;0
20a684739e1e6cb2e37a61c8b260532c8b483643;Wed Aug 05 15:13:07 EDT 2009;Committer;knu;2;12;5;17;0
8bc6c715475aae33d292b077003d15ea47b9913f;Wed Aug 05 10:19:18 EDT 2009;Committer;nobu;3;20;31;51;0
cb9038cbafd42efd669524417ee73919bed58c49;Wed Aug 05 10:18:21 EDT 2009;Committer;nobu;2;2;2;4;0
c6abdf3e0cc73a7d280976f404984f7da1500462;Wed Aug 05 10:12:31 EDT 2009;Committer;naruse;2;6;0;6;0
a2d42dab14a7593235062b557699b155daf5cef6;Wed Aug 05 09:46:07 EDT 2009;Committer;nobu;3;7;3;10;0
da19797648fae92b0e283ce4cdf84fb20bfc89a6;Wed Aug 05 05:01:12 EDT 2009;Committer;matz;3;14;2;16;0
c82826ce5f90f2b678b5e42309c4fd226863230f;Wed Aug 05 04:01:08 EDT 2009;Committer;nobu;1;13;1;14;0
6b0ac4ae63f630db39549455ff6529abf84b0796;Wed Aug 05 03:54:08 EDT 2009;Committer;nobu;2;7;0;7;0
0a2b36a99c189d7a7397e1589d161277a4324cc8;Wed Aug 05 03:39:29 EDT 2009;Committer;nobu;3;10;3;13;0
d857a1b0d77b1961d7432f598deab0308fe7d361;Wed Aug 05 01:40:15 EDT 2009;Committer;naruse;1;1;1;2;0
88c0b8fec94c192033c9522e7edc64ea2fb960e4;Wed Aug 05 01:38:36 EDT 2009;Committer;naruse;2;22;5;27;0
93b9f2cc5ef029d4cdeab7637fd419580af57d79;Tue Aug 04 18:28:49 EDT 2009;Committer;nobu;2;8;3;11;0
528574c2e21e25fe1f848f77f4e7606636a7a2dc;Tue Aug 04 16:44:05 EDT 2009;Committer;mame;3;46;3;49;0
5ea7e7f60b2c8393cc2a034aabd874768b32807c;Tue Aug 04 15:33:11 EDT 2009;Committer;nobu;3;8;3;11;0
f00babd1a6d9c5ec1b99442e3a38c53ddbb52a62;Tue Aug 04 13:13:17 EDT 2009;Committer;usa;2;8;2;10;0
61c11677c8ee20e07dea84a5a3bf8b68ff449188;Tue Aug 04 06:10:42 EDT 2009;Committer;knu;2;41;0;41;0
60ab77a16a89b0461205a3a6395009266a3ba279;Tue Aug 04 04:14:38 EDT 2009;Committer;naruse;4;103;51;154;0
38107457a387811b1dae6bba6c2904385f52722e;Tue Aug 04 03:42:11 EDT 2009;Committer;naruse;2;6;1;7;0
8c658137d9d4ae409bcf3f76b738392145c21401;Tue Aug 04 00:51:22 EDT 2009;Committer;naruse;2;86;5;91;0
b3d7273dc1f7e29a759de8dd88cd00f99a66bed1;Tue Aug 04 00:50:59 EDT 2009;Committer;naruse;4;30;1;31;0
e00b83ceb91048da8549399c11618345ce32d9cc;Mon Aug 03 22:44:45 EDT 2009;Committer;matz;2;9;0;9;0
d6b9cc7baaa8d54e996f43f2520698279c6d349f;Mon Aug 03 20:45:52 EDT 2009;Committer;matz;2;5;0;5;0
8fa67f4e5877ef92a2e3db151a8a2b7c2e13d8cf;Mon Aug 03 19:01:20 EDT 2009;Committer;svn;1;2;2;4;0
4293a98596af89a882629e47e84da8e5c05e1459;Mon Aug 03 19:01:03 EDT 2009;Committer;nagai;9;307;66;373;0
6b639283743fbae46db9fbe51960c674bb410ed2;Mon Aug 03 13:22:07 EDT 2009;Committer;mame;2;5;1;6;0
e2ea286ec9edd54f1edbe7190e354c77f7219284;Mon Aug 03 09:26:26 EDT 2009;Committer;matz;4;11;3;14;0
0f1c1ecbd89de6dfc4133c625c2ed234f50b19f5;Mon Aug 03 09:15:09 EDT 2009;Committer;matz;2;8;0;8;0
0fe4c1decbd71c2aa5f09aa84f7b46e4394b8593;Mon Aug 03 08:07:11 EDT 2009;Committer;matz;2;22;4;26;0
fe038100d98e5352139367627809c17f1773f9c9;Mon Aug 03 07:30:19 EDT 2009;Committer;usa;2;10;7;17;0
9997227af889127eb1af4298e485708c4be3b367;Mon Aug 03 07:20:14 EDT 2009;Committer;nobu;1;1;0;1;0
34401f9014c0d983f66d144ca8cccd25b1fe47a7;Mon Aug 03 06:56:57 EDT 2009;Committer;nobu;2;7;5;12;0
49816a25525e96e6d78e013ad632555a83672187;Mon Aug 03 06:48:46 EDT 2009;Committer;nobu;2;20;9;29;0
8b0fef3747e8b6dcf13ed97404c6642495964b94;Mon Aug 03 06:35:38 EDT 2009;Committer;nobu;1;1;3;4;0
45cd729f17d6585c00241b230f2f2dd0e5e2db52;Mon Aug 03 05:15:54 EDT 2009;Committer;matz;2;6;0;6;0
330be69e4310886cc0d54356b2273113d288d9b1;Mon Aug 03 04:05:37 EDT 2009;Committer;nobu;2;10;5;15;0
bd85292d3fa7a3164deae2ef2a4a7d89f3633738;Sun Aug 02 15:32:15 EDT 2009;Committer;svn;1;2;2;4;0
a194550e5c3076770a16b44ef3cdd1ab3cb904ed;Sun Aug 02 15:32:04 EDT 2009;Committer;nobu;3;9;2;11;0
59e5d0f1779304baf931f2bd6bf82f168cbc9ef4;Sun Aug 02 12:06:31 EDT 2009;Committer;nobu;1;3;0;3;0
6a26b59600c7c66611c9a52038bb95ff4d4194c0;Sun Aug 02 12:04:43 EDT 2009;Committer;nobu;3;10;0;10;0
3770ac98ff18a7ebc9836550f91b81dcfc19106d;Sun Aug 02 11:09:12 EDT 2009;Committer;nobu;2;10;2;12;0
dfd3d1fb295ad736b2bc2366a7bab49923793bb2;Sun Aug 02 08:40:52 EDT 2009;Committer;mame;2;8;0;8;0
e626e0bdec56d15e01450509828f587cc5fa4687;Sun Aug 02 05:20:51 EDT 2009;Committer;nobu;3;33;13;46;0
3fcfe38c1a6a674d1438e8a8396cbe2cede9d196;Sat Aug 01 21:35:40 EDT 2009;Committer;svn;1;2;2;4;0
8cdfbfd844060c20e7de34796cc9171383fc5e20;Sat Aug 01 10:25:48 EDT 2009;Committer;naruse;2;6;2;8;0
51d1c5e73bf44baecf598b8997a0d291518da351;Sat Aug 01 09:51:05 EDT 2009;Committer;nobu;2;11;0;11;0
5a5355e84f93b84245e7e66af0bd87a4b3300d4a;Sat Aug 01 09:35:00 EDT 2009;Committer;nobu;2;12;6;18;0
17dc5b35189d39a45689cfdb0fb07dfd1775cc27;Fri Jul 31 20:52:00 EDT 2009;Committer;svn;1;3;3;6;0
c4641d6a00c4ea3689867d74ae347c6505371af0;Fri Jul 31 20:36:04 EDT 2009;Committer;naruse;2;7;1;8;0
971f2bb7690cf673121b53cdf17b61ab90ee5eca;Fri Jul 31 09:03:09 EDT 2009;Committer;usa;2;6;1;7;0
00499c097f0d62a0389d006b61d766cef0ba14ff;Fri Jul 31 07:37:02 EDT 2009;Committer;naruse;3;19;0;19;0
bc70ea70cd455261d185ec386e4c04ce9ccabf62;Fri Jul 31 06:09:13 EDT 2009;Committer;usa;2;15;5;20;0
a436212282330a6b132e0a4174178a4ca253dea0;Fri Jul 31 04:16:01 EDT 2009;Committer;usa;2;9;2;11;0
e5df8fd261824a4ed6fc65a5a846b8b7a37ee3c3;Fri Jul 31 02:48:10 EDT 2009;Committer;nobu;2;5;3;8;0
5004e33f8de3b7ce8208421da512102c95c597cb;Fri Jul 31 01:54:14 EDT 2009;Committer;nobu;2;12;1;13;0
3129ed327ed8a365652fedf1d311e0af6137491c;Thu Jul 30 18:02:37 EDT 2009;Committer;mame;3;11;3;14;0
22acf29509f5cfc44a3dfa9d418bad13b29291da;Thu Jul 30 15:57:06 EDT 2009;Committer;mame;2;17;6;23;0
f3f74f49f0b91bf9186412c78ac93919d1e12b5e;Thu Jul 30 15:35:05 EDT 2009;Committer;svn;1;2;2;4;0
447df19520513eb5bdac973bcfc94ddc26580d17;Thu Jul 30 15:34:56 EDT 2009;Committer;mame;2;6;1;7;0
b5b8e5e0f4e2d220073d69032c9b2b8a8289d49f;Thu Jul 30 14:12:42 EDT 2009;Committer;yugui;2;18;1;19;0
e60463034a468ec9fcee73466e76bd541c9a39c3;Thu Jul 30 14:12:25 EDT 2009;Committer;yugui;4;34;107;141;0
045136d47599596c78e72ecb8de688671dfae669;Thu Jul 30 12:57:02 EDT 2009;Committer;mame;2;194;0;194;0
fe22f83ecf03f969860ce8cddc53d9917e32cbc2;Thu Jul 30 12:55:04 EDT 2009;Committer;mame;2;7;1;8;0
6937a3e26f15199cb2c2cd180f2e83d941eaad8b;Thu Jul 30 12:45:51 EDT 2009;Committer;mame;2;6;1;7;0
df878f78c5c53137f1fad3c494362b6d821f8dc1;Thu Jul 30 12:42:41 EDT 2009;Committer;mame;3;19;6;25;0
5e85648b770f6999bc0020ddddfe0bcdbf5149c5;Thu Jul 30 09:40:06 EDT 2009;Committer;duerst;3;12;0;12;0
b8b083dbd5444007645a667dcb9d7a30e1e44b0b;Thu Jul 30 07:45:42 EDT 2009;Committer;nobu;6;43;2;45;0
d919a67c1e704ba7c7f0067ec649c98288a662fe;Thu Jul 30 07:43:32 EDT 2009;Committer;nobu;1;1;1;2;0
8bc2fb5ba4c20437a6f4929163769fdc37a89e8b;Thu Jul 30 07:39:09 EDT 2009;Committer;xibbar;1;5;0;5;0
08fa9bad5bc00a8315900c7eed180a3925d8a75b;Thu Jul 30 07:12:56 EDT 2009;Committer;nobu;2;6;7;13;0
d67e9aeae2225e0a8e1ea6e47ac5a43e975027d6;Thu Jul 30 07:10:51 EDT 2009;Committer;nobu;2;80;69;149;0
cf81e3cc733af514c121cc61151d278c4a3d0f08;Thu Jul 30 05:34:13 EDT 2009;Committer;svn;1;2;2;4;0
1976ef38a7630addb63689053b6dc1d4889d934d;Thu Jul 30 05:34:02 EDT 2009;Committer;xibbar;6;57;16;73;0
3ca25b5a292edfee968d64aac686b46265cad5b5;Tue Jul 28 23:11:29 EDT 2009;Committer;naruse;2;6;1;7;0
edf05962c018e9decf6c49c141d0133c716ac770;Tue Jul 28 18:40:17 EDT 2009;Committer;matz;2;5;1;6;0
07de51fc4fbb392cedc5b5700bab7b2ac37cfd02;Tue Jul 28 18:38:59 EDT 2009;Committer;ko1;3;8;4;12;0
8c0e6223f20e8e2318f43f9a957de00fb08b2d24;Tue Jul 28 18:14:32 EDT 2009;Committer;svn;1;2;2;4;0
497ee63f8d8c5df055efa6b8782a07ebdbcb0443;Tue Jul 28 18:14:11 EDT 2009;Committer;ko1;2;9;2;11;0
9050b61dcbee9bbd5ad9e494de65cd4cd3103af8;Tue Jul 28 10:41:11 EDT 2009;Committer;ko1;3;18;0;18;0
49991ff6f85455f57ee9495a082d85c68da7d63c;Tue Jul 28 08:46:04 EDT 2009;Committer;matz;2;6;0;6;0
fc13dbdcf58e45b0121f8c07629c6a184ef92437;Tue Jul 28 07:02:03 EDT 2009;Committer;kazu;1;12;12;24;0
5ff79f0bfd51cf5232bbbc873c14225d0bedbfa9;Mon Jul 27 19:42:08 EDT 2009;Committer;svn;1;2;2;4;0
8e7e28f15c2973a6e083da7da9ccaf4769d272c0;Mon Jul 27 19:40:43 EDT 2009;Committer;nagai;4;327;170;497;0
2b2a9a23d0e8adb2e53e99bc780e6084a404c53b;Mon Jul 27 10:03:12 EDT 2009;Committer;nobu;2;15;10;25;0
1ac307dddc22f333e5e1d93110eb4eeb947fc79c;Mon Jul 27 01:25:01 EDT 2009;Committer;nobu;3;12;5;17;0
f9e7c3c37f022aa88dc19c993e814df03c623239;Mon Jul 27 00:37:54 EDT 2009;Committer;nobu;2;3;3;6;0
b7f26835dae3005f1eefbb1700aa711b811fb2fc;Sun Jul 26 10:17:39 EDT 2009;Committer;nobu;3;18;0;18;0
f9f1581f6d777be9ee2fe8612d77832cd214d1a2;Sun Jul 26 09:36:32 EDT 2009;Committer;nobu;1;17;28;45;0
00d61f1fe52b7637e93dde5a7c55cb2138a88405;Sun Jul 26 09:30:08 EDT 2009;Committer;nobu;3;29;2;31;0
34df0e5c9f82a604e3448757e580bd7a75169596;Sun Jul 26 09:27:45 EDT 2009;Committer;nobu;1;36;37;73;0
9eef2ad2823cf1164e63e77964be7ea82af468f2;Sat Jul 25 15:24:13 EDT 2009;Committer;azav;1;1;1;2;0
f1587cc43f64bd14380113afcd03dcea9f32d0c0;Sat Jul 25 15:21:04 EDT 2009;Committer;azav;1;8;0;8;0
6c4e4f9a4b08cdc18323cb4e2550211628a33791;Sat Jul 25 15:19:26 EDT 2009;Committer;azav;1;5;0;5;0
0a12f4acc13c915e4106aca68aeb6e774d59d9ce;Sat Jul 25 15:18:47 EDT 2009;Committer;svn;1;2;2;4;0
a34dc9dc148d16d290961b8c477fb5ed103140c7;Sat Jul 25 15:18:37 EDT 2009;Committer;azav;1;18;18;36;0
c689ee1a89feb9d5acebb7a6092aef23af3cf35b;Sat Jul 25 08:49:08 EDT 2009;Committer;nobu;3;11;5;16;0
d6ab828369b8ab6995b47abd9ab5982618c2d334;Sat Jul 25 04:44:36 EDT 2009;Committer;nobu;5;19;8;27;0
4fd615943ed879a3694bd986f48a52486c7c52e1;Sat Jul 25 04:42:48 EDT 2009;Committer;nobu;0;0;0;0;0
6e8aa03d2dc44826c0931dd719e3b75cbf877b75;Fri Jul 24 16:16:14 EDT 2009;Committer;svn;1;2;2;4;0
a8951a5b3a97af7f4e1a5e93c69b2cb1c892edd2;Fri Jul 24 16:15:53 EDT 2009;Committer;naruse;2;39;18;57;0
28862075842f6e8e62d00954a291b01ba80e61a1;Fri Jul 24 10:26:18 EDT 2009;Committer;duerst;6;18474;1;18475;0
9914a16ca941f47b9fa32874933594a59cf65267;Fri Jul 24 09:09:04 EDT 2009;Committer;shugo;3;116;10;126;0
bdd52721b3fc5cfeb0602f7127ade39afa759a3e;Thu Jul 23 15:20:59 EDT 2009;Committer;svn;1;2;2;4;0
4676ede3d1338ca78c58496a3ce11e78df188215;Thu Jul 23 15:20:47 EDT 2009;Committer;shugo;3;130;5;135;0
f984a4d8476c8e1349caed98379843d1268bb069;Thu Jul 23 08:35:22 EDT 2009;Committer;keiju;2;44;1;45;0
dac591d01b0f6f85003b0268119da1d3df8527b5;Thu Jul 23 08:28:49 EDT 2009;Committer;nagai;2;12;8;20;0
87487a8c8ae89455b897c4ee16db461cd1490f03;Thu Jul 23 05:36:57 EDT 2009;Committer;usa;2;7;2;9;0
375ccf82c799a41ee288781fe9f5caf1b1e426c8;Wed Jul 22 23:55:12 EDT 2009;Committer;drbrain;1;5;0;5;0
f8faa5e8fe58638af854df11f47ac9d553c938fc;Wed Jul 22 23:52:20 EDT 2009;Committer;nobu;2;13;5;18;0
7a5d48f6ab6dc3d195b715b58d4bd1e3d6e0aaff;Wed Jul 22 18:21:32 EDT 2009;Committer;matz;2;6;1;7;0
9ce6eb65bbeb97778c96fba55487c9aead469fea;Wed Jul 22 17:53:56 EDT 2009;Committer;matz;2;7;2;9;0
9adaa9e9df9c3aefc13473ae9bcfbbc58bc2de15;Wed Jul 22 15:39:32 EDT 2009;Committer;nobu;2;5;1;6;0
9f66faa3749e3919726828199b25a9b3b6b30e96;Wed Jul 22 15:09:50 EDT 2009;Committer;nobu;2;6;0;6;0
a60b9f919054c7e72a1574a93d1925351ff40ca8;Wed Jul 22 15:07:57 EDT 2009;Committer;nobu;2;3;3;6;0
31c561f66a4fc727f24a1010bf1dfff6f6c85ffc;Wed Jul 22 13:37:26 EDT 2009;Committer;mame;6;64;51;115;0
506a9821ce44db2b02bf3da99bef8b2e55f46562;Wed Jul 22 13:27:26 EDT 2009;Committer;shyouhei;4;15;4;19;0
9d43aefe922a432a5f0accfa3599976ee9de7734;Wed Jul 22 11:43:32 EDT 2009;Committer;usa;2;8;0;8;0
82041cfdecf74a47827a23bbdb017f7b6f043cd5;Wed Jul 22 10:32:51 EDT 2009;Committer;usa;2;6;1;7;0
52d3e529ab9006f1493eb36d5e1cf4e97cfc754e;Wed Jul 22 10:24:37 EDT 2009;Committer;usa;2;5;1;6;0
ce1ef5b6044027e8042a3685502976d8c057c444;Wed Jul 22 08:42:12 EDT 2009;Committer;usa;2;9;0;9;0
6b7603194da41c578ffb79f937106f39424a97ca;Wed Jul 22 08:30:41 EDT 2009;Committer;usa;2;6;0;6;0
e1f50e25647e18aa4894f19f1abb6cb8ded1113c;Wed Jul 22 07:46:37 EDT 2009;Committer;yugui;2;16;7;23;0
681dce6bfefc2f4cb4adedce884e91d97e50b321;Wed Jul 22 01:01:27 EDT 2009;Committer;usa;2;7;1;8;0
2e4ad56fc2139991cb6e90df1f7bfd1cfbe49f00;Tue Jul 21 23:38:23 EDT 2009;Committer;nobu;1;1;2;3;0
5ab016489cb35b77bbb0192a2bf818ff0fe9be8c;Tue Jul 21 17:35:24 EDT 2009;Committer;keiju;2;14;2;16;0
300d60a8e425ef35a18f46d74fd582473cfafc4e;Tue Jul 21 16:36:41 EDT 2009;Committer;matz;2;20;14;34;0
09d18a1a8f1aded0b6d8ac63908e3b1da36cfc75;Tue Jul 21 15:40:05 EDT 2009;Committer;svn;1;2;2;4;0
24a510a11e1dd00b485fc48d48648d9371390cef;Tue Jul 21 15:39:51 EDT 2009;Committer;keiju;3;40;19;59;0
4516f623b8628e8b424197cf29c786172f23e1ad;Tue Jul 21 14:51:17 EDT 2009;Committer;mame;3;14;4;18;0
7203e59f275dfe6f0b6e6f301673400565c5e0dc;Tue Jul 21 12:41:01 EDT 2009;Committer;keiju;2;10;4;14;0
623cfccb6f40c61f2b014301e13ac0c11c01f8a8;Tue Jul 21 11:45:24 EDT 2009;Committer;keiju;2;59;25;84;0
904abb1d9b05a7a3f01fbf72fd53b77c2afbd5af;Tue Jul 21 07:27:08 EDT 2009;Committer;suke;3;75;143;218;0
4ec8dc6d61986fa8d778ebe43876d15674038c74;Tue Jul 21 07:08:02 EDT 2009;Committer;nobu;2;5;1;6;0
9dd0d271568c6bf37987698c229d162b4d664281;Tue Jul 21 04:38:20 EDT 2009;Committer;usa;3;229;1;230;0
3f0308dbf13e831435f3958b51b4319533e01a03;Tue Jul 21 04:35:56 EDT 2009;Committer;usa;2;7;0;7;0
9009b471da52a3bdd1ca7194e84e24317e591879;Tue Jul 21 03:45:37 EDT 2009;Committer;nobu;2;6;2;8;0
ea850e3030dac8e054ba854ba8c4eea2a3c46f7d;Tue Jul 21 03:38:17 EDT 2009;Committer;nobu;3;12;7;19;0
c38487d06322cbe5eb5ee008e681fee6ec7363b4;Mon Jul 20 11:37:26 EDT 2009;Committer;naruse;2;7;0;7;0
5a392c71dbf5cdc5af261acd3c56eac39e217988;Mon Jul 20 10:01:05 EDT 2009;Committer;nobu;4;25;10;35;0
abc20ed0f4b0067ad912f345245161426d331ed8;Mon Jul 20 03:53:19 EDT 2009;Committer;wanabe;2;7;3;10;0
aea1193a9635f732315043248dee6b3da48739a1;Mon Jul 20 03:29:22 EDT 2009;Committer;akr;1;3;0;3;0
ce34147cf4de2212b77d11d83a8e4cbd9df52683;Mon Jul 20 02:13:00 EDT 2009;Committer;nobu;4;26;5;31;0
1a36dbe3ba91c7254169f67f0142680eb05aeaa8;Mon Jul 20 01:57:43 EDT 2009;Committer;svn;1;2;2;4;0
5453433223fea3fbbae2399c4c5ee66f843a238a;Mon Jul 20 01:57:32 EDT 2009;Committer;akr;2;6;1;7;0
bb45f1b2b8a21a8e6de705c9a68724a49563c66c;Sun Jul 19 13:25:05 EDT 2009;Committer;tadf;2;20;0;20;0
a7290749a5a6d4e0420d4b18a8153b25f86c34f2;Sun Jul 19 11:43:23 EDT 2009;Committer;tadf;3;8;2;10;0
666049981f1bb5a886a7ae837f800946f0192adb;Sun Jul 19 08:53:11 EDT 2009;Committer;akr;1;31;5;36;0
2737b90e36f43865be74ebf6b71ea3ab42309720;Sun Jul 19 08:32:44 EDT 2009;Committer;nobu;3;11;0;11;0
33fc55acef6a2d7b79cf5ac084bbb94cb3b14b31;Sun Jul 19 02:00:27 EDT 2009;Committer;nobu;3;15;0;15;0
3d57dfa01b8603da4d63a85014fa4cd0b640048e;Sun Jul 19 01:56:50 EDT 2009;Committer;akr;2;8;2;10;0
828d7a368acab6ca389a0d34791368c2e708f48b;Sun Jul 19 00:48:40 EDT 2009;Committer;usa;1;13;6;19;0
1e18f3a857cf6c3065a1ffed3627f61e2f232c27;Sat Jul 18 15:01:00 EDT 2009;Committer;svn;1;2;2;4;0
acbb181219e83eeb6f54f725cf72d05aa3048863;Sat Jul 18 15:00:50 EDT 2009;Committer;naruse;2;8;1;9;0
33151fcfe40cbe9c2410cec1a4760a0e1f62bce5;Sat Jul 18 08:43:30 EDT 2009;Committer;nobu;2;5;1;6;0
e07cb859cc882adc05f818466b45e75f1d5a1e39;Sat Jul 18 08:05:32 EDT 2009;Committer;nobu;16;151;145;296;0
0f6d9dfc96c145e69b94d24d51d98480abd72ae1;Sat Jul 18 07:22:42 EDT 2009;Committer;nobu;1;8;8;16;0
b3b7cd5f0ea597dfdf4321b36bb59c5780757963;Sat Jul 18 07:03:15 EDT 2009;Committer;nobu;2;16;0;16;0
4c7c46b6af84efab1848ae21896ad7264aba6d79;Sat Jul 18 02:40:31 EDT 2009;Committer;usa;2;10;1;11;0
f3d022543ef2afde3d53e7f6b3028eafe39d0ef4;Sat Jul 18 00:16:25 EDT 2009;Committer;nobu;3;35;5;40;0
8195282dfc4752ae8ec7fc1cb18f7c8e5f3d9d65;Sat Jul 18 00:10:46 EDT 2009;Committer;nobu;1;4;1;5;0
b12c5a85b47c55d94b5baace09ad668ce610f716;Sat Jul 18 00:07:07 EDT 2009;Committer;nobu;2;11;0;11;0
924e2fcefa36ad9f2750590e3daa184b03b9d734;Fri Jul 17 22:57:10 EDT 2009;Committer;nagai;2;6;1;7;0
bdfe1c7f8e5afbda4be37285370edb5153a4626e;Fri Jul 17 22:28:28 EDT 2009;Committer;akr;1;1;1;2;0
556232734e0003ce327d22a7ea1ada57a86a10dd;Fri Jul 17 22:09:14 EDT 2009;Committer;nagai;3;41;8;49;0
436b2f887a937f26f8c4a69c2dc26ad60667aa1e;Fri Jul 17 21:33:05 EDT 2009;Committer;usa;3;15;7;22;0
7d7ca2d9eceb6dc05762e230c605f611a3a02f11;Fri Jul 17 15:26:40 EDT 2009;Committer;svn;1;2;2;4;0
37859b522727f99e76ab0878822ae4b0bc412bed;Fri Jul 17 15:26:30 EDT 2009;Committer;yugui;3;10;0;10;0
229b4e4c3773949987950c7fa5ed09868fcd094d;Fri Jul 17 13:40:59 EDT 2009;Committer;usa;5;33;5;38;0
3d704802ddcd23c5396428d9bb96f96ae2de6e77;Fri Jul 17 13:31:00 EDT 2009;Committer;usa;3;11;0;11;0
bc2df4136536496e72a8bbdf14a8980f65b259b8;Fri Jul 17 09:28:46 EDT 2009;Committer;akr;2;25;10;35;0
2cdcc564fd9a15e8f6d7f20c972cdc6e98243b67;Fri Jul 17 09:13:29 EDT 2009;Committer;akr;2;23;8;31;0
0101958745f8a18679a71f378656f0ed5184e36b;Fri Jul 17 07:49:06 EDT 2009;Committer;akr;3;6;4;10;0
003fa83e0cce2b1cc514acc8a9aa7e4c7278104d;Fri Jul 17 06:21:14 EDT 2009;Committer;nobu;2;5;3;8;0
ed52949e7960693eb2498d20b8e4d4cc06c3a801;Fri Jul 17 04:58:38 EDT 2009;Committer;nobu;2;12;3;15;0
115c220b4d7593bccff0ad3feb66bcdbc4bb008a;Fri Jul 17 04:56:12 EDT 2009;Committer;nobu;2;25;0;25;0
bc0ea18dbd073bea10a8f3c610bb879a31468c60;Fri Jul 17 04:52:22 EDT 2009;Committer;nobu;1;0;14;14;0
c7550e2a3d7b048e3c2b516fd5c7449c32f0a105;Fri Jul 17 04:38:27 EDT 2009;Committer;akr;2;6;1;7;0
ae487eda6e961a7010b1a6914cb05100fdf207a5;Fri Jul 17 02:04:37 EDT 2009;Committer;matz;3;14;5;19;0
4d70a43e3d014ff2eb4f0d7a8efabff6e657439f;Fri Jul 17 00:18:44 EDT 2009;Committer;svn;1;2;2;4;0
6dc1fea5526e858985043af075c0bb712a056549;Fri Jul 17 00:18:34 EDT 2009;Committer;akr;1;0;6;6;0
31060fb11be83c8d8c38fa1c2b8f0f7bc10cac9c;Thu Jul 16 14:34:09 EDT 2009;Committer;nagai;4;71;17;88;0
6d7ddc3b297bfe6ca9f091c0097722b0422cc7e2;Thu Jul 16 12:06:23 EDT 2009;Committer;suke;3;57;17;74;0
1c75d58165fef446d507ce6f05e50eeaa66772f7;Thu Jul 16 10:04:17 EDT 2009;Committer;usa;2;6;1;7;0
3622071601cd1d325a0155cd8c37df2692374722;Thu Jul 16 09:43:01 EDT 2009;Committer;nobu;2;5;1;6;0
b0c869c983bc0e468113728eeea526479752d8bd;Thu Jul 16 09:33:51 EDT 2009;Committer;nobu;1;0;1;1;0
1cd0ddea1bee76e77e207e0e65c2a782e0cf21f2;Thu Jul 16 09:30:23 EDT 2009;Committer;nobu;2;9;1;10;0
415d5ebc2f96e04fea438cd86ad23aa94a0e1da2;Thu Jul 16 09:28:12 EDT 2009;Committer;nobu;7;38;24;62;0
fa41dad1b2ae2bdf58bff62dac561362cf81ab49;Thu Jul 16 09:02:26 EDT 2009;Committer;nobu;1;4;0;4;0
c15e6bf465a10a25dc866f50b5589d4d64a2155d;Thu Jul 16 08:55:00 EDT 2009;Committer;nobu;1;1245;36;1281;0
b5dd85f049ce4dc7249711ac9ee5c7a90520d4f1;Thu Jul 16 08:44:23 EDT 2009;Committer;ko1;3;17;4;21;0
53163f8138e1e0d1c0f91351a8cfe8749151d56e;Thu Jul 16 07:00:23 EDT 2009;Committer;nobu;2;13;0;13;0
5e65d8f433f555af052ae6a32f42adb897778c58;Thu Jul 16 06:52:29 EDT 2009;Committer;nobu;4;40;7;47;0
eb9bc2d2655c336a1e5a34af69fdf5bf2c7d0788;Thu Jul 16 06:00:35 EDT 2009;Committer;nobu;3;569;125;694;0
57264a4fae07ab1caca704519c1f426145eafe93;Thu Jul 16 05:10:18 EDT 2009;Committer;matz;2;10;3;13;0
606ea39a3b03566079d49711ab8a7b53d447b938;Thu Jul 16 03:45:12 EDT 2009;Committer;naruse;2;11;0;11;0
34f8c6becdc7e713e12bf76b99567ef55ec74195;Thu Jul 16 00:38:07 EDT 2009;Committer;nobu;1;58;58;116;0
934b700100fcca8f3dd59b98cb39542a3d25afe6;Thu Jul 16 00:37:25 EDT 2009;Committer;nobu;1;78;78;156;0
94664d6d0cc8042e98c7256ec28a751d3e5b687c;Thu Jul 16 00:01:06 EDT 2009;Committer;ko1;8;26;24;50;0
d4628c0bcd0479b15593cfa4ed0907b4360857e0;Wed Jul 15 23:59:15 EDT 2009;Committer;ko1;2;12;4;16;0
0e03a296e63b9694709de9bc462c08de60873a58;Wed Jul 15 23:57:33 EDT 2009;Committer;ko1;2;5;2;7;0
70303852733730508621b1185f8032449efafa80;Wed Jul 15 23:56:25 EDT 2009;Committer;ko1;2;5;1;6;0
7336e811459baeb6b7b07b091b6481a2460fab25;Wed Jul 15 23:55:30 EDT 2009;Committer;svn;1;2;2;4;0
0d2449bd35061399c57d6ce87128d7e876db645c;Wed Jul 15 23:55:21 EDT 2009;Committer;ko1;2;6;1;7;0
c330876d7c5065f89234becc5125426d0d136bdc;Wed Jul 15 14:59:41 EDT 2009;Committer;ko1;19;882;785;1667;0
d3cbda6e8dc5732f64b06cacb4c137f01ebe0461;Wed Jul 15 14:46:44 EDT 2009;Committer;ko1;2;5;0;5;0
618cb2cab05ea0629c91dc5a5351fe3cfd6d0863;Wed Jul 15 09:05:32 EDT 2009;Committer;yugui;3;49;6;55;0
dc1327a6f2c779775e147fc3f020b0af114c4c19;Wed Jul 15 07:30:42 EDT 2009;Committer;usa;2;5;1;6;0
3272d17d0c80c714a173ba87eda87a7eb8806bf8;Tue Jul 14 21:29:49 EDT 2009;Committer;nagai;2;6;2;8;0
0845f5c16532edbee7c739e97b4cb1cfb905d4b8;Tue Jul 14 19:30:34 EDT 2009;Committer;svn;1;2;2;4;0
ed5508324623cf95f63df5cf686a8027e8ae4009;Tue Jul 14 19:26:59 EDT 2009;Committer;naruse;2;7;2;9;0
c749e4fca225cd00f5be15f6fe6e4538a6c29413;Tue Jul 14 12:53:23 EDT 2009;Committer;nobu;4;120;23;143;0
6a3931e0f630f56d4acd2b232f58c0225f03f52b;Tue Jul 14 08:30:54 EDT 2009;Committer;naruse;2;7;0;7;0
9681409e3691037c11c19052295616454f74c936;Tue Jul 14 07:13:11 EDT 2009;Committer;nobu;3;25;5;30;0
ed586352292f331f2166205c0d7b99b69eab4ba4;Tue Jul 14 00:28:31 EDT 2009;Committer;nagai;3;8;2;10;0
2b94358ac41e2d1553c4f769fdb378c659fb5e0a;Mon Jul 13 23:11:34 EDT 2009;Committer;nagai;1;1;1;2;0
5cc1edcd0d03cf433b08b8ac8a99bfee5dd7538e;Mon Jul 13 16:32:00 EDT 2009;Committer;naruse;2;8;2;10;0
f03642038e3c0f8c387226d845b0910179c0d72a;Mon Jul 13 16:26:08 EDT 2009;Committer;naruse;2;13;9;22;0
cb46d98caad5b49dd416c5909e4b10fe957ea876;Mon Jul 13 16:07:43 EDT 2009;Committer;mame;4;35;9;44;0
9e6a1e1479c001910ed84c8768a534e23800d40b;Mon Jul 13 15:47:29 EDT 2009;Committer;svn;1;2;2;4;0
d41195a3bc2e40a15dd18adf2038de1266456cc6;Mon Jul 13 15:47:20 EDT 2009;Committer;yugui;2;16;0;16;0
7287b852da95b3bee1395fd80752e62b686da294;Mon Jul 13 13:51:49 EDT 2009;Committer;yugui;3;18;1;19;0
0fefd1902329f72434e859bd77a7ea5a114c00ff;Mon Jul 13 13:33:00 EDT 2009;Committer;usa;2;17;3;20;0
76e30054317d1f56137e6ae46e494b1c43f4a85e;Mon Jul 13 12:41:24 EDT 2009;Committer;yugui;1;26;0;26;0
b3b6698e2f05ddf186e71153f81b76098222a6b0;Mon Jul 13 11:39:05 EDT 2009;Committer;yugui;1;1;1;2;0
4fbc270cd5116dcfc0dc8677c5c0937e20addcf9;Mon Jul 13 11:21:55 EDT 2009;Committer;nobu;2;6;1;7;0
ecb962058ad33f722f749391d648dd145e940e44;Mon Jul 13 10:43:45 EDT 2009;Committer;naruse;2;7;2;9;0
20d9aefccbc5d9b5f9feacef9ee52dc1731aec55;Mon Jul 13 09:30:23 EDT 2009;Committer;ko1;8;83;27;110;0
762f9b28c675b49a4667bfae011857e9e02bcea5;Mon Jul 13 09:12:02 EDT 2009;Committer;yugui;2;382;62;444;0
0ac93a1a405d3642a1e73294c04f428c79f5f947;Mon Jul 13 04:44:20 EDT 2009;Committer;ko1;6;86;37;123;0
aaf53ad5b82483a33753f0ca1589e8fa3003924c;Mon Jul 13 00:33:06 EDT 2009;Committer;nobu;1;1;1;2;0
ed6ce8b43b6f25df1d4809ac799de4dd1c85c1f3;Sun Jul 12 23:08:32 EDT 2009;Committer;nagai;228;7260;1043;8303;0
e13fb8029b87943ab8af2211226b7c9347d3976d;Sun Jul 12 17:36:23 EDT 2009;Committer;akr;1;1;0;1;0
796fc30f8404061d173bb48f1af0a5a35ce5c900;Sun Jul 12 16:18:18 EDT 2009;Committer;nobu;2;11;12;23;0
400d826393030c5dcf45e55192506fa9d6765b01;Sun Jul 12 15:04:42 EDT 2009;Committer;svn;1;2;2;4;0
0dc7839b7f6176de843126466a97fc24a034398e;Sun Jul 12 15:04:33 EDT 2009;Committer;naruse;2;8;2;10;0
8d9896c3b98aba5eb86a4b9405bc661658cb0a80;Sun Jul 12 14:57:42 EDT 2009;Committer;tadf;3;72;12;84;0
b1f618e9e511ee9fd16cb86153a48193652472db;Sun Jul 12 14:30:32 EDT 2009;Committer;nobu;2;7;0;7;0
898bb1cbe3391dd69093edbbc00f2f164c8457b6;Sun Jul 12 12:09:21 EDT 2009;Committer;tadf;3;24;16;40;0
fff1183ffefc1cc29860672eb39992a942c33dfb;Sun Jul 12 11:46:40 EDT 2009;Committer;tadf;4;28;1;29;0
17c1e454055eaa8e6884e23a195a5fc65ed4277f;Sat Jul 11 17:24:46 EDT 2009;Committer;nobu;3;38;33;71;0
3f405a768880bf6c042c072fd833d7be47162034;Sat Jul 11 05:49:22 EDT 2009;Committer;nobu;1;1;1;2;0
cb7075a6a2e57bea2c689baa79df15cccbc206b0;Sat Jul 11 05:46:36 EDT 2009;Committer;naruse;2;18;0;18;0
c51a9689033dc9cc3deb6e4cca8d7d6aeb91457b;Fri Jul 10 22:12:07 EDT 2009;Committer;nobu;2;14;6;20;0
a88589c7d18c5004bb8b9f8191cb0d3aa3e5a705;Fri Jul 10 17:37:52 EDT 2009;Committer;nobu;2;7;2;9;0
1dabc36b8f3545611b00c7161e535246951c5866;Fri Jul 10 15:16:32 EDT 2009;Committer;nobu;2;8;4;12;0
38867cc1150e533a8df65de673195fe632c2d7f8;Fri Jul 10 15:11:43 EDT 2009;Committer;nobu;4;8;2;10;0
161f0a16990d8025135bcca1af3c992bfc3cf68c;Fri Jul 10 14:21:13 EDT 2009;Committer;naruse;2;5;0;5;0
f188db310555c347544d29916dd4a270b8a7419c;Fri Jul 10 14:21:04 EDT 2009;Committer;naruse;2;6;1;7;0
cdeed3b3ebb6a03f5ee265e1dd98f327fdbb7a8c;Fri Jul 10 13:47:48 EDT 2009;Committer;nobu;1;1;1;2;0
67016f368ca55493c34d8b3a6c38a2cd01a951fa;Fri Jul 10 13:17:43 EDT 2009;Committer;naruse;1;8;5;13;0
257c314fbb34230aea4528fbc1276304f6c7575c;Fri Jul 10 13:03:40 EDT 2009;Committer;kouji;4;31;0;31;0
89fd52131942b4f5365194344ce32346ace5f112;Fri Jul 10 12:13:18 EDT 2009;Committer;kouji;5;161;38;199;0
5d8b373b05d8710a397c2b8da0406847c5e883ec;Fri Jul 10 11:41:27 EDT 2009;Committer;nobu;1;1;1;2;0
af8f8e5b0e135570f9e5cd2aa8e949ec2e204b31;Fri Jul 10 07:30:08 EDT 2009;Committer;nobu;5;33;39;72;0
5e2a28d13de0d44852c7b040c17d80387cc0f058;Fri Jul 10 05:51:28 EDT 2009;Committer;naruse;1;7;0;7;0
143d1d840d18636379c141e425fe79cfe2f0e8bf;Fri Jul 10 05:51:17 EDT 2009;Committer;naruse;2;6;1;7;0
234485dc7d0a6d2c228e76581deb56ef415b28bf;Fri Jul 10 05:44:08 EDT 2009;Committer;nobu;2;75;48;123;0
5cc13fcb2265564000617d39f69ae957a3087261;Fri Jul 10 02:41:44 EDT 2009;Committer;nobu;2;8;0;8;0
bee49b34944410e22bbd5a368148d6dbcd40e287;Fri Jul 10 01:25:26 EDT 2009;Committer;nobu;3;30;7;37;0
b16c326d5ec0dabaee355f29ee0ff5998919ff70;Thu Jul 09 22:22:33 EDT 2009;Committer;nobu;2;50;16;66;0
081625d16e00b349477c7216ee01f82fb8df835b;Thu Jul 09 22:18:55 EDT 2009;Committer;nobu;2;3;2;5;0
1dc339e5a44d97814cdd27c14212668a6de8f485;Thu Jul 09 16:02:07 EDT 2009;Committer;svn;1;2;2;4;0
f69af8e8777c2fd2e70481092bd46ee40676f3bf;Thu Jul 09 16:02:02 EDT 2009;Committer;naruse;1;0;1;1;0
634cfdc6e675e0643df699780dbbf44ff4854640;Thu Jul 09 14:47:48 EDT 2009;Committer;naruse;3;127;2;129;0
a113d4f843ec2524010b06379d69b428061dd7f9;Thu Jul 09 14:47:31 EDT 2009;Committer;svn;1;2;2;4;0
e6989a7ec2aee8bfd6d4716607df0b7b989b2b4f;Thu Jul 09 14:47:22 EDT 2009;Committer;naruse;2;17;2;19;0
d43de333deae8734fcb115b018039f2ffbe58431;Wed Jul 08 14:18:02 EDT 2009;Committer;tadf;2;8;2;10;0
855d0d1a1add7b12998831831d38488dbf8b7417;Wed Jul 08 12:01:44 EDT 2009;Committer;keiju;2;107;0;107;0
a7c32bf81d3391cfb78cfda278f469717d0fb794;Wed Jul 08 10:10:28 EDT 2009;Committer;nobu;2;7;1;8;0
abbd115cae8f6db1bfe1c349ed6f928ac96c6622;Wed Jul 08 09:28:09 EDT 2009;Committer;nobu;2;16;3;19;0
ebd13e3eed9e3c4f4eb5b2122590420a76f70184;Wed Jul 08 08:13:41 EDT 2009;Committer;nobu;2;64;44;108;0
ca93e00559d739170150cae27749d64fe07c37fe;Wed Jul 08 07:47:09 EDT 2009;Committer;nobu;3;11;4;15;0
dddd406b0cbb599a286bbed5c2d97a855af13950;Wed Jul 08 00:02:45 EDT 2009;Committer;drbrain;2;17;0;17;0
9e607430088d2b89576769530aa9069680da97f5;Tue Jul 07 20:28:27 EDT 2009;Committer;ko1;7;35;23;58;0
26a1d97d8ccca6987549b3b4b5cdac61dacfdfe6;Tue Jul 07 13:13:49 EDT 2009;Committer;akr;1;9;9;18;0
c7fa0c727c8342717d2c75c1c5750a54df461eae;Tue Jul 07 11:36:20 EDT 2009;Committer;keiju;37;92;49;141;0
649237de8f9e1c784493f4a8f29178ac0e969237;Tue Jul 07 08:00:44 EDT 2009;Committer;nobu;2;7;3;10;0
ac3c2866c74a703d5208a9001606ac4738daadbd;Tue Jul 07 07:54:28 EDT 2009;Committer;nobu;3;17;0;17;0
74a6cc877cb0d8af8f34103a003689c9f184d85e;Tue Jul 07 06:23:39 EDT 2009;Committer;nobu;1;3;3;6;0
7bb9cc23a143a512ca97a21345ac98542e26d091;Tue Jul 07 04:44:54 EDT 2009;Committer;nobu;3;34;0;34;0
0f2d1527ab1b3b54da2e219ffe3fdd7a741ee1dc;Tue Jul 07 04:36:50 EDT 2009;Committer;nobu;2;19;22;41;0
e895bc3cdb71eb950951f6a7b7ce70bcb2ae9022;Tue Jul 07 04:34:34 EDT 2009;Committer;nobu;3;15;0;15;0
9041ac4289cc88751d4d7d492f0402c13fac3057;Tue Jul 07 03:55:18 EDT 2009;Committer;matz;2;10;1;11;0
450f7842160237a533d90c0f94384f8c2a73253a;Tue Jul 07 02:56:57 EDT 2009;Committer;nobu;2;20;16;36;0
999123c147fa8177d83e8cec0ff713bcee03ea89;Tue Jul 07 01:15:32 EDT 2009;Committer;naruse;2;6;1;7;0
c19129be51361790a8c1563a81a9b05166e568a4;Tue Jul 07 01:12:25 EDT 2009;Committer;svn;1;2;2;4;0
729d726e30108a8fc0207d44ae9dc10fa4114759;Tue Jul 07 01:12:17 EDT 2009;Committer;nobu;1;3;3;6;0
8c7f7c29b47ae1423f1efd7a0b2350b3c961b0f2;Mon Jul 06 01:03:16 EDT 2009;Committer;matz;2;11;0;11;0
06b9094f96fb104ef1adf887edcb960a20fe2747;Mon Jul 06 00:31:55 EDT 2009;Committer;nobu;3;21;3;24;0
425696848891d9b83749d76ccf11ee4abf0092b5;Mon Jul 06 00:23:36 EDT 2009;Committer;nobu;2;6;2;8;0
ed86848563a9d739f090b6c56c7f7eb76c804331;Mon Jul 06 00:15:29 EDT 2009;Committer;matz;3;13;4;17;0
7c3fff4f547dc8f74ffa9a0532597afeceb7bcc4;Mon Jul 06 00:09:59 EDT 2009;Committer;nobu;1;14;0;14;0
def66ceca3ec7f899ab78bb21f534a6172b4c8a1;Mon Jul 06 00:04:56 EDT 2009;Committer;nobu;2;30;1;31;0
e86d1ce77e43df78decae079eef94fc9099cd9f1;Sun Jul 05 23:15:51 EDT 2009;Committer;nobu;1;8;0;8;0
2db86440394caa983103ddab5233778684bb5731;Sun Jul 05 15:48:09 EDT 2009;Committer;tadf;2;9;5;14;0
95b71ae3fb141bfcd857c7a9e90c0ab7c38bd47a;Sun Jul 05 15:11:33 EDT 2009;Committer;svn;1;2;2;4;0
b5279bb551daae4ad7b4585864b017c25c9f8d5e;Sun Jul 05 15:11:27 EDT 2009;Committer;akr;2;63;10;73;0
b50cc1fe570b9eac594d5b8d8bbdde0bce5d5587;Sun Jul 05 13:46:10 EDT 2009;Committer;tadf;2;20;4;24;0
5a763bb525d3d0d51e4f2ea0da4a3fa514656a4a;Sun Jul 05 11:44:34 EDT 2009;Committer;tadf;2;7;1;8;0
b35d1e714c1df44b5346e35a6dc519da5e8de4d5;Sun Jul 05 05:04:41 EDT 2009;Committer;nobu;4;39;19;58;0
fd4d1dde2f88547afadb8270143911adfd50d916;Sat Jul 04 23:14:43 EDT 2009;Committer;nobu;2;8;4;12;0
ba0ac946e9d1a3a94930e4538b34412d2af50466;Sat Jul 04 23:12:04 EDT 2009;Committer;nobu;2;6;3;9;0
918fefb7f71487770b538336fca0dca8d442d32e;Sat Jul 04 23:08:32 EDT 2009;Committer;nobu;4;20;4;24;0
a82c5ee48b805333f68b613b8eb76cd05e5a0078;Sat Jul 04 00:46:14 EDT 2009;Committer;matz;2;6;7;13;0
b083b7eea60f514c10a3162218058b380c0ae297;Fri Jul 03 18:14:39 EDT 2009;Committer;svn;1;2;2;4;0
9d9986d25cc08e68afadacdfec7ebb57f8e26251;Fri Jul 03 18:14:33 EDT 2009;Committer;matz;3;112;32;144;0
e97228092110119cd4c1d9ab7af92a143ce9f3e0;Fri Jul 03 14:02:38 EDT 2009;Committer;tadf;1;2;0;2;0
7eb5c0ac7472f7e73fb286f7e6f114b7e6f0fc85;Fri Jul 03 13:49:41 EDT 2009;Committer;akr;2;16;2;18;0
0d2d098660566761019c8d5ffbeafd0444d0605c;Fri Jul 03 12:31:26 EDT 2009;Committer;tadf;3;7;43;50;0
bac1841a9382494fcc1bad5d982aa8677091a544;Fri Jul 03 12:19:54 EDT 2009;Committer;tadf;5;82;26;108;0
b61ab11f4942c3fcf0458cf60f8a1064baf3a94c;Fri Jul 03 10:50:17 EDT 2009;Committer;tadf;3;36;5;41;0
61203382872a9f6dd9b2589c88e8d571856332dd;Fri Jul 03 09:35:08 EDT 2009;Committer;nobu;2;9;3;12;0
0cc978e2a11d252f9df5a824c2ed55c57388e80b;Fri Jul 03 03:46:46 EDT 2009;Committer;nobu;1;6;5;11;0
4e195adda53ea444db983d6be96a61ee078dec18;Thu Jul 02 17:53:21 EDT 2009;Committer;akr;2;49;115;164;0
e8f835a10ed8d3aad77ebf5ccfe30d494f9d08aa;Thu Jul 02 15:42:18 EDT 2009;Committer;akr;1;1;1;2;0
fbf2cc7caf88d58c951abecb640a3f04a345263c;Thu Jul 02 15:37:12 EDT 2009;Committer;svn;1;2;2;4;0
26f32868c73d6550fc7df69b7f4a7d0a2bfac3b6;Thu Jul 02 15:37:06 EDT 2009;Committer;akr;2;144;109;253;0
6897fddd656479cdd88d42aaea4ce65d369e2bc3;Thu Jul 02 11:04:11 EDT 2009;Committer;akr;1;15;15;30;0
00f5982e9755cf6637321ef97d51a002a5f0a166;Thu Jul 02 02:19:37 EDT 2009;Committer;shugo;2;19;4;23;0
432768449deaf044574506d689ca049c4fc796e7;Wed Jul 01 23:04:46 EDT 2009;Committer;nobu;2;7;5;12;0
fc5f0cafa1473547e0961bb4187752107cf5e3de;Wed Jul 01 22:53:51 EDT 2009;Committer;nobu;2;5;1;6;0
a5e227edfe3d6dbfe24c2a74e347904151e85c6c;Wed Jul 01 21:20:44 EDT 2009;Committer;matz;6;33;15;48;0
841cf3b9488c0e7ea23b92acbb9078dee3347deb;Wed Jul 01 20:38:57 EDT 2009;Committer;akr;2;5;48;53;0
36b84733f4493ef6c259ac9cc83291980cd68c36;Wed Jul 01 20:17:00 EDT 2009;Committer;akr;2;16;1;17;0
2cb0c380143550469504d1fef6af16d40cd7d365;Wed Jul 01 18:48:34 EDT 2009;Committer;akr;1;0;1;1;0
db0721aaeb5b28437d970c351bb38aa64c63df8f;Wed Jul 01 18:46:41 EDT 2009;Committer;svn;1;2;2;4;0
d516a3e4710d0583317dbf8d068242b27948435c;Wed Jul 01 18:45:57 EDT 2009;Committer;akr;1;0;3;3;0
2f8b6234cd5b5a6b1bd5e2abdd07813e81f6e0c5;Wed Jul 01 12:11:53 EDT 2009;Committer;akr;5;53;10;63;0
ae9c138e2dc7723ec2c9ba6fc5fc8737f20043e2;Wed Jul 01 02:32:24 EDT 2009;Committer;nobu;1;1;0;1;0
4bef732db14d0adc56514462cc4eaeeb6ff56ea4;Tue Jun 30 23:46:20 EDT 2009;Committer;nobu;2;8;3;11;0
01430b6e69b252670fe6e01460b5e0fe46ebf89c;Tue Jun 30 21:47:14 EDT 2009;Committer;nobu;3;12;6;18;0
5d7a215f6e4fddb5dedcd9bb20d3dd1c8d9f3195;Tue Jun 30 09:06:48 EDT 2009;Committer;matz;4;19;4;23;0
b472f9b61a4a73d90842ac9db5f73c52cec28e1a;Tue Jun 30 08:02:13 EDT 2009;Committer;nobu;0;0;0;0;0
9a46638fb3fc1d34059861a803c11a3efcff9ea8;Tue Jun 30 07:57:11 EDT 2009;Committer;nobu;4;555;552;1107;0
9ae3b070c12851600273463fff14bb79b101440d;Tue Jun 30 07:55:36 EDT 2009;Committer;nobu;2;8;5;13;0
99c8ded878ba60391fb5439a2b17adefa607a3dd;Tue Jun 30 07:53:22 EDT 2009;Committer;nobu;2;17;13;30;0
fd8323072678d42891f097e2992189ae27cfcf5f;Tue Jun 30 07:48:52 EDT 2009;Committer;nobu;2;6;2;8;0
d06f74d736311f128f5303a995cf01071531a6f4;Tue Jun 30 07:46:44 EDT 2009;Committer;nobu;3;18;13;31;0
7259c3f2e005cf2e5182796d3589b5032b7b58c4;Tue Jun 30 07:40:05 EDT 2009;Committer;nobu;0;0;0;0;0
23a32d6444cea5b1719edc42d63911e108d3086e;Tue Jun 30 02:08:54 EDT 2009;Committer;nobu;10;72;57;129;0
88ca298efbb004600e1853cef872038f78843252;Tue Jun 30 02:06:04 EDT 2009;Committer;nobu;2;6;2;8;0
4a29a3e90bbd123bca191961cb8223345b6d5bdf;Mon Jun 29 23:53:36 EDT 2009;Committer;drbrain;1;1;1;2;0
d88b7ea53005dc7a1e1abeb6762e9ae2eb004944;Mon Jun 29 23:44:48 EDT 2009;Committer;drbrain;2;11;1;12;0
cbb56c75145f6f4f7d1c12c28dd566cf5bbb7e33;Mon Jun 29 16:52:57 EDT 2009;Committer;yugui;1;4;2;6;0
2d42e704f4b46e05943041d87fc98ca04630c843;Mon Jun 29 16:39:28 EDT 2009;Committer;yugui;4;92;4;96;0
d6ef893798f27a335eef884b8bff717f09936a23;Mon Jun 29 16:39:14 EDT 2009;Committer;yugui;2;7;3;10;0
ad1d5a3c3135afd762b856f3b817f2780a0e51bf;Mon Jun 29 16:25:11 EDT 2009;Committer;tadf;2;26;2;28;0
c8b995e7ac35b43ddd0b9c9571114647f8bf3321;Mon Jun 29 16:22:02 EDT 2009;Committer;tadf;1;2;23;25;0
59a9da6443db4baf5631dfad363e86673223e6d4;Mon Jun 29 16:20:32 EDT 2009;Committer;tadf;3;29;11;40;0
8bacaf1f5c713a7a94b5a1540493c990259c14a5;Mon Jun 29 15:34:30 EDT 2009;Committer;yugui;1;18;20;38;0
da2c21614afcda63af383283b702f8c286ff7dd9;Mon Jun 29 15:34:10 EDT 2009;Committer;svn;1;2;2;4;0
d154bc4c7d546ed4dcfc1181b573227cc4b06ea8;Mon Jun 29 15:34:05 EDT 2009;Committer;yugui;5;267;253;520;0
aa68d47b888beb3d7fd2af6137d3abbedb92722b;Mon Jun 29 12:03:25 EDT 2009;Committer;tadf;2;17;11;28;0
51e70cae465b09957f67b0df82f0b2d556626ca2;Mon Jun 29 11:33:52 EDT 2009;Committer;tadf;1;1;0;1;0
2b9df66146001e3672b91ace98aba1cb72d355e4;Mon Jun 29 11:31:03 EDT 2009;Committer;tadf;2;5;1;6;0
ee5add4a793fb5d0fda51dbc01c59842e5f615c2;Mon Jun 29 09:56:03 EDT 2009;Committer;nobu;3;44;13;57;0
ae72efc541bc716b86124a1807cfea1257938ad4;Mon Jun 29 08:16:19 EDT 2009;Committer;nobu;1;2;2;4;0
b861b2a6b2eb4deda6e842c705cf6b602fad3784;Mon Jun 29 08:14:39 EDT 2009;Committer;nobu;2;39;1243;1282;0
c212f81dde8dc5b26c9d6552752d1454e92b6947;Sun Jun 28 16:22:20 EDT 2009;Committer;svn;1;2;2;4;0
4a1f1ba66e569ad2e33b1d260bf53bcffa9cedaa;Sun Jun 28 16:22:14 EDT 2009;Committer;yugui;2;15;7;22;0
0bd29ba21645e15403ecf72721f0efdd888ea8da;Sun Jun 28 14:39:31 EDT 2009;Committer;tadf;3;17;1;18;0
268432c51dae147cebc456aea8ca05842aa78c9a;Sun Jun 28 13:27:48 EDT 2009;Committer;tadf;3;26;3;29;0
faea8893f82230eb0e2c5759361138fa20af7a9a;Sun Jun 28 12:20:02 EDT 2009;Committer;tadf;2;6;1;7;0
f365778c263db6a3d02f3c2fcf676e8964a4674e;Sun Jun 28 10:50:39 EDT 2009;Committer;tadf;3;58;6;64;0
c97f55efa5a7cd96e047d585f1270193acd784fb;Sun Jun 28 10:08:52 EDT 2009;Committer;yugui;2;16;6;22;0
5d8bff6d904685f9c317cd04c5b6ae07165c02fb;Sun Jun 28 10:08:36 EDT 2009;Committer;yugui;3;13;2;15;0
426afe1e67b2cba59cdc15f3c0b23b1bfbd9392a;Sun Jun 28 00:22:41 EDT 2009;Committer;tadf;1;9;8;17;0
11ab22bba68607e0dcd1f2b0fd8f0d412453555a;Sun Jun 28 00:22:17 EDT 2009;Committer;svn;1;2;2;4;0
53125214ccdfdb335cbe015461faf6ec7e5a8593;Sun Jun 28 00:22:07 EDT 2009;Committer;tadf;3;28;23;51;0
ae96b225c403b3e36e53d8763df986ffc632aa49;Sat Jun 27 10:35:17 EDT 2009;Committer;tadf;1;1;1;2;0
7cf1d66848cf26bbabe4d3942bc1489719366f65;Sat Jun 27 10:12:04 EDT 2009;Committer;tadf;2;76;39;115;0
f94228c8bd02cb16d0ffeff697bcf37dca6d420e;Sat Jun 27 07:58:15 EDT 2009;Committer;tadf;3;8;1;9;0
b2fb759624ff814a9429536e594082eb6e644857;Sat Jun 27 07:46:57 EDT 2009;Committer;tadf;4;503;562;1065;0
4365f6710d42c17152e94c40e9ce349d96b5c057;Sat Jun 27 04:45:24 EDT 2009;Committer;kou;4;38;0;38;0
23c14c361377e15d875cd059df07190bfbde2c79;Sat Jun 27 04:41:36 EDT 2009;Committer;kou;4;9;3;12;0
4b85c77e662d5c2327a540b8c8790b13752da3ba;Fri Jun 26 18:40:11 EDT 2009;Committer;matz;1;1;1;2;0
8a5ffe48e5f4bee500927577188ac0e202817fb7;Fri Jun 26 18:18:12 EDT 2009;Committer;matz;2;12;1;13;0
974b30a902da0598b3bc678d166a06860439566a;Fri Jun 26 18:10:19 EDT 2009;Committer;svn;1;2;2;4;0
917286208cdccf52c49186c23568ec6b9f45cb56;Fri Jun 26 18:10:12 EDT 2009;Committer;matz;2;25;19;44;0
c86115e9961c85736d2672a015e3113780551db1;Fri Jun 26 13:01:16 EDT 2009;Committer;akr;2;27;1;28;0
cadee06b2a09c309b0fb944251a8105b449d7dd1;Fri Jun 26 12:48:15 EDT 2009;Committer;matz;3;14;6;20;0
2f262b2351aa5acaa072a1d288c54545bfa7c924;Fri Jun 26 12:41:25 EDT 2009;Committer;akr;1;3;0;3;0
9522466f4675543249a5dd0cfa1893cd61638a43;Fri Jun 26 07:34:10 EDT 2009;Committer;svn;1;2;2;4;0
fc16289627d72c88152b2e57fe90c60e8a5cf667;Fri Jun 26 07:34:03 EDT 2009;Committer;usa;2;6;1;7;0
03f53e3c46835975ca1a9a850c25bbcd129e833b;Thu Jun 25 09:46:17 EDT 2009;Committer;ryan;2;45;5;50;0
06e3782978f7a04921f87123962ce168b56f49a3;Thu Jun 25 09:01:45 EDT 2009;Committer;matz;2;8;2;10;0
f11903311d91b9aa2ef2ba27f43d0711c615da96;Thu Jun 25 04:11:50 EDT 2009;Committer;usa;1;1;0;1;0
7a45306dc6d57ab8a1d127706e7564af6da49520;Thu Jun 25 04:10:21 EDT 2009;Committer;usa;2;6;2;8;0
42c6cc841c8594e8ead9c2671a7d2cc49e7db06a;Thu Jun 25 01:42:08 EDT 2009;Committer;nobu;0;0;0;0;0
bfcc8dbbd33651a99ec7a58b198e2b5efab893c6;Wed Jun 24 22:49:37 EDT 2009;Committer;matz;2;6;1;7;0
6abc3e1b41439a56916675893c9c2404e5288bcd;Wed Jun 24 22:46:45 EDT 2009;Committer;svn;1;2;2;4;0
304c060d4a241a16c6b1d70c6fa3f7cbcbe557b4;Wed Jun 24 22:46:35 EDT 2009;Committer;matz;2;17;12;29;0
c6480cd096da34cd36bea89d0a9b44577ca69570;Wed Jun 24 11:19:58 EDT 2009;Committer;akr;2;20;1;21;0
62c885753c9ebb5f8eaeccf1eca1d7d5726f5188;Wed Jun 24 07:09:40 EDT 2009;Committer;usa;2;6;1;7;0
a560aa5620fabdfcedbabc52c2aa7c001a48e647;Wed Jun 24 07:07:59 EDT 2009;Committer;usa;2;5;1;6;0
37138a2a9327e22485c43a1b79aa60a6393d5b00;Wed Jun 24 06:02:33 EDT 2009;Committer;nobu;2;17;2;19;0
4d0e9c451533e3391f051b231626629f1f276716;Wed Jun 24 02:41:57 EDT 2009;Committer;knu;2;10;4;14;0
516487dee0e2ea8b8fe1ebc8c222880f7c4142b3;Wed Jun 24 00:54:31 EDT 2009;Committer;nobu;1;1;1;2;0
157c95294b0458f462b495b7dbef868190a80ccb;Tue Jun 23 17:02:00 EDT 2009;Committer;svn;1;2;2;4;0
907415bbb6c5eeba9926f1de3689e553aaa116a1;Tue Jun 23 17:01:58 EDT 2009;Committer;akr;1;3;0;3;0
fdd6c4be17d6a9190a914b2eb48c6e549a811f0f;Tue Jun 23 13:06:27 EDT 2009;Committer;nobu;1;9;0;9;0
8b920b4ac80bf9d7c4193ecff9046b4ae95502e4;Tue Jun 23 12:28:16 EDT 2009;Committer;nobu;3;25;14;39;0
5be8596447769ece72b58ba21590e83afa622b22;Tue Jun 23 11:34:03 EDT 2009;Committer;mame;2;4;3;7;0
b15fd851c67e9aaa9bfd5b92073e120f9a76f412;Tue Jun 23 07:16:17 EDT 2009;Committer;nobu;2;6;0;6;0
ff1b8b75930160a12e03216defa77efcc46b0fec;Tue Jun 23 07:05:04 EDT 2009;Committer;nobu;4;103;55;158;0
12811c59325c57c69ec770d2357fdcfff9763164;Tue Jun 23 03:44:01 EDT 2009;Committer;nobu;2;7;6;13;0
cb5eb54da7986c2370c5d97c746e1247b54956e7;Mon Jun 22 17:17:25 EDT 2009;Committer;akr;1;1;1;2;0
5202b22bfec6539620b310e4ea2cdb49fa251bba;Mon Jun 22 16:25:50 EDT 2009;Committer;akr;1;7;4;11;0
86b418c27577c065eb99186321ebd919c5af66be;Mon Jun 22 16:21:16 EDT 2009;Committer;svn;1;2;2;4;0
98aac1e6519eb7c09bc089c65fa804ed6c011ac2;Mon Jun 22 16:21:09 EDT 2009;Committer;akr;3;10;3;13;0
e0d24f31edddb51468cd34e0bb7891c7d5095af0;Mon Jun 22 14:25:04 EDT 2009;Committer;matz;3;10;3;13;0
fc6402829157928e66019ebca577d51fecf8d179;Mon Jun 22 12:23:06 EDT 2009;Committer;akr;6;27;23;50;0
fa31dda1f839909a96cdcc6339d4674e80173ac2;Mon Jun 22 08:23:30 EDT 2009;Committer;matz;4;146;1;147;0
b205b5e7b62529435ad566c253ebd5cf9ade7033;Mon Jun 22 07:28:33 EDT 2009;Committer;akr;2;2;2;4;0
4a81d1359221170c213f1cca8c008def9d4b5b55;Mon Jun 22 07:26:16 EDT 2009;Committer;nobu;2;4;4;8;0
877acd03f60c76e94da377ec5838fd5bb95725d7;Mon Jun 22 07:14:32 EDT 2009;Committer;nobu;3;11;3;14;0
53106bd5c3f54e0f922a7325875406f7c724153d;Mon Jun 22 07:05:50 EDT 2009;Committer;nobu;1;8;8;16;0
c030cf1975d0cd935f9cd1dbac6daaea7a7b9f54;Mon Jun 22 05:41:51 EDT 2009;Committer;nobu;3;6;3;9;0
210e51f3bdb1cd38272dc60f6040cfed59b07520;Mon Jun 22 05:35:51 EDT 2009;Committer;nobu;2;7;2;9;0
a7dedc272e6e987ed53c468204f9ab0edca4ab2c;Mon Jun 22 04:50:29 EDT 2009;Committer;nobu;4;37;4;41;0
5d30ddec179c9c3174a2266c4ce1c91093c931ee;Sun Jun 21 13:35:41 EDT 2009;Committer;mame;3;8;2;10;0
a02b33742cc3c6fb134737636f7df951b14e9338;Sun Jun 21 01:47:25 EDT 2009;Committer;nobu;2;8;1;9;0
3448160b248e92b2c0c2a39ba42a9d9c366b4e72;Sun Jun 21 01:46:37 EDT 2009;Committer;nobu;2;7;2;9;0
29313aa3200007e23561a2f862fa74e0bf58aca4;Sun Jun 21 00:08:46 EDT 2009;Committer;nobu;1;3;3;6;0
231314bee68dc1b4fe5fab06377a606da28a6bcf;Sat Jun 20 19:15:48 EDT 2009;Committer;svn;1;2;2;4;0
5baa0431b94b220325ae09692938e2d1271d5b7f;Sat Jun 20 19:15:08 EDT 2009;Committer;akr;1;1;1;2;0
fa2ab2fca38af189b857cad8031ee1f4124d7121;Sat Jun 20 13:12:59 EDT 2009;Committer;akr;1;1;1;2;0
d82ed7e2c6e0f873ccacafb28c36a293383c3c15;Sat Jun 20 12:37:13 EDT 2009;Committer;tadf;4;64;169;233;0
a05fd849a148f129e5797b8261cd7e14f871e650;Sat Jun 20 11:29:21 EDT 2009;Committer;tadf;3;22;2;24;0
40d6a7527e6ea663585ea3d82b2e3968fe0d4836;Fri Jun 19 23:57:34 EDT 2009;Committer;tadf;4;86;81;167;0
a910caecb8089efbad4ea57649db01f2d375f9e0;Fri Jun 19 22:19:56 EDT 2009;Committer;matz;2;12;6;18;0
ab7baebb6ddb8ad4b06dfdc0f75fbecba19ca21d;Fri Jun 19 21:57:51 EDT 2009;Committer;tadf;6;44;28;72;0
63f2557b56ca791e9fee0fdeba4ad5f6aa378fe2;Fri Jun 19 20:10:13 EDT 2009;Committer;tadf;3;46;45;91;0
c21b9570dc93293a80f1ff99db36c518ffdd9cb7;Fri Jun 19 19:31:41 EDT 2009;Committer;tadf;2;4;25;29;0
64eccf4d6b0b54bf192a10ed821c406ce39c809d;Fri Jun 19 18:36:10 EDT 2009;Committer;svn;1;2;2;4;0
94f371aacc9794fc4236c35d243c3092c21dfba9;Fri Jun 19 18:35:39 EDT 2009;Committer;tadf;2;263;0;263;0
d11b549104e21dfcc57f6769beab3e2ccf292230;Fri Jun 19 14:44:03 EDT 2009;Committer;tadf;2;33;18;51;0
ed0bdbc575093c209d665e4d516f78dd9a93b26a;Fri Jun 19 13:59:08 EDT 2009;Committer;tadf;2;14;1;15;0
f86ad72d2a2fe28004570c401f506a713e764fec;Fri Jun 19 13:37:04 EDT 2009;Committer;tadf;3;277;223;500;0
cb699fc9306f499b38cbf03e767d8d481620a636;Fri Jun 19 11:54:37 EDT 2009;Committer;matz;2;4;2;6;0
03f49cbb326425c0e591152ad5e73c6c89990c1c;Fri Jun 19 11:47:53 EDT 2009;Committer;tadf;3;9;11;20;0
a6e1a03e07025e6f0dded33ce4296cb57d83e84a;Fri Jun 19 11:42:07 EDT 2009;Committer;tadf;2;666;2;668;0
cdba56b38ad83496b654bba626c7dc44140a0938;Fri Jun 19 08:19:14 EDT 2009;Committer;matz;2;13;0;13;0
5134783cdef392aa47692f95427affe4fd59c6fa;Fri Jun 19 00:31:08 EDT 2009;Committer;tadf;3;66;53;119;0
44a1d99635cde200a09e9d6c1667b7b9c1a327f2;Thu Jun 18 23:14:08 EDT 2009;Committer;nobu;2;27;22;49;0
f0a75dbba868e5df972fc6e2c933a2dfb85f7378;Thu Jun 18 16:02:24 EDT 2009;Committer;svn;1;2;2;4;0
fe737a1e1d0f49073ba49e2df2ea90db1795af80;Thu Jun 18 16:02:21 EDT 2009;Committer;matz;2;6;1;7;0
32004e3c46bb323a6559ad0a357dc3de1008abce;Thu Jun 18 14:04:54 EDT 2009;Committer;akr;2;16;16;32;0
67f93ddc216c56298aeb9981fc36649987438457;Thu Jun 18 13:41:44 EDT 2009;Committer;tadf;5;25;6;31;0
430eb945ceeec646f30ee79302d2f265b25bc1ee;Thu Jun 18 11:39:40 EDT 2009;Committer;tadf;1;1;1;2;0
1fda5e1a3fc8b8f8baedff353f22ff5cd9fd280b;Thu Jun 18 11:33:52 EDT 2009;Committer;tadf;2;9;2;11;0
dd2c22ae4d56c936b3eccc3ce2321b1de7c61a8a;Thu Jun 18 07:32:17 EDT 2009;Committer;ryan;1;1;1;2;0
58cfb41d2a5f5f42def95ac02ed0089e852cba2a;Thu Jun 18 07:31:39 EDT 2009;Committer;ryan;5;49;24;73;0
7fc9c4a4a0660b05edcfa1f92fef416bc3dcb49d;Wed Jun 17 17:05:31 EDT 2009;Committer;matz;4;25;1;26;0
7785612a384d7582dedbf4419917c821ad30ed95;Wed Jun 17 16:29:22 EDT 2009;Committer;nobu;2;6;0;6;0
4d3c75e2b05cfd4af34c3415e4f72da049532da3;Wed Jun 17 16:09:30 EDT 2009;Committer;nobu;3;9;3;12;0
cefaa1680c4f7175d4bb0a3c627e6902cd3b9014;Wed Jun 17 14:49:10 EDT 2009;Committer;tadf;2;9;0;9;0
b6849b2502e7f9ea93e5c1dc6a27359a6311f140;Wed Jun 17 12:55:16 EDT 2009;Committer;tadf;5;91;47;138;0
bbd2b5e9bd62c708a0ea026706528a114e6d5f5a;Wed Jun 17 08:00:29 EDT 2009;Committer;matz;1;2;0;2;0
bb7a1e8d5e69b5caee7c7252fdebef6ed835d265;Wed Jun 17 07:59:26 EDT 2009;Committer;matz;2;10;5;15;0
a6db50e02b3a93eb9b475d65cb0e9d0e96a46e1c;Wed Jun 17 06:22:58 EDT 2009;Committer;nobu;2;2;2;4;0
53ecede90b163d37c3e2b5b4f845be23eabb2caa;Wed Jun 17 05:37:23 EDT 2009;Committer;nobu;3;13;5;18;0
d121a3fb790192ca816d417c32829a36b7a04ae1;Wed Jun 17 04:57:11 EDT 2009;Committer;matz;3;6;14;20;0
945ea61cd7a6ee0701e7b337bae5a090afca92e1;Wed Jun 17 03:56:29 EDT 2009;Committer;matz;2;18;1;19;0
39a770b7205fe79b50bb8cd370f758e8a82759bf;Tue Jun 16 23:56:48 EDT 2009;Committer;ko1;3;563;0;563;0
ad522685814acd682765d4ca81e2e6fb35595471;Tue Jun 16 23:17:17 EDT 2009;Committer;tadf;5;25;0;25;0
cde491005e3776b73c25cb7ec45e8750f7ade770;Tue Jun 16 22:42:13 EDT 2009;Committer;naruse;2;6;1;7;0
3caa4ee5e545ee975ca3dc3fa798e63876e59a05;Tue Jun 16 22:36:27 EDT 2009;Committer;ko1;7;113;0;113;0
51d174a17704c56342488cc1cc932b0825a3f305;Tue Jun 16 22:23:53 EDT 2009;Committer;ko1;3;196;85;281;0
af0429b54eef973077f00d24d40fd17687a86ac0;Tue Jun 16 22:03:12 EDT 2009;Committer;ko1;3;17;0;17;0
dfb0fa0ca6b6d860affae3339f7bec83bb694bb4;Tue Jun 16 21:40:42 EDT 2009;Committer;ko1;1;1;1;2;0
a74d12dc285ed07464d1272c7c15ab3eae4972be;Tue Jun 16 21:36:50 EDT 2009;Committer;ko1;3;103;2;105;0
a0e0fafa0c45eba54689854d6c8d3ace9badefe0;Tue Jun 16 21:15:15 EDT 2009;Committer;ko1;2;25;21;46;0
06f833e6d5b096afa294725044c1f54e5ae9c414;Tue Jun 16 21:07:26 EDT 2009;Committer;ko1;2;94;12;106;0
6883f97a0e8c0ab95171e2723e4bf6a7e603134b;Tue Jun 16 15:49:48 EDT 2009;Committer;svn;1;2;2;4;0
be3c53d59da1306fb97d5b306a71dc3be0e4c091;Tue Jun 16 15:49:41 EDT 2009;Committer;matz;2;7;6;13;0
d3b852345a646f1058b40033c9f02e3d14c45ab6;Tue Jun 16 14:46:53 EDT 2009;Committer;matz;2;9;3;12;0
e54f880643a91c9bb1dcecc5cec6b43254ef466d;Tue Jun 16 11:10:10 EDT 2009;Committer;naruse;2;18;9;27;0
bc4c51eccea7d6d549bcf2874182022043974971;Tue Jun 16 07:14:48 EDT 2009;Committer;takano32;2;7;2;9;0
6f1edacc010c48c5762598fed74ff4f1e62d1b20;Tue Jun 16 01:14:28 EDT 2009;Committer;matz;2;9;2;11;0
7a71dff0bf2a8b701ae05acced62c99fed46c233;Mon Jun 15 22:58:46 EDT 2009;Committer;tadf;1;3;3;6;0
d25a5d9aec7de965921c3d798929b2dfe9a1d2ea;Mon Jun 15 16:52:06 EDT 2009;Committer;svn;1;2;2;4;0
5aac65484e00f78ca4c09d3b47506ed088da8366;Mon Jun 15 16:52:00 EDT 2009;Committer;akr;2;9;2;11;0
04388f9f9dae3dc6af0ff7b30495760a8dc352b4;Mon Jun 15 13:39:18 EDT 2009;Committer;tadf;2;9;1;10;0
c6cb57262d244a1e888807d9e85eed57bb447558;Mon Jun 15 09:54:36 EDT 2009;Committer;matz;2;9;4;13;0
50e7cb3b38bb703c1b6abf00c38dddeeac4e21da;Mon Jun 15 09:06:16 EDT 2009;Committer;matz;2;8;1;9;0
b1f3890b57a4a72a9f2b7b5eef445a45791a8ec5;Mon Jun 15 02:04:36 EDT 2009;Committer;nobu;3;11;5;16;0
63bd8a74e81537ecf2aba0be0f8ef6eec9df2758;Sun Jun 14 05:59:23 EDT 2009;Committer;ko1;4;44;0;44;0
d3027870eeebed365979875858159d98e0f1effa;Sun Jun 14 05:50:46 EDT 2009;Committer;ko1;2;14;10;24;0
439ad47eb8a9d141d818eada9ce71503a4fb1d85;Sun Jun 14 01:49:23 EDT 2009;Committer;nobu;2;6;4;10;0
122018e8029d5f6052d7448d8da1ec3f005d4afb;Sun Jun 14 01:23:21 EDT 2009;Committer;nobu;2;15;0;15;0
9540aa5b7b01712eadf30540d9163ed949daaa68;Sat Jun 13 22:57:02 EDT 2009;Committer;tadf;3;44;41;85;0
d9cf0f822f68a9e1bc439b5aae5ae292c7c4ac84;Sat Jun 13 18:55:55 EDT 2009;Committer;naruse;2;4;9;13;0
44a8a15037bd85151e1d2ded07cfa8ac56edd089;Sat Jun 13 16:54:53 EDT 2009;Committer;naruse;2;14;9;23;0
5b697c7e5ce1c9c64ddea4400570e10878ddfbc9;Sat Jun 13 16:25:21 EDT 2009;Committer;svn;1;2;2;4;0
63721ea54e3dfa35367f2c62cbae1ba9c387e697;Sat Jun 13 16:25:16 EDT 2009;Committer;tadf;2;7;81;88;0
6066cfadab9df0589062f8b002104e9d05a30ee9;Sat Jun 13 09:59:46 EDT 2009;Committer;naruse;1;5;5;10;0
3bfa955a8c983d2da8d8aed7fcc9fe5d0eb50005;Sat Jun 13 06:03:44 EDT 2009;Committer;nobu;2;7;2;9;0
b26e4cbb22824d6ab6c44ede091f85e23fcc635f;Sat Jun 13 06:00:45 EDT 2009;Committer;nobu;2;4;2;6;0
7d8ae4129e9fb91a9e4df4484675b5870ff13a47;Sat Jun 13 05:59:01 EDT 2009;Committer;nobu;2;4;3;7;0
087ecdf5edfeb5c29866bb39ce0eaecaa6550ed0;Sat Jun 13 05:57:41 EDT 2009;Committer;nobu;2;6;1;7;0
d70719b0614f8624020f8cdc561a426a45cdda1b;Sat Jun 13 00:58:30 EDT 2009;Committer;nobu;3;16;3;19;0
4150c2c05dff1a034af010bb6a6c11ad9abd05ac;Fri Jun 12 22:08:46 EDT 2009;Committer;nobu;2;6;1;7;0
6e678a2d9feebc47cca0c7ca4991d873d408543c;Fri Jun 12 22:06:59 EDT 2009;Committer;nobu;2;16;5;21;0
63118829d98010431898cd0038ff9cce90d79076;Fri Jun 12 21:50:35 EDT 2009;Committer;nobu;2;7;2;9;0
6d781384c512fb5c3121893a65b7c44d013a85f8;Fri Jun 12 21:45:52 EDT 2009;Committer;nobu;3;8;3;11;0
a860431e3b2a62401b2daef2efb4fe6924213afe;Fri Jun 12 05:56:53 EDT 2009;Committer;nobu;2;6;0;6;0
7915aed8752566f355ab4b19216da96836fd9589;Thu Jun 11 17:41:27 EDT 2009;Committer;nobu;3;16;4;20;0
e03cafe16c38826128b58bcd4767f82cc312ab26;Thu Jun 11 12:08:30 EDT 2009;Committer;tadf;2;16;11;27;0
610c0568c4f14f11f824a7d30bfe4c51e11b0b7a;Thu Jun 11 08:49:37 EDT 2009;Committer;nobu;3;22;12;34;0
831e03ebd611b3d3b810f0dee1ab6cd6d8f7783c;Thu Jun 11 06:29:11 EDT 2009;Committer;svn;1;2;2;4;0
cf8c9c3dd175c689092f22590104d828cd54f1b4;Thu Jun 11 06:29:06 EDT 2009;Committer;matz;2;7;2;9;0
a610b0a959c58099597fcfa52443b806a7b3ab7f;Wed Jun 10 09:15:55 EDT 2009;Committer;usa;3;9;0;9;0
b28d9b6d18d67898e60b8e7e84526430bcdb55c7;Tue Jun 09 21:39:13 EDT 2009;Committer;svn;1;2;2;4;0
31c94ffeb5f09d09ac2c86fc9e6614e38251a43d;Tue Jun 09 21:38:59 EDT 2009;Committer;drbrain;125;7427;3564;10991;0
a6afbaeb3be396c0fdea3b9077d9256c59edcfca;Tue Jun 09 13:43:49 EDT 2009;Committer;tadf;2;6;1;7;0
d1dd8717079593f582c00acbf8b2e17cb529f6e1;Tue Jun 09 06:13:16 EDT 2009;Committer;nobu;2;5;2;7;0
11fd9224f784a2e1904cd9cc573c926d072c56e1;Tue Jun 09 06:11:10 EDT 2009;Committer;nobu;2;13;6;19;0
a5488474c29af2cf97377f7a93d820c2beb9a3e2;Tue Jun 09 01:58:51 EDT 2009;Committer;nobu;3;6;0;6;0
79b62da9b421527917bbf9eecd657f369b8175fc;Mon Jun 08 16:14:06 EDT 2009;Committer;ko1;9;86;52;138;0
33a8def1e1f0a0cef4e88e26e8870e6806092cd9;Mon Jun 08 05:44:17 EDT 2009;Committer;matz;2;18;3;21;0
0cdfbc9446d65959dc24b82e38b3cb5d6f9d825f;Sun Jun 07 23:59:58 EDT 2009;Committer;ko1;5;17;9;26;0
27174800d460c9aa7fac49d90428a6cb01f2d66c;Sun Jun 07 13:46:56 EDT 2009;Committer;tadf;2;5;2;7;0
2a0342a442936bcc1e9704b388ae19bd52103db1;Sun Jun 07 10:05:16 EDT 2009;Committer;svn;1;2;2;4;0
c77cd2c11b5ef210cb4f16856976643c346cf097;Sun Jun 07 10:05:14 EDT 2009;Committer;tadf;2;7;7;14;0
8376d7cca025c1ff908c846adafc0ad00a08b78d;Thu Jun 04 22:15:11 EDT 2009;Committer;svn;1;2;2;4;0
fbd58422de621fd80a0dfd56468301b85c64b004;Thu Jun 04 22:15:03 EDT 2009;Committer;matz;2;6;1;7;0
0d28ad19859e51c4399c6bc19d111f8ad221fdff;Thu Jun 04 00:53:19 EDT 2009;Committer;nobu;1;3;3;6;0
dd9338bc66b84d60b80baaed81be319d24e7f703;Wed Jun 03 17:26:42 EDT 2009;Committer;svn;1;2;2;4;0
6c987f3e0679d34f4eb48fe7ebeb5e6697ca4b01;Wed Jun 03 17:26:35 EDT 2009;Committer;matz;2;5;1;6;0
cab726cface40ef953c748c2aa77596757ca14d4;Wed Jun 03 00:06:40 EDT 2009;Committer;matz;2;7;0;7;0
967001d9da6a2f26736e092dba924748fa80d099;Wed Jun 03 00:02:14 EDT 2009;Committer;matz;2;18;6;24;0
6eaf79f39a92687bcdbe5b0e9bda2b639f1e8ede;Tue Jun 02 15:24:30 EDT 2009;Committer;svn;1;2;2;4;0
c5949a0e58c3ba55a98ac0625e0cdab4dc416275;Tue Jun 02 15:24:23 EDT 2009;Committer;matz;2;23;6;29;0
8b362c8a238a553afc5f2b36cffb5c5cae1713ba;Tue Jun 02 04:29:36 EDT 2009;Committer;svn;1;2;2;4;0
06ac7185468b67921030a8dde04a81725b10f44b;Tue Jun 02 04:29:31 EDT 2009;Committer;kazu;2;58;0;58;0
6c743b0e5ab15529af20c89f59582b4483e30066;Mon Jun 01 02:21:31 EDT 2009;Committer;nobu;3;24;2;26;0
4c79d4bee2beda76473144adc39777a8251051c5;Mon Jun 01 01:41:43 EDT 2009;Committer;nobu;3;12;0;12;0
99945ed6642458660ea112409ad5c393ff0e3f6c;Mon Jun 01 01:11:04 EDT 2009;Committer;nobu;1;3;3;6;0
cfacda1a9f8b8689cb009269b68d25434c9bc1e7;Sun May 31 22:46:51 EDT 2009;Committer;svn;1;3;3;6;0
5594f2bffbc488d9f8d6daa83fe60c68038eecc3;Sun May 31 22:46:43 EDT 2009;Committer;matz;2;10;3;13;0
17d88c0333db35379ae109c6a2a7c570ef4a3d6a;Sun May 31 14:28:04 EDT 2009;Committer;nobu;2;17;10;27;0
d6d8d973c848c6e6e4691a0e98aa280c09b2f307;Sun May 31 14:26:40 EDT 2009;Committer;nobu;3;14;10;24;0
08e914f33104b985e7c6bc16d51378cd39c76474;Fri May 29 08:10:10 EDT 2009;Committer;nobu;2;8;2;10;0
2a6fb9690a698134659cd905d6c9a29dfb0080d6;Fri May 29 08:08:25 EDT 2009;Committer;nobu;2;13;16;29;0
893349cadfe0fc95b94152b798305c83fc9e9a4d;Fri May 29 01:04:34 EDT 2009;Committer;nobu;2;17;8;25;0
82f2e90d07ff9b576e010f0cf91d066cfb5d389a;Fri May 29 00:30:02 EDT 2009;Committer;nobu;3;7;2;9;0
f0371f2f28b0a0138bf7d56efdc481f4627afe00;Wed May 27 22:39:24 EDT 2009;Committer;nobu;2;17;1;18;0
62005d344bcea9bc589876fc174f72f1fd556ff8;Wed May 27 18:48:49 EDT 2009;Committer;matz;2;5;1;6;0
4f6bfb4a8300780b1bb378dd36f7a4b2bfec6881;Wed May 27 18:44:54 EDT 2009;Committer;matz;2;20;0;20;0
0fd221bd781a28f46794d250236ed21da5ae1022;Wed May 27 17:48:54 EDT 2009;Committer;akr;3;43;30;73;0
7afe0c92ea9f4e363429f3209567b4bc3de302db;Wed May 27 16:31:51 EDT 2009;Committer;matz;2;26;0;26;0
80ad1473cfefea77b4964d285fcae8ff5a4cac4b;Wed May 27 16:16:57 EDT 2009;Committer;matz;2;144;19;163;0
72f4e2c7098df4093d1fcf6dabca2655fcd8fef9;Wed May 27 15:56:21 EDT 2009;Committer;svn;1;2;2;4;0
844a6890c6fb00a311af6c27bcac482c2086cc3a;Wed May 27 15:56:14 EDT 2009;Committer;matz;4;51;3;54;0
51bf0388aa1b9cf86af556104917a6a544152cf8;Wed May 27 14:00:40 EDT 2009;Committer;nobu;2;12;13;25;0
6fc35dffb41b37c25450b796407112a955fe70c9;Wed May 27 09:44:51 EDT 2009;Committer;nobu;1;4;6;10;0
9aaa2da65b2093c21e8417d4d5091d1a7e397fc9;Tue May 26 17:39:42 EDT 2009;Committer;naruse;3;11;5;16;0
3898e7b8eec31631a928fa48f7a5f278301a4100;Tue May 26 05:24:19 EDT 2009;Committer;nobu;2;9;7;16;0
8e86bd59c02bd17e838c89e2dd33e095cc270777;Tue May 26 04:58:15 EDT 2009;Committer;nobu;7;87;64;151;0
0acedf8066b7a4654fd9a5e45260a1bc66421f43;Tue May 26 02:19:33 EDT 2009;Committer;matz;2;20;6;26;0
120d1b493b6b28ba763316eac5d0d3ccac9a1161;Tue May 26 02:10:36 EDT 2009;Committer;takano32;2;6;2;8;0
064057166b2a33c1367c24308427af9497bffab5;Tue May 26 00:22:20 EDT 2009;Committer;nobu;1;3;2;5;0
5a9f87f17912f863624bd475b9589e29d6b79056;Mon May 25 20:39:30 EDT 2009;Committer;nobu;2;4;2;6;0
a273dc9b1669f7659a894f3b46ae7fbbedfdb89c;Mon May 25 20:38:06 EDT 2009;Committer;nobu;2;12;2;14;0
762fec4946d4ab0eea846ef87de22e783ddd5ac7;Mon May 25 18:41:32 EDT 2009;Committer;nobu;3;24;3;27;0
5ac1389aeaa9219bbf56962f5ed4e617a7fdff86;Mon May 25 18:38:46 EDT 2009;Committer;nobu;3;10;4;14;0
4bc66b71f33d8c27d54010a4df17fba738d750e1;Mon May 25 04:32:00 EDT 2009;Committer;takano32;2;5;1;6;0
e11a1fc9b7ee5242bbb51fe8eb100e15be93abbc;Mon May 25 02:47:07 EDT 2009;Committer;nobu;3;7;3;10;0
970cfee510c3d536ae5348ecbb4d3d8232d72c20;Mon May 25 00:43:23 EDT 2009;Committer;matz;2;41;24;65;0
d629684bb91e7ea64508cd24629a44d41ff328dd;Sun May 24 23:06:57 EDT 2009;Committer;nobu;3;6;1;7;0
7102c3b1a1185311c70b53aec3475754cb41ad96;Sun May 24 23:00:01 EDT 2009;Committer;matz;3;11;2;13;0
7a938f98f929b3c52b35df88c7ab141a062c764b;Sun May 24 22:50:11 EDT 2009;Committer;nobu;3;8;0;8;0
74c714170501053c852d09bcc211162bece103ad;Sun May 24 20:34:32 EDT 2009;Committer;svn;1;2;2;4;0
706f910300dea9c0d4ead429f564be9a049201d3;Sun May 24 20:34:21 EDT 2009;Committer;matz;2;6;1;7;0
02fb261ec11afc34e0329aa3bbbe146cd1c89e84;Sun May 24 13:48:23 EDT 2009;Committer;nobu;5;87;26;113;0
b55ff9989153cbe786967d8a1382846059fd2c54;Sun May 24 13:39:35 EDT 2009;Committer;nobu;2;5;1;6;0
6eebf142e1cb80659d8395420590947809ff5fb3;Sun May 24 13:37:43 EDT 2009;Committer;akr;1;5;1;6;0
8875ffc4120fd8ef273f1b584803bc83891ff23b;Sat May 23 16:07:46 EDT 2009;Committer;yugui;7;48;15;63;0
803c0550439fadc86699fd193d541330f1503890;Sat May 23 15:59:14 EDT 2009;Committer;svn;1;2;2;4;0
0fd3bdac6a837f06edbea22f9a72eaea5d4053db;Sat May 23 15:59:09 EDT 2009;Committer;matz;2;13;2;15;0
34cf45ab19f0d4ec3f42ec414173aeb5fe0164b0;Sat May 23 12:49:00 EDT 2009;Committer;nobu;2;54;10;64;0
96e6cfb83507565e2b567b9f05742494af0fe778;Sat May 23 09:53:15 EDT 2009;Committer;nobu;2;6;2;8;0
fb3fa6aa4e3a27d5af763970ce25eb04a5102456;Sat May 23 09:48:54 EDT 2009;Committer;nobu;2;9;1;10;0
4bdd854347bd9f8fad73f5af4978059fafabcdf6;Fri May 22 15:22:36 EDT 2009;Committer;yugui;2;11;1;12;0
5220b19b3e4160dceeee4d2cdd4b0824c635b85b;Fri May 22 15:22:23 EDT 2009;Committer;svn;1;2;2;4;0
7378c8fa618d94be61fbc2331ec7d14063eef612;Fri May 22 15:22:18 EDT 2009;Committer;yugui;2;5;1;6;0
dfffa96baa4a99202fb04efdd31b27673eff11ac;Fri May 22 12:39:22 EDT 2009;Committer;mame;2;7;0;7;0
1d9f6c92b7695639df5ad56234e22635665495b1;Fri May 22 12:32:30 EDT 2009;Committer;akr;1;3;3;6;0
8d1e0c0a5a358a47c0f1683faeb45ba7ceaefb93;Fri May 22 11:48:52 EDT 2009;Committer;yugui;7;3206;3193;6399;0
a654e0b57b861b7ca7d04d640eb9798c40b2fd53;Fri May 22 11:48:42 EDT 2009;Committer;yugui;12;911;895;1806;0
58949cf8f3b5df1b410bc71c57b56c1c74ed9092;Thu May 21 22:35:43 EDT 2009;Committer;matz;2;14;3;17;0
8d8a31bd7a4eaff794ec3db6f9292828cdc3d616;Thu May 21 20:08:12 EDT 2009;Committer;svn;1;2;2;4;0
3ee7fcc76364021b3bbc52fcc72845d81b14d375;Thu May 21 20:08:03 EDT 2009;Committer;matz;2;23;6;29;0
1b4d0c76de494b8bdbcf83db6f0d0950d4ccc64a;Thu May 21 13:17:54 EDT 2009;Committer;nobu;5;210;117;327;0
7427390cadb47a77f9f0389e0bf477bb9b86ec70;Thu May 21 12:42:54 EDT 2009;Committer;nobu;1;1;0;1;0
08732d4f570eedf1c6471a07590f52be629f8c02;Thu May 21 12:07:25 EDT 2009;Committer;nobu;2;60;27;87;0
8f1f47a072c5044f3a24ab63afb3be6bf951f0c3;Thu May 21 10:00:48 EDT 2009;Committer;yugui;2;9;8;17;0
c6a24c45f8eb8f3e64dedaec492eaabfd5ec5ddc;Thu May 21 03:07:45 EDT 2009;Committer;nobu;4;27;4;31;0
060f433f48ccb293ed21bc99a89b162a548d2e74;Wed May 20 16:43:41 EDT 2009;Committer;nobu;7;45;21;66;0
c573aaf73f68500ec482f756dd14508002714e61;Wed May 20 14:04:04 EDT 2009;Committer;yugui;1;9;0;9;0
a1b5cd1ca2fed8844d69631a2574e3a79f61ab87;Wed May 20 12:16:23 EDT 2009;Committer;yugui;2;9;0;9;0
9d0add09cf224279e084f413333bca152f1a25b7;Wed May 20 11:55:39 EDT 2009;Committer;yugui;2;6;0;6;0
e2a43c9e09014903fde535ab01212459ac8ea563;Wed May 20 10:41:46 EDT 2009;Committer;nobu;2;15;5;20;0
53812198daa147f1e77e29b0b417cc0e9736c371;Wed May 20 09:58:29 EDT 2009;Committer;nobu;3;24;19;43;0
6494314d2a53bb550119672bedcb69f3457aac91;Wed May 20 09:34:34 EDT 2009;Committer;nobu;2;4;2;6;0
1da3e0f9928ddeb80fd0df61855281614e0678e6;Wed May 20 08:58:56 EDT 2009;Committer;nobu;2;5;1;6;0
0980fe7903b253e8a67a45eea6bd9856d0d85cf0;Wed May 20 04:44:36 EDT 2009;Committer;matz;4;91;25;116;0
c81863c321798391409f8beb2c1660309964efda;Wed May 20 00:35:30 EDT 2009;Committer;matz;2;9;1;10;0
91e5ba1cb865a2385d3e1cbfacd824496898e098;Tue May 19 16:59:22 EDT 2009;Committer;matz;6;81;46;127;0
2510c468fff22b436f85381fe4ebe1485ab9a0ae;Tue May 19 15:07:52 EDT 2009;Committer;svn;1;2;2;4;0
9553911f29dca2b485098c1c720d6e1cfb622ca9;Tue May 19 15:07:45 EDT 2009;Committer;matz;2;9;1;10;0
3465856922deedc246eed120b812fa07923491f2;Tue May 19 14:00:04 EDT 2009;Committer;mame;2;32;1;33;0
4d4bd7ab95ad805c3de639e610fb0d744e121a8e;Tue May 19 05:00:19 EDT 2009;Committer;matz;2;6;1;7;0
7d1f48b5c3768aba7f742532f00dd3d5a404a819;Tue May 19 04:58:36 EDT 2009;Committer;matz;3;31;10;41;0
6009d184ff73b623ec4eaba1a636f8abd5747b4a;Mon May 18 22:53:13 EDT 2009;Committer;svn;1;2;2;4;0
cef83891cac79d54c71d4e96579556b92d127c77;Mon May 18 22:53:05 EDT 2009;Committer;akr;2;7;2;9;0
5a83cfaef5cc00dbe7da3fee0184d9b14eb46711;Mon May 18 12:41:15 EDT 2009;Committer;svn;1;2;2;4;0
8ce34a86a27b9fc05fe5d35d387e34f8ab217531;Mon May 18 12:41:08 EDT 2009;Committer;akr;2;5;1;6;0
65750099298c2b8fc2499396976ccac1077af6ed;Sun May 17 14:23:17 EDT 2009;Committer;nobu;2;6;1;7;0
3b6d6b086138ab408cf2892dd1036a2acfe36104;Sun May 17 14:05:08 EDT 2009;Committer;nobu;2;6;1;7;0
d291fd52084187a7d7ed09927a2c98b4589d157c;Sun May 17 13:27:53 EDT 2009;Committer;nobu;1;1;1;2;0
cf125a912aa86918dbc043166c2a1b6858ae65cf;Sun May 17 09:59:48 EDT 2009;Committer;nobu;2;8;2;10;0
d25ea00ac0b3f7ea5a73c6fe821df5352831a151;Sun May 17 05:27:32 EDT 2009;Committer;nobu;1;15;14;29;0
f91b0dc811d709b260451809c5e35397e75f6d2d;Sun May 17 05:23:10 EDT 2009;Committer;nobu;3;12;4;16;0
589ec2beb565ffae7e387e951539da03a1d0b255;Sun May 17 05:02:58 EDT 2009;Committer;nobu;4;21;22;43;0
52b3bf363ad4f67d79226e2d0e3143d4f85f31c5;Sun May 17 04:15:33 EDT 2009;Committer;nobu;2;8;3;11;0
cda453c238054963535b51fe45d9d67159917220;Sun May 17 00:51:09 EDT 2009;Committer;nobu;1;0;2;2;0
64f767b5568f2996f96bb0af806586a0d5d27628;Sun May 17 00:47:49 EDT 2009;Committer;nobu;2;41;28;69;0
8ea0786da1843a3a88605d05f337289f01fa63a9;Sun May 17 00:37:07 EDT 2009;Committer;suke;2;8;2;10;0
bd9a5871dd6669946f584d4f59f56590edb973c3;Sun May 17 00:02:58 EDT 2009;Committer;nobu;2;50;5;55;0
214e72533428355e6145d292f059952fa7e799af;Sat May 16 23:55:46 EDT 2009;Committer;nobu;3;10;23;33;0
a6239ec35215a9e28860140fa0df9b04d72c62de;Sat May 16 09:37:28 EDT 2009;Committer;kou;2;5;1;6;0
98bbfeae5e0879acc8477d09206d05815a1904be;Sat May 16 09:35:08 EDT 2009;Committer;kou;2;7;3;10;0
1d2acd56640b0613191182bf075bf64f2110b5af;Sat May 16 09:32:36 EDT 2009;Committer;kou;2;7;0;7;0
86f2dc74256ea3223b715e6b2311fa0cf3d60c86;Sat May 16 09:25:59 EDT 2009;Committer;kou;6;49;11;60;0
a687b15ff8df120be282d939bc1ff21b1a4861fd;Sat May 16 09:22:55 EDT 2009;Committer;kou;8;50;0;50;0
c5f0360c074ca35d26ab73740bdb7c6eca98b94d;Sat May 16 09:12:31 EDT 2009;Committer;kou;7;7;6;13;0
b49be81dbb422c4e349555a6dcf0bf7b4ed5aad3;Sat May 16 09:08:58 EDT 2009;Committer;kou;3;32;7;39;0
a7cf993f2522c28d94867cbb1765a9718c3d7554;Sat May 16 09:04:33 EDT 2009;Committer;kou;2;5;1;6;0
01fb989358d581904724c7c11fbcd3eaacf5d8ca;Sat May 16 09:03:04 EDT 2009;Committer;kou;4;36;0;36;0
277f48de57ce32717ed6de16c4d96900b237fbf8;Sat May 16 09:01:18 EDT 2009;Committer;kou;6;58;0;58;0
28e7beb54c560a43f72e55d512c4f09b55061030;Sat May 16 08:57:41 EDT 2009;Committer;nobu;2;6;1;7;0
461daa604b8be8a8255525d00e7e7630303aa042;Sat May 16 08:50:38 EDT 2009;Committer;kou;3;9;4;13;0
4ed361e0db6bcef3260bf7b203df996cde7ff5ed;Sat May 16 08:48:38 EDT 2009;Committer;kou;3;7;2;9;0
832d5a832961b8cd6b58ec91079fa24af099f458;Sat May 16 08:27:36 EDT 2009;Committer;nari;4;15;7;22;0
8c7172605b2bad7935c85ec99ccd864ca17f5d65;Sat May 16 04:49:26 EDT 2009;Committer;nobu;2;23;9;32;0
b10617c3d1c302e03c41fbd8fffdc7a61bf3d1cf;Sat May 16 02:00:42 EDT 2009;Committer;matz;4;11;1;12;0
beae2288d17080ff8fc025edceeb390d27e90f1a;Sat May 16 00:50:25 EDT 2009;Committer;nobu;1;2;0;2;0
f29235378da7033d502d5b1f44df24ad4efa228e;Sat May 16 00:49:10 EDT 2009;Committer;nobu;2;4;3;7;0
78e376a3eeab15deb1d1a240bb9b575691178a46;Sat May 16 00:30:16 EDT 2009;Committer;nobu;5;68;47;115;0
d2c07ecb88425b9f9571b1637499f8f977b06714;Sat May 16 00:19:18 EDT 2009;Committer;nobu;2;7;2;9;0
60a5a54e17e274daa6c6c8d2282ee0148ff6b6ec;Sat May 16 00:03:31 EDT 2009;Committer;nobu;3;9;3;12;0
62e5fa173788a443ad230eb379905515cad04a87;Fri May 15 08:35:35 EDT 2009;Committer;nobu;2;11;0;11;0
f4a0a7317566bba66b8ea59df99b4b59b3d35d5c;Fri May 15 06:15:14 EDT 2009;Committer;nobu;3;26;8;34;0
f7c9c767691f0b6f398f28132828893221f45673;Fri May 15 02:31:55 EDT 2009;Committer;usa;1;1;0;1;0
ad9959c95123ec6c7f85875b932a1ad0b05087d9;Fri May 15 02:20:55 EDT 2009;Committer;svn;1;2;2;4;0
e753b2e8adc4aa89b43ec80f32d03f67bb60c77e;Fri May 15 02:20:50 EDT 2009;Committer;usa;1;6;0;6;0
875f969fd91ad537b3aa8d248ba2c2fe4d86bd6e;Thu May 14 07:13:40 EDT 2009;Committer;nobu;2;4;6;10;0
af634f8455ecb48209637bf8c748dad7136b9c9f;Thu May 14 07:07:55 EDT 2009;Committer;nobu;4;67;2;69;0
760f2c2917393f597c1a833c3c3015fd1bd50c3f;Thu May 14 01:52:10 EDT 2009;Committer;nobu;1;19;11;30;0
1c05712d435bdb5e9a8ee469238eb2f5a39c3ee3;Thu May 14 01:17:49 EDT 2009;Committer;nobu;3;8;3;11;0
57b83a5191be20c49d5d4cff77582170a507cf88;Wed May 13 14:08:26 EDT 2009;Committer;nari;13;333;48;381;0
e7ba39350a1ed1ab2789afe4f2401a7f54ff8bb4;Wed May 13 10:36:52 EDT 2009;Committer;akr;1;28;29;57;0
8265f3125e7201d8fc1af8bf778fd6cede6900db;Wed May 13 06:23:20 EDT 2009;Committer;nobu;3;67;13;80;0
6727d4a14a029f9b79c4bc50142e0bf9122fb055;Tue May 12 18:21:18 EDT 2009;Committer;akr;2;4;2;6;0
41167eaf20396423464f5739c0de5f142073031c;Tue May 12 18:00:29 EDT 2009;Committer;svn;1;2;2;4;0
87d95fdbc892847d52145a56037c6dae0d4691ff;Tue May 12 18:00:25 EDT 2009;Committer;akr;1;15;0;15;0
f64e076260cf60b25d78dcfe157c3b4e8c704ce5;Tue May 12 12:07:49 EDT 2009;Committer;akr;4;432;40;472;0
fab2a85c455246f52a61f711ac4c673bf2640018;Tue May 12 09:24:18 EDT 2009;Committer;svn;1;2;2;4;0
b2e399636a51eeef995f737c32fef853869ed696;Tue May 12 09:24:13 EDT 2009;Committer;usa;12;4;3170;3174;0
ab2119fc3d61a7504d836cfb0231b736c1c33742;Mon May 11 13:54:59 EDT 2009;Committer;matz;2;16;0;16;0
a7a1968ad134ce8565dbe81c8e762de7f4fc2c15;Mon May 11 11:11:11 EDT 2009;Committer;kazu;2;7;0;7;0
0ae26d6c2a69771dae4db6d503765f1f4377e474;Mon May 11 11:07:57 EDT 2009;Committer;kazu;1;5;0;5;0
ae8386f85102c103f69c51a1575ecaa20686bc0c;Mon May 11 04:08:32 EDT 2009;Committer;nobu;2;5;1;6;0
70abf7e8fa8d84987465b2f43c47264087cb54d6;Sun May 10 23:59:10 EDT 2009;Committer;matz;2;15;5;20;0
81cf906bbd9a073038a8ed7237dd8e8cade0534d;Sun May 10 23:56:29 EDT 2009;Committer;svn;1;2;2;4;0
0fa6bb37c6113b93ec3f255d766f5ff50b396b68;Sun May 10 23:56:22 EDT 2009;Committer;matz;2;6;1;7;0
ab142b727463329d29e10c6eba430858b52ef091;Sun May 10 02:36:13 EDT 2009;Committer;nobu;3;13;1;14;0
8812fe1a973e66130a560708b15a76bd2e08e5a7;Sun May 10 02:13:20 EDT 2009;Committer;nobu;4;32;11;43;0
07b5520752bfe9217ff906189a32c878717a3917;Sun May 10 01:47:10 EDT 2009;Committer;nobu;1;157;157;314;0
3fd6cac52c9b8fecb3a7b167528829f148fb0375;Sun May 10 01:40:10 EDT 2009;Committer;svn;1;2;2;4;0
e102f89472f2f2ad934fef96d060c04c744bd604;Sun May 10 01:40:04 EDT 2009;Committer;nobu;2;6;1;7;0
d3cf82e22a69bfde02278be5371d9adc084f8fc7;Sat May 09 11:01:47 EDT 2009;Committer;akr;1;11;2;13;0
1d0252d597a4c06b81353459374e0db8befa0bfb;Sat May 09 10:59:54 EDT 2009;Committer;kazu;1;5;0;5;0
ad20a9e01ae998e672f4b2c87b100199066eaf17;Sat May 09 10:28:37 EDT 2009;Committer;tadf;3;13;2;15;0
e9e7e6202555165e28684ac9af9d4b9f1027a776;Sat May 09 05:44:20 EDT 2009;Committer;akr;1;10;10;20;0
015821d17e178c1f4873120c2f4c07f3ae05f52a;Sat May 09 05:04:25 EDT 2009;Committer;akr;2;22;12;34;0
e480675652acf4842a86f4c5a24988df0aea8c6b;Sat May 09 03:37:00 EDT 2009;Committer;nobu;1;1;1;2;0
46be98a8cf0375a27c04a1fb6026f29eb2c1a6e1;Sat May 09 03:25:16 EDT 2009;Committer;nobu;1;6;6;12;0
f4be2ca564309bb4a52b634c91923764259834ec;Sat May 09 03:19:52 EDT 2009;Committer;nobu;2;53;30;83;0
8864383839cfe0a60582d196b9140fdf116fb30f;Sat May 09 02:14:52 EDT 2009;Committer;nobu;3;8;3;11;0
b6ed3dce38e6fa54ee328d0df00410f9310ed1b5;Fri May 08 10:38:55 EDT 2009;Committer;nobu;2;18;2;20;0
9a99663fa97d49d30b192a2632f0c9ddfb6509bc;Fri May 08 10:17:04 EDT 2009;Committer;nobu;2;13;4;17;0
15fabcb2db1be5c8aa40a55f2c52fd1289b1a1e4;Fri May 08 01:14:14 EDT 2009;Committer;nobu;5;54;21;75;0
0d9c4400fce3f52c305b299d405f09e6bfaa6069;Fri May 08 01:07:03 EDT 2009;Committer;nobu;2;19;2;21;0
f6ac12f7beb853417ce991ba72116b9908d68e42;Thu May 07 17:32:55 EDT 2009;Committer;svn;1;2;2;4;0
77b04fb6d55dc7b0b151e71f7698b612cc6028f3;Thu May 07 17:32:48 EDT 2009;Committer;knu;2;9;4;13;0
a0901920325eddda423babfa3976554c244e6616;Thu May 07 12:44:25 EDT 2009;Committer;mame;2;16;0;16;0
94ee3e7e0207eedac81b30444f72d5b51a7c2230;Thu May 07 07:40:11 EDT 2009;Committer;nobu;3;9;1;10;0
2f164472392ada9858971da5900b8895e70fc6be;Thu May 07 07:36:57 EDT 2009;Committer;nobu;1;2;2;4;0
9936642c409c48cfaced1a1f9d0f95fa100744e5;Thu May 07 05:26:16 EDT 2009;Committer;nobu;3;8;0;8;0
013b277316157a255141f2f5ddc2e0da9f167214;Thu May 07 05:16:26 EDT 2009;Committer;nobu;3;30;23;53;0
94ecf211e574a3d8440efb5018d41fd0e1a92d1b;Thu May 07 05:01:56 EDT 2009;Committer;nobu;2;7;5;12;0
61d0d8babbdeabd8776a1c6bafb038be963d2dbc;Thu May 07 04:58:54 EDT 2009;Committer;nobu;2;7;3;10;0
defd374aae4a4201590ed5ae28238c68a43f5ce6;Thu May 07 04:10:27 EDT 2009;Committer;nobu;3;7;3;10;0
91892b820e53ccd9620a6374416eb928375acd2c;Wed May 06 09:30:04 EDT 2009;Committer;akr;1;22;0;22;0
c36aeb5360eebb9ef94aa0b47f2023b04606a882;Wed May 06 07:51:20 EDT 2009;Committer;akr;2;49;11;60;0
821831a290f8d94d777ae3e5ea66940b3ea04afd;Wed May 06 00:27:10 EDT 2009;Committer;nobu;2;12;9;21;0
e6c0a7836cdcb60b0f0f75b3e0d4fee56b3e28e2;Tue May 05 20:34:05 EDT 2009;Committer;nobu;3;10;6;16;0
42c9483e6e06f731ddcaa89e2491945b51f90999;Tue May 05 08:49:55 EDT 2009;Committer;nobu;1;29;8;37;0
4fda9d1f7387eac08fa1e62b6978b5c2ad3343f2;Tue May 05 02:33:02 EDT 2009;Committer;naruse;2;7;1;8;0
4f364c6bf7f5bcc064b5a12b235fd63b200359a0;Tue May 05 02:32:49 EDT 2009;Committer;naruse;12;343;833;1176;0
1735892962c9e05ff679fc32f933a66141b2cbaf;Tue May 05 00:05:18 EDT 2009;Committer;svn;1;2;2;4;0
3abca796f4e5cd2162217d6a508b0667302a8cba;Tue May 05 00:05:11 EDT 2009;Committer;naruse;5;32;22;54;0
92c89f12fb25f19285b411717b4b37f46434e097;Sat May 02 13:54:09 EDT 2009;Committer;knu;2;6;2;8;0
f207f9fd51521c98c893ee9b75bbb768366af988;Sat May 02 01:38:27 EDT 2009;Committer;naruse;3;955;955;1910;0
e4d687f3721477ec6804ca3483c4fb078af61e94;Sat May 02 00:19:41 EDT 2009;Committer;nobu;2;7;1;8;0
1f6f4e6b591a1f79ab90d45991f609423494d1f1;Sat May 02 00:13:45 EDT 2009;Committer;nobu;2;6;6;12;0
f7b562ef0114d8421d7d1cc6595e0c056feada8f;Fri May 01 07:52:09 EDT 2009;Committer;knu;2;8;2;10;0
8dded0725b1ed215c8da1131a132b4ca6eb2f434;Fri May 01 07:46:23 EDT 2009;Committer;knu;2;43;4;47;0
35899279e86fdf2a742e49a295058216f7212a10;Fri May 01 04:18:02 EDT 2009;Committer;nobu;2;10;1;11;0
60b6f22e44f2a172979a5a709dc7f02f2cc5bc43;Thu Apr 30 17:05:31 EDT 2009;Committer;akr;1;6;6;12;0
02ecc990a2b7eceecde5e391a3d906f96fe3cc9b;Thu Apr 30 16:34:06 EDT 2009;Committer;svn;1;3;3;6;0
c42a5df5c15514f3bdd385fcc4209afede940686;Thu Apr 30 16:34:01 EDT 2009;Committer;akr;5;15;5;20;0
d5bfa31f824005f7a8ce6c2bae1fafd2461aad80;Thu Apr 30 12:25:23 EDT 2009;Committer;akr;11;37;15;52;0
587082d57cb4bbf8255239c36cafd253978f87fa;Thu Apr 30 09:19:42 EDT 2009;Committer;matz;2;5;1;6;0
8543ecee533a498b152fa7216cb8688b52915f52;Thu Apr 30 06:27:51 EDT 2009;Committer;nobu;2;7;2;9;0
f7bfe5f2df545fc96305e758afbbeaf80ade6fad;Thu Apr 30 02:38:47 EDT 2009;Committer;naruse;3;8;3;11;0
80705b9fbf6996f5f5caf4fcd09000109d01a4ea;Wed Apr 29 12:50:57 EDT 2009;Committer;naruse;3;207;0;207;0
fea2ebff1a148f9dc9a6b2e9f149958a968c2f9f;Wed Apr 29 06:22:29 EDT 2009;Committer;nobu;3;12;4;16;0
f4f3096dd3304d1d4b5e717becc7c15e01d08f19;Tue Apr 28 10:10:05 EDT 2009;Committer;kazu;2;18;1;19;0
46f23b51f6f86d7261fed63bec4b06910ca05597;Mon Apr 27 22:13:50 EDT 2009;Committer;nobu;3;8;3;11;0
fbcde451c5c505d3a3a121183e933ffd1be862de;Mon Apr 27 07:47:14 EDT 2009;Committer;nobu;2;6;1;7;0
2b08fc19478c616a79a27efc792aaf6f7190ba1a;Sun Apr 26 16:25:15 EDT 2009;Committer;nobu;3;40;5;45;0
c362380d9f8ee515571f920e269a88009b6b6885;Sun Apr 26 15:47:27 EDT 2009;Committer;svn;1;2;2;4;0
ebd2090d29afbdbc8792166b3a35c7ead69dcc3c;Sun Apr 26 15:47:24 EDT 2009;Committer;akr;1;5;1;6;0
d0a4f8ada90c7868abb726489438dc69a1b8de8b;Sun Apr 26 14:21:43 EDT 2009;Committer;naruse;4;1218;0;1218;0
b6285a01fb49551e85c20587f6f9846a55f32bf5;Sun Apr 26 13:25:09 EDT 2009;Committer;naruse;2;14;1;15;0
0881a39acd7d3dfa6cdbea76f80dabd939996807;Sun Apr 26 13:03:50 EDT 2009;Committer;naruse;3;18;2;20;0
67798d11b8114b4528df537a425cc83daa84f728;Sun Apr 26 11:34:15 EDT 2009;Committer;naruse;2;7;1;8;0
ce70dcc0effd3e72e706eeac69100150982aec8a;Sun Apr 26 11:22:18 EDT 2009;Committer;naruse;2;60;0;60;0
d2214aa2fb317cec985a4e4c20c01dfe42747a74;Sun Apr 26 11:18:00 EDT 2009;Committer;akr;3;11;5;16;0
d75996ec8ab58195c0442c4a891e567030b286b1;Sun Apr 26 10:30:54 EDT 2009;Committer;akr;2;4;1;5;0
5a809d60bd3ea54474e34f897ae60b1ae78bab73;Sun Apr 26 09:46:41 EDT 2009;Committer;nobu;1;85;61;146;0
d222c7533c466d34f188c9d5b6babadabcce0540;Sun Apr 26 09:44:35 EDT 2009;Committer;nobu;1;6;0;6;0
ff8681ba574081fa547f0d20df98c637d4c2e378;Sun Apr 26 09:35:34 EDT 2009;Committer;nobu;2;6;2;8;0
a20f1713c3a86422c68ce1a9d93c32d5737328db;Sun Apr 26 06:13:11 EDT 2009;Committer;nobu;4;16;1;17;0
cde360334dfb1a40d1919db0dc933ddc0b67f001;Sun Apr 26 00:45:20 EDT 2009;Committer;svn;1;2;2;4;0
0e61068c2b2e307fda8541c154178f743d2eb84c;Sun Apr 26 00:45:17 EDT 2009;Committer;nagai;1;10;0;10;0
1b67ef40c284b6b6943fdc6e1916276a5e3b59e9;Sat Apr 25 10:28:25 EDT 2009;Committer;nobu;1;2;1;3;0
a7adde7a57544625c0628136063a7110e6900fa4;Sat Apr 25 10:11:15 EDT 2009;Committer;nobu;1;2;2;4;0
16acb620227bd7313300f45b9dbec946ab7b1914;Sat Apr 25 09:26:58 EDT 2009;Committer;nobu;1;2;1;3;0
1d103770c6e14914a85cf1c9232f130b7df8eaf4;Sat Apr 25 09:26:22 EDT 2009;Committer;nobu;1;14;16;30;0
9bb7a8ccddf15537da6af71e594322f2519350f7;Sat Apr 25 09:21:49 EDT 2009;Committer;nobu;3;26;2;28;0
0dae2c910fa646a2b41d33f0b4d1dad818eb00da;Sat Apr 25 07:20:20 EDT 2009;Committer;akr;2;49;30;79;0
939383275c555c1a23cee3d41676aee90e843b92;Sat Apr 25 07:04:02 EDT 2009;Committer;akr;2;10;2;12;0
c7cfaac6686e20871ada91c6b5872b6405c34ecc;Sat Apr 25 06:54:49 EDT 2009;Committer;akr;2;6;2;8;0
c8f938d0b5c322d8d82d431cf6bead9e51a33289;Sat Apr 25 06:48:39 EDT 2009;Committer;akr;2;8;4;12;0
4c2e9430917f86266f42cee05b34bd176a501276;Sat Apr 25 06:40:59 EDT 2009;Committer;akr;2;12;7;19;0
afbb1ba21bcc8c9a64d3960f5aff7647e2b5e1dd;Sat Apr 25 06:25:06 EDT 2009;Committer;akr;2;75;63;138;0
df4cd06d494a3711ff10a3f217d35eb49ffe8e1e;Sat Apr 25 06:04:44 EDT 2009;Committer;svn;1;2;2;4;0
73aa1639bcc9428a0fa1f6c0dfb212c04cc26173;Sat Apr 25 06:04:40 EDT 2009;Committer;akr;1;4;0;4;0
6b7cda3fd5b5ff9c55af314b1f0d9ec6af5d9384;Thu Apr 23 17:48:02 EDT 2009;Committer;svn;1;2;2;4;0
8dc753f481d234ac7707d36ce89af906a9040a73;Thu Apr 23 17:47:58 EDT 2009;Committer;akr;1;1;1;2;0
385223daa2e3d4ce3c093242e2eadee384ede80b;Wed Apr 22 16:32:43 EDT 2009;Committer;knu;1;1;1;2;0
1ce1b7e8dfe1df10b2a63cc35c4c485e8e9c1800;Wed Apr 22 16:31:13 EDT 2009;Committer;svn;1;2;2;4;0
2bb576e5acc2120123ed33b00391c3226baae3bd;Wed Apr 22 16:31:06 EDT 2009;Committer;knu;5;73;1;74;0
5f956fda430e87305bb21e48fddbea1892bbd633;Wed Apr 22 11:27:10 EDT 2009;Committer;nobu;1;4;0;4;0
a397887e58da366f5c009a31e4b8b4725a8865d8;Wed Apr 22 11:25:26 EDT 2009;Committer;nobu;2;11;3;14;0
258ed42c12ab2d0d2d23cbd0b5bcbd60f3ed55d6;Wed Apr 22 10:34:29 EDT 2009;Committer;akr;2;7;16;23;0
f50bcf93171c4a73a513e04b91d6c9c8824c42ba;Wed Apr 22 02:13:44 EDT 2009;Committer;usa;2;9;3;12;0
8da932fe46bad40937605633605dd61fd16fcde5;Wed Apr 22 01:40:09 EDT 2009;Committer;usa;3;10;2;12;0
d5704eb61aee97081c0ceed99608be4287835c23;Wed Apr 22 00:27:33 EDT 2009;Committer;nobu;3;22;14;36;0
a69b87e80eccfe22c5d67141a91d12af9194bcae;Tue Apr 21 18:41:07 EDT 2009;Committer;akr;1;4;0;4;0
58c31ca6d84bf5393e7200faac97ee877be2b1e8;Tue Apr 21 18:38:20 EDT 2009;Committer;akr;1;2;2;4;0
d9dd33fc27fc2108e78dd60cc0b37042bd39f5fd;Tue Apr 21 18:08:47 EDT 2009;Committer;akr;3;22;3;25;0
6df2f3d59c0222c3be5623cb03ab05c333d7f2bf;Tue Apr 21 17:41:24 EDT 2009;Committer;akr;1;3;0;3;0
f67380be58e0a401163bfb1729864e6eae52764d;Tue Apr 21 17:16:11 EDT 2009;Committer;akr;1;6;7;13;0
fd9bfef325f037e5d3ae3551a11736ce52b5af9f;Tue Apr 21 17:11:27 EDT 2009;Committer;akr;3;17;3;20;0
16dc9e04cbedff54c12235ae81121ce2f4acad1e;Tue Apr 21 16:43:15 EDT 2009;Committer;akr;5;27;19;46;0
7930673c5dd0c7d20844f5abf1ca9a7c59df3132;Tue Apr 21 16:27:19 EDT 2009;Committer;akr;1;5;0;5;0
ac3dcc30da222efb34c565b24518310cb50cd6f1;Tue Apr 21 15:32:19 EDT 2009;Committer;nobu;2;7;3;10;0
7618e3b5ad774ed9fcd865bc2e461755bc72be14;Tue Apr 21 15:11:51 EDT 2009;Committer;svn;1;2;2;4;0
1dd6a6dfa47ac463b88113afe7be37b5d1147e1a;Tue Apr 21 15:11:44 EDT 2009;Committer;akr;2;4;7;11;0
3bc16f62c1fb6225b3f6cb96b62f78e44636aae4;Tue Apr 21 14:56:59 EDT 2009;Committer;akr;7;1616;547;2163;0
143846ad369eba2324e13743ff03bcf50d56c942;Tue Apr 21 00:25:43 EDT 2009;Committer;nobu;3;25;11;36;0
94890f6a9e30351b612b7a2237b7d8c1971a8361;Tue Apr 21 00:20:25 EDT 2009;Committer;nobu;2;6;1;7;0
8e75f9705fcd519390652dfebfef99ce3c6314a1;Mon Apr 20 22:09:30 EDT 2009;Committer;matz;2;12;1;13;0
dd54da6edeaa576ece85ec652612a5c93e7a4883;Mon Apr 20 17:53:36 EDT 2009;Committer;matz;2;147;6;153;0
5fc9b700bbb6c43fae78c20a278404c882f9139c;Mon Apr 20 15:27:02 EDT 2009;Committer;azav;1;4;0;4;0
2be23d478950c00cd4ca80ff5a767bd95b965101;Mon Apr 20 15:11:46 EDT 2009;Committer;azav;1;2;0;2;0
7a2a81503751f5d5adc740bb09ef68bafb551fb3;Mon Apr 20 15:04:25 EDT 2009;Committer;svn;1;2;2;4;0
254d12215c3223b5820c1356dc12cd38eaa4cc37;Mon Apr 20 15:04:18 EDT 2009;Committer;matz;2;59;9;68;0
c7853b4344d821667a158bea0288e1861f70047f;Sun Apr 19 05:43:20 EDT 2009;Committer;nobu;7;26;15;41;0
53054c0ff600d00b03cda11e3788db4b9a05d317;Sun Apr 19 04:17:26 EDT 2009;Committer;nobu;2;17;9;26;0
f3d5d707cc69c06fcbb81c65523b730c39337674;Sat Apr 18 16:41:16 EDT 2009;Committer;akr;2;20;2;22;0
df8ff329bb923522b3a4d7de4355584d46e72ee9;Sat Apr 18 16:04:42 EDT 2009;Committer;svn;1;2;2;4;0
1e96c9817ee9171769813c2924dcbcaee93245ce;Sat Apr 18 16:04:34 EDT 2009;Committer;akr;2;13;4;17;0
05a278b4cdc8456580e51055ccb89fe4d1cd46ed;Sat Apr 18 14:10:06 EDT 2009;Committer;akr;13;227;208;435;0
be2d3f5979f10cd06f6d1512ee367b2ec43ef315;Sat Apr 18 12:09:23 EDT 2009;Committer;akr;2;52;47;99;0
1196098343af4588726eb746b2af3480e9723f23;Sat Apr 18 09:06:39 EDT 2009;Committer;svn;1;2;2;4;0
9fada90406215511c011f278d28bc1e073b71a04;Sat Apr 18 09:06:34 EDT 2009;Committer;akr;1;1;0;1;0
29655d072bdab94932be4420769091c976f9315a;Thu Apr 16 17:21:51 EDT 2009;Committer;akr;1;2;2;4;0
8e8ae2a9c53d58a59bc680c6d05c453ac866db8c;Thu Apr 16 16:58:06 EDT 2009;Committer;akr;8;193;157;350;0
50cea7a5c90eb70539c07ccc63532b4e880e0557;Thu Apr 16 15:58:23 EDT 2009;Committer;mame;2;13;1;14;0
5e1cb6cbc625b720b1c3bc9b43d5870df9aa476a;Thu Apr 16 15:48:31 EDT 2009;Committer;svn;1;2;2;4;0
1b71f8f81631bb1bf3bfe3c28764b82e60d61252;Thu Apr 16 15:48:25 EDT 2009;Committer;mame;2;6;1;7;0
c14689a0fd834e9eef672954debaf86cd922766a;Thu Apr 16 14:17:20 EDT 2009;Committer;svn;1;2;2;4;0
8b27d153d22a266d77f3bdfa98ff60a1bfa53322;Thu Apr 16 14:17:14 EDT 2009;Committer;akr;9;141;14;155;0
bded3bb726d1c2b052d20a1b1398a6ed8eebae6e;Wed Apr 15 11:47:54 EDT 2009;Committer;mame;3;19;1;20;0
31c1883a54335d4ecad81919d8f9cb7a0fc4ffce;Wed Apr 15 03:00:31 EDT 2009;Committer;naruse;3;10;3;13;0
205c4b490cf4d66484f7357646cbf8748e427c5b;Tue Apr 14 09:11:29 EDT 2009;Committer;nobu;3;12;4;16;0
946fe69932080cad33fd951d32eb68577befb61a;Mon Apr 13 08:21:41 EDT 2009;Committer;nobu;2;20;0;20;0
b2ac99dfa3328ff37bad39bf069a5f9e6f1621c8;Mon Apr 13 02:40:20 EDT 2009;Committer;naruse;2;7;1;8;0
87335c3e2f04f946b768a46e677f576863665cbb;Mon Apr 13 02:00:30 EDT 2009;Committer;naruse;3;8;3;11;0
207becd9422e53e15fcbbb5a0ab92aae2b87121d;Sun Apr 12 10:54:59 EDT 2009;Committer;nobu;3;49;33;82;0
633479795eba48f0e38d043d29a47a3b9275a265;Sat Apr 11 00:04:54 EDT 2009;Committer;nobu;1;1;1;2;0
6e785b17b66294eaf0e471c7528c1e9bd60f9af4;Fri Apr 10 23:45:59 EDT 2009;Committer;nobu;3;7;3;10;0
4ab8fb1a01a14a2de59ea68ef95df13bfbce4e7c;Fri Apr 10 02:32:15 EDT 2009;Committer;nobu;2;5;1;6;0
5c5329418985b57d32c3ee06af3f646fc8d394f8;Thu Apr 09 19:54:10 EDT 2009;Committer;nobu;2;7;2;9;0
3a60f6efdc418cba77d9c6fd2331576701ca2ec0;Thu Apr 09 18:46:59 EDT 2009;Committer;nobu;2;7;3;10;0
8191f129b5607d4b4a2ae71625eac1ebc8d98ef0;Thu Apr 09 18:01:26 EDT 2009;Committer;nobu;4;59;9;68;0
7bce5959703d814e62f0edc7408d157fca49d38b;Thu Apr 09 14:59:58 EDT 2009;Committer;svn;1;2;2;4;0
07aede586f92b77a1124c6435b8cb8d5db102e97;Thu Apr 09 14:59:51 EDT 2009;Committer;akr;2;5;1;6;0
a5596dc6a32caf39533965f5776791dba5a4a22b;Wed Apr 08 13:05:07 EDT 2009;Committer;mame;3;11;1;12;0
6387c5dc8c3b67f289b47cd82111c106b08ff7bb;Wed Apr 08 11:08:18 EDT 2009;Committer;nobu;3;9;1;10;0
c9ad044dfb797efff78a17caccb64cbb72b4a552;Wed Apr 08 10:48:52 EDT 2009;Committer;nobu;1;5;0;5;0
8b95a0df1b305238fb085544fcb0dd9445458f3d;Wed Apr 08 08:31:25 EDT 2009;Committer;naruse;2;5;1;6;0
a6fa5855a864a69466556182d429a5c2ab2651bb;Wed Apr 08 05:00:07 EDT 2009;Committer;nobu;2;55;26;81;0
64be577b5398fda13ad0e0ad52e18e8d01549c6e;Wed Apr 08 04:57:59 EDT 2009;Committer;nobu;2;3;3;6;0
0b05fc5a85f0b88c35e63735db14f62c66ae2b9e;Wed Apr 08 02:46:28 EDT 2009;Committer;nobu;2;5;1;6;0
34f01201f9d36913434832d062db77569d401ab7;Wed Apr 08 00:46:00 EDT 2009;Committer;nobu;3;10;5;15;0
d9921b1de6aa697805f61f1c5ffda1f755fe1f90;Tue Apr 07 04:35:24 EDT 2009;Committer;nobu;4;19;4;23;0
99b38e10f7d953138bb9507153ca9ae60ddd4310;Tue Apr 07 04:14:34 EDT 2009;Committer;nobu;2;5;2;7;0
4b4dc16feb498c289c14b92020ba23120804ac49;Tue Apr 07 04:10:21 EDT 2009;Committer;nobu;2;7;0;7;0
04d1fc84b47eedef3a3036afe89749116467481a;Mon Apr 06 17:47:33 EDT 2009;Committer;nobu;1;2;2;4;0
c30f5e82a7330ec714d6fd7e3b3ff7b9212fcc0f;Mon Apr 06 17:27:50 EDT 2009;Committer;nobu;2;9;5;14;0
254446f555a23a830d4b26972c1fdbad000d815b;Mon Apr 06 17:25:28 EDT 2009;Committer;nobu;2;9;4;13;0
8ebd0d4320a633c520eb94fe4a31e6dc16e4ce42;Mon Apr 06 16:08:23 EDT 2009;Committer;nobu;3;13;5;18;0
aa75b002de21dfeb4ab0f3ca9bc0d50a3dd5b65c;Mon Apr 06 14:16:10 EDT 2009;Committer;nobu;2;9;8;17;0
d456f0aabe786310116cbe2cedaf01c97e6070bb;Mon Apr 06 11:16:15 EDT 2009;Committer;nobu;2;26;9;35;0
228d3e46a3dc29d8a2dcff51e58e4dd2ffc04626;Mon Apr 06 10:26:20 EDT 2009;Committer;nobu;2;65;13;78;0
a3a88c6bcdd96423bcf2ea9821ccc27f3dd02f96;Mon Apr 06 07:38:52 EDT 2009;Committer;nobu;3;20;15;35;0
1b71f8a53ba28fb0fa10620ce9bae2771ce5f1dd;Mon Apr 06 06:11:57 EDT 2009;Committer;nobu;2;13;1;14;0
090dc8fd544c999e7526165b5f172d404af4e15b;Mon Apr 06 01:49:48 EDT 2009;Committer;nobu;1;0;4;4;0
aaec30f96a67c43b89b8b5173734c77bd1a3411e;Mon Apr 06 01:47:15 EDT 2009;Committer;nobu;3;9;9;18;0
03dbd024ee994dde01597daa15389c7d0c6aec02;Sun Apr 05 09:02:57 EDT 2009;Committer;nobu;2;5;0;5;0
a3e7e369bc60ffee31ad3caaf6cdca21354d5f6f;Sun Apr 05 08:59:02 EDT 2009;Committer;nobu;2;3;3;6;0
08e5b6de325512b506bc160fe69e653267f20e3a;Sat Apr 04 08:05:17 EDT 2009;Committer;nobu;2;6;0;6;0
c2b381c5c0d04f760182882fe2ec2e6dc1908dd6;Fri Apr 03 22:38:54 EDT 2009;Committer;nobu;3;20;11;31;0
ae846f9fb810ecd241a20579495a94a15212ca56;Fri Apr 03 05:04:02 EDT 2009;Committer;knu;4;22;13;35;0
2b7279ba5fce23a653323423309cfa4fc1173e06;Fri Apr 03 03:45:58 EDT 2009;Committer;nobu;3;7;3;10;0
12bbcbb3631e91224737d233e80fbe92b9ec5652;Thu Apr 02 05:52:06 EDT 2009;Committer;matz;2;5;1;6;0
b6e82baca53367e023051d0ad42f8609c916ac86;Wed Apr 01 22:42:29 EDT 2009;Committer;nobu;3;10;6;16;0
3158c0f6516a0359a59edfa8089dec3cb94b0442;Wed Apr 01 11:40:38 EDT 2009;Committer;akr;2;7;0;7;0
72c161bb55d7232b804e9e79f518dbff56d44263;Wed Apr 01 10:46:48 EDT 2009;Committer;nobu;2;6;1;7;0
48d18d3783924e912ec0d298a035cc08c9e3b675;Wed Apr 01 10:39:27 EDT 2009;Committer;nobu;2;7;2;9;0
6941189b948ad67b9b46e09fe16f3a5f5410746c;Wed Apr 01 09:53:52 EDT 2009;Committer;nobu;2;9;1;10;0
af9459a46934f2ee30ce7d9bc9e059200340244d;Wed Apr 01 09:44:56 EDT 2009;Committer;nobu;2;7;1;8;0
3e845f19e05b5048a0430a8ecd1b5dd6e36ab044;Wed Apr 01 06:12:23 EDT 2009;Committer;nobu;2;6;1;7;0
d98da36b8c4534b87a0277716091f8df9f04f2d7;Wed Apr 01 04:56:51 EDT 2009;Committer;matz;4;47;5;52;0
9be62b3b1aeb25114c6867f54c5d3a76d9f1db0b;Wed Apr 01 04:20:05 EDT 2009;Committer;matz;2;6;2;8;0
2fa90ebea09aac25b315615c0b81d0e4eca6cb89;Tue Mar 31 18:49:51 EDT 2009;Committer;svn;1;3;3;6;0
e2dab32d0b41d4d58d549c7b52711fca54413ab5;Tue Mar 31 18:49:25 EDT 2009;Committer;akr;1;4;4;8;0
0d3bf82f80de838d4e26132b20acc4073afe3515;Tue Mar 31 06:17:38 EDT 2009;Committer;nobu;2;37;25;62;0
7fd6fb63d1c3b4f0b6f7f142db0e1f9ad1d8a02d;Mon Mar 30 23:20:50 EDT 2009;Committer;svn;1;2;2;4;0
8e2eedf46b39fa82ca68dd2ea929616d2b7b356a;Mon Mar 30 23:20:44 EDT 2009;Committer;jeg2;3;26;21;47;0
2a58eebd8f3b0f359c25c5e20be3d8045aa1651a;Mon Mar 30 10:04:51 EDT 2009;Committer;akr;2;5;1;6;0
c11f63669a668c4cc742656d0d08b8fb24764717;Mon Mar 30 03:12:48 EDT 2009;Committer;nobu;2;16;3;19;0
c3faa28bb7f14a7470ac329a400b3e0196b15b3d;Sun Mar 29 16:00:52 EDT 2009;Committer;svn;1;2;2;4;0
a9b53f6397e33fee8e4d9cda5a3a4e113a21a520;Sun Mar 29 16:00:47 EDT 2009;Committer;jeg2;2;6;1;7;0
896db7d62512ec9baa5b5f7b0644e22d3c619064;Sat Mar 28 23:59:28 EDT 2009;Committer;nobu;3;17;4;21;0
c79e8ba065140371cf3845556efc66dcf3f62075;Sat Mar 28 14:49:49 EDT 2009;Committer;akr;1;2;0;2;0
f4cecb53bd3e39c24e8b1445ae226a931ff9cb70;Sat Mar 28 02:10:34 EDT 2009;Committer;nobu;2;9;2;11;0
48379c7309a0603186f6a450f73ea2178185589a;Fri Mar 27 23:49:52 EDT 2009;Committer;nobu;3;23;7;30;0
456f68f2fd3ee8f0d95641ac98b9550465487c01;Fri Mar 27 21:18:29 EDT 2009;Committer;nobu;2;6;1;7;0
72122dd947cecee1ba0acdde15ce390650ec1963;Fri Mar 27 18:17:07 EDT 2009;Committer;nobu;3;7;5;12;0
a8eaf316303bd7660a55d563e24fcbd4c19230a1;Fri Mar 27 03:56:46 EDT 2009;Committer;nobu;2;36;15;51;0
29983664fcaecee6e92b269095398c56899e57ca;Thu Mar 26 16:35:18 EDT 2009;Committer;akr;3;15;1;16;0
f0c0f504f4dfc0e8d5e806911fa6b238f18b42c0;Thu Mar 26 16:21:04 EDT 2009;Committer;svn;1;2;2;4;0
5f64ea6c6011ef3c37cb9d36e1958d0008969c30;Thu Mar 26 16:20:58 EDT 2009;Committer;akr;2;10;1;11;0
598684944857eac0113fb2ae8e33d3be66931b65;Thu Mar 26 14:32:22 EDT 2009;Committer;matz;2;7;0;7;0
8eee0060f563ebf3d35d91d560944d4dfe648eb0;Thu Mar 26 03:22:09 EDT 2009;Committer;nobu;3;14;10;24;0
e0b7af69b461773c66ebfef29e2303f13b111d13;Thu Mar 26 02:33:16 EDT 2009;Committer;nobu;2;14;2;16;0
340d9c59fd491e1fc97a18706dd0b81d9b461b85;Thu Mar 26 01:31:24 EDT 2009;Committer;nobu;1;2;2;4;0
cc11923a9d324dfcc0a3cf29fe981114b0314493;Tue Mar 24 22:45:13 EDT 2009;Committer;nobu;3;16;2;18;0
9eb6a24f3f223831b77806e414cbebce0d8d03bb;Tue Mar 24 22:44:24 EDT 2009;Committer;svn;1;2;2;4;0
e5ffb6df0f41d327c391de4b21cea29a865ed7c8;Tue Mar 24 22:44:17 EDT 2009;Committer;nobu;2;13;17;30;0
22a3520dee278cc56284616de4eee9efee1089da;Tue Mar 24 10:23:45 EDT 2009;Committer;nobu;2;8;3;11;0
be974b81ddaa25084f054bbd45dd8d5797a597bb;Tue Mar 24 08:11:06 EDT 2009;Committer;svn;1;2;2;4;0
6c024efb9064aafb69ea55a7df8c2005cce86081;Tue Mar 24 08:11:01 EDT 2009;Committer;knu;2;8;1;9;0
4a0bb2dc4879f4b2f945af4b9e2ff847e0075ee6;Mon Mar 23 13:02:12 EDT 2009;Committer;akr;2;9;4;13;0
8d31e446208992e07bac91435fc72e6d5c88794f;Mon Mar 23 12:53:52 EDT 2009;Committer;knu;2;13;4;17;0
38d2bcd952d9768d0a920facb8d5660f6daf5ca2;Mon Mar 23 12:45:23 EDT 2009;Committer;knu;3;12;2;14;0
61e6f9b81c621d2f55e00590bbb7b44fe6431b25;Mon Mar 23 10:22:49 EDT 2009;Committer;knu;2;5;1;6;0
fe3de995b6d4f77ff078ec9cca68acead9679437;Mon Mar 23 10:00:57 EDT 2009;Committer;knu;2;6;2;8;0
5cb55eca6fac360c94fd5fa54566609dfc3db45c;Mon Mar 23 05:58:15 EDT 2009;Committer;nari;2;16;0;16;0
2c772139b60ddc71d126f42dca37f3c3e5af1caa;Mon Mar 23 05:32:26 EDT 2009;Committer;nobu;2;5;2;7;0
15265f8be67d3d35c6748481348f47bbea9a75b5;Sun Mar 22 21:51:18 EDT 2009;Committer;nobu;3;16;4;20;0
6a64e9e4ac2318cba4f9e70c66cf82885da9f46a;Sun Mar 22 05:51:58 EDT 2009;Committer;nobu;4;85;32;117;0
5bdeb55a0261e3324a6155e59843aadd55adea7c;Sat Mar 21 08:08:52 EDT 2009;Committer;akr;1;28;0;28;0
7fd155cf0f088f763dfb6353f251319775549b77;Sat Mar 21 06:56:33 EDT 2009;Committer;akr;4;126;24;150;0
f65d706529969593b318e79ca26bf03c11b6347b;Sat Mar 21 00:51:51 EDT 2009;Committer;nobu;1;1;1;2;0
1e94f2f4f64fc1643d5a94c9a520d89cd4904f32;Fri Mar 20 23:52:43 EDT 2009;Committer;nobu;1;7;0;7;0
c9cc612c0935e445de1c17e10c2abe81f497b61d;Fri Mar 20 23:28:20 EDT 2009;Committer;nobu;1;22;11;33;0
564517840edd91b632d7456cc74ede31fcfc1b82;Fri Mar 20 23:22:34 EDT 2009;Committer;nobu;1;0;56;56;0
f60de59a7058877d69031c45c6ce88a2c11f2130;Fri Mar 20 23:19:52 EDT 2009;Committer;nobu;2;20;6;26;0
ba1a12170b972485ee5271d7d84e2b79382f27a9;Fri Mar 20 23:17:42 EDT 2009;Committer;nobu;2;122;50;172;0
148f58c2dff689ef6b62bf5fe36be96a839e5817;Fri Mar 20 22:25:57 EDT 2009;Committer;nobu;2;6;1;7;0
f6e1b6ec7407a06624d51ac9b59b84f68928e566;Fri Mar 20 17:39:51 EDT 2009;Committer;svn;1;2;2;4;0
17a085ea8cd6f5e9d5dcdacfa48ef4364b3e7025;Fri Mar 20 17:39:44 EDT 2009;Committer;akr;5;113;7;120;0
88db4af385823214b918d6f694370aa90a0add01;Fri Mar 20 09:25:26 EDT 2009;Committer;nobu;2;5;0;5;0
8aad14327bbb4b802a929a640d585971d09f231d;Fri Mar 20 00:33:59 EDT 2009;Committer;nobu;1;2;1;3;0
9bd7249fa50786e67b647b5410ef09dc8c5e6c73;Fri Mar 20 00:23:01 EDT 2009;Committer;nobu;2;7;2;9;0
835ad8b35cc9248ca1f2da67df3b24a10d944ce8;Fri Mar 20 00:20:08 EDT 2009;Committer;nobu;1;13;0;13;0
6de469ae0631e22ff28d4cb883b481f10ede74a6;Thu Mar 19 15:31:29 EDT 2009;Committer;svn;1;2;2;4;0
2208c990e19f9c372978457a636c8814deea77c5;Thu Mar 19 15:31:24 EDT 2009;Committer;akr;3;66;0;66;0
758f9510a61ee4e7914ff1dae7046a6737029776;Thu Mar 19 12:45:40 EDT 2009;Committer;akr;2;2;2;4;0
c4049f4cb6d27ffdfe9f15f4a9ddc5a48271ecf3;Thu Mar 19 11:40:38 EDT 2009;Committer;akr;20;208;70;278;0
b7800329d3070a4fb9f9dbdbe8b411c5f628f942;Thu Mar 19 09:49:51 EDT 2009;Committer;nobu;4;60;58;118;0
0ff55a1bd21f61f22fd2d176abbe5663372a6871;Wed Mar 18 12:19:52 EDT 2009;Committer;akr;1;2;2;4;0
867cd89920f99ecc316bc226323fc075d5bc7c51;Wed Mar 18 08:04:17 EDT 2009;Committer;takano32;3;12;4;16;0
a8aa5c44fcacdb5e2b2c842d71aabe98a7570005;Wed Mar 18 08:01:48 EDT 2009;Committer;kazu;2;9;2;11;0
950bd573f672ff86fe504d11dc429b6871c5fb00;Wed Mar 18 07:40:26 EDT 2009;Committer;kazu;2;8;3;11;0
402b8f5de9b29449bb66de21d95c87edcf186b84;Wed Mar 18 03:48:03 EDT 2009;Committer;nobu;2;8;1;9;0
d0182b81b3c0fbf99aa9e7f2e76ae6ddb3db18d7;Tue Mar 17 17:43:53 EDT 2009;Committer;svn;1;2;2;4;0
998217fb3d8bb905641fc7e2216466a766bee408;Tue Mar 17 17:43:48 EDT 2009;Committer;seki;2;9;9;18;0
39dfe919094c76461865196a7444ca4e76a46251;Tue Mar 17 12:42:56 EDT 2009;Committer;nobu;2;7;1;8;0
616932fbdb0b788fab113439276965fafcd70ea7;Tue Mar 17 10:27:17 EDT 2009;Committer;akr;1;5;5;10;0
e36cfc749f5da0167023f731613ef0e7eb61ae42;Tue Mar 17 10:14:01 EDT 2009;Committer;akr;1;1;1;2;0
6712cca3b5f040d0a4da03d660f3c1063ad5693c;Tue Mar 17 09:07:18 EDT 2009;Committer;knu;2;20;5;25;0
929a85f60ec3f8a37ba78f0ceb69ecae75160eb5;Tue Mar 17 06:50:33 EDT 2009;Committer;nobu;1;1;2;3;0
c5501b8b196c54780a1a49151084fc2efc44287e;Tue Mar 17 06:40:20 EDT 2009;Committer;akr;1;9;2;11;0
a28532dcf3e237b8d75c724cd65eb04ca57e6da1;Tue Mar 17 05:26:15 EDT 2009;Committer;akr;3;29;1;30;0
27a39b8ffed0c8317f5d44e21dee52e66ee66e40;Tue Mar 17 04:48:03 EDT 2009;Committer;nobu;4;44;1;45;0
e3cb6518d1c4fb3fc74737f66785be419f162ea4;Tue Mar 17 01:37:57 EDT 2009;Committer;akr;1;42;4;46;0
22cde7b682328ba195ce0ee214edb6c2feb81b23;Tue Mar 17 01:29:17 EDT 2009;Committer;nobu;11;46;35;81;0
ea9628c3bc700c5162a6298b79d2b8cd7a334fea;Tue Mar 17 01:15:38 EDT 2009;Committer;svn;1;2;2;4;0
f797bdae704a7ba86cb227c72e07fe6e75c19bc0;Tue Mar 17 01:15:35 EDT 2009;Committer;nobu;3;160;160;320;0
1b6808913adfcffc03e8096e26e6e41e11f74004;Mon Mar 16 08:15:10 EDT 2009;Committer;nobu;2;8;3;11;0
f86cd0d4c20b3422c7715f7d79dbb47df2eb8e52;Mon Mar 16 07:37:24 EDT 2009;Committer;nobu;2;9;4;13;0
c569163e9e20bbba9dc49aa59d32ce08445df509;Mon Mar 16 06:22:37 EDT 2009;Committer;nobu;1;2;0;2;0
2bb561ea5f96f8b6edd622be16be89ee6af3cd7e;Mon Mar 16 03:30:01 EDT 2009;Committer;nobu;4;61;17;78;0
40819d4599203e324cab5c6beea33cfb09a6ddfc;Mon Mar 16 00:29:00 EDT 2009;Committer;nobu;5;24;3;27;0
7b713539ee10e68d899646adec8339d49ac3c5c3;Sun Mar 15 05:01:48 EDT 2009;Committer;akr;1;1;1;2;0
0596555042765213809264066fee32a736e175e5;Sun Mar 15 03:34:18 EDT 2009;Committer;nobu;1;13;5;18;0
d85689f5cb7ae6faa4cbf938679f8338331f5f66;Sun Mar 15 03:01:39 EDT 2009;Committer;nobu;3;19;19;38;0
375258ed9833762bb4ff19ccb3aba31aa2cd9cda;Sun Mar 15 02:17:48 EDT 2009;Committer;nobu;1;5;5;10;0
afdeb2d35ec63079a37bffbc81b5e7c54760ee5d;Sun Mar 15 02:15:19 EDT 2009;Committer;nobu;2;12;4;16;0
8c8f85ed4f82ab0671b5608d81327b8f51108afe;Sun Mar 15 02:11:45 EDT 2009;Committer;nobu;3;45;28;73;0
731504b4d33ef12f21e9fc20fe3d63261af2295f;Sun Mar 15 02:00:15 EDT 2009;Committer;nobu;2;6;0;6;0
28398e91f114f1b47d51965e03e5198e30268e18;Sun Mar 15 00:17:21 EDT 2009;Committer;nobu;4;10;1;11;0
02136ebbb54e0cda1aa928a971d8ef59a4659735;Sat Mar 14 23:26:11 EDT 2009;Committer;nobu;3;16;3;19;0
dbb66effeffd8011a71cfb5fe617eb09a9574fdf;Sat Mar 14 19:24:27 EDT 2009;Committer;nobu;1;1;1;2;0
34877b581d61c7a90dea53a8335117d5c863a26c;Sat Mar 14 18:30:00 EDT 2009;Committer;nobu;2;10;4;14;0
f414bd65aec6093f38860d5a9ddca4e4d581c95d;Sat Mar 14 18:04:21 EDT 2009;Committer;akr;6;47;9;56;0
f621b32e58fa7266e83884be795d00ee41c86560;Sat Mar 14 17:09:33 EDT 2009;Committer;nobu;3;9;4;13;0
4de12b6ae9a7fc1e28ada4b62291a78f28ae7528;Sat Mar 14 09:25:20 EDT 2009;Committer;nobu;6;23;23;46;0
eca77cc85c9c90f23d6f09ecdfa185eba488f8ed;Sat Mar 14 09:19:55 EDT 2009;Committer;nobu;1;1;2;3;0
4fc5c897007f7843c5be216c40f1bf81e04b6390;Sat Mar 14 09:18:09 EDT 2009;Committer;nobu;2;30;14;44;0
886214bc0136207264428f42a5d5ca31a7e1ac9b;Sat Mar 14 09:05:09 EDT 2009;Committer;nobu;2;11;2;13;0
eb89ad23cb322c5c2c435efd42f271daa80d6327;Sat Mar 14 09:03:48 EDT 2009;Committer;nobu;1;1;1;2;0
07167378cbde84212db9c8d2e2379743cd3628ff;Sat Mar 14 08:59:12 EDT 2009;Committer;nobu;2;18;12;30;0
1f433219918829a6f0afc0f926fc46ea01e3156a;Sat Mar 14 08:54:21 EDT 2009;Committer;nobu;2;5;1;6;0
e368a2e15833892697889a55a873fd3431072a74;Sat Mar 14 06:59:55 EDT 2009;Committer;akr;2;8;3;11;0
ba8fbae364e862baeb169a23567685563b895119;Sat Mar 14 06:58:50 EDT 2009;Committer;akr;1;6;1;7;0
ec5e44f2c704d6e47159b5f61ec761e7b2a7a76a;Sat Mar 14 05:46:43 EDT 2009;Committer;akr;2;18;12;30;0
24ccacfafd8aa0bcb152cc666554c189373c13aa;Sat Mar 14 05:16:03 EDT 2009;Committer;nobu;2;22;12;34;0
1f17d739cea157e23437e011a857dbf4bce9f05b;Sat Mar 14 04:53:13 EDT 2009;Committer;nobu;2;24;18;42;0
b82b4e6e481bd5afbf6c10c9f248870f88f4e43d;Sat Mar 14 01:56:42 EDT 2009;Committer;nobu;1;1;1;2;0
01643960295ba45d2a7a501f8f0db5168b8f4ac6;Sat Mar 14 01:56:15 EDT 2009;Committer;nobu;5;22;13;35;0
2e498843b6bbcc474824823dd3f9e65f9ab38907;Sat Mar 14 01:39:15 EDT 2009;Committer;nobu;2;15;10;25;0
e9299bc22feb48fa092a2a83acf85351f14980a3;Fri Mar 13 22:42:21 EDT 2009;Committer;svn;1;2;2;4;0
70e504b34ed44c983f0c4cc579778285f14143db;Fri Mar 13 22:42:16 EDT 2009;Committer;matz;2;6;0;6;0
7d1e856766303311b9e23545f93c7a58950343a8;Fri Mar 13 14:04:05 EDT 2009;Committer;akr;2;4;2;6;0
6156cc47f63e6a3bf473cd3af8e36a864775d953;Fri Mar 13 14:01:13 EDT 2009;Committer;akr;2;5;1;6;0
d5a60df399386d52a557be7ebca572d8eb0f70ed;Fri Mar 13 12:00:04 EDT 2009;Committer;akr;2;10;3;13;0
d202fd4f97f6f871887cb9c92cf3cc3b39175434;Fri Mar 13 09:58:05 EDT 2009;Committer;nobu;2;7;2;9;0
bc34d16363712a1b0f536b6996fcf7685b9a8582;Fri Mar 13 09:10:07 EDT 2009;Committer;nobu;2;14;21;35;0
b4bfc3aa79dfd89cbd51cd70cbc4eee199000955;Fri Mar 13 08:04:11 EDT 2009;Committer;nobu;2;8;25;33;0
1f46af14e48e2bcd86e02ac015b985f9841d1189;Fri Mar 13 07:45:35 EDT 2009;Committer;nobu;6;30;12;42;0
9300355bec6c21ae165be18ad116ce8651f95e8e;Fri Mar 13 06:10:45 EDT 2009;Committer;nobu;2;9;3;12;0
ffbaa25b6216c67438e739151dee57e035934639;Fri Mar 13 05:55:13 EDT 2009;Committer;nobu;1;21;21;42;0
e9b98f413e344b3fab57db5aad6133801b09d8d6;Fri Mar 13 01:42:21 EDT 2009;Committer;nobu;5;53;12;65;0
11e89eb719333f6e86eaaade5938ae79bfc3cc87;Fri Mar 13 01:16:38 EDT 2009;Committer;nobu;2;5;0;5;0
96c31ac787a64d9c21eb498fc8af7e85e100eb5a;Fri Mar 13 00:30:15 EDT 2009;Committer;nobu;2;6;1;7;0
0f71c10acbb86ea272b665b61782bf5b502c11fc;Thu Mar 12 23:06:51 EDT 2009;Committer;nobu;3;17;10;27;0
241216295911bd7cf2008efd534e583678fa9569;Thu Mar 12 13:44:37 EDT 2009;Committer;akr;8;61;54;115;0
61c216748c5742ca837c7b50cafb4f2c50b607b1;Thu Mar 12 13:31:11 EDT 2009;Committer;usa;2;9;0;9;0
a69f46bc2b32ad1a175146fefc1dac699f9211c7;Thu Mar 12 13:16:19 EDT 2009;Committer;akr;2;6;1;7;0
50d1f54d4d7d23c5cf0bfb90a7e52cd54e182ddb;Thu Mar 12 10:40:33 EDT 2009;Committer;nobu;1;2;2;4;0
d1abc53721a15bd545b60c875b05f28dd7e01e57;Thu Mar 12 09:16:15 EDT 2009;Committer;nobu;21;132;121;253;0
080525aa68c68df1fd4c1484bea1de88e3c1f79f;Thu Mar 12 09:09:15 EDT 2009;Committer;nobu;3;38;8;46;0
1c6ca1eec5c35e1665273b891ecc05e2daf0e063;Thu Mar 12 09:02:06 EDT 2009;Committer;nobu;3;6;3;9;0
7cdc73235aee44599b99a89369edbaa61f4204bc;Thu Mar 12 08:56:31 EDT 2009;Committer;nobu;2;12;8;20;0
dd41485efb9e62f36f9319d0cc701862e6a671a8;Thu Mar 12 00:30:55 EDT 2009;Committer;nobu;2;24;12;36;0
e166801d3de1fcfb1b177f7d7c7ad783c070862a;Thu Mar 12 00:24:51 EDT 2009;Committer;akr;2;6;2;8;0
53d061ec33575ea0972ab3a3e0be0db7016b5aee;Thu Mar 12 00:16:00 EDT 2009;Committer;akr;2;6;2;8;0
ab46076e3838ac8d6873999ab4f5bde6f61d4400;Wed Mar 11 20:49:07 EDT 2009;Committer;nobu;2;21;2;23;0
2b9df35cd0d8a4a710c9c836ed4a6abef1986221;Wed Mar 11 20:27:07 EDT 2009;Committer;nobu;3;34;13;47;0
748ed24234a2d9a7f01e2d541b95842337de4b1a;Wed Mar 11 20:22:52 EDT 2009;Committer;nobu;2;6;4;10;0
f61b80079e086e9fbeb767b80992a1abada1c719;Wed Mar 11 20:19:24 EDT 2009;Committer;nobu;2;6;3;9;0
d7720b2fc00aa448c4d00eeb28ffc3e6c2c31bf4;Wed Mar 11 20:16:08 EDT 2009;Committer;nobu;2;4;2;6;0
383b905f5eb834c9573ae41d192d0f90f3aa147e;Wed Mar 11 20:14:51 EDT 2009;Committer;nobu;2;6;1;7;0
bb1811d6a3621d04d9f45d137c35b8862135a140;Wed Mar 11 20:12:56 EDT 2009;Committer;nobu;2;6;3;9;0
bb8a49812a78c8842ff5f2d8949a14bcdcd8fe8e;Wed Mar 11 20:09:58 EDT 2009;Committer;nobu;2;6;1;7;0
68b3cd3ea2365b3bc008754fc6aba5841edfa9f2;Wed Mar 11 17:47:20 EDT 2009;Committer;akr;1;2;2;4;0
de292258b9c7cb2909235e0bbc29a72cc0f086e4;Wed Mar 11 17:12:35 EDT 2009;Committer;akr;2;7;1;8;0
fd0a91b5ababba864749c599cb677198a2f52983;Wed Mar 11 16:18:10 EDT 2009;Committer;nobu;2;5;1;6;0
1c2cc09063937a77b0e46d23bb92a01e893b7960;Wed Mar 11 16:08:24 EDT 2009;Committer;nobu;4;8;3;11;0
d1bc6cc720a8a36b59fa59e6f1312effdbb8091a;Wed Mar 11 12:23:41 EDT 2009;Committer;akr;2;5;1;6;0
976c01b404220d7ffcdea2203b17d93ccfbb33aa;Wed Mar 11 11:13:40 EDT 2009;Committer;nobu;2;6;11;17;0
612fe10526f0d88318d4c6a57b2f7897b31b1f7b;Wed Mar 11 08:39:37 EDT 2009;Committer;usa;1;5;5;10;0
df63af6be28cbed1b3652b7f00f68b18ce16345e;Wed Mar 11 08:27:21 EDT 2009;Committer;usa;2;7;2;9;0
8a41bd7f51506b455d9559c2c9229bd54a59c1f3;Wed Mar 11 06:59:12 EDT 2009;Committer;nobu;1;2;1;3;0
315ee838bc9eb4ea5b3a58b72ea3d0360e5f089d;Wed Mar 11 04:27:11 EDT 2009;Committer;nobu;2;8;7;15;0
c8d40b9a3d3c64401a10f0f6cd7edd230395fc6b;Wed Mar 11 04:22:38 EDT 2009;Committer;nobu;2;4;56;60;0
bf065f2e2e7e596d9c415cfa4eecce5a406011c9;Wed Mar 11 04:16:56 EDT 2009;Committer;nobu;3;119;10;129;0
f5315680aabcca7f29eb8e893953c26dca0042f8;Wed Mar 11 04:06:57 EDT 2009;Committer;nobu;1;1;1;2;0
7e59a8c5e4dcbc19170a54e8a26f77e7256ee29d;Wed Mar 11 04:03:14 EDT 2009;Committer;nobu;2;14;9;23;0
745bc1fd83595c869e9d4b3e5e933e332a6c7c8d;Tue Mar 10 21:12:49 EDT 2009;Committer;nobu;2;8;3;11;0
8231655dea0c216d9a3bd08796a43ddb3399d699;Tue Mar 10 19:47:46 EDT 2009;Committer;nobu;3;34;8;42;0
0032476a243f28684f14fcdb8cf59e38798cb6a5;Tue Mar 10 19:29:51 EDT 2009;Committer;nobu;2;29;23;52;0
cb434b4a80ef26aab670b41ec2b6204916c38ce9;Tue Mar 10 19:22:11 EDT 2009;Committer;nobu;3;8;4;12;0
c26d21bf71dc2aef9de9f92d0aba2f098df85986;Tue Mar 10 11:07:42 EDT 2009;Committer;nobu;2;9;2;11;0
0641a4d83e6580bf98a09cef4073b541e0bb4929;Tue Mar 10 10:58:49 EDT 2009;Committer;nobu;2;6;3;9;0
5bfb9a63b7e2d440a459bdd0c09c22919bbf53ec;Tue Mar 10 10:40:07 EDT 2009;Committer;nobu;2;6;2;8;0
2e54fe9d4dd4569032590d0cf1bcea472d422c91;Tue Mar 10 05:43:14 EDT 2009;Committer;nobu;10;35;29;64;0
f8147318dd1a613e6594fc4acc931184fefeaddd;Tue Mar 10 04:52:29 EDT 2009;Committer;usa;1;1;1;2;0
a3e3fcbcd074a012a090e785f71510c0cce7f350;Tue Mar 10 04:45:51 EDT 2009;Committer;nobu;2;10;7;17;0
5157e572b8169f6a06bf265cea81da408ec0cd18;Tue Mar 10 03:27:54 EDT 2009;Committer;nobu;2;6;1;7;0
6fe3eaec6c18105e0a6d80534d191d200b55c550;Tue Mar 10 02:36:33 EDT 2009;Committer;nobu;2;7;2;9;0
756c80388115a0450431d836d7f8b247cd65125a;Tue Mar 10 01:54:01 EDT 2009;Committer;nobu;2;14;8;22;0
ee4fbaa37e4577a4a51a5810489393afe51ce870;Mon Mar 09 19:56:46 EDT 2009;Committer;nobu;4;21;18;39;0
d9d4df418ba0cc30e7a098f436675331520c0487;Mon Mar 09 19:53:18 EDT 2009;Committer;nobu;2;4;2;6;0
99bb6a3f768c7981d99991905e61883b663e5fbb;Mon Mar 09 19:43:24 EDT 2009;Committer;nobu;2;11;5;16;0
53f011e662e74a846abf2c53ad2d1b096811f4f7;Mon Mar 09 18:48:34 EDT 2009;Committer;nobu;4;30;24;54;0
d3c4a4686a8f4533380c24d17736db3f6124de34;Mon Mar 09 16:57:17 EDT 2009;Committer;nobu;2;9;7;16;0
31d1d0a829a8d59939f55dccd50911cf1f7e49b4;Mon Mar 09 15:06:22 EDT 2009;Committer;nobu;4;37;3;40;0
700a2b2350ce22ffd060be811f0258875425b592;Mon Mar 09 07:49:14 EDT 2009;Committer;nobu;4;127;54;181;0
e09da0d0924ed046f10129536fe2512966123ddf;Mon Mar 09 07:03:39 EDT 2009;Committer;nobu;2;32;16;48;0
3b759e62ac4f530075eaab1a4c4b5fee65664b73;Mon Mar 09 06:25:14 EDT 2009;Committer;nobu;4;7;7;14;0
2d2cf42ed1d6fcc8a0fb62e91211a6819757d994;Mon Mar 09 06:19:57 EDT 2009;Committer;nobu;2;8;3;11;0
6ec4b205203786a8591d029f0c50429a96752dee;Mon Mar 09 05:55:28 EDT 2009;Committer;nobu;2;15;0;15;0
8fd1340296a5f367769fbfc5a4cc8ea577d9c383;Mon Mar 09 05:48:54 EDT 2009;Committer;usa;1;4;0;4;0
f2be33ac7629e664756016171df4c882c290504c;Mon Mar 09 05:33:59 EDT 2009;Committer;nobu;2;63;45;108;0
d84595deb0a38a88d2b501969f135fba8da34b80;Sun Mar 08 17:26:26 EDT 2009;Committer;mame;2;35;0;35;0
f725819666fea2eb3746f02ef81fca64f4b03992;Sun Mar 08 16:38:33 EDT 2009;Committer;mame;2;13;0;13;0
835513a23486946b389b2cfec2ad2db1cf7fca22;Sun Mar 08 16:13:26 EDT 2009;Committer;mame;2;12;0;12;0
4bcd1853af7bd1efc9f68d521dd9d52fa5fa19f0;Sun Mar 08 16:12:13 EDT 2009;Committer;svn;1;2;2;4;0
6ff04457c00614c28bc17d75fcceea8c52386ec0;Sun Mar 08 16:12:09 EDT 2009;Committer;mame;2;23;1;24;0
6ad0626daa46055f674a46fce243a46aeb46b3a1;Sun Mar 08 14:02:50 EDT 2009;Committer;nobu;2;6;1;7;0
54a52efe09e5d47911cbbfe634167051197d1e62;Sun Mar 08 04:13:06 EDT 2009;Committer;akr;1;1;1;2;0
d6ffa4b9186be5be98a01def77c3c5cae010a9d8;Sun Mar 08 03:40:00 EDT 2009;Committer;nobu;2;85;21;106;0
cc8b3517ed024dd4c593d18de85814727fbc7238;Sat Mar 07 17:21:40 EST 2009;Committer;akr;1;33;30;63;0
0d5171c5f8497ae4041e298570f40f615f4bca82;Sat Mar 07 16:56:56 EST 2009;Committer;svn;1;2;2;4;0
5abafda82620d9f0e0fe2934a298a5be7d191c62;Sat Mar 07 16:56:54 EST 2009;Committer;akr;1;8;2;10;0
f51f35a32fa672ef60bba39b4ab8908f24455dee;Sat Mar 07 13:06:05 EST 2009;Committer;nobu;2;19;0;19;0
753f4824e3f283f5b292e8fb895d9c3eee5b53ec;Sat Mar 07 10:36:27 EST 2009;Committer;nobu;1;13;9;22;0
31c2bfe8810315875549a28ffd1039b785b3b973;Sat Mar 07 09:47:05 EST 2009;Committer;nobu;2;7;3;10;0
33b9638cfc2f7d011b851b3e08a5fd6614a90ca0;Sat Mar 07 05:49:33 EST 2009;Committer;akr;1;10;10;20;0
dfb1573e0bdce09659eb8e4727d725179d435f81;Sat Mar 07 05:37:58 EST 2009;Committer;akr;1;10;10;20;0
f9690e0f9a5df5a3aed050e2efb8e982ba6f0d3b;Sat Mar 07 05:26:00 EST 2009;Committer;akr;2;6;1;7;0
94dc341e4bd27fe95fe74209deecd99a5aeab6ed;Sat Mar 07 05:08:58 EST 2009;Committer;akr;2;7;3;10;0
4210e54d264e118e75c4704600de3e49e25b37f8;Sat Mar 07 04:55:48 EST 2009;Committer;akr;2;7;1;8;0
ba45b0fe487dd1572e30590e76ee8a49394d9f8d;Sat Mar 07 04:20:51 EST 2009;Committer;nobu;1;6;1;7;0
466e33b8633fb8bef50b85711531582a354a7393;Sat Mar 07 03:35:44 EST 2009;Committer;nobu;1;1;1;2;0
882900d2d498a9baea8ad07e151738b90803086c;Sat Mar 07 03:31:32 EST 2009;Committer;nobu;4;26;18;44;0
888d29478408ce283863a13450d1d47902fdc5a3;Sat Mar 07 03:10:48 EST 2009;Committer;svn;1;2;2;4;0
dd76b8b8b139eb72f2a645c9c5331b1ca630f2b2;Sat Mar 07 03:10:44 EST 2009;Committer;akr;1;12;4;16;0
42d25de9583aab686cab04b572a56597d4f3f8bd;Fri Mar 06 14:36:33 EST 2009;Committer;akr;2;18;6;24;0
e2421845dfa50789cdeec02189290fdbe093acf2;Fri Mar 06 10:25:41 EST 2009;Committer;nobu;3;28;8;36;0
4e015093125bc6dd074905ddfb4b1c88900453b2;Fri Mar 06 09:53:59 EST 2009;Committer;nobu;1;0;2;2;0
849c996270c76ffe8a54583e892113792c440516;Fri Mar 06 09:46:52 EST 2009;Committer;nobu;3;36;11;47;0
2a413f97a497b2e86a0523b5c849e3fc075e887c;Fri Mar 06 09:37:31 EST 2009;Committer;nobu;5;32;33;65;0
9c14f3beeecb9b369c63ec8c5279ed99cb8d96f6;Fri Mar 06 09:31:53 EST 2009;Committer;nobu;1;1;1;2;0
4965ea4f58b9fd459c76ad49eb3715e6ae75424c;Fri Mar 06 07:17:46 EST 2009;Committer;nobu;2;8;4;12;0
36f56996abe5b5c01ca862fcd8efa5c0f6a4f2c8;Fri Mar 06 06:00:41 EST 2009;Committer;matz;2;6;1;7;0
f11665878aaee8ec99f7fbaeba3390f9b849e40b;Fri Mar 06 05:52:09 EST 2009;Committer;nobu;1;17;1;18;0
6e000d88543e214d1ba816b91e44090d8e63e361;Fri Mar 06 05:28:42 EST 2009;Committer;nobu;4;11;3;14;0
cf4f718bc8fe352b450a1a6aa80b002701998263;Fri Mar 06 04:47:12 EST 2009;Committer;nobu;2;18;10;28;0
c520d1fc84c338db3370fc7086f2840daa361dc9;Fri Mar 06 04:45:38 EST 2009;Committer;nobu;2;7;2;9;0
84880187bdfc63a4b7271b56505670bf9cc5f4bc;Fri Mar 06 04:25:25 EST 2009;Committer;nobu;4;3;60;63;0
f378f104732476abb5979594383517a273ceca4f;Fri Mar 06 04:23:05 EST 2009;Committer;nobu;19;2;34;36;0
60d2f945fb5140f3cb49cadd0a4afa8dab817750;Fri Mar 06 04:12:56 EST 2009;Committer;matz;2;6;16;22;0
0aeb2336ba958d1110a10115b88dbe43522aba3f;Fri Mar 06 04:04:56 EST 2009;Committer;nobu;2;164;164;328;0
5361beca991499deb73fe5437da5e969629b5f33;Fri Mar 06 03:57:41 EST 2009;Committer;svn;1;2;2;4;0
287a34ae0dfc23e4158f67cb7783d239f202c368;Fri Mar 06 03:56:38 EST 2009;Committer;nobu;856;13989;13989;27978;0
9b52ae2e6491bb5d6c59e1799449f6268baf6f89;Thu Mar 05 09:36:39 EST 2009;Committer;nobu;2;10;3;13;0
e691ba3baca5883a052d062df7c5d671c384ed0c;Thu Mar 05 07:56:19 EST 2009;Committer;nobu;2;8;4;12;0
90b0b8d4379ab10f3cde333cdd1d9e0d63fa3624;Thu Mar 05 05:52:51 EST 2009;Committer;nobu;2;7;15;22;0
b9e0c6ec08e9ccdbaf388c76c9efcbe52f73c377;Thu Mar 05 04:38:23 EST 2009;Committer;nobu;1;5;3;8;0
f4259225d56cee04f358a59a325768e5e70ef1a0;Thu Mar 05 04:21:47 EST 2009;Committer;nobu;2;29;12;41;0
11075c9332204eb7a722e36e740c19967b6cdfa0;Thu Mar 05 02:52:21 EST 2009;Committer;nobu;4;31;12;43;0
a6c117a2b1051c07cb945bb234b584742741303b;Thu Mar 05 02:27:20 EST 2009;Committer;nobu;2;10;2;12;0
9e75b2670227ee1b765f88a6e025f5584faa9844;Thu Mar 05 01:33:22 EST 2009;Committer;naruse;2;5;1;6;0
3dc758d96601532e4ff27ab002cb558be7631396;Thu Mar 05 01:29:12 EST 2009;Committer;nobu;2;17;18;35;0
37dd754e970cc177761093980cc249328866578a;Thu Mar 05 01:24:57 EST 2009;Committer;nobu;2;8;1;9;0
ec46ba5b90c3c9d4d73fea7989681d78c7c9ec7b;Thu Mar 05 01:10:41 EST 2009;Committer;nobu;2;8;3;11;0
4f39e639f4f73b417f6ba3c74dc2e7ab059bf028;Wed Mar 04 22:19:33 EST 2009;Committer;akr;1;2;2;4;0
0da23f4b5bb878bbf28aa2d0c407d04d0fcfb3d3;Wed Mar 04 19:43:35 EST 2009;Committer;mame;2;12;1;13;0
62739518691b39c61a1360d596fac4d94a3af0c0;Wed Mar 04 19:33:14 EST 2009;Committer;mame;2;18;0;18;0
00305d36f015cae4c4c5e8a0999ade8599a2d5eb;Wed Mar 04 15:26:17 EST 2009;Committer;nobu;1;1;1;2;0
5f05be456ba7c61d12b622910ecb820246a96240;Wed Mar 04 15:06:44 EST 2009;Committer;svn;1;2;2;4;0
e7184e7a53fc76057c542034e0fc8d4235e916be;Wed Mar 04 15:06:39 EST 2009;Committer;nobu;2;10;2;12;0
d34f9699fc3adf72e40e4eb3f837eaf8ee60137f;Wed Mar 04 14:29:58 EST 2009;Committer;nobu;5;41;5;46;0
40c2dd156bd983d5f7a6cf85a11b4977f3720fef;Wed Mar 04 12:23:37 EST 2009;Committer;mame;2;6;1;7;0
43ba7d00586a03a18e321514d5287bd1fae69d2a;Wed Mar 04 11:27:12 EST 2009;Committer;nobu;3;10;1;11;0
6e7d7bf5dd4af81ad71fba0be1346f14acafe201;Wed Mar 04 10:35:28 EST 2009;Committer;nobu;4;28;11;39;0
f45caa14f6e239afac1eb66910a2d1f6fd59abf2;Tue Mar 03 20:20:08 EST 2009;Committer;jeg2;2;8;4;12;0
111c48e6117ef916b1154c76839f1b2a7dd9d8ed;Tue Mar 03 18:43:53 EST 2009;Committer;jeg2;2;6;3;9;0
5371f5cb26d8c934c5065450b867eb33e4db3e00;Tue Mar 03 15:57:20 EST 2009;Committer;svn;1;2;2;4;0
294f45b0fc23b91bf5291fd2936f2076f375e467;Tue Mar 03 15:57:15 EST 2009;Committer;yugui;3;24;0;24;0
27cc677088c21785815b1c137ec8e65e51c2dc83;Tue Mar 03 08:10:10 EST 2009;Committer;nobu;2;9;3;12;0
dba06de110c9ba74a58253f5be8a9293980d7bff;Tue Mar 03 07:52:42 EST 2009;Committer;usa;3;11;3;14;0
2b3a2048328e23810283f83d23fa20a63242c0fe;Tue Mar 03 07:25:50 EST 2009;Committer;nobu;3;11;8;19;0
2a89c088a25ef0ff7b148a211160bc4894d7a9b2;Tue Mar 03 06:55:26 EST 2009;Committer;usa;3;39;18;57;0
95189045d06ab1ff40b023dfb69552f20957e3a0;Tue Mar 03 06:54:00 EST 2009;Committer;usa;2;8;0;8;0
1001173ccd68f728d28cf7fb8752326bc3ddf3eb;Tue Mar 03 06:40:40 EST 2009;Committer;nobu;8;285;253;538;0
2233d34b39c491d3930ad3a5e970200b6d43c32d;Tue Mar 03 06:28:55 EST 2009;Committer;nobu;1;1;0;1;0
91dd419efb58527291369b15b7614ca77be7763a;Tue Mar 03 06:09:14 EST 2009;Committer;nobu;2;5;2;7;0
daa2217d48e8076d07f4d4c352b7932ecbb5ad67;Tue Mar 03 06:07:24 EST 2009;Committer;nobu;3;19;89;108;0
0cceff94ca29bed2d934a495f1a97041f46b2e76;Tue Mar 03 06:05:21 EST 2009;Committer;nobu;2;5;1;6;0
f9ca2119e403653cdf529646d3a3790c5c473ac2;Tue Mar 03 06:03:23 EST 2009;Committer;nobu;12;455;461;916;0
078928bbdd66586ee18fce8fa4485ac31d960df3;Tue Mar 03 05:57:30 EST 2009;Committer;nobu;2;5;1;6;0
91c9a4becb625e10011e82e74d1be22835dda775;Tue Mar 03 05:53:18 EST 2009;Committer;nobu;3;10;4;14;0
8dba4cdf88afe060be1ae5397dbcb002a0db5080;Mon Mar 02 16:56:45 EST 2009;Committer;svn;1;2;2;4;0
1c2005fbf6150d09af2e0f9af6411b69fc671791;Mon Mar 02 16:56:40 EST 2009;Committer;akr;2;10;3;13;0
557359d170ddb9fa7db3ff5485fcf907c1970ae4;Mon Mar 02 12:39:47 EST 2009;Committer;akr;2;7;1;8;0
8a00868c3dc6981c300cc62020767bda5bb4b2a0;Mon Mar 02 12:27:33 EST 2009;Committer;akr;2;6;2;8;0
fb5d4ecfb5d03aa9f6116b53dbcb1b72bbba3c95;Mon Mar 02 12:14:35 EST 2009;Committer;akr;4;10;1;11;0
a36ea435d26b97d2ca185e315106c856e5d2c9de;Mon Mar 02 12:13:00 EST 2009;Committer;akr;1;7;7;14;0
344dcc25be6741e58e80b3dbf10f7d702bd080cc;Mon Mar 02 12:07:41 EST 2009;Committer;akr;1;5;0;5;0
27475f4dec9a3c694e2b197e1c8f5ddff9a5bf77;Mon Mar 02 12:02:22 EST 2009;Committer;akr;2;8;0;8;0
3f0060c0426dd468964c3ec07b4c4d56d3894894;Mon Mar 02 10:43:04 EST 2009;Committer;nobu;2;10;2;12;0
5b35cbf5d380eff0db01592be9b77e88e8897713;Mon Mar 02 07:40:13 EST 2009;Committer;nobu;3;15;0;15;0
a8c4a7e44c10ab7049487907df6910d6cb61be10;Mon Mar 02 03:22:14 EST 2009;Committer;nobu;2;41;20;61;0
033bed37c84cdc3ca5906b24f12a38779605b9d0;Mon Mar 02 02:01:48 EST 2009;Committer;nobu;4;20;2;22;0
46e06b572bca7e7e483a26750c59d8f85de5a2f8;Mon Mar 02 01:50:56 EST 2009;Committer;nobu;2;30;30;60;0
9fb56049eb62bdc5953a2cd66e472a23cd20070b;Mon Mar 02 01:29:19 EST 2009;Committer;nobu;3;7;2;9;0
d6802f03b8e983dd7ed5be38c5bf0f941ab1c6d5;Sun Mar 01 15:57:37 EST 2009;Committer;svn;1;2;2;4;0
4104010c88a499cdcfbf91f51381a602c7f57b7d;Sun Mar 01 15:57:33 EST 2009;Committer;seki;2;16;10;26;0
d79dc0f6a0cd69e58922cf9baa637774cf7165e6;Sun Mar 01 14:00:48 EST 2009;Committer;akr;4;14;6;20;0
4ca8057c3e0f511274a7810ec0eadec9c16be44d;Sun Mar 01 12:59:59 EST 2009;Committer;akr;1;1;1;2;0
aa2b22bba288a06b8faea3180613e896a8b3f084;Sun Mar 01 11:58:13 EST 2009;Committer;akr;5;11;6;17;0
895b3f6e06be7d9fdbb6711170889559260105a3;Sun Mar 01 10:52:48 EST 2009;Committer;nobu;2;7;2;9;0
2f3c15cb227e425205f2614e04ae388c7edc0f94;Sun Mar 01 10:39:01 EST 2009;Committer;nobu;2;6;1;7;0
cbeec4561285b6afe00cd9bd61eebe9f5e3a6919;Sun Mar 01 10:36:19 EST 2009;Committer;nobu;2;6;1;7;0
a6c52eec0c12226d2c1a86597fa59ff0c2516533;Sun Mar 01 10:11:00 EST 2009;Committer;nobu;2;5;1;6;0
3465e37e63242c62c8a86cff16ba156fedf4a202;Sun Mar 01 10:02:06 EST 2009;Committer;nobu;5;51;27;78;0
0fee78a198acd9dc95ec138a083a13c361dd8bb5;Sun Mar 01 08:27:17 EST 2009;Committer;nobu;2;6;1;7;0
da9ffe378fd00bc0853aefdda7ee70401dcf3994;Sun Mar 01 07:15:33 EST 2009;Committer;nobu;2;49;34;83;0
135930e95b081a9f4391e23122f5c29f301b128b;Sun Mar 01 07:01:03 EST 2009;Committer;nobu;2;8;0;8;0
172d20878955c7b8eca9ebc782dfa7e91340dc8c;Sun Mar 01 06:48:22 EST 2009;Committer;akr;9;47;38;85;0
a6274c1e72689ad0425560a637f96beeb9e93ad2;Sun Mar 01 06:33:13 EST 2009;Committer;akr;1;1;1;2;0
c49f05dd792049e45608c1132be912695f4909e4;Sun Mar 01 06:30:41 EST 2009;Committer;akr;17;286;282;568;0
faabbf230a026405feebf75a7cd9f4c0d9379d60;Sun Mar 01 05:16:14 EST 2009;Committer;nobu;1;9;0;9;0
fe017d1450fbdd46fedef508e4bfa1377c7ca035;Sun Mar 01 05:10:41 EST 2009;Committer;svn;1;3;3;6;0
d988d0945804becf3e3196ff5b67aa3ee31de788;Sun Mar 01 05:10:36 EST 2009;Committer;nobu;1;2;0;2;0
3888bfecf2c193658bb11af3609671d91a44b778;Sat Feb 28 12:56:10 EST 2009;Committer;akr;3;8;2;10;0
cfe9dcb886b225e5607e0bc13b591f9c4a020daa;Sat Feb 28 11:12:36 EST 2009;Committer;akr;6;23;9;32;0
2ba6eec1fa50cacaff647525358fd93c7c862a27;Sat Feb 28 09:29:26 EST 2009;Committer;akr;3;20;0;20;0
8746e342bc3b45ec7d14df09d1288a9b53f225f0;Sat Feb 28 07:19:55 EST 2009;Committer;akr;2;9;1;10;0
54cd7ea16834cac420067b7ea8bee3b619f082c0;Sat Feb 28 06:05:44 EST 2009;Committer;akr;2;7;0;7;0
2f83f7a7f466eed59044d2be4898ceb426b7cdb7;Fri Feb 27 19:51:56 EST 2009;Committer;kazu;2;4;2;6;0
8e8e5e770f79c8cb44ebe0661923954a07b2492f;Fri Feb 27 17:12:50 EST 2009;Committer;kazu;1;5;5;10;0
4012672433b642634a6e45af20c08297dd33c351;Fri Feb 27 15:21:28 EST 2009;Committer;svn;1;2;2;4;0
5fb1faf2bfc87597dbbf1a6686bab6b36482529d;Fri Feb 27 15:21:23 EST 2009;Committer;akr;5;31;10;41;0
d8c66c433393cb0ff97fcbd32f6a4fdc4d8f8b79;Fri Feb 27 14:23:54 EST 2009;Committer;akr;3;72;20;92;0
a7d581fa2f88d2f45d1f2d670cc1c8f9e755b2d1;Fri Feb 27 13:15:35 EST 2009;Committer;akr;2;7;0;7;0
7f247b9d0c652cfd88c4d4ebbc1a6587e48cad83;Fri Feb 27 13:10:25 EST 2009;Committer;akr;1;33;0;33;0
0f82f65cee9e754784b70a000b3a683978a343ae;Fri Feb 27 13:10:07 EST 2009;Committer;akr;2;9;2;11;0
f252633804045e3a39c8f463fb89281b20a98a10;Fri Feb 27 13:05:30 EST 2009;Committer;akr;2;49;33;82;0
506af65de1db31eea9e0ab55a6b1d32a0c972931;Fri Feb 27 09:30:53 EST 2009;Committer;nobu;2;39;0;39;0
88d63339b3416c57ad94fc3d402bdac44369a8a9;Fri Feb 27 09:14:36 EST 2009;Committer;nobu;1;1;1;2;0
8d325b6bbcaccd1708f7ebdeb1db6d28e9f1fce6;Fri Feb 27 09:14:17 EST 2009;Committer;nobu;1;1;1;2;0
be7679308bfaab473f8114fb4cb15740a75e1496;Fri Feb 27 09:01:21 EST 2009;Committer;nobu;3;9;4;13;0
12331d4939f431e84ed7ca26efc53d7dcf861cf0;Fri Feb 27 08:45:26 EST 2009;Committer;nobu;2;15;7;22;0
c660a9c466dc6368bae07f2c3b1451b8102fa3c0;Fri Feb 27 08:35:56 EST 2009;Committer;nobu;1;1;0;1;0
5f47ed9b59afa0fbaa30aa191d739a260f54c3f9;Fri Feb 27 06:49:43 EST 2009;Committer;nobu;3;23;16;39;0
c691d55bcdd09081bb18d7ee88983175470f7249;Fri Feb 27 05:42:06 EST 2009;Committer;usa;3;57;3;60;0
6792751d4f134d7c97495c5b5044df3b03f6ba5a;Fri Feb 27 05:23:16 EST 2009;Committer;svn;1;2;2;4;0
1942710d429d393584a4fa78af8f7984c2c67f72;Fri Feb 27 05:23:10 EST 2009;Committer;nobu;3;13;2;15;0
770f854176b746226bfba50298450633bf4e1823;Thu Feb 26 14:39:12 EST 2009;Committer;akr;1;1;1;2;0
7f44badcbeee93d70d93c44dc0e244f6053084e4;Thu Feb 26 14:18:09 EST 2009;Committer;akr;1;2;2;4;0
ecb22ce2c54a635036031c2de70473d9daf4bfd5;Thu Feb 26 14:15:39 EST 2009;Committer;akr;4;47;15;62;0
cbc7f1b89bee06ccad0915821762c41251a97aff;Thu Feb 26 10:29:13 EST 2009;Committer;nobu;2;8;4;12;0
25d66aebccc5df1a24db917d5aaec390576638a8;Thu Feb 26 09:36:13 EST 2009;Committer;nobu;4;15;38;53;0
4176051753dafbd2d73123cb5647b2c52231a1f4;Thu Feb 26 05:02:21 EST 2009;Committer;usa;1;8;5;13;0
3eff6d398bfa74e39afe3a7e78965a433d04f249;Thu Feb 26 05:01:03 EST 2009;Committer;usa;1;1;1;2;0
5fb7052bb9dacd30f2a5e4241c87613009135dfe;Thu Feb 26 04:31:21 EST 2009;Committer;usa;2;8;11;19;0
905c1579174296a9c876a20e93b1fe540ed7adbe;Thu Feb 26 04:23:21 EST 2009;Committer;nobu;2;5;1;6;0
2c288bf91f04f93476d2794dff996979ccdfb4cf;Thu Feb 26 01:58:20 EST 2009;Committer;usa;3;12;10;22;0
2276b2f9044a7a53d9058145ac9d35261524cf0a;Wed Feb 25 16:35:05 EST 2009;Committer;akr;2;12;0;12;0
20bb7abc6e2fa4f4e20bb77a20503222028b9d49;Wed Feb 25 15:26:30 EST 2009;Committer;svn;1;2;2;4;0
e6f0b1de8953c6c3803a2be9eccf748643d08f21;Wed Feb 25 15:26:25 EST 2009;Committer;akr;3;113;4;117;0
1ff020df70f76d32ceea70e859d9f0b567e7a59a;Wed Feb 25 14:24:10 EST 2009;Committer;akr;2;26;11;37;0
56c52c1da8b9718bab1b5e2e9c1b43f00905f3d2;Wed Feb 25 14:19:24 EST 2009;Committer;akr;3;114;1;115;0
c17b915eb8c558df1ce4089f763e520b75ad71df;Wed Feb 25 14:03:42 EST 2009;Committer;akr;4;37;17;54;0
a898f0fb4b8e31d86a372f7d1438823195015249;Wed Feb 25 08:36:45 EST 2009;Committer;usa;3;96;17;113;0
3540727af57ee166993da274d924b278a0bd0d9a;Wed Feb 25 06:07:10 EST 2009;Committer;usa;3;9;2;11;0
dd43561fd6d7d816e6a8e8b045305fe560961040;Wed Feb 25 03:29:25 EST 2009;Committer;nobu;1;1;1;2;0
43b9684962629fb035275d9d362207f5361e809b;Wed Feb 25 03:28:00 EST 2009;Committer;nobu;3;13;3;16;0
ac9d09ba3c73417a6a53e9683d433419ca15504a;Wed Feb 25 03:06:12 EST 2009;Committer;nobu;3;24;16;40;0
9594c893f7c5940bbd4e08044eef6ff94ef27a97;Tue Feb 24 23:46:39 EST 2009;Committer;akr;1;1;1;2;0
6dd9388545183868ac08ab2dad7b3d4c4a4b07e4;Tue Feb 24 17:28:56 EST 2009;Committer;nobu;3;10;1;11;0
01e9a7be61ad5a9be0fe3a0c6c469d03ff21f51e;Tue Feb 24 17:18:55 EST 2009;Committer;akr;1;8;5;13;0
42eeb2c1b1788c5975d2a383c9b0c3ff2c90b6b8;Tue Feb 24 17:17:35 EST 2009;Committer;nobu;3;20;2;22;0
4b265d3e7bbb508bd0f846491b64ca06970bae60;Tue Feb 24 17:07:38 EST 2009;Committer;akr;1;13;1;14;0
8428347e99598e7808575d97becfaf0c881af3cc;Tue Feb 24 15:45:16 EST 2009;Committer;matz;2;21;0;21;0
400ded9338961ce39b3cd9cb58f03277e0a37f2d;Tue Feb 24 15:41:39 EST 2009;Committer;knu;5;23;9;32;0
02316f11d5cabf4a5cbaaa1f9f48711d5c61b7dd;Tue Feb 24 15:19:17 EST 2009;Committer;matz;3;32;0;32;0
ca292099a61fd3f0f8da461515c70a17572c0712;Tue Feb 24 15:15:25 EST 2009;Committer;knu;2;74;78;152;0
d91f52ae8b913e3aec9cc8eea3e81f1c1389af49;Tue Feb 24 15:02:06 EST 2009;Committer;svn;1;2;2;4;0
0d0d5e9f717aa1e0c1f830ffcf0908c51a049712;Tue Feb 24 15:02:01 EST 2009;Committer;knu;2;9;0;9;0
470103861e5b071393676836c9ede947bfea16bb;Tue Feb 24 13:19:04 EST 2009;Committer;akr;1;1;0;1;0
0ae09794e5ec3682303abf38192dfc4c184dac07;Tue Feb 24 13:02:59 EST 2009;Committer;akr;2;20;0;20;0
7e20506eae51a76415e46132f769e6d1b799c415;Tue Feb 24 12:08:23 EST 2009;Committer;akr;1;3;3;6;0
62b787b5698fa67f87db2e874c0946a267d938af;Tue Feb 24 11:00:24 EST 2009;Committer;akr;1;2;0;2;0
e137e939b7922044994f1fd8ea96b9e9b2a6b665;Tue Feb 24 10:56:57 EST 2009;Committer;akr;3;27;2;29;0
b404c651d2e732fa25e0c009892682a7718d0d2a;Tue Feb 24 10:45:46 EST 2009;Committer;akr;3;68;0;68;0
96322412616091404ffef2687df19e9136119ae0;Tue Feb 24 10:01:08 EST 2009;Committer;nobu;5;59;11;70;0
ff9bfed83dc694b87244a5caff7e19e27e16b3a9;Tue Feb 24 08:58:10 EST 2009;Committer;nobu;4;9;2;11;0
11abc445dd035fb1a7a60efcca3575ab3ff21e8a;Tue Feb 24 08:54:50 EST 2009;Committer;nobu;2;5;1;6;0
5028921a25dd9bba8260579140f4c8b591f06bf4;Tue Feb 24 04:13:53 EST 2009;Committer;nobu;2;10;0;10;0
6bdeed2b479dad4b4a735fb8075db1b96dd3101c;Tue Feb 24 02:21:53 EST 2009;Committer;nobu;2;7;2;9;0
85034513877d71d803f9ea96406217ceeb782b86;Tue Feb 24 01:49:39 EST 2009;Committer;nobu;2;9;2;11;0
60e8b398cd968178717d6cb4a105ba7258825d9d;Mon Feb 23 17:15:17 EST 2009;Committer;matz;2;9;15;24;0
c43236eaf78b7b74dfa7a41456d347deb2b5da1f;Mon Feb 23 16:24:46 EST 2009;Committer;mame;2;12;3;15;0
c55dd9b7d8cf71f62709dab492f4221f090a6a79;Mon Feb 23 16:20:06 EST 2009;Committer;mame;3;28;11;39;0
7019187067b9cc611f09ccf1445f484d9f609e2d;Mon Feb 23 16:12:38 EST 2009;Committer;matz;2;51;0;51;0
0b58675868978bbde67c25eec1223b8de05aba34;Mon Feb 23 15:51:31 EST 2009;Committer;matz;2;4;1;5;0
e69f2129339e9b13dbce30c0bcfd139b696bf2fe;Mon Feb 23 15:46:02 EST 2009;Committer;matz;2;9;4;13;0
20f46281698c368b2dfda69cd77f87b11876b552;Mon Feb 23 15:20:40 EST 2009;Committer;svn;1;2;2;4;0
b47b9fbb874c88b07fffa8f5029dfdcc3f06b616;Mon Feb 23 15:20:35 EST 2009;Committer;matz;2;5;6;11;0
605cd65904343ec13049820ed6c1b0335ddbc69e;Mon Feb 23 11:41:38 EST 2009;Committer;akr;3;54;2;56;0
23e286f3fb1b7570e107b9a028c1fb03bacc5cca;Mon Feb 23 11:32:43 EST 2009;Committer;akr;4;78;0;78;0
a0e3e8e4d134bc1b94d5d43d613e13606c9a94d8;Mon Feb 23 11:21:45 EST 2009;Committer;akr;3;15;7;22;0
1a1990df715ebaa4fb54c69dc312b048aa56174f;Mon Feb 23 06:54:58 EST 2009;Committer;knu;2;12;4;16;0
bcf6fd2c86e9159aee777e9de177d21772e62f08;Mon Feb 23 05:47:06 EST 2009;Committer;nobu;2;6;1;7;0
15700ff0be5394e9b33111a8ef2b81bdd3ddd85f;Mon Feb 23 01:19:43 EST 2009;Committer;nobu;4;19;0;19;0
7e162b150d5ad0e54fb392e26aaac23109f9e395;Mon Feb 23 01:15:37 EST 2009;Committer;nobu;3;54;0;54;0
02bfe1f6e70ad83a65d285fd99cbdeb115838a16;Mon Feb 23 01:14:26 EST 2009;Committer;nobu;1;1;1;2;0
97ef9728d587e1268f34844b9886bac9c46a0ad4;Sun Feb 22 18:20:11 EST 2009;Committer;akr;2;7;0;7;0
decee680285d718d2055d168bed400b5b2f4cd76;Sun Feb 22 18:14:01 EST 2009;Committer;akr;1;18;0;18;0
b7fe0657411dce7f2384100dc9e5c93bd0ff12dc;Sun Feb 22 17:55:52 EST 2009;Committer;akr;2;8;3;11;0
475a350df89c14aa2680454cf179a176ffa3591e;Sun Feb 22 17:46:51 EST 2009;Committer;akr;2;30;0;30;0
0c95958c2d446feb85d4c0267bb5bd67edbe383b;Sun Feb 22 17:27:15 EST 2009;Committer;akr;2;8;3;11;0
cdca4e19d0274e86e128ae9dc61291fb13b18763;Sun Feb 22 17:10:47 EST 2009;Committer;akr;2;5;1;6;0
e5dd6a792d974d8d8d9f81c21102a4c1f527926b;Sun Feb 22 16:25:06 EST 2009;Committer;akr;1;2;2;4;0
5a980f59775b187753a36a2dfa690e60eed9b2d6;Sun Feb 22 16:22:31 EST 2009;Committer;svn;1;2;2;4;0
2e0a20d3e2fed00674c2d3a1f25fbd27d5732e9b;Sun Feb 22 16:22:28 EST 2009;Committer;akr;1;2;2;4;0
a384273d6d7efecd19ac3f6902a6233fcb586ab1;Sun Feb 22 14:38:05 EST 2009;Committer;akr;1;13;12;25;0
83930529b269a3f27ff403c453d5ea9f1f5bd8f5;Sun Feb 22 14:26:27 EST 2009;Committer;nobu;1;202;202;404;0
12d2c8ba41edb5a02a7471e39d67ece2894492d8;Sun Feb 22 14:23:33 EST 2009;Committer;nobu;43;847;849;1696;0
624d07b0e4257a5261558a154eddd464d85e6174;Sun Feb 22 13:42:22 EST 2009;Committer;nobu;3;20;2;22;0
7b1bbd59e12f8c3f262c7157ea6b73f8e3e7dad6;Sun Feb 22 13:38:24 EST 2009;Committer;nobu;1;8;3;11;0
80d230c3945a0c79e5215b14c864b1acf503e163;Sun Feb 22 11:09:55 EST 2009;Committer;akr;2;5;1;6;0
22cef963c31c575dd08b3e7af372f69772372988;Sun Feb 22 10:28:38 EST 2009;Committer;akr;2;8;0;8;0
ec5d31b307bdd2876c829bd98fe8e0c5f038a04b;Sun Feb 22 10:23:58 EST 2009;Committer;nobu;1;1;0;1;0
c160c6e59eb65e3159f979a54dc3d609265829c4;Sun Feb 22 09:40:42 EST 2009;Committer;akr;2;22;1;23;0
af7d8584c56e42c9fb2848f797dfddb37c41fb59;Sun Feb 22 06:12:21 EST 2009;Committer;akr;2;5;0;5;0
bc59123dc0b862362fca0cc44d9c43fd012dd767;Sun Feb 22 05:33:07 EST 2009;Committer;nobu;3;31;6;37;0
0ec57a60af78c82fbdcb36375c812dae33eeca6d;Sun Feb 22 04:38:46 EST 2009;Committer;nobu;2;23;2;25;0
88860a065ecdf87a6eb38c776fdf5c97b865c3ef;Sun Feb 22 04:06:15 EST 2009;Committer;akr;1;1;1;2;0
5c94b5d11383629b604c455a2a57ccdde4e3f672;Sun Feb 22 04:04:31 EST 2009;Committer;yugui;3;13;7;20;0
510f34d615e655c52f7633aafbd703b943d43b36;Sun Feb 22 04:03:16 EST 2009;Committer;nobu;2;5;2;7;0
70946fb3ea60bb91f63310836762e4cd8eca85ba;Sun Feb 22 03:56:37 EST 2009;Committer;nobu;2;5;1;6;0
1e51a7b2c6ba2a53f7a7a87244d76351be868999;Sun Feb 22 01:47:11 EST 2009;Committer;nobu;1;11;0;11;0
19bbab6140847de08dd0278a7ebaae6b01352513;Sun Feb 22 01:43:59 EST 2009;Committer;nobu;4;62;21;83;0
3b39217fb4f115129522207e083a4875beecf5e9;Sat Feb 21 19:32:39 EST 2009;Committer;matz;2;15;1;16;0
47c6ecfa6429e0cb38d405ba83917119ebd65070;Sat Feb 21 17:16:18 EST 2009;Committer;akr;2;12;2;14;0
6b0f5967193ab3a827ac07d24bdf1c099135c381;Sat Feb 21 17:04:22 EST 2009;Committer;akr;2;11;0;11;0
60f2cec6468bd4ce1d9821d851c9758b4299635c;Sat Feb 21 16:53:30 EST 2009;Committer;akr;2;8;2;10;0
ad2f293d4fb1df2b78649e649feb41ed48913998;Sat Feb 21 16:49:44 EST 2009;Committer;akr;2;29;2;31;0
9cfe35ad503cd6bb598dea85517949b932719afe;Sat Feb 21 15:57:52 EST 2009;Committer;akr;7;131;5;136;0
6adda0379c0dc2b2f881060cba2ad40493e59608;Sat Feb 21 15:32:57 EST 2009;Committer;svn;1;2;2;4;0
d227ca29f4fdac6a62bc17673f265b0ccec6a2d4;Sat Feb 21 15:32:52 EST 2009;Committer;akr;2;8;3;11;0
90fc8d84adbedccde2439aa82a10bb85a923be7e;Sat Feb 21 14:05:07 EST 2009;Committer;akr;1;3;3;6;0
ca38e81fcb20eae18181b21756fb0f4b9679294c;Sat Feb 21 02:22:41 EST 2009;Committer;svn;1;2;2;4;0
ab1a639cbe18354f942af745b6115e1286a6bbcc;Sat Feb 21 02:22:36 EST 2009;Committer;akr;1;1;1;2;0
6ccdc76ffbd24d2bb6bf8a89a3bb91a8b7c9bfc0;Fri Feb 20 14:29:05 EST 2009;Committer;svn;1;2;2;4;0
8563b285fb1bae6a9729a1583f1e6d8b8abf3a1b;Fri Feb 20 14:29:00 EST 2009;Committer;usa;3;21;17;38;0
09396dcf21d6d769f0537aacce69369132e9a4eb;Thu Feb 19 14:01:17 EST 2009;Committer;akr;2;21;11;32;0
98f82fc633d327350ca1f098d71b7e0bd5208bd8;Thu Feb 19 13:18:02 EST 2009;Committer;akr;2;5;1;6;0
bed429445169865659af13d0f491f4b7060cf7e6;Thu Feb 19 12:13:38 EST 2009;Committer;akr;3;19;15;34;0
7c7690045870396816624bf57775eb29e6a478fd;Thu Feb 19 06:47:13 EST 2009;Committer;nobu;4;26;17;43;0
3e1394f36fd39da810ebd807d5346ddd0c0f3b5b;Thu Feb 19 06:39:52 EST 2009;Committer;nobu;2;9;4;13;0
a285f8565d73bc1cba0b369f5cd46d7e23911bc1;Thu Feb 19 06:17:01 EST 2009;Committer;nobu;2;7;4;11;0
22f1a984f193db2c390826c70c1b030dd7cd9e4c;Thu Feb 19 06:14:27 EST 2009;Committer;nobu;2;7;2;9;0
f35308b3ef20be1716660a751087b4e726db2171;Thu Feb 19 06:11:41 EST 2009;Committer;nobu;6;42;32;74;0
6d3ceb6ce38f91898dfc388fc96f5401ff3edc52;Thu Feb 19 05:48:14 EST 2009;Committer;nobu;5;14;10;24;0
e2f62813029b886850901daa2dc2aec0008f5730;Thu Feb 19 05:39:55 EST 2009;Committer;nobu;2;9;3;12;0
c59107a9fa48b0085af89fce6c304688de2c30d7;Thu Feb 19 05:24:43 EST 2009;Committer;nobu;2;5;0;5;0
030eed8f39ca1f1fc757c9a5b65e7748fc258153;Thu Feb 19 05:22:04 EST 2009;Committer;nobu;2;8;2;10;0
fb3fee22caf33027bcc7cc24426a4bed71592395;Thu Feb 19 05:18:27 EST 2009;Committer;nobu;2;5;3;8;0
6784d8fda6c1a5dd31cfab4f4dccda7c04447d47;Thu Feb 19 05:14:30 EST 2009;Committer;nobu;2;6;2;8;0
4caba4ebd09c7bede067c4124d009138a5fd7d3c;Thu Feb 19 04:56:01 EST 2009;Committer;nobu;2;5;1;6;0
90f84988fc27c391ecf24723e58f02f22339adac;Wed Feb 18 23:47:21 EST 2009;Committer;takano32;2;5;0;5;0
18afbc891c3ac8d21b7d93a2d8ad76c2f536956d;Wed Feb 18 18:43:15 EST 2009;Committer;akr;3;73;10;83;0
2485ed517745088bf2b26707f2a66217b778d4f3;Wed Feb 18 18:39:22 EST 2009;Committer;knu;1;2;1;3;0
678adc8714bd325967464eaf4b37c8a863f04919;Wed Feb 18 18:34:38 EST 2009;Committer;knu;3;78;74;152;0
234bc1d7a9149d3eeb3cf834102fd8ad08c03b31;Wed Feb 18 18:17:26 EST 2009;Committer;mame;2;14;1;15;0
b09fde68e6ebffe43381f37d0e14359d1adce0ba;Wed Feb 18 18:02:07 EST 2009;Committer;svn;1;2;2;4;0
f98759935c5b0b33f5ba09115e7ff1fdf52bce4b;Wed Feb 18 18:02:02 EST 2009;Committer;knu;3;40;20;60;0
75ba47e8e87e7dd2c92f1dee2cac834b505429f4;Wed Feb 18 13:47:53 EST 2009;Committer;akr;2;31;0;31;0
f1a39b9e5cc8ac74757c42aab4721a6d7a08b46c;Wed Feb 18 12:48:11 EST 2009;Committer;akr;2;11;3;14;0
34152d654ad67035e5e20b6ea7f854b18f942c98;Wed Feb 18 12:35:22 EST 2009;Committer;akr;2;18;11;29;0
d89e09b3087dbaf09301648868d0d8ac340da04c;Wed Feb 18 12:27:13 EST 2009;Committer;akr;2;19;6;25;0
288e892a108a86f7e2659ce53fe1b9956686d149;Wed Feb 18 11:27:17 EST 2009;Committer;nobu;2;6;1;7;0
58f97825278b0d45c58aa46d662a3d6b2c99e782;Wed Feb 18 06:35:38 EST 2009;Committer;nobu;2;4;2;6;0
30231731a9539e8b3474bd3ffa8e24624ea726d1;Wed Feb 18 06:33:53 EST 2009;Committer;nobu;2;6;2;8;0
fd2b650d068779887bd794e0097c081a6c70763e;Wed Feb 18 06:27:47 EST 2009;Committer;knu;2;11;2;13;0
3229c32008a9a1a3d83463ccbcd97013c10668d7;Wed Feb 18 06:21:04 EST 2009;Committer;nobu;3;7;7;14;0
1128e61562bd05ade1afcc8b2a7b52a37b7818e6;Wed Feb 18 05:33:36 EST 2009;Committer;nobu;6;43;13;56;0
829ab73879fe7b997a295e2d4c4684fd528105dc;Wed Feb 18 03:38:42 EST 2009;Committer;nobu;1;25;26;51;0
5f9342fa8aec29df47604df5a149c45505783357;Wed Feb 18 03:35:34 EST 2009;Committer;nobu;2;6;1;7;0
656e005ac0ceef8f2e174ea96cb244ef692944d4;Wed Feb 18 03:04:49 EST 2009;Committer;nobu;1;209;207;416;0
17aa3d898da249ddd1478b21de6187bfdd873497;Wed Feb 18 03:01:03 EST 2009;Committer;nobu;2;15;4;19;0
e5edfbf2074d2c99c7c0128688367c28fd911a26;Wed Feb 18 01:49:17 EST 2009;Committer;nobu;1;9;0;9;0
28ec52c087c1cf621c55ac7bd412465623fc6379;Wed Feb 18 01:29:13 EST 2009;Committer;nobu;2;13;6;19;0
e1f9891eebca22ff317ba9bf781a0fe9bf20cd2a;Tue Feb 17 22:02:22 EST 2009;Committer;akr;1;1;0;1;0
056d798ed2aff0f5f9a3abfb73e749cdc174d8bf;Tue Feb 17 18:17:51 EST 2009;Committer;nobu;1;1;2;3;0
da97071549496807cedae46a2b81d68407fed2fe;Tue Feb 17 18:14:20 EST 2009;Committer;nobu;1;4;1;5;0
d968f625587b845a245e7835c60891a64e3cbb2f;Tue Feb 17 16:59:06 EST 2009;Committer;nobu;1;5;0;5;0
9bd0ecd9179452bbb410ee69c387dadb813cf95a;Tue Feb 17 16:29:43 EST 2009;Committer;akr;2;7;0;7;0
0b058a1c2a505c1fa60b65f4c48aa4fa30f8da8f;Tue Feb 17 16:17:03 EST 2009;Committer;akr;2;0;3;3;0
e14c9923b47f3075ca9040620f12c8e258b3435a;Tue Feb 17 16:09:44 EST 2009;Committer;akr;9;352;338;690;0
47d55a02a332633a75847d819cab3241f7060289;Tue Feb 17 15:55:49 EST 2009;Committer;nobu;3;91;14;105;0
28cf7a6d6f105b500fd2e83291fbecc9dac2473d;Tue Feb 17 14:26:34 EST 2009;Committer;akr;2;7;0;7;0
536adb5d7cf0b35a3980f11f0512e85ff72d71e6;Tue Feb 17 11:05:35 EST 2009;Committer;akr;1;6;1;7;0
2f8b471b89ce803c54f30e6d2cc95e12f62247c0;Tue Feb 17 10:43:55 EST 2009;Committer;akr;1;1;1;2;0
3d39a9a0702f5bcfae88be5d8dfe5e3e28f95dd2;Tue Feb 17 10:40:20 EST 2009;Committer;akr;2;30;3;33;0
0958624759441b5e5b4e9c08f9e778b36a96c91f;Tue Feb 17 09:57:12 EST 2009;Committer;nobu;1;2;0;2;0
62dd7a00fcef20ef5c74007bc93f8851e002a449;Tue Feb 17 03:50:59 EST 2009;Committer;nobu;2;21;11;32;0
c9e4dc308f51122e0401756ac3aa4972d0b4ad32;Mon Feb 16 20:54:58 EST 2009;Committer;ko1;3;66;31;97;0
cd2434deb6cc59b3ea95ac3db2e66f3c6a62d921;Mon Feb 16 16:55:38 EST 2009;Committer;svn;1;2;2;4;0
d9bb9b32550027d44de9e47c90a9bd1b85f97593;Mon Feb 16 16:55:33 EST 2009;Committer;akr;4;31;34;65;0
835fa875cc7e9c993c3f93aa6175df76aba4114c;Mon Feb 16 14:36:28 EST 2009;Committer;akr;1;1;1;2;0
351f54de4505dac2a5b4c54727dfa366962fc1cb;Mon Feb 16 14:34:01 EST 2009;Committer;akr;2;8;0;8;0
112b228273eb58912e5de30ba684a1ce912213a6;Mon Feb 16 13:01:52 EST 2009;Committer;azav;1;5;1;6;0
1b85104996a3c6e664916be23019fbc5cbb97c08;Mon Feb 16 12:55:49 EST 2009;Committer;azav;1;1;1;2;0
f5ca95ee10189e91c39c63f4bedbfa6fa75ef763;Mon Feb 16 08:04:56 EST 2009;Committer;knu;4;59;18;77;0
1e5de389da4c5043b8aed81138c4980fad7393e3;Mon Feb 16 07:46:24 EST 2009;Committer;nobu;4;40;8;48;0
2b206be6acca2b0e5c2894860f578e087a4e3c5b;Mon Feb 16 05:54:17 EST 2009;Committer;knu;2;46;11;57;0
2a3d58d6924767433d296df187fc68e1d8485f0c;Sun Feb 15 17:39:38 EST 2009;Committer;nobu;1;9;12;21;0
82fa04e212dcff441d8ffa941fe2c252393db489;Sun Feb 15 16:18:01 EST 2009;Committer;nobu;3;9;2;11;0
a4eb3395643835b87c504701f2964ae461a5727c;Sun Feb 15 12:43:46 EST 2009;Committer;nobu;3;25;8;33;0
8fc45476ebf80e8da9c50ff441e623c1550799e6;Sun Feb 15 12:22:50 EST 2009;Committer;nobu;2;9;0;9;0
1f125adde0e6cad77b13c521cb95c7089885b398;Sun Feb 15 10:03:02 EST 2009;Committer;akr;1;1;0;1;0
57394f14845482d8e16d85f3375c82639b6a4b51;Sun Feb 15 09:42:00 EST 2009;Committer;akr;1;4;0;4;0
357f66670c33ee3d8acf85d94bb004c4294c39ae;Sun Feb 15 07:58:31 EST 2009;Committer;akr;2;57;0;57;0
d40578e4385c888712b8450c1b9e32dbf38c3d72;Sun Feb 15 07:18:14 EST 2009;Committer;akr;1;5;5;10;0
e279c5d6e5c213b15cde0ba37982a9daa1fb7094;Sun Feb 15 05:59:03 EST 2009;Committer;akr;2;5;2;7;0
08638ed7b837bef4ec94bd56e38941e737e42f5d;Sun Feb 15 05:19:39 EST 2009;Committer;akr;1;15;0;15;0
b955b34d5fe4792bb85742ced659b1d2b1d74d6a;Sun Feb 15 02:45:31 EST 2009;Committer;nobu;2;31;31;62;0
29f73c43a5dde61a8ddea3dd31af7d806fc51c2b;Sat Feb 14 23:36:45 EST 2009;Committer;akr;7;747;759;1506;0
a2f28cb6f5c388964161b105a851eaaf3697b891;Sat Feb 14 22:30:56 EST 2009;Committer;akr;1;3;1;4;0
183582ab29b5e81fc4a090eb69102857210e2824;Sat Feb 14 22:04:21 EST 2009;Committer;akr;1;5;0;5;0
1b4c1f715e5abcf68ea680dbed3b36007b9aa761;Sat Feb 14 22:03:28 EST 2009;Committer;akr;4;18;3;21;0
e722ad99d5b0e6a9bb0249ff3d9c8cce28d3204e;Sat Feb 14 19:55:34 EST 2009;Committer;mame;12;117;30;147;0
a48f90b05b654cc98727a91c5fd9952c5a86221c;Sat Feb 14 18:53:40 EST 2009;Committer;mame;3;33;5;38;0
766df600db46f3cc8a2bd0c0af2dfceeec2d8fb3;Sat Feb 14 15:45:43 EST 2009;Committer;nobu;3;88;17;105;0
e1646e639a14f8430046dd424c1b745bea7f9840;Sat Feb 14 15:39:46 EST 2009;Committer;nobu;3;9;3;12;0
a8167d58b9c1b3cd3860e4e55cb98e7460337a00;Sat Feb 14 12:14:38 EST 2009;Committer;akr;1;0;2;2;0
f343c9d3b71fa1ebc93a828d673b0f194ccb2d72;Sat Feb 14 12:00:54 EST 2009;Committer;akr;1;0;4;4;0
5b512b7fa9ae81c0919ef4301351fb71fd7e14e6;Sat Feb 14 11:19:52 EST 2009;Committer;akr;3;367;368;735;0
9ddde2773f31f95311aa6128fc1809f5b5d06ecc;Sat Feb 14 11:06:23 EST 2009;Committer;akr;1;8;1;9;0
23843e8b3cb8598bec5cc2a0148b8cfc5018e026;Sat Feb 14 10:21:15 EST 2009;Committer;akr;2;5;52;57;0
53bea54768538ca7160e0eafedd816cae54402d3;Sat Feb 14 04:15:32 EST 2009;Committer;takano32;2;5;2;7;0
28eb7acf2c8c8b883090617599ec3439dc55e8e9;Fri Feb 13 22:31:46 EST 2009;Committer;naruse;2;7;2;9;0
9d37857e2b8a4b227e52ff8438e44968d6249f95;Fri Feb 13 17:21:53 EST 2009;Committer;akr;2;7;2;9;0
6c4d5d1c0dea9c638b8cfd966373981eb70eafc8;Fri Feb 13 17:11:35 EST 2009;Committer;svn;1;2;2;4;0
760ee609d27063720460d4fcde5855444e3f8b21;Fri Feb 13 17:11:32 EST 2009;Committer;akr;1;1;1;2;0
3a7c7e2d062928e78eeac6de0493a7bf6f7fb879;Fri Feb 13 14:49:40 EST 2009;Committer;akr;1;1;0;1;0
9842858add66b084d4fc6f662d40daa0e984f131;Fri Feb 13 14:43:12 EST 2009;Committer;akr;2;10;4;14;0
1fb7ce63031d2a2180b2706dd2185c741b0ff365;Fri Feb 13 14:37:11 EST 2009;Committer;nobu;2;7;0;7;0
2a2cc2e9c41718b29843ddbab8addd95f0371a09;Fri Feb 13 14:33:48 EST 2009;Committer;nobu;1;26;3;29;0
36dcff1cf562d095a17fd6251407f37980c7f766;Fri Feb 13 12:14:00 EST 2009;Committer;akr;4;11;2;13;0
840e6c70e811908236f5f3c5ae81eec817c6f461;Fri Feb 13 12:01:53 EST 2009;Committer;akr;1;5;1;6;0
5b8339edf65091d3fab69cd902954a8da291b33f;Fri Feb 13 12:00:25 EST 2009;Committer;akr;2;5;0;5;0
e4917c6dcbb51c050ff2d5649dab3613e3b362ac;Fri Feb 13 09:10:28 EST 2009;Committer;nobu;2;25;25;50;0
8a5746bf34f9b4952dc18566a69c7762b30e1c6a;Fri Feb 13 06:53:35 EST 2009;Committer;ko1;1;1;1;2;0
a14bd973ed6d94db6899948a412d15f5a5a2437d;Fri Feb 13 06:34:20 EST 2009;Committer;nobu;2;5;35;40;0
0cb68b619ef80f8edb050ac4aa21306815b2a501;Fri Feb 13 06:25:59 EST 2009;Committer;ko1;4;11;3;14;0
c5d7d78daeb44b4c5ad7a9b624638ffd1be96135;Fri Feb 13 06:04:25 EST 2009;Committer;ko1;3;17;1;18;0
03ee5fa027616680d74717d74bf3f53b6aacfc9a;Fri Feb 13 00:43:31 EST 2009;Committer;nobu;2;6;0;6;0
31734b907ae902f0262bcae8ff11a2c6c973c90e;Thu Feb 12 20:02:03 EST 2009;Committer;nobu;1;1;1;2;0
ae6ba9f084b6605da010768d9d116f88cd04a81c;Thu Feb 12 16:45:18 EST 2009;Committer;nobu;2;4;2;6;0
11a4e69447e457d229477f427987da444a0c7ec3;Thu Feb 12 16:29:17 EST 2009;Committer;nobu;2;11;2;13;0
6b7dbd3e31c7d5943a5f021c9e45af0a0c3a664d;Thu Feb 12 15:48:44 EST 2009;Committer;nobu;3;14;0;14;0
3d9c0014e6c9ebe269781c718f380b9527114d8f;Thu Feb 12 15:04:44 EST 2009;Committer;svn;1;2;2;4;0
385b6a15ff7bb0c2bbc6fdcc958d382769948e10;Thu Feb 12 15:04:41 EST 2009;Committer;knu;1;298;82;380;0
643b8cb4b4622eefd94d28da857f14d0582e07e1;Thu Feb 12 14:28:58 EST 2009;Committer;nobu;1;2;2;4;0
3abae536a6c97378e97f15b53238bf6dcd25ab2c;Thu Feb 12 14:26:02 EST 2009;Committer;nobu;1;3;1;4;0
a61786398aaed4b81fd63f80c7f69adbd1e7c9b8;Thu Feb 12 14:24:11 EST 2009;Committer;akr;2;8;0;8;0
5dd1a4c14e7d7a70afb8f3e1ebded95040d321ab;Thu Feb 12 13:51:19 EST 2009;Committer;nobu;2;9;2;11;0
7882b61a038257199a2b6776a9b9c2f77db693f8;Thu Feb 12 12:57:14 EST 2009;Committer;akr;1;2;0;2;0
97a922e2ff26a04a408032e8662442b8f0bb3be3;Thu Feb 12 12:45:24 EST 2009;Committer;akr;1;1;1;2;0
7a01268aebada78b505f9ac4736cb23fa8bf260d;Thu Feb 12 12:43:04 EST 2009;Committer;akr;4;25;0;25;0
e52da919872f8cf71c90a27b470cef724204eece;Thu Feb 12 10:42:36 EST 2009;Committer;nobu;6;41;11;52;0
48149dff328079a25b9f17d47999a513b14389c6;Thu Feb 12 10:41:48 EST 2009;Committer;nobu;1;15;0;15;0
ee159271dd036aef604ddf7687a6923f524b7d70;Thu Feb 12 08:17:53 EST 2009;Committer;nobu;2;7;1;8;0
9565e98b6e42f50986d3865cd196cce77cb5b182;Thu Feb 12 07:50:28 EST 2009;Committer;nobu;2;9;4;13;0
04e2a72f1ec29949d8543116160cb8c315a23dd8;Thu Feb 12 07:21:42 EST 2009;Committer;nobu;1;2;2;4;0
ee5f857a0542e5483e9bf25442fe9ed6a7f5e11c;Thu Feb 12 06:38:26 EST 2009;Committer;matz;2;8;0;8;0
208b52a3d3b2d1b33cbf23d5ea9761508fbb0195;Wed Feb 11 15:49:58 EST 2009;Committer;gotoken;1;1;0;1;0
c1cb27402f511aa6ec4daf9dc39de8edf08bdcaa;Wed Feb 11 15:29:38 EST 2009;Committer;svn;1;2;2;4;0
3032bdb1d300c06c7b38e06e211d492d13039a37;Wed Feb 11 15:29:35 EST 2009;Committer;akr;1;27;23;50;0
e3c5fbba9163f608d21e2b14652603258de63f5a;Wed Feb 11 09:11:48 EST 2009;Committer;usa;2;11;0;11;0
a2c779be35d7721a1e067227086a5458f9a16f9a;Wed Feb 11 08:49:49 EST 2009;Committer;akr;1;13;7;20;0
83eddaad27990c840ac186cc6cb8941aeb356caf;Wed Feb 11 08:39:57 EST 2009;Committer;akr;2;18;5;23;0
b9d2a4399065197d5a42b78b622ac456ae02d631;Wed Feb 11 08:35:35 EST 2009;Committer;akr;2;48;30;78;0
d27c1748cd5d41fcf286545d34d7891516dc5e68;Wed Feb 11 08:13:20 EST 2009;Committer;akr;1;10;2;12;0
630e4ef492b5647bae57d00fffa2004b7ececfc8;Wed Feb 11 08:03:17 EST 2009;Committer;akr;2;8;4;12;0
3f0d724dc36df47e4b262f5c37f6690c2832277e;Wed Feb 11 07:54:52 EST 2009;Committer;akr;3;9;0;9;0
0a954e9117168f0221b7cfd833b1e2ea6243ba16;Wed Feb 11 07:51:53 EST 2009;Committer;akr;3;26;1;27;0
ff955766d496954140ed9c72ac0be898cbb913da;Wed Feb 11 07:44:53 EST 2009;Committer;akr;3;19;3;22;0
f23292afb45db6a52e8e4949620162a230a2eea7;Wed Feb 11 06:47:12 EST 2009;Committer;nobu;2;20;3;23;0
66a5fcab3a510282df64c8f4b28d62ef2aa2f438;Wed Feb 11 05:46:17 EST 2009;Committer;nobu;2;11;4;15;0
4b036bb69b74f9d4c46c5598b3338c4db5bf0501;Wed Feb 11 05:10:47 EST 2009;Committer;akr;2;105;63;168;0
6e6676a2234ec190aaea02efaa31949388c02622;Wed Feb 11 04:31:19 EST 2009;Committer;akr;1;16;0;16;0
f871e8cf0d111b7dc65f25e8c03df8e9996247ea;Wed Feb 11 04:29:12 EST 2009;Committer;akr;1;31;0;31;0
a8de15e0b56056b0ba5d4d7f724f38ea8d97d888;Wed Feb 11 04:17:57 EST 2009;Committer;akr;6;6;6;12;0
c9c3437b20efd7a8a5583a83a26a3eeb769f9666;Wed Feb 11 04:11:48 EST 2009;Committer;akr;1;56;0;56;0
c7a66ff8043562c9d8e2cbb5c588b80d83ef1a90;Wed Feb 11 03:56:13 EST 2009;Committer;akr;2;102;4;106;0
fa65ca097b7c82802762b6ccbbdcf53ad3e87ec3;Wed Feb 11 02:48:08 EST 2009;Committer;akr;2;6;0;6;0
c645978f1cd9915cb1a03f72264dbacd1d105385;Wed Feb 11 01:38:02 EST 2009;Committer;akr;1;10;4;14;0
fdf5d808900241e48f33293e81934ead1c8968ce;Wed Feb 11 01:30:05 EST 2009;Committer;akr;1;1;0;1;0
b4e50055c3ab9fed6bfded69c2fbd7c5bb410780;Wed Feb 11 01:22:08 EST 2009;Committer;akr;4;59;0;59;0
b8147c444b70e0e07dcd3c90e3af76ff28f65602;Wed Feb 11 00:59:30 EST 2009;Committer;akr;2;6;1;7;0
bb4abd612e912a9b9dfc3cba7f6d8bda508fe0b7;Tue Feb 10 15:43:02 EST 2009;Committer;akr;1;5;5;10;0
923284e2422e1c74dab94be8cbbc8fcdc629dfad;Tue Feb 10 15:39:20 EST 2009;Committer;svn;1;2;2;4;0
be25c48638a0ba5d619e28fe67defc8e23078317;Tue Feb 10 15:39:16 EST 2009;Committer;akr;3;13;4;17;0
2ee08591190bed1f57a43a5cdd6486e3abfa664f;Tue Feb 10 14:46:51 EST 2009;Committer;akr;4;36;21;57;0
6245caf58ccd2ccafc829c9c6a37b2b534c0a94d;Tue Feb 10 14:31:21 EST 2009;Committer;akr;2;16;9;25;0
1463f1dfe70005ca1eac16547097370f6b9c6466;Tue Feb 10 12:38:16 EST 2009;Committer;akr;3;219;10;229;0
a038fab64970fd76d336aa57a2993f71f631695d;Tue Feb 10 12:15:54 EST 2009;Committer;akr;2;5;1;6;0
98d3eca7fc092e0237f6cfd06bb5cf58d3796d36;Tue Feb 10 12:09:57 EST 2009;Committer;akr;3;71;0;71;0
7be3cdbc0443e007ab5aa294d216e086c8a8af7e;Tue Feb 10 11:59:16 EST 2009;Committer;akr;1;1;1;2;0
939efe7d4c17c7bc17fa4a11ef07831dd91b1306;Tue Feb 10 11:59:04 EST 2009;Committer;akr;2;17;9;26;0
ba75dd6b95793e3a8476dc8e112ea98961d5a183;Tue Feb 10 11:57:07 EST 2009;Committer;akr;2;7;4;11;0
df0f575e1d1359c75230ab1b70b7ed3059f77306;Tue Feb 10 08:55:40 EST 2009;Committer;knu;6;17;17;34;0
160c230f94919299b1270e90b961c04fc06cc255;Tue Feb 10 03:57:23 EST 2009;Committer;nobu;2;5;4;9;0
395abae93d6c9d86364714b4cbf4c3cad9d020ef;Tue Feb 10 03:54:12 EST 2009;Committer;nobu;1;4;3;7;0
2acc18ad994a5ac8091e1a622140d36f7252f946;Tue Feb 10 00:18:53 EST 2009;Committer;akr;2;6;6;12;0
d1ec92918853473c77d6d7e6d93e1bec70807baa;Mon Feb 09 20:07:00 EST 2009;Committer;nobu;1;2;2;4;0
4165800cae942e886c7931baeba871829f53d742;Mon Feb 09 19:34:43 EST 2009;Committer;nobu;2;292;286;578;0
c6ea437727e9138c703a99c01333fcafe1215c69;Mon Feb 09 16:29:16 EST 2009;Committer;akr;2;7;2;9;0
b877fc2f15e231b80bd4d60280adf8579e75f0d9;Mon Feb 09 16:23:36 EST 2009;Committer;akr;2;28;5;33;0
41f256b48452df2de253edf737e1543d7ce88e12;Mon Feb 09 16:03:12 EST 2009;Committer;svn;1;2;2;4;0
97ba0d4aa788273c4d4b4432a51683597c32c2cc;Mon Feb 09 16:03:08 EST 2009;Committer;akr;4;12;2;14;0
810dd43a207e74141f450f30bd239185ce49df2d;Mon Feb 09 14:23:53 EST 2009;Committer;akr;4;73;36;109;0
2dd3fa9f3e222866e0c3577a3e447509cc40a647;Mon Feb 09 14:05:37 EST 2009;Committer;akr;5;16;5;21;0
f5da7031b91426f362e8ec2101bf794976ecc590;Mon Feb 09 13:56:43 EST 2009;Committer;akr;7;85;44;129;0
2092fbcc3ad4437f066dc79a64a80236afcbdf50;Mon Feb 09 12:52:11 EST 2009;Committer;akr;1;5;1;6;0
ecfea8e28e0042cea1f242393714eff7c16b8e60;Mon Feb 09 12:49:24 EST 2009;Committer;akr;2;24;9;33;0
8977fe1e3617cff23c01db396a0617b6ca5da56e;Mon Feb 09 11:19:57 EST 2009;Committer;akr;2;7;3;10;0
a9a17a5a44836d90403659a371e2f9e0377445f8;Mon Feb 09 11:11:57 EST 2009;Committer;nobu;2;48;32;80;0
7ad35679341cf4da962bc00deb97068398959397;Mon Feb 09 11:04:51 EST 2009;Committer;akr;2;136;120;256;0
bee960d4e95d5b8003cd659405334c51898b6abc;Mon Feb 09 11:00:45 EST 2009;Committer;akr;2;9;0;9;0
7d63280c17acff8093b9e909349eafbbab19f8fe;Mon Feb 09 10:59:55 EST 2009;Committer;akr;2;6;2;8;0
48de4753d1b376953676463ceddf75c303acdd94;Mon Feb 09 10:52:55 EST 2009;Committer;akr;2;9;5;14;0
fd9c7e8af11fb79fa61ad7c462ff47e2ccd54486;Mon Feb 09 10:49:16 EST 2009;Committer;akr;3;74;28;102;0
3a701d728184d31c7abb7a106b78b7630b575081;Mon Feb 09 05:52:09 EST 2009;Committer;knu;1;1;1;2;0
03d38468ac4ea2493eb24fc17c44177ca9b2c7c1;Mon Feb 09 05:51:31 EST 2009;Committer;knu;1;9;4;13;0
646e2efaef83f789632260bc88a154506c9b25af;Mon Feb 09 02:35:38 EST 2009;Committer;naruse;2;9;0;9;0
70f76601969f7e8b5bfb3bfd5d83e5d32c5c3e41;Mon Feb 09 00:06:41 EST 2009;Committer;akr;2;11;0;11;0
64f12a46d591887a716822305dba29dd3da1cf8f;Sun Feb 08 17:04:40 EST 2009;Committer;akr;3;8;3;11;0
0fe7022c0b5603582fc96c630e9756ca4b49fe1a;Sun Feb 08 16:28:14 EST 2009;Committer;akr;1;1;1;2;0
299264224525d80a585e695a7bfaaa22e32ef8dc;Sun Feb 08 15:49:35 EST 2009;Committer;akr;2;2;2;4;0
d0454a211e1bb2803ca424af79eda3676b7a48c7;Sun Feb 08 15:45:15 EST 2009;Committer;akr;2;7;0;7;0
f11d2b55f745810c6e1de8c0474001bdf8310efe;Sun Feb 08 15:42:17 EST 2009;Committer;akr;3;7;2;9;0
9e457481438cf8b4dbe033b6fbd5ea612c4529c1;Sun Feb 08 15:37:55 EST 2009;Committer;akr;6;93;12;105;0
ce6e0937346c4ecf93d7e4eff7b832c5e60edd12;Sun Feb 08 15:12:32 EST 2009;Committer;svn;1;2;2;4;0
c02ce88762eeda44002b82f4176e9fdbc0dd7e3c;Sun Feb 08 15:12:27 EST 2009;Committer;akr;4;63;16;79;0
3e11901f1c03f7d3a88349644223f6c920f5f9e2;Sun Feb 08 14:42:01 EST 2009;Committer;mame;3;34;9;43;0
e5f588c83d7ed0ecdbbafe12aa2920c3b5227c3e;Sun Feb 08 14:39:59 EST 2009;Committer;akr;1;0;2;2;0
f64018b111a371d6ece84d509535b760d072053f;Sun Feb 08 14:34:13 EST 2009;Committer;mame;3;28;21;49;0
8f9d6d1863e3b00ed44ac693e9659b860cf1e507;Sun Feb 08 14:23:16 EST 2009;Committer;akr;3;45;4;49;0
5baafac0b73f8e242e93926bc02754fd821ba00d;Sun Feb 08 13:44:21 EST 2009;Committer;nobu;2;11;3;14;0
411e9997d2062d7d871f8a4ffe810c8261be4b36;Sun Feb 08 12:53:55 EST 2009;Committer;akr;4;97;29;126;0
c79dac1c3ec4477af4e8a115942c80cfc414f648;Sun Feb 08 12:06:42 EST 2009;Committer;akr;2;6;1;7;0
eb636217f619875b7d66a29caa44daddc4d3d0d5;Sun Feb 08 11:37:39 EST 2009;Committer;akr;1;2;2;4;0
e960cf417abc5b3c2fef8271412fcfc9c2c32607;Sun Feb 08 11:36:18 EST 2009;Committer;akr;4;68;4;72;0
732b695163362f2ef865a077a22c2bf5187cd4d4;Sun Feb 08 11:30:26 EST 2009;Committer;akr;1;18;0;18;0
aa28707309ebec740094065bded6f108ef4481f1;Sun Feb 08 10:24:51 EST 2009;Committer;akr;1;6;0;6;0
e1fc88726e4062f1e1f2e50c99fc6d3fc4e9226c;Sun Feb 08 10:05:26 EST 2009;Committer;nobu;2;20;0;20;0
a23547cafadf44f9d3812de6baea01c5c6011581;Sun Feb 08 09:47:00 EST 2009;Committer;akr;2;25;0;25;0
25d14edf294cd0e79dfb89217025396edf3e1245;Sun Feb 08 09:34:46 EST 2009;Committer;nobu;2;5;0;5;0
03149710e8fe06daef196b1ea890608ca40eb02c;Sun Feb 08 04:53:17 EST 2009;Committer;akr;3;36;9;45;0
6dd9865ff2172986a52a700ccaea11a8884f5b9d;Sun Feb 08 04:09:34 EST 2009;Committer;nobu;2;121;40;161;0
e3cc17a3ac5cd2a5e48b841f70a98a81620155f3;Sun Feb 08 02:10:57 EST 2009;Committer;akr;1;1;1;2;0
6294d065bba7d59a9fb7b50483a9f91f4e6405fd;Sun Feb 08 02:01:22 EST 2009;Committer;akr;1;1;0;1;0
048acb66383cae6926c0d4a661f1b87bb62d716f;Sun Feb 08 00:41:49 EST 2009;Committer;nobu;2;6;1;7;0
a61cd5ed3984dedc92c0eea6f35c179b305d0afe;Sun Feb 08 00:10:17 EST 2009;Committer;svn;1;2;2;4;0
ad235344c4e7371a58138565d0c126f136125b8a;Sun Feb 08 00:10:13 EST 2009;Committer;akr;1;10;2;12;0
b83188dc1efb5d9ce1b25333965d6a35309579f7;Sat Feb 07 12:33:25 EST 2009;Committer;akr;1;1;0;1;0
2b8ab6c54febcf6aa8f28f1fc9c7910755a04462;Sat Feb 07 12:28:15 EST 2009;Committer;akr;2;8;2;10;0
af14ba145e5b74e72f508be35cbfab4677659825;Sat Feb 07 10:22:20 EST 2009;Committer;akr;1;14;2;16;0
5610e5dc70196d9dc6c884c4f977572b05db67e3;Sat Feb 07 09:02:50 EST 2009;Committer;nobu;5;145;85;230;0
3c164fd92eb42acd915bdf702c73dc1be5a77d5f;Sat Feb 07 03:31:04 EST 2009;Committer;nobu;2;10;3;13;0
7f0a43c1e13bb0dbfb79aebd6b7b1f5f79d615ed;Sat Feb 07 02:57:15 EST 2009;Committer;nobu;2;19;3;22;0
7c93e565600f3645659e603161c9ac992184c7d0;Sat Feb 07 02:44:07 EST 2009;Committer;nobu;3;10;3;13;0
0c0f9873760236083a003a70b668fb1ea3473bfa;Fri Feb 06 19:04:44 EST 2009;Committer;akr;2;8;3;11;0
641bdd84ef675cfb9a472a1969052afd9f7fbd46;Fri Feb 06 15:29:39 EST 2009;Committer;nobu;1;2;0;2;0
d89dbc4d3b0145e64d726cce21c9f4f7aed3bc5c;Fri Feb 06 15:26:36 EST 2009;Committer;nobu;2;10;14;24;0
a0b54e6cbdb08fb0a0644e3c3b9f1a870a10f7c1;Fri Feb 06 14:46:21 EST 2009;Committer;akr;2;8;0;8;0
7f38c3b1a7ac88f460ab9fb29e1483622440e480;Fri Feb 06 13:45:05 EST 2009;Committer;azav;1;8;0;8;0
07a250652705681a804ffb2704753d636e1d60eb;Fri Feb 06 13:35:15 EST 2009;Committer;azav;1;6;2;8;0
71dd79212880ddf4f99451befde26737f0cefa2c;Fri Feb 06 13:31:20 EST 2009;Committer;azav;1;2;0;2;0
cbee174e29d0f1c0be1bc48a79b571a8bac90312;Fri Feb 06 13:13:58 EST 2009;Committer;azav;1;4;0;4;0
c4fe2b2840ab84692cc6e0c889c5aa9040ccf2fe;Fri Feb 06 13:09:44 EST 2009;Committer;azav;1;2;0;2;0
3539c932155869af4da5752ed13d5fad75796ede;Fri Feb 06 13:04:08 EST 2009;Committer;azav;1;6;0;6;0
7ecbd56af4366cbe6a1d4cecf82778f94697894a;Fri Feb 06 12:54:52 EST 2009;Committer;azav;2;20;17;37;0
4e2141622f17113d10eb79326244369054b2330d;Fri Feb 06 11:40:33 EST 2009;Committer;akr;2;6;2;8;0
fb128ef26f66f48612c962a853b1fa211ccf8bc6;Fri Feb 06 11:36:23 EST 2009;Committer;akr;1;1;3;4;0
48823bbd0190be3f3e5df66bfb17e4c80320e8ae;Fri Feb 06 09:19:43 EST 2009;Committer;usa;1;1;1;2;0
7e1050e604157245694d00f344afad286ec46347;Fri Feb 06 09:18:46 EST 2009;Committer;usa;2;9;1;10;0
6343c99a2e43a60ffde0f445c2656f5cef24db0e;Fri Feb 06 08:23:00 EST 2009;Committer;usa;4;115;37;152;0
03c7332241e8f85b2a1d87dd88ed2946c9d32060;Fri Feb 06 03:12:09 EST 2009;Committer;usa;2;11;0;11;0
5067bfe36ee11c7cf601df7e2bab3ed5f3b01e4e;Fri Feb 06 03:05:27 EST 2009;Committer;usa;2;12;7;19;0
1bd6111488e56948a221e9f8c81f7ad286ccbff1;Thu Feb 05 22:53:44 EST 2009;Committer;akr;2;5;1;6;0
68ac487d194a225caee05bf48daeb2ccb4163e1e;Thu Feb 05 17:53:26 EST 2009;Committer;matz;2;7;1;8;0
bbb86032863d4d4b501d7018693f76ff1fa2b667;Thu Feb 05 16:13:58 EST 2009;Committer;svn;1;2;2;4;0
495293a136b3eed09920b3a199185b1d9f7b49e6;Thu Feb 05 16:13:54 EST 2009;Committer;mame;2;9;3;12;0
74063bf4d325a05d19e73f2b78bbd2dc945ee215;Thu Feb 05 11:33:19 EST 2009;Committer;akr;5;102;26;128;0
88f04bdd32fcbb2333f6b034e98f7f398e97604c;Thu Feb 05 11:01:43 EST 2009;Committer;akr;13;230;226;456;0
b3e665760e06b90102a8a9594bfbdbe73234f213;Thu Feb 05 07:18:15 EST 2009;Committer;nobu;2;9;2;11;0
1754ec8a59ce1350b2c0c0d927d752a59e915ae7;Thu Feb 05 07:05:05 EST 2009;Committer;usa;2;11;5;16;0
1fbd605da88c62a3a4d31ea3baf687ba9128e722;Thu Feb 05 05:26:22 EST 2009;Committer;nobu;3;16;16;32;0
a2c7fdc70939e9c8a57a560aec786f3a7303f378;Thu Feb 05 03:24:20 EST 2009;Committer;nobu;2;20;6;26;0
e3c8cdca4413219dccc57eec6d898cac6851a5db;Thu Feb 05 03:01:55 EST 2009;Committer;nobu;2;39;15;54;0
8b093ebc3c091edf3bf15ae7061ea3bba753f2fc;Thu Feb 05 02:37:49 EST 2009;Committer;nobu;2;5;0;5;0
38a6dfcbbb9edaf6c770955ccd11de88916833b0;Thu Feb 05 02:24:49 EST 2009;Committer;nobu;1;11;11;22;0
f4e9d9a2c5c87314d5a7141e5ddbab6d3baa10d2;Thu Feb 05 02:21:37 EST 2009;Committer;nobu;5;108;48;156;0
0d0fe1a5adbda4b9157118b8dbf64f28185f7b1e;Thu Feb 05 00:09:39 EST 2009;Committer;akr;1;20;1;21;0
4a7a6794c177168611316e2119c08b91545d9d55;Wed Feb 04 22:46:58 EST 2009;Committer;kazu;1;2;2;4;0
37131afdd31b8c3d272dff74de3b76873791991e;Wed Feb 04 22:42:06 EST 2009;Committer;kazu;2;9;2;11;0
b5ae8db530b3f091f5803bc0db3e8b5cbe237d2d;Wed Feb 04 19:09:58 EST 2009;Committer;matz;2;6;1;7;0
efdc317e5967dbba486dbe36f7e9f84f5fdb525a;Wed Feb 04 17:42:03 EST 2009;Committer;azav;1;11;0;11;0
dfbe79f239e2d52a3da3857c6d251f1a701c96d5;Wed Feb 04 17:31:44 EST 2009;Committer;azav;3;86;91;177;0
c501546edd46c67f944d30742ee843ed5456bbd1;Wed Feb 04 17:31:01 EST 2009;Committer;azav;1;20;13;33;0
b916afddc967829b473573cf604295b97a836660;Wed Feb 04 16:45:31 EST 2009;Committer;akr;2;24;9;33;0
5127799e65f46451fa5011049b37576e9e595e1c;Wed Feb 04 16:21:15 EST 2009;Committer;akr;1;1;0;1;0
5ce10c1359be7f7278491a736be95ce4b50116ae;Wed Feb 04 16:20:05 EST 2009;Committer;akr;4;24;5;29;0
1934c7a80b21c281552011801029c871f5b04120;Wed Feb 04 15:42:13 EST 2009;Committer;akr;1;6;2;8;0
3eab19122b1647f8f0c14786c71fdeda8e978039;Wed Feb 04 15:34:32 EST 2009;Committer;akr;1;16;2;18;0
e2f0aeb4973c81a54d38295bafc9d5b48cb0b3ef;Wed Feb 04 15:12:53 EST 2009;Committer;akr;1;9;2;11;0
1d46aa9fc1c78d235ca8a001505530bb60500663;Wed Feb 04 15:10:07 EST 2009;Committer;svn;1;2;2;4;0
9dfc90dc70faf1a9be1f3051a7ac831b0cf2ba51;Wed Feb 04 15:10:03 EST 2009;Committer;akr;2;39;0;39;0
ac5b6813341f00b69b4ff286f94dbde91e8c0d59;Wed Feb 04 14:51:08 EST 2009;Committer;azav;1;0;1407;1407;0
9845b50c1103a6ce3fdd535ad523df1400ff8da4;Wed Feb 04 13:38:24 EST 2009;Committer;akr;1;9;1;10;0
e193fa79d6a34e8afc74ce8be256d7dea743c0aa;Wed Feb 04 13:01:12 EST 2009;Committer;akr;2;21;2;23;0
54936663303d578c49fa2b5e4504800db7cce4ef;Wed Feb 04 12:59:09 EST 2009;Committer;akr;1;12;7;19;0
28e33ad61e9e38661f70ee580b97317463772a87;Wed Feb 04 12:58:55 EST 2009;Committer;akr;1;0;2;2;0
6ae8b15d939e12c25740864c119aff1886d5c350;Wed Feb 04 12:58:30 EST 2009;Committer;akr;2;6;2;8;0
c77f323088fe118191dc0ea62e283114a6b00589;Wed Feb 04 12:57:17 EST 2009;Committer;akr;2;9;1;10;0
9a7834730d4590b99cb0e044c06cd959ab53993d;Wed Feb 04 10:47:25 EST 2009;Committer;kazu;1;10;5;15;0
c5229b7d8465d8eb41c6e63774910921d197c4a9;Wed Feb 04 10:45:10 EST 2009;Committer;kazu;1;6;6;12;0
136f31b09811c392cc0401c2639c6f8cf123f3ab;Wed Feb 04 10:10:44 EST 2009;Committer;nobu;3;9;4;13;0
fbea35aa4742671c9e1975cfb163103eec46ecff;Wed Feb 04 02:50:04 EST 2009;Committer;usa;2;8;2;10;0
049d98c6ffae93db44e83a6f8a88cb66cba735a1;Wed Feb 04 01:16:14 EST 2009;Committer;matz;2;7;0;7;0
12a5cf8287f1d2e33f94385ca8a227d9b1cea689;Tue Feb 03 16:40:42 EST 2009;Committer;akr;1;2;2;4;0
20ac101daea286f23801789d40635722cc68cfde;Tue Feb 03 16:29:23 EST 2009;Committer;akr;2;9;4;13;0
c07b4ef145993f89d4a9baf36781fcb08112a3ac;Tue Feb 03 15:39:44 EST 2009;Committer;mame;2;20;9;29;0
ee3c53a7a9bf1d9d58c4c3054cee604459324d17;Tue Feb 03 15:21:46 EST 2009;Committer;svn;1;2;2;4;0
9274fbfae9f9430adb1bce7bdc02e5932448bf20;Tue Feb 03 15:21:42 EST 2009;Committer;akr;2;10;1;11;0
5a56fc35ec46acc57300a7c2212d115fe695b4e1;Tue Feb 03 14:50:50 EST 2009;Committer;akr;1;14;3;17;0
813dad7afd646e675d191fe6eac8e7a70e37aefe;Tue Feb 03 14:37:09 EST 2009;Committer;nobu;2;7;1;8;0
bca5029d8b4e27a8bfb9fa9c42617adeaa23b7d7;Tue Feb 03 14:13:36 EST 2009;Committer;nobu;2;8;0;8;0
e2fc3f38afe79b32c698d7fb05a2fed26af81c4d;Tue Feb 03 12:28:07 EST 2009;Committer;kouji;1;9;0;9;0
d60cd5b3793bb362c09391623e365f405b750ec8;Tue Feb 03 12:21:08 EST 2009;Committer;kouji;4;90;0;90;0
4a2b6b2067e74a5226e9f68e4aef566d48fdbcad;Tue Feb 03 12:17:26 EST 2009;Committer;kouji;1;1;1;2;0
dbf657caade698b057f0165aafc12963c1bd22f2;Tue Feb 03 12:15:20 EST 2009;Committer;kouji;2;8;1;9;0
8b729eed969b6c7f0229b9182344360e61774c46;Tue Feb 03 07:55:03 EST 2009;Committer;akr;1;57;27;84;0
2b692644d9969438d47423c77f7fceb46ef5a32b;Tue Feb 03 07:36:55 EST 2009;Committer;kazu;3;11;2;13;0
22f6e2e771ef689f5408b094dff38be78ab9ba7f;Tue Feb 03 07:30:52 EST 2009;Committer;kazu;1;1;1;2;0
24eafe83763c2c71efdd9b8198d45c0cb1af4b7c;Tue Feb 03 07:25:57 EST 2009;Committer;akr;3;110;20;130;0
260d0d0399f902e9c079b3447d67957678c461c5;Tue Feb 03 06:37:06 EST 2009;Committer;akr;1;26;0;26;0
4aec56ba712d8f91e7c8a14071267b635d534826;Tue Feb 03 06:27:07 EST 2009;Committer;akr;1;74;0;74;0
1643d1c28a58ba726d96842826ed9a476b2173fe;Tue Feb 03 06:12:23 EST 2009;Committer;akr;1;102;0;102;0
1c400db1d57fecda49f1e32bd0a4711973d44a23;Tue Feb 03 05:20:27 EST 2009;Committer;matz;2;16;4;20;0
3f59f0e06c4755babf5b667d13779951280d92f2;Tue Feb 03 05:14:26 EST 2009;Committer;shugo;2;60;4;64;0
bb9435a75ca13504304ef000a1469b096fdce4c2;Tue Feb 03 03:12:30 EST 2009;Committer;shugo;2;7;2;9;0
0f9422ef230c0f7d873563e5ab29230ad54c6d41;Tue Feb 03 02:25:42 EST 2009;Committer;nobu;2;6;0;6;0
13a468db1710405ccdff3358abf7d2aea396d9b5;Mon Feb 02 23:36:43 EST 2009;Committer;akr;2;104;43;147;0
2df1053c1db22aa5693d4982814e79fcb040c5ab;Mon Feb 02 23:30:46 EST 2009;Committer;akr;1;9;0;9;0
fe39ce87dda92a3c9a76a70d8465da4b4e172567;Mon Feb 02 23:21:10 EST 2009;Committer;nobu;2;7;0;7;0
5ac71d9f9e4b413702e53b3c6464c1e249e298be;Mon Feb 02 23:18:30 EST 2009;Committer;nobu;3;17;11;28;0
dc960b8729c195dab6e382d762c88cf904e8e0a2;Mon Feb 02 23:15:59 EST 2009;Committer;nobu;1;2;2;4;0
42e0d76c25a8a3875d194579bf2a795cbac2772d;Mon Feb 02 23:10:28 EST 2009;Committer;nobu;6;34;10;44;0
209cfdcfb58c5c1a56792edc03388796d506a679;Mon Feb 02 23:01:43 EST 2009;Committer;nobu;2;6;1;7;0
b256c5fb8f58f85b40659b046bdef1549dc7b361;Mon Feb 02 22:58:03 EST 2009;Committer;nobu;3;19;5;24;0
e53c88a44f691176941b528e389db01c6884930d;Mon Feb 02 22:31:50 EST 2009;Committer;akr;1;2;2;4;0
a1dd4a613a521dd4250c26b1aab7e40f49b0d4e9;Mon Feb 02 22:02:16 EST 2009;Committer;nobu;2;9;3;12;0
28155915a5ad8fecae349894a3445b0fdc876d58;Mon Feb 02 22:01:26 EST 2009;Committer;nobu;2;14;1;15;0
04ae31eb2412b79aba3d1cda13f4927e45700534;Mon Feb 02 15:02:48 EST 2009;Committer;svn;1;2;2;4;0
2b241a3395fef16df5fb46563b8306f0bda42355;Mon Feb 02 15:02:44 EST 2009;Committer;akr;1;2;0;2;0
9946e700c15a962ecae845ad637879aa308f8fa5;Mon Feb 02 14:44:28 EST 2009;Committer;akr;3;11;0;11;0
092861f37d0fb0da71dd6c24cde1b1da24ce6ecb;Mon Feb 02 12:05:06 EST 2009;Committer;matz;2;5;1;6;0
2654904a1a1e36e1b4792cf1376f47ed5d9d7986;Mon Feb 02 11:50:49 EST 2009;Committer;knu;2;12;6;18;0
1d551324bb3e2081c6cb9a4ddbe95a64c774101f;Mon Feb 02 11:33:08 EST 2009;Committer;yugui;1;46;0;46;0
416ab0f7bebbcd7ebb77457ed11d215acadc71bb;Mon Feb 02 11:09:19 EST 2009;Committer;akr;1;9;9;18;0
352dcd9ee75818eaefbb3fce2df822b840bf24bc;Mon Feb 02 10:59:17 EST 2009;Committer;akr;2;19;6;25;0
765a6be7008d0eba3f374d9e9875aa9e65ea4112;Mon Feb 02 10:43:27 EST 2009;Committer;matz;2;33;0;33;0
1d07fd73d84e6e926b437aec9d7f7032c8af7780;Mon Feb 02 10:19:26 EST 2009;Committer;matz;2;6;1;7;0
678b9240ca617f5db4d31316344a943bc797bcc8;Mon Feb 02 09:34:36 EST 2009;Committer;akr;1;5;5;10;0
083e01b006bd9435978a93d371b941edeb1d71f4;Mon Feb 02 08:23:15 EST 2009;Committer;nobu;2;6;0;6;0
b204d48f76b92d62c3940cfc17bdb68156e5f5f2;Mon Feb 02 08:14:06 EST 2009;Committer;usa;3;11;4;15;0
29bd89281b296a1f72ed50936028ce88a8e3a736;Mon Feb 02 08:12:10 EST 2009;Committer;akr;2;7;0;7;0
21675bb6a70e927e54f6adb92e105773d08459e7;Mon Feb 02 08:08:52 EST 2009;Committer;akr;1;2;1;3;0
ce44723cf8a97c03895d75cf906e404c5dde6aae;Mon Feb 02 08:05:59 EST 2009;Committer;nobu;2;6;0;6;0
aac16ed13ebdf9c9e4bd75c58e7779b4475e6dd8;Mon Feb 02 07:59:35 EST 2009;Committer;nobu;1;3;0;3;0
043f665274006e4f040e681e0a1aee4975cf30b5;Mon Feb 02 07:33:08 EST 2009;Committer;nobu;3;78;37;115;0
41eb896e09fc2f9a1fa31ca26388b433e74875b5;Mon Feb 02 07:07:59 EST 2009;Committer;akr;4;17;6;23;0
5ad05f37a5823530648f2bd42b4ec510a6e9046b;Mon Feb 02 05:55:56 EST 2009;Committer;akr;3;24;8;32;0
57d85f32f53b122012a63e1a2b93fdcdd7737cdc;Mon Feb 02 05:23:23 EST 2009;Committer;usa;2;6;0;6;0
197747f7d6642276d2f8e344f3de24079a7b7717;Mon Feb 02 05:19:51 EST 2009;Committer;usa;2;5;4;9;0
b41a9abb6a5a2bc9cd8327209467b3ccf968cf4c;Mon Feb 02 05:18:55 EST 2009;Committer;akr;2;5;1;6;0
bf23d53b9423f6d75c045b2eb522f49009a57bb0;Mon Feb 02 03:48:31 EST 2009;Committer;usa;3;9;2;11;0
a98cbcbf0b74112ff93d9b3c25b8abebba1a91b5;Mon Feb 02 03:45:28 EST 2009;Committer;shugo;2;8;1;9;0
ce720ca0dc2b66d50eabdbc335d5369366b6bd61;Mon Feb 02 03:39:01 EST 2009;Committer;nobu;3;10;4;14;0
61fc0c6cf4de377a14a0ec0d64aea067e72fa755;Mon Feb 02 02:51:02 EST 2009;Committer;akr;10;1259;0;1259;0
41e770944ee9ee3be4eaad1ec282cd6b88b5933f;Mon Feb 02 01:59:05 EST 2009;Committer;usa;2;42;27;69;0
ef9206bbea3b8cb1af66966e74fe8527edab2418;Mon Feb 02 01:53:02 EST 2009;Committer;akr;10;428;8;436;0
a2d8643e9313590e339933d296ff13d8d85f6b45;Mon Feb 02 00:49:40 EST 2009;Committer;nobu;2;7;2;9;0
7b5c9eb0419c2336b353b3532fc4555375b02920;Sun Feb 01 23:52:39 EST 2009;Committer;nobu;1;1;1;2;0
2478f1caaf72fa07201c3f461ade8d2bd13f21ca;Sun Feb 01 23:12:52 EST 2009;Committer;nobu;8;30;16;46;0
a7b5c603b4747704d8ed7ce22c342649e88f6993;Sun Feb 01 22:36:15 EST 2009;Committer;nobu;6;76;57;133;0
1c4e92c1851d1027f22b64cdd6e4d40d212609b6;Sun Feb 01 21:53:19 EST 2009;Committer;svn;1;2;2;4;0
9bd77cfd7734955a4e85479fb1482085f49aaba5;Sun Feb 01 21:53:14 EST 2009;Committer;usa;2;7;1;8;0
845103b751fe79f22e2d31b08e3ed21de1987535;Sun Feb 01 12:51:44 EST 2009;Committer;nobu;7;13;13;26;0
f1137963e30affd655319c6baab0245492c4f404;Sun Feb 01 12:28:50 EST 2009;Committer;akr;3;84;1;85;0
d99eeabea61dbe0bdf132afb6d02312332f281ea;Sun Feb 01 07:10:08 EST 2009;Committer;nobu;2;13;1;14;0
132d0624ec5b59d2d55fc0ccf01b53c10010d787;Sat Jan 31 20:19:44 EST 2009;Committer;nobu;5;22;3;25;0
cd350b676813f8313e9bc3c3289f1209b04e4299;Sat Jan 31 14:48:48 EST 2009;Committer;akr;1;2;2;4;0
a0b15459ef32d644a33565aed8bea06c19c4f0e9;Sat Jan 31 13:51:46 EST 2009;Committer;akr;2;9;0;9;0
14605ab0ade61e64144645d53c536c56d4bf25fe;Sat Jan 31 13:42:18 EST 2009;Committer;akr;1;2;2;4;0
c109d8ab9f126faca71b4ffee10d2ecdc45235a3;Sat Jan 31 13:40:05 EST 2009;Committer;akr;2;18;1;19;0
074a374c86dbef53f29e3edd830bdba7696d3210;Sat Jan 31 13:30:17 EST 2009;Committer;akr;5;11;26;37;0
849e730f1573812b1bd64ac7f6512fa55bd91686;Sat Jan 31 11:09:51 EST 2009;Committer;akr;3;234;3;237;0
b9faa6b74ca443157ed93172bd3cd7bb44141ba5;Sat Jan 31 10:15:30 EST 2009;Committer;akr;1;11;0;11;0
fa4f685ef7094810c2b3b71dbb8f4de42fbfc5ea;Sat Jan 31 10:07:49 EST 2009;Committer;nobu;2;10;1;11;0
62e7e47bdb6d5b4f13138bd3290ca3c40d3ddbab;Sat Jan 31 09:09:01 EST 2009;Committer;nobu;2;6;1;7;0
de398e8f6145da7b761a95339fec30273b7df24a;Sat Jan 31 09:03:43 EST 2009;Committer;nobu;2;9;4;13;0
fc77d9d1cbfb857a4429627bd58d6c015c6fe133;Sat Jan 31 05:18:25 EST 2009;Committer;akr;1;24;24;48;0
8cc36df9c325327d5984b4139d97cce043b0898f;Sat Jan 31 05:13:49 EST 2009;Committer;akr;3;37;1;38;0
4a3e62b3836a239089f87e0aed7058856026b793;Sat Jan 31 05:12:23 EST 2009;Committer;akr;1;11;0;11;0
d5a47333d9a540957d82ccf8c181f05d62db13d4;Fri Jan 30 15:09:22 EST 2009;Committer;svn;1;2;2;4;0
966675c860b505968972be02a6aaf99f4d620e4c;Fri Jan 30 15:09:17 EST 2009;Committer;akr;2;7;1;8;0
e265c074711ad491a91866c9976abf773c8d6e6c;Fri Jan 30 13:01:04 EST 2009;Committer;akr;1;2;1;3;0
e94e674d0e8a8ab7641717c2d2ba4b5aac5c7295;Fri Jan 30 12:50:55 EST 2009;Committer;akr;4;89;21;110;0
7a4a31064a59eba104d7204a320220a6cdbddf60;Fri Jan 30 09:08:19 EST 2009;Committer;usa;2;23;3;26;0
374e2f34b12737fd2b8639b1633790be3b4ea568;Fri Jan 30 07:12:45 EST 2009;Committer;kouji;2;8;2;10;0
2f7f34f10702c8afded1846415fb3e6ee6fc0848;Fri Jan 30 05:32:43 EST 2009;Committer;usa;2;6;9;15;0
39bc33d9a7dcc987994a075f3770a8e3cfcef8bf;Fri Jan 30 05:13:22 EST 2009;Committer;usa;2;8;11;19;0
210651a8e00e484b4eaeaee4ea22c7854b1cd5b4;Fri Jan 30 03:59:51 EST 2009;Committer;nobu;2;4;2;6;0
77285faf19d84f8a9563ba05b6143eb12ecaaa7f;Fri Jan 30 03:57:31 EST 2009;Committer;nobu;2;6;1;7;0
e501209104a6dbce00fbaec6206c7c6edf3c3e55;Fri Jan 30 02:03:32 EST 2009;Committer;nobu;2;10;0;10;0
e0469eea596b2454fb335520c3717a9e374d495d;Thu Jan 29 18:02:25 EST 2009;Committer;akr;1;45;1;46;0
07408d7d5b2c6676233c4aa4f2d04f424f611a78;Thu Jan 29 17:57:21 EST 2009;Committer;svn;1;2;2;4;0
07aeaa0686c162df9bb94e06eb0995e50e3469ad;Thu Jan 29 17:57:13 EST 2009;Committer;akr;2;6;1;7;0
1a89baadd3956e3ac185b95796c84c89d7da2519;Thu Jan 29 07:32:07 EST 2009;Committer;shugo;2;7;1;8;0
094a247a04cec7078a84a3b4259ead9a711da347;Thu Jan 29 05:12:17 EST 2009;Committer;nobu;2;4;2;6;0
958874ba0a54506e02bf2d86cac7e4d57b0d2db6;Thu Jan 29 05:09:01 EST 2009;Committer;nobu;2;9;0;9;0
f10e2af1e68392fff2e22e1f577ad2fb828f2d75;Thu Jan 29 04:16:17 EST 2009;Committer;nobu;2;8;5;13;0
f226c386308b749cd44dd02b1100a65ad588484b;Thu Jan 29 03:29:53 EST 2009;Committer;nobu;3;33;40;73;0
7dd1a098a6db52ff628cb504303726ccddf945df;Thu Jan 29 03:20:26 EST 2009;Committer;technorama;2;14;0;14;0
68db4a346417a4544399dbe1643a8e945c69755a;Thu Jan 29 02:25:39 EST 2009;Committer;usa;3;101;2;103;0
d899ed632189db0d07c7fa7729f2e3124900f84c;Wed Jan 28 15:26:08 EST 2009;Committer;svn;1;2;2;4;0
17bd806aea3502721f564f406311eec41f0dfc2b;Wed Jan 28 15:26:03 EST 2009;Committer;usa;2;9;1;10;0
f80356eb91da126f32d3691456186255bc1c659c;Wed Jan 28 13:55:13 EST 2009;Committer;usa;2;6;1;7;0
c4e79b640b7afd9b9e243b4faaa51b4ab22c474c;Wed Jan 28 06:42:09 EST 2009;Committer;takano32;2;6;0;6;0
186f7fe9cf63c0242aa0e37bfa7f724ee8f10c03;Tue Jan 27 22:22:34 EST 2009;Committer;nobu;0;0;0;0;0
aada62da2b020b15fd266425a92db0a413b171fb;Tue Jan 27 22:02:51 EST 2009;Committer;nobu;2;3;4;7;0
2d958b7fb03e44e3d65347147e5781e55a8e3b72;Tue Jan 27 11:07:41 EST 2009;Committer;akr;3;17;10;27;0
9c29032c7316c1e6f876c497f0eb80b62b32ba16;Tue Jan 27 05:41:38 EST 2009;Committer;nobu;3;9;2;11;0
7cefea6ff4471f6b8830b80e58506753e04b44cc;Tue Jan 27 04:02:53 EST 2009;Committer;naruse;2;7;1;8;0
6f39590affcc28f989834ea30f736ddb013a7f33;Tue Jan 27 03:24:17 EST 2009;Committer;naruse;2;5;1;6;0
d232a50435a683bef2703f5f8e040154344f322e;Tue Jan 27 02:09:47 EST 2009;Committer;nobu;3;18;3;21;0
c938de20cd80f18375d2cf198ce58033f2d32be7;Tue Jan 27 02:03:54 EST 2009;Committer;nobu;6;28;16;44;0
882cb2e37d2beb0b34e886754ab5d8ab842abc86;Tue Jan 27 01:15:37 EST 2009;Committer;nobu;2;6;2;8;0
7788bbfaf597b7075271f355eb11a8d99e8850cc;Tue Jan 27 01:10:18 EST 2009;Committer;nobu;2;7;2;9;0
0fff7aa624c8d0335e2c78fda1728715bf4c803e;Mon Jan 26 19:06:39 EST 2009;Committer;matz;2;6;1;7;0
85c2f0aa4af9c6497892eda310bac2c53811c9c8;Mon Jan 26 18:53:44 EST 2009;Committer;matz;1;1;1;2;0
ad049bc5df91104e0d59e014b2b244b47694d2ef;Mon Jan 26 18:48:47 EST 2009;Committer;matz;2;9;0;9;0
f327dd57bb9da29ed3ad74dbec2af3854d2906db;Mon Jan 26 18:28:19 EST 2009;Committer;svn;1;2;2;4;0
a0947ecd752ef6f47bc4aaa13ca5600f7df12ee9;Mon Jan 26 18:27:58 EST 2009;Committer;matz;2;6;1;7;0
62734f6db5867f0b41b6e99e69c4b990330e4da0;Mon Jan 26 07:32:53 EST 2009;Committer;nobu;1;0;1;1;0
c330fb421e6fb3cf293fe6e07ba9b9a6658c1104;Mon Jan 26 07:00:43 EST 2009;Committer;nobu;2;7;1;8;0
522599861208bb705ec6d06b8ab43d4790ffd4f1;Mon Jan 26 06:49:46 EST 2009;Committer;nobu;3;8;4;12;0
083bddec3e4efbf8e1993424661a33c8bf8995ce;Sun Jan 25 07:44:39 EST 2009;Committer;nobu;1;1;1;2;0
efdef4dbe2738ee0f77b3cc5d77132e8bd3cfb0c;Sun Jan 25 07:36:45 EST 2009;Committer;akr;3;11;6;17;0
45c4ae9b8b8cb2ac466f0156222c0134eff90f51;Sun Jan 25 03:33:54 EST 2009;Committer;nobu;1;1;1;2;0
050a8e912f7fb21a610aa72ead6e0fbfa1063f68;Sun Jan 25 03:17:28 EST 2009;Committer;nobu;2;5;1;6;0
0243b1d29c4992654b04926bb92eb0e72d6c0e31;Sun Jan 25 03:03:00 EST 2009;Committer;nobu;2;5;1;6;0
cdaadbd9032afa66f8a92cc9d8b5c029f5630815;Sun Jan 25 02:50:24 EST 2009;Committer;nobu;2;6;1;7;0
0834056aec212978049db29a78718c18e5550f30;Sun Jan 25 02:23:47 EST 2009;Committer;nobu;4;14;11;25;0
97de7d1081e69ad9d63c03b0f6a700954f8e4402;Sun Jan 25 02:06:29 EST 2009;Committer;nobu;11;189;40;229;0
0506348ef501d5f2e3dc64666b6bb6785870583c;Sun Jan 25 00:08:06 EST 2009;Committer;nobu;2;14;6;20;0
940e021edce66ff9760f57148a813f1dff357d9f;Sat Jan 24 21:45:48 EST 2009;Committer;svn;1;2;2;4;0
7361a2ecb3b86e1fea0cc1bb5a3c4351ab50068f;Sat Jan 24 21:45:42 EST 2009;Committer;technorama;4;151;6;157;0
b9170351da22956db16ae9ed06975d216d414809;Fri Jan 23 23:21:16 EST 2009;Committer;nobu;3;13;8;21;0
3e76849cc80ede856069beb0dc85b89ef892f05e;Fri Jan 23 08:26:10 EST 2009;Committer;eban;2;5;0;5;0
834e7488afd8023995ea8bd7ca67d002c4071a51;Fri Jan 23 06:11:39 EST 2009;Committer;nobu;2;3;3;6;0
389157d8cfab7b6e84cdcdb2863421bd2c93bd7f;Fri Jan 23 05:56:01 EST 2009;Committer;nobu;2;34;4;38;0
1c374fef37707468de12e95f51ce01334ae7832a;Fri Jan 23 05:34:49 EST 2009;Committer;nobu;2;7;6;13;0
0af33599a0d8d28e62dca5b2ed4f3cf916c590b5;Fri Jan 23 04:25:34 EST 2009;Committer;svn;1;2;2;4;0
9e22c8390c0ff2e925762c636969e5a584c0b8a7;Fri Jan 23 04:25:29 EST 2009;Committer;nobu;2;8;0;8;0
770d89c5fa39e6dff431c0fbc44e68db91440aae;Thu Jan 22 11:59:26 EST 2009;Committer;naruse;1;1;0;1;0
6708c103dcf8259744b842714f1690584e2c3b27;Thu Jan 22 09:12:49 EST 2009;Committer;nobu;2;13;6;19;0
9dce4d52ca0d9422a7fefabfc4afb1138dafddea;Thu Jan 22 08:25:44 EST 2009;Committer;xibbar;3;11;1;12;0
044965df97730730ff27918098dc70e546fc1461;Thu Jan 22 08:02:41 EST 2009;Committer;nobu;1;1;1;2;0
d597a390428272102ecde2f09b359cc88d574e06;Thu Jan 22 07:57:41 EST 2009;Committer;nobu;1;1;1;2;0
018e1e4f5ef9ce7242d971d42d923d8edb87225b;Thu Jan 22 07:28:35 EST 2009;Committer;nobu;6;44;12;56;0
9e83ce20b1121068d9a708b41c623f4493c2eb53;Thu Jan 22 07:13:40 EST 2009;Committer;usa;4;6;14;20;0
a3e8d63a758dd32c01159f2ca8a980223ada300e;Thu Jan 22 06:55:20 EST 2009;Committer;usa;4;21;2;23;0
7e4ca5266944acabab84283fab88f35cfcfeb56e;Thu Jan 22 06:27:44 EST 2009;Committer;usa;1;24;22;46;0
33f7e749989423a3cb53c1ec9a555f2fedb69c72;Thu Jan 22 05:52:14 EST 2009;Committer;nobu;2;6;1;7;0
55bde4fbbd5e3ce449a44c8d0154127438cddf4a;Thu Jan 22 03:18:16 EST 2009;Committer;nobu;2;16;2;18;0
3899c1bed7d5d4f519897b1d3b87292084fbcad6;Thu Jan 22 02:31:54 EST 2009;Committer;nobu;2;6;1;7;0
92ad9fb2d7345270bc7b485ea9dc75436aae1274;Wed Jan 21 15:27:39 EST 2009;Committer;svn;1;2;2;4;0
d47e8e81a0a481c01bb12ca825866c92ff3d1db5;Wed Jan 21 15:27:35 EST 2009;Committer;matz;2;30;13;43;0
938fcd6b701e0ac1bf985da4a9d6314d6a0f9f08;Wed Jan 21 12:42:39 EST 2009;Committer;nobu;3;11;2;13;0
f0cc645afadfef5488583091dc0f9902c41cb637;Wed Jan 21 08:41:47 EST 2009;Committer;naruse;1;12;0;12;0
237c54075a575ab683584e451423098c039e5dba;Wed Jan 21 06:31:03 EST 2009;Committer;nobu;2;8;1;9;0
c5dea4c69d0cd357f277a9607319802ef34fec8a;Wed Jan 21 06:26:51 EST 2009;Committer;nobu;1;2;0;2;0
6ff613fc091549f3bcd3e49ee9f6dc8222f62147;Wed Jan 21 05:43:04 EST 2009;Committer;usa;4;15;4;19;0
3b817f834a7a5e7d49642ab1b7576174b104dd50;Wed Jan 21 05:32:08 EST 2009;Committer;nobu;2;8;2;10;0
1a0f593b3c679c769160c1bb75af09c3f9820468;Wed Jan 21 04:59:20 EST 2009;Committer;nobu;1;10;10;20;0
767a9a5ecd8e1f98daae65ce6b871cc7b9db9508;Wed Jan 21 04:57:06 EST 2009;Committer;nobu;1;11;8;19;0
877dca1e272e5582bd739fb4fed90ef8209e5095;Wed Jan 21 04:56:06 EST 2009;Committer;nobu;3;25;3;28;0
8029f3d2996de5500fa2d700b06d7160f7fff18e;Tue Jan 20 23:27:06 EST 2009;Committer;svn;1;2;2;4;0
7bcd50555b18117a84125bc6d8bd2d098651ca9d;Tue Jan 20 23:26:55 EST 2009;Committer;ryan;3;21;0;21;0
bd3cdcf3940d1647bf86a3cce1e770a8be31e091;Tue Jan 20 11:19:09 EST 2009;Committer;akr;6;281;1;282;0
9ffca4659b0cb91c6253eeb1e0c12978e9567d1a;Tue Jan 20 11:06:22 EST 2009;Committer;akr;3;22;4;26;0
3c13fd9be0386f19e74621e2ab9d07287846dba4;Tue Jan 20 08:59:06 EST 2009;Committer;naruse;2;26;20;46;0
11c00acf8e52db4b58b373fc4a4e140960aa584b;Tue Jan 20 07:17:28 EST 2009;Committer;nobu;4;16;9;25;0
2d03f7274f84ab5abf8825c8e0c339caa659c27a;Tue Jan 20 06:32:36 EST 2009;Committer;nobu;5;31;18;49;0
e77a0b7b246b4f0fcb751d6897b7c9ba0c277d55;Tue Jan 20 04:02:42 EST 2009;Committer;nobu;2;15;4;19;0
2ad3120ea66689a67222d119a46e677d7cd80b4e;Tue Jan 20 00:27:17 EST 2009;Committer;usa;2;9;1;10;0
cab67c31977e8c5b466f38dcb8800cbe6b32b60e;Mon Jan 19 21:47:48 EST 2009;Committer;nobu;5;24;3;27;0
13313688b243882aff7815598ddd9fcbae69bc17;Mon Jan 19 18:52:42 EST 2009;Committer;naruse;2;334;264;598;0
d66c0cf36843b44461faef59d554c15e740e88ac;Mon Jan 19 18:42:46 EST 2009;Committer;nobu;2;5;1;6;0
108377fc6bf8c7279b969cca973e07a8d6bda62e;Mon Jan 19 16:16:09 EST 2009;Committer;svn;1;2;2;4;0
6d39bc3189cd62ebf9a01ff1a09e34ad099bc3c6;Mon Jan 19 16:16:05 EST 2009;Committer;akr;2;6;0;6;0
b1956f058f0192edb0242aab3c501d6b24581a1c;Mon Jan 19 13:32:31 EST 2009;Committer;akr;2;14;7;21;0
42d9223a2db7da93cf2f937b75b9ae287f6c7a0d;Mon Jan 19 08:32:41 EST 2009;Committer;nobu;2;6;2;8;0
4e6ad7d910a27b9bddc9e3616464885184875ab4;Mon Jan 19 08:28:28 EST 2009;Committer;nobu;3;7;7;14;0
49e685a0af54f3916542b4720da9b7e3f92e347d;Mon Jan 19 08:24:10 EST 2009;Committer;nobu;3;23;8;31;0
c872df9e285eeb6aa3a57ce3b91f70df1c2e34da;Mon Jan 19 08:22:58 EST 2009;Committer;nobu;1;2;1;3;0
768988f918e23403ce80f2bbec63eddcf587604e;Mon Jan 19 07:32:42 EST 2009;Committer;nobu;2;97;54;151;0
4c4aef3bbe4db3e1d7fc2116bf2a868e44f52dee;Mon Jan 19 05:32:05 EST 2009;Committer;nobu;3;6;2;8;0
d31e1d4a52fc17c0cd8848eedd6e0934f5ea5291;Mon Jan 19 04:41:19 EST 2009;Committer;ko1;2;9;0;9;0
9b520ddcec94c4654ca36bbb404bf4e9569b70cc;Mon Jan 19 03:03:09 EST 2009;Committer;ko1;6;55;44;99;0
cf23d0f0f0b6f3c118a0c243e16cc9b66a81d541;Mon Jan 19 02:38:11 EST 2009;Committer;ko1;14;92;77;169;0
2aa6644acda2d59b5c2a77fa52404db80c8eb31b;Mon Jan 19 02:22:57 EST 2009;Committer;nobu;2;8;1;9;0
651f0e48bb148cfbeb190bd92fa2da736dac0d6c;Mon Jan 19 02:09:43 EST 2009;Committer;ko1;4;35;23;58;0
fb4bea8aaff84adedc4674758ac503d28d30ed0b;Mon Jan 19 02:00:52 EST 2009;Committer;nobu;2;15;2;17;0
7d431933b65252109bde705391398126fb5930b9;Mon Jan 19 01:44:39 EST 2009;Committer;ko1;2;5;1;6;0
f14e2a074a34d5bbc4ee6f5ca51562b112e095f1;Mon Jan 19 01:35:57 EST 2009;Committer;usa;2;8;2;10;0
c4c3f238d78f58242682b8c8428da63b3c018e54;Mon Jan 19 01:06:56 EST 2009;Committer;ko1;10;69;47;116;0
80980a98b10c0fae6b041e4b85fb888467b2dfaa;Mon Jan 19 00:23:48 EST 2009;Committer;usa;3;18;6;24;0
4316e4d99b856fcd16a2aa0f08cb6285dcab24af;Mon Jan 19 00:13:44 EST 2009;Committer;ko1;4;68;62;130;0
b96f428e4892e4eb568ae47478947b886ae2dc87;Sun Jan 18 19:05:15 EST 2009;Committer;nobu;4;9;4;13;0
69ee4246e59593b8bea71d4ad8a151d5a3d52ae9;Sun Jan 18 18:32:24 EST 2009;Committer;naruse;3;9;3;12;0
db881044bcaf3fce9fbce99f6af8d3cd353ef05e;Sun Jan 18 08:03:24 EST 2009;Committer;akr;3;67;16;83;0
d620500dda16cfc3777894541a417d6153d5a1fb;Sun Jan 18 07:47:35 EST 2009;Committer;akr;3;77;0;77;0
55bf8fa11c3cc2833f6848ee8a5a4b56a51bc3d9;Sun Jan 18 05:30:35 EST 2009;Committer;akr;2;4;4;8;0
464efd977f473eb3a898c718035503f48b2f24b5;Sat Jan 17 20:17:37 EST 2009;Committer;ryan;1;1;1;2;0
ec52a6379269ec75b535e6914529b46550f7c7f1;Sat Jan 17 18:35:15 EST 2009;Committer;akr;2;17;21;38;0
86aa5043d86a24ad9e1bbddecbf84ed21b87005a;Sat Jan 17 18:14:34 EST 2009;Committer;akr;6;253;10;263;0
75e0fde36b829fa558b87ac1a3edd6a8dbccf600;Sat Jan 17 16:46:37 EST 2009;Committer;akr;1;2;0;2;0
e2f88006670866382c47efb8a10318d7ca0bcb1a;Sat Jan 17 16:39:03 EST 2009;Committer;akr;5;23;1;24;0
858987b06bac789b9de8c1e99571ef1d2cd6845d;Sat Jan 17 15:43:07 EST 2009;Committer;akr;1;2;2;4;0
81732537b67f5d122870809cf9b82b707e817334;Sat Jan 17 15:40:33 EST 2009;Committer;svn;1;2;2;4;0
d4510f59738d28c60802e9145f0813c758fe143f;Sat Jan 17 15:40:30 EST 2009;Committer;akr;1;4;0;4;0
52152a63aa4afe2fd89d0267d89f7afba6f7eacc;Sat Jan 17 13:04:03 EST 2009;Committer;akr;4;379;0;379;0
fe011304e7cddc0080ca59cb0df0bbe21bf203bb;Sat Jan 17 10:40:51 EST 2009;Committer;yugui;4;13;5;18;0
67da4aebc56b1a1058ab17e256f7d64b6b8bbd90;Sat Jan 17 10:20:07 EST 2009;Committer;nobu;2;10;2;12;0
28028fc2b92dfe13b4e53cb0db5ece74064e76a6;Sat Jan 17 10:19:03 EST 2009;Committer;akr;5;74;28;102;0
29aff19f1ab92bd9a4fc891fcaed5b6b4bb18cb6;Sat Jan 17 09:39:14 EST 2009;Committer;akr;2;88;83;171;0
fa1bec3664c43fa58bb83a3711d61d88a2eb65ed;Sat Jan 17 08:59:54 EST 2009;Committer;yugui;2;17;0;17;0
9cd0874fc2d52bb0e42f5a1f363f854139d8fe64;Sat Jan 17 06:03:42 EST 2009;Committer;akr;2;34;5;39;0
32bbcc6d526aafb1d9a540ef6f6bc30af719c267;Sat Jan 17 05:53:05 EST 2009;Committer;akr;2;9;1;10;0
3f9d4f1fbd1cfd5d10f454d9036fa71f4577b819;Sat Jan 17 05:52:16 EST 2009;Committer;akr;1;3;1;4;0
97cbab78dcc43f696077d3bbce1ee35f9d947339;Sat Jan 17 04:11:27 EST 2009;Committer;akr;18;4579;4207;8786;0
8ae8afa649e7f59bfddf60dcb9fb844c02b3dc95;Sat Jan 17 02:11:38 EST 2009;Committer;nobu;2;17;4;21;0
f09bcbf96e19959a1a521f174a8b80a1482f02fb;Sat Jan 17 02:11:21 EST 2009;Committer;nobu;3;10;9;19;0
6184d1d52a68fe2f3ac5951245d951ad6a0cfd50;Fri Jan 16 13:31:49 EST 2009;Committer;akr;2;4062;4054;8116;0
75412a432214c87d92549a780507f9232994d4bb;Fri Jan 16 09:53:17 EST 2009;Committer;usa;2;6;1;7;0
afba32494c492a70132550278ffa495a10541c9a;Fri Jan 16 09:42:33 EST 2009;Committer;nobu;2;14;2;16;0
99e9aca09622bdfc67143205754744a877ff7c4d;Fri Jan 16 09:31:05 EST 2009;Committer;nobu;1;6;3;9;0
f53ead0d4e55bcbd03f448de102d601833b95a16;Fri Jan 16 09:25:49 EST 2009;Committer;nobu;1;5;2;7;0
cb57ec83025d1e1ae09a2ee489a52859565f1ec1;Fri Jan 16 09:18:41 EST 2009;Committer;nobu;1;2;1;3;0
72aa4a8c46bb99c3c44675408c7994a2317b871a;Fri Jan 16 08:33:02 EST 2009;Committer;nobu;5;40;6;46;0
0be9fb8caa6e511336dfb9f8348e55b20b1f75f3;Fri Jan 16 05:12:59 EST 2009;Committer;duerst;1;11;0;11;0
a04df27e72aa8e1f5940e80e8646d046977f5198;Fri Jan 16 03:42:50 EST 2009;Committer;ko1;2;6;1;7;0
c68fdad4736be4b1281dda9e8563bc9c4aacf344;Fri Jan 16 03:38:58 EST 2009;Committer;usa;2;20;26;46;0
f1e87dd9ac46c3d3f7c5101eeaee8a43b2ddaab6;Fri Jan 16 03:18:09 EST 2009;Committer;usa;3;13;1;14;0
0be716237d732469f0ff2f77518f9e4153827fd5;Fri Jan 16 02:51:22 EST 2009;Committer;nobu;3;120;117;237;0
8b392f4d4c0282e6477dc0cab8afa7db1c22d37f;Fri Jan 16 02:47:58 EST 2009;Committer;nobu;2;5;1;6;0
5b6a192755359617da7ba8ca286bd41d3a67ad32;Fri Jan 16 02:41:26 EST 2009;Committer;nobu;3;67;14;81;0
3e7c34140c4eb7dabd7a0c6176222df795029920;Thu Jan 15 17:27:31 EST 2009;Committer;mame;2;15;2;17;0
de0297f596159b379452b5dfade1f769347b6f21;Thu Jan 15 17:21:20 EST 2009;Committer;kazu;1;1;1;2;0
7e7504dde6422a88f1163f336e1939a8b50921f6;Thu Jan 15 17:10:01 EST 2009;Committer;kazu;1;9;9;18;0
aaddab6dea1381b5491121b6b36c21d65fadcf56;Thu Jan 15 17:06:37 EST 2009;Committer;akr;3;37;2;39;0
d9395fc46630c113204cece80781f31373b5a818;Thu Jan 15 16:45:41 EST 2009;Committer;ko1;2;10;2;12;0
e40928733d9849b63bfe665d8b1d0df7bc26df83;Thu Jan 15 16:14:43 EST 2009;Committer;ko1;4;21;3;24;0
e317b93409e04275605aa0082fb94340a784dc1c;Thu Jan 15 15:59:59 EST 2009;Committer;ko1;2;9;3;12;0
a3a45fafa3d7df3ea1a406847abef1b4aaa07bf1;Thu Jan 15 15:31:43 EST 2009;Committer;ko1;6;42;2;44;0
e39bd71126c6834637d115995a3602c56302b224;Thu Jan 15 15:27:06 EST 2009;Committer;ko1;2;5;1;6;0
a9cd6cc0a17a5974d0b15936b6e2789fcf403142;Thu Jan 15 15:23:59 EST 2009;Committer;usa;2;14;6;20;0
b5cd33a4adacf86dbf13889ec30c1701b0479c60;Thu Jan 15 15:21:43 EST 2009;Committer;ko1;3;7;3;10;0
81bdf8a1f2bb3bf46c72191523168ef7dd04983c;Thu Jan 15 13:47:47 EST 2009;Committer;naruse;1;5;1;6;0
c1575836273665b5fad8828c45238ce1bee157c7;Thu Jan 15 13:45:06 EST 2009;Committer;akr;1;13;10;23;0
1084032fb48e8efb101cdb8d72b513b14bc965b0;Thu Jan 15 11:45:01 EST 2009;Committer;akr;2;5;1;6;0
80088a55fc964c60fdbc18960775c209d11f1488;Thu Jan 15 06:57:55 EST 2009;Committer;matz;2;9;6;15;0
2a0b6280bb5c10bf69c699dbcc0d9dc1f3025815;Thu Jan 15 06:06:47 EST 2009;Committer;matz;2;30;24;54;0
0149e4515da3ef6508e9ecca7f422c029f1b9c22;Thu Jan 15 05:28:29 EST 2009;Committer;duerst;1;4;0;4;0
1fc5fb2b7bc627780c65f88efb81d4da4a35ce24;Thu Jan 15 05:23:51 EST 2009;Committer;matz;2;10;0;10;0
994293bc811ddf5def474de86bc64333abad8b7f;Thu Jan 15 04:21:59 EST 2009;Committer;nobu;1;1;1;2;0
ec033198bf069581bffae602c4c47f69c1dfbcd0;Thu Jan 15 04:14:18 EST 2009;Committer;usa;2;5;1;6;0
ece0628ebe83bce6968f7f47ce5898266b8e8410;Thu Jan 15 04:10:16 EST 2009;Committer;nobu;5;20;6;26;0
9e99ce38313cda42a4e2c6c0dba8d1356eec2c7f;Thu Jan 15 03:11:42 EST 2009;Committer;usa;2;11;6;17;0
4430438c66596f0eb1d2db1d9368b1cb5e0c66ee;Thu Jan 15 02:41:38 EST 2009;Committer;usa;2;8;6;14;0
5932de4991e48ffcae71be6885ecdf9f10dd8f02;Thu Jan 15 01:55:41 EST 2009;Committer;matz;7;2228;0;2228;0
c6af6b1b947f8b367c22904bd5b31079784059f6;Thu Jan 15 01:53:08 EST 2009;Committer;matz;7;37;9;46;0
e24346d6c6b4bdf91e1e32bfd53a328086b8d772;Wed Jan 14 15:06:19 EST 2009;Committer;nobu;4;12;8;20;0
22e711c4bf382422f861d598ff6dd188d0482951;Wed Jan 14 14:57:34 EST 2009;Committer;nobu;3;58;28;86;0
3d829c8697500086c67940c54f8f9b7de8c71528;Wed Jan 14 13:39:17 EST 2009;Committer;akr;3;10;4;14;0
82c673d3a1cab4a9f8a1e9ac30b28f108d726606;Wed Jan 14 11:12:30 EST 2009;Committer;duerst;7;63613;6;63619;0
b949be82cfc78993d8cc5ec431e9193a5a07af50;Wed Jan 14 07:19:58 EST 2009;Committer;matz;2;7;1;8;0
aa87e280eafa5d118028577978af5780dd61da69;Wed Jan 14 05:43:49 EST 2009;Committer;takano32;2;5;1;6;0
2717a2eb6e49c08c98ed74679ecb3e5c2e56060e;Wed Jan 14 04:19:28 EST 2009;Committer;nobu;2;8;2;10;0
f188bf2acb3aef0a6525500a84bf38b1fa6d2a3f;Wed Jan 14 04:09:05 EST 2009;Committer;nobu;3;26;2;28;0
96a49b1ada2ca59e039d05b539d05643c6d74fc2;Wed Jan 14 03:39:20 EST 2009;Committer;nobu;2;5;3;8;0
ff80e84db969c41e60771981d5236ecb474360b7;Wed Jan 14 03:38:06 EST 2009;Committer;nobu;2;12;15;27;0
d4beba3f3ef026f56ecae9fc4fed963dd819d620;Wed Jan 14 03:35:25 EST 2009;Committer;nobu;3;13;5;18;0
badd44845e77d6813de6b18b39ab3bcd646cbf01;Tue Jan 13 13:57:53 EST 2009;Committer;akr;3;12;1;13;0
ed15422759aef6f0fa17fb9595b799b6aa487a73;Tue Jan 13 12:52:23 EST 2009;Committer;yugui;3;34;14;48;0
be551172edbf6d533674e84ecdf3745c4432f039;Tue Jan 13 12:45:43 EST 2009;Committer;usa;2;13;0;13;0
84775721bcd0b4b7330e0743fe3d53d9522ae858;Tue Jan 13 12:41:12 EST 2009;Committer;akr;3;23;0;23;0
e1809a0cedfd948bdc229653b5e8b0d5972d114e;Tue Jan 13 12:29:54 EST 2009;Committer;yugui;2;8;2;10;0
c4554d20a694da8c5669b7ef86e33a39f5c33ef9;Tue Jan 13 09:23:54 EST 2009;Committer;usa;2;8;2;10;0
fbc4429d727161c2e002863d2f9ab2cb823941d2;Tue Jan 13 09:21:14 EST 2009;Committer;usa;2;11;0;11;0
e668e36b49b38d6d422c6e9d4b3eddd374bcbb15;Tue Jan 13 09:05:29 EST 2009;Committer;nobu;5;142;144;286;0
4cb8d3316afc452993d8e6d26e2818f412b400a2;Tue Jan 13 08:28:14 EST 2009;Committer;nobu;2;10;1;11;0
7371086f6883270cdcc77e3eb32edf08f2d0ae9a;Tue Jan 13 08:18:16 EST 2009;Committer;naruse;1;1;0;1;0
50258b19fd449048eaf22e88eec873d86c8719bf;Tue Jan 13 07:52:22 EST 2009;Committer;usa;5;139;39;178;0
e41bd61822076275c337258ef53566ea18b70f87;Tue Jan 13 03:37:24 EST 2009;Committer;yugui;2;12;3;15;0
a5fdc9de347bc18243266c1c5c771bb4655dfc78;Tue Jan 13 03:37:15 EST 2009;Committer;yugui;2;8;2;10;0
fc8835a5bb150e083a3175641bd9e29070ddd39e;Tue Jan 13 03:11:17 EST 2009;Committer;usa;3;7;0;7;0
654e94e1c976d675ac464e7edc1c1891a4a6b780;Tue Jan 13 00:55:32 EST 2009;Committer;duerst;1;1;1;2;0
c2cc750dd7ab1b9e4ef3c742f2f8e554736e5e58;Tue Jan 13 00:49:40 EST 2009;Committer;duerst;1;4;0;4;0
8212ca438dde1b8fb4004e38fe5827c15725571b;Mon Jan 12 18:08:02 EST 2009;Committer;usa;2;5;2;7;0
370ffc6a2a098ba9e545cfad90013fd7e0b0f8a7;Mon Jan 12 17:59:45 EST 2009;Committer;usa;3;13;3;16;0
f0e91e54a35806573b2b1a5ab20b8e0511e29ede;Mon Jan 12 17:28:40 EST 2009;Committer;akr;1;5;0;5;0
dea3ad3cbaa5f7560ad4ee486ec2281b9bd03ef8;Mon Jan 12 17:21:45 EST 2009;Committer;nobu;3;45;16;61;0
3f2b281eeec85f34fcf0f9f3a42ef3d3e57810fa;Mon Jan 12 17:10:02 EST 2009;Committer;nagai;2;8;2;10;0
8106658535e01d2de6f61489c1b629abf2fcacb5;Mon Jan 12 16:00:08 EST 2009;Committer;svn;1;2;2;4;0
91ff87c05df679b84ba4c537a71b10cd9e2b9613;Mon Jan 12 16:00:03 EST 2009;Committer;akr;3;18;0;18;0
73757753aef81b97b69a82ccbbcdd7fcfafc6e16;Mon Jan 12 14:58:25 EST 2009;Committer;akr;3;88;1;89;0
68552c4248398d5460ce67710647b1578e109c21;Mon Jan 12 14:32:21 EST 2009;Committer;akr;2;12;6;18;0
839214e1e635d3af9049fa637e484b3b8b9c0dfb;Mon Jan 12 08:52:37 EST 2009;Committer;akr;1;300;0;300;0
6b0304a5d7c063018830705b9596fe75ce31329c;Mon Jan 12 08:23:07 EST 2009;Committer;nobu;2;18;3;21;0
9aa8fcde5565a49abf97991a7914b05c66232f0f;Mon Jan 12 07:49:22 EST 2009;Committer;nobu;1;1;1;2;0
729b4a813b40c30ef7940f54ecb7759dbfb4b615;Mon Jan 12 07:45:31 EST 2009;Committer;nobu;3;75;28;103;0
7099360a6ccc8a7fd392acda11657847cf677c77;Mon Jan 12 06:57:54 EST 2009;Committer;akr;1;17;15;32;0
fdd7e03b79107046b106d0df02f6a4d845b95004;Mon Jan 12 04:08:25 EST 2009;Committer;nobu;1;12;12;24;0
9da504bbaed4e6e761a44b020cead1dd0e549de5;Mon Jan 12 03:43:57 EST 2009;Committer;nobu;2;37;14;51;0
29a6650d86c12c0756a4bb3ae8bf25079d44dbcd;Mon Jan 12 03:41:20 EST 2009;Committer;ko1;2;89;8;97;0
4f2b409a108b1ed38d20eb480146994b8a8a5935;Mon Jan 12 03:39:58 EST 2009;Committer;nobu;2;53;16;69;0
5c94a67eca00071edb4cc84a3f90dbb860d8c945;Mon Jan 12 03:34:48 EST 2009;Committer;akr;2;6;1;7;0
6f09fc2efd1915c4337ce6dded52a8a8771c3222;Mon Jan 12 01:43:23 EST 2009;Committer;ko1;3;56;6;62;0
af12cefe06d4731a1796d815ad5738517de19199;Mon Jan 12 01:21:56 EST 2009;Committer;ko1;3;6;3;9;0
2d53925643c5756d8e750f212713fe666fc6f76b;Sun Jan 11 07:58:02 EST 2009;Committer;seki;3;11;34;45;0
832740d15c94b8f104f4f2774d3001864a3dd5f9;Sun Jan 11 01:30:59 EST 2009;Committer;naruse;1;1;0;1;0
f914b5a7c212d52aa6b77bb666d132e8f6f397a8;Sun Jan 11 00:53:03 EST 2009;Committer;nobu;2;6;1;7;0
5a38751d0286d0a69ff301491207d7fd61b12bd2;Sun Jan 11 00:47:32 EST 2009;Committer;nobu;2;14;3;17;0
b802f1bb02c5bad3e7721ae22981ed9074e1f2e6;Sat Jan 10 18:06:39 EST 2009;Committer;akr;1;2;0;2;0
94c668f1abec0f861853f5a1b2a9c314d8d26241;Sat Jan 10 17:26:17 EST 2009;Committer;akr;1;10;0;10;0
f86c38212f519e9e6ddeb743ddaf6a95d528c731;Sat Jan 10 17:16:54 EST 2009;Committer;svn;1;2;2;4;0
166c122fd399fc244ae8ba0685ae6771d84a2f76;Sat Jan 10 17:16:51 EST 2009;Committer;akr;1;711;2;713;0
7f52fa08b10cdaecf9e64e7d1e14709543d56743;Sat Jan 10 12:18:26 EST 2009;Committer;akr;2;6;2;8;0
8de603784a5e9abee3a33e47b7dd226952e161ef;Sat Jan 10 11:58:58 EST 2009;Committer;akr;1;2;2;4;0
8a1261995ea0b4b68c96ea99cbe3832d8d6f2466;Sat Jan 10 11:52:06 EST 2009;Committer;akr;2;39;23;62;0
21495774766472ed7a4c2ac0d80dec76e07df14b;Sat Jan 10 11:28:41 EST 2009;Committer;akr;2;11;5;16;0
d46fcaf485dbf1fedf32330e200c039a55853fff;Sat Jan 10 10:07:21 EST 2009;Committer;ko1;3;7;3;10;0
ab8a2c7c1f61cec4706058e6efe0a564e998c953;Fri Jan 09 12:53:14 EST 2009;Committer;akr;2;6;2;8;0
f73dca932c1172d9add59c499b7e3c2ada00ea61;Fri Jan 09 06:41:07 EST 2009;Committer;usa;2;12;4;16;0
c8b8db001b06e464982f227f6b0b893ac74228d6;Fri Jan 09 04:21:28 EST 2009;Committer;nagai;2;6;2;8;0
040a7fa7e2beca2e732086e9a0933d2947278ba4;Fri Jan 09 03:29:10 EST 2009;Committer;nobu;3;11;28;39;0
057f2866b762550321eafaeb52efbf1589de2003;Fri Jan 09 01:40:21 EST 2009;Committer;svn;1;2;2;4;0
a931f961118ccb8f0d457a1ad88c788431aa5c76;Fri Jan 09 01:40:16 EST 2009;Committer;nobu;2;32;5;37;0
07f0d97d878ed9d3855504b440101fa1ae83e444;Thu Jan 08 14:33:08 EST 2009;Committer;usa;1;4;0;4;0
6645606d41f2990182d7581fb1729b8945eaa15e;Thu Jan 08 14:26:26 EST 2009;Committer;usa;1;5;3;8;0
80618e75aa6a304e11105932f0120ff66ead261c;Thu Jan 08 14:20:47 EST 2009;Committer;akr;4;22;6;28;0
2f31ea3c86b3966405fab773381e5dc7fd7d8c0f;Thu Jan 08 14:00:34 EST 2009;Committer;akr;2;26;52;78;0
c9ef4fc52faa92a884afaa4b8516431c9b6769f2;Thu Jan 08 13:45:50 EST 2009;Committer;akr;2;14;1;15;0
20f786810655ef7ad130f58f8593d3214d146c4b;Thu Jan 08 08:32:17 EST 2009;Committer;nobu;2;13;5;18;0
0dd41d0d78ff19d23e5c8e7b664855aa8bbe1e95;Wed Jan 07 22:53:41 EST 2009;Committer;akr;2;5;4;9;0
ccdcc971f6d0dbc6122d547be814c7e8826b7453;Wed Jan 07 22:33:00 EST 2009;Committer;akr;2;5;1;6;0
3a0aa7f8d836cec8354ffce06d8ff189cee5d1a0;Wed Jan 07 22:21:40 EST 2009;Committer;akr;1;7;0;7;0
d45c4a810705d8b8822c5840c236657cdbe26470;Wed Jan 07 15:33:17 EST 2009;Committer;akr;2;6;0;6;0
3802c43ea16b6691121f69b4cbe392fc0d42ac34;Wed Jan 07 15:27:09 EST 2009;Committer;akr;2;8;0;8;0
0f94c670f707144b0157227425a650aba3d61ae6;Wed Jan 07 15:21:47 EST 2009;Committer;svn;1;2;2;4;0
69d908a10c6ed9e1dd9887d5fe89fc71ec15437b;Wed Jan 07 15:21:43 EST 2009;Committer;akr;2;18;5;23;0
0e9023acd07476e1a8bd613f395c95b71b277086;Wed Jan 07 14:33:17 EST 2009;Committer;nobu;1;0;22;22;0
55b2bf4dec43aa50ea4acef723e46123054bb151;Wed Jan 07 14:20:15 EST 2009;Committer;akr;4;1135;14;1149;0
376004e9c4cc74850670c9ff8e022d9f769958c3;Wed Jan 07 13:12:32 EST 2009;Committer;nobu;2;9;2;11;0
72937eead89a226cedfbfae5f898ec1c3e96d471;Wed Jan 07 08:14:08 EST 2009;Committer;nobu;1;3;1;4;0
f597d65a6f11b9ec8d3d55c81104dc6967d7f44e;Wed Jan 07 08:13:07 EST 2009;Committer;nobu;4;39;40;79;0
99f0026927cf21727930a9bb9627b9cd43028b43;Wed Jan 07 08:06:32 EST 2009;Committer;svn;1;2;2;4;0
3117bab125d75b4b0a0cd5d405d25a3adf0e7b66;Wed Jan 07 08:06:29 EST 2009;Committer;nobu;1;21;26;47;0
b5470fd243b0fecc3763dff2938081411709b3d0;Tue Jan 06 10:18:44 EST 2009;Committer;nobu;2;3;2;5;0
53716bfce783666039c53da88a02c5f1a9045205;Tue Jan 06 10:09:54 EST 2009;Committer;nobu;2;33;18;51;0
1fffe3d399433d43ffa213c5ca20c5cea2c5d163;Mon Jan 05 15:35:25 EST 2009;Committer;svn;1;2;2;4;0
e6045986ef2c491a7842c1a5d34b683303c11ef0;Mon Jan 05 15:35:21 EST 2009;Committer;akr;2;10;1;11;0
0cd078e358fda09865d2a5b2d4c0c24eeb629811;Mon Jan 05 13:40:42 EST 2009;Committer;akr;1;14;10;24;0
8dee58d7e15bf41196f07f52e13c789139f18414;Mon Jan 05 09:54:47 EST 2009;Committer;nobu;1;2;2;4;0
893efc4db955c94f77049a0b339abae27327b822;Mon Jan 05 08:59:46 EST 2009;Committer;nobu;2;5;3;8;0
c6827f709c07f182b1713621246dc56125ade0cf;Mon Jan 05 08:51:44 EST 2009;Committer;nobu;3;138;1;139;0
c123952745ca08effdafe7d71d5010bba1b89d3e;Mon Jan 05 08:44:10 EST 2009;Committer;usa;2;10;2;12;0
e49d229a62a9e9394db8cbd1cd58d8a16b7c9374;Mon Jan 05 08:00:43 EST 2009;Committer;kazu;1;47;47;94;0
49ef25b1516b87f4e21db9aade96fbaee6731df3;Mon Jan 05 07:26:51 EST 2009;Committer;nobu;2;18;10;28;0
8dd121b5b7a30f9d30a89b566bbe4e6e3f60f6a4;Mon Jan 05 07:16:12 EST 2009;Committer;kazu;2;6;1;7;0
38c5409667d7504e3d66572f2e065a7152a796a8;Mon Jan 05 06:55:14 EST 2009;Committer;kazu;1;1;1;2;0
8f86bc858fa507c2d4c3dba065c7908b8c4eb203;Mon Jan 05 06:53:42 EST 2009;Committer;kazu;2;5;1;6;0
97826efddd45f85de681cc2c62f4bace1c642b3d;Mon Jan 05 03:52:11 EST 2009;Committer;nobu;2;29;7;36;0
8b7b9e33a517c09c487cd118ffa9c2efd7bed769;Sun Jan 04 23:59:20 EST 2009;Committer;matz;2;28;9;37;0
f3844ccf44060801c7ceed331efa025d73e8f718;Sun Jan 04 23:20:39 EST 2009;Committer;matz;2;11;3;14;0
3c66767bda0dbd0a92ead7c2e2721614a9f82bbe;Sun Jan 04 23:00:39 EST 2009;Committer;matz;2;5;1;6;0
639da29270948fa22f68a4c29936ac43401e7942;Sun Jan 04 22:32:44 EST 2009;Committer;svn;1;2;2;4;0
61394a1b5544d525c55241b2ec99187f9da14b24;Sun Jan 04 22:32:40 EST 2009;Committer;matz;2;11;3;14;0
d4a0895181eae1867db36b2083fe98c1dabc7e1c;Sun Jan 04 13:38:58 EST 2009;Committer;akr;2;91;11;102;0
deeade6f3e249d92062d52a62a777bb495bd6e63;Sun Jan 04 09:12:14 EST 2009;Committer;duerst;4;21932;1;21933;0
fecce9e5e5293ebc8fbb161e8b5ecc3884a27d4e;Sun Jan 04 08:55:04 EST 2009;Committer;duerst;3;60;1;61;0
3bc30f0b73d917360b0a550eafbe6894fbf0b334;Sun Jan 04 08:40:26 EST 2009;Committer;duerst;4;13796;1;13797;0
6754cad8e9dc6db89f07d3df378fa124fae70944;Sun Jan 04 08:07:22 EST 2009;Committer;nobu;4;26;34;60;0
ef7057fe2f7634a91052e1bed39001c05fc34744;Sun Jan 04 06:41:43 EST 2009;Committer;nobu;3;19;5;24;0
367de8b97ba2e446ab7828c1f6629d1610c24123;Sun Jan 04 02:58:45 EST 2009;Committer;nobu;3;41;21;62;0
a7999ab13c234001c0f52e09f409f1a694073bb4;Sun Jan 04 02:11:33 EST 2009;Committer;nobu;3;14;6;20;0
9ac683818301ea2cdf089b0154f7b4f7c2b1c11d;Sun Jan 04 00:27:43 EST 2009;Committer;nobu;3;14;1;15;0
d51c5a137ff595cd5f5a344853df81589af63fe0;Sat Jan 03 19:34:17 EST 2009;Committer;akr;2;4;2;6;0
1dfea336528757e19cc713dd84990afe11598b0a;Sat Jan 03 18:34:06 EST 2009;Committer;akr;2;28;17;45;0
13a67cfcf2291ab141827bb28cdcf5289a7628cf;Sat Jan 03 15:36:18 EST 2009;Committer;svn;1;2;2;4;0
da3eba755176fc781ec01117a7944ab8cb8c73e2;Sat Jan 03 15:36:14 EST 2009;Committer;seki;3;223;135;358;0
1240916075e339a9b1ddaac253a743da88db59cf;Sat Jan 03 14:12:39 EST 2009;Committer;naruse;1;2;2;4;0
9282f9f9d41d1deda430246454a684aa7dd683cb;Sat Jan 03 13:26:11 EST 2009;Committer;usa;4;15;6;21;0
2920aaa2d1de830becbdc289ea151585aed4a1c0;Sat Jan 03 06:31:05 EST 2009;Committer;naruse;6;30337;0;30337;0
d11950cbad89147162423b760306626c18f4066b;Sat Jan 03 06:29:36 EST 2009;Committer;naruse;1;5;0;5;0
8e0c298f58f4d31295510f2dda6e4646d9919382;Fri Jan 02 18:03:10 EST 2009;Committer;svn;1;2;2;4;0
0d1e85ee4bf93b566b79a9c71c3809743e1cc7d8;Fri Jan 02 18:03:05 EST 2009;Committer;usa;4;59;8;67;0
1e516be7110a8f167b416d37380b8e579deec46c;Fri Jan 02 14:49:58 EST 2009;Committer;mame;2;7;0;7;0
a900ab57de15691d0eaeccf34afe0ae5e2a6bd83;Fri Jan 02 14:36:39 EST 2009;Committer;akr;2;13;4;17;0
7fc5fa69f115488cff017965f487b0abc9b77f77;Fri Jan 02 14:35:07 EST 2009;Committer;usa;3;10;6;16;0
6e959da0712f92653d0dc9ed438398729df3dc50;Fri Jan 02 14:28:02 EST 2009;Committer;matz;2;6;2;8;0
f408202de2f417e6cb44089fcb2f919bff2253dc;Fri Jan 02 13:25:09 EST 2009;Committer;mame;2;6;6;12;0
f35f46a9f193ea0a5d7da69291818c8520366515;Fri Jan 02 13:20:46 EST 2009;Committer;mame;2;7;0;7;0
d8d5cda2d48fd076d5eeba0e1cc4dc8d581ff4c9;Fri Jan 02 13:18:57 EST 2009;Committer;mame;2;6;1;7;0
e4b7c0e8a36c3788f180202f0511b3f70d566c6f;Fri Jan 02 08:46:26 EST 2009;Committer;akr;3;21;13;34;0
b5aebd12c003342a68ca756b2a43c17b1ff254c1;Fri Jan 02 08:22:36 EST 2009;Committer;akr;3;29;17;46;0
9ce8d4e3b964774294c88d9414fdf4a92c352709;Fri Jan 02 08:02:36 EST 2009;Committer;akr;2;42;10;52;0
775d5d8f0368afd3d74f0446928340c693ac028b;Fri Jan 02 06:33:24 EST 2009;Committer;akr;3;46;16;62;0
d68b60741ce0ee26f61f4bb16ca14769cd1f0988;Fri Jan 02 06:01:57 EST 2009;Committer;akr;3;32;18;50;0
270f2034a71cecc3361920d5ff609bda41ecef8f;Fri Jan 02 05:33:56 EST 2009;Committer;akr;2;13;12;25;0
90a65796e78c99696a39a1fcda344bf4e3cb8856;Fri Jan 02 05:12:14 EST 2009;Committer;akr;3;13;7;20;0
d4b3e8ae70590a92ec5051edbaf9382923301497;Thu Jan 01 21:50:01 EST 2009;Committer;naruse;3;23;4;27;0
28c2711230240fde0a9f66effbbd71108b4b0dfd;Thu Jan 01 19:43:49 EST 2009;Committer;akr;2;14;8;22;0
aa0ae0d3b6ab8d6c3143960bd0b3d154bd96d10e;Thu Jan 01 17:40:41 EST 2009;Committer;akr;4;87;5;92;0
ff7e0f7f614ed1db3e3464db290192aebac1c096;Thu Jan 01 17:09:35 EST 2009;Committer;akr;2;26;53;79;0
12b443d02f2af705ea75d7fe8c99cb50f72128b7;Thu Jan 01 16:22:15 EST 2009;Committer;akr;1;0;3;3;0
59556a0849afb29c699261a9a837e72c590686bc;Thu Jan 01 16:16:08 EST 2009;Committer;akr;4;46;2;48;0
c6bbf28a9f139a5fbf34e54673328d3d58e8e397;Thu Jan 01 15:59:10 EST 2009;Committer;akr;4;23;4;27;0
31fa80daddbdeb074bd8bb4afb5e129f1c92ec82;Thu Jan 01 15:50:16 EST 2009;Committer;akr;2;5;1;6;0
af5678c203417baf043f386766792fcc057074a8;Thu Jan 01 15:15:35 EST 2009;Committer;svn;1;2;2;4;0
f0dd0577b08cb00025c3dacb85d276715c43b6c2;Thu Jan 01 15:15:31 EST 2009;Committer;akr;3;76;58;134;0
8d8d36c15cb2d113a9ff50ba6c3ea0bfabb86eb8;Thu Jan 01 13:30:25 EST 2009;Committer;yugui;3;14;5;19;0
e924cabede82193e86e505f735b2d91954d07b2b;Thu Jan 01 12:26:57 EST 2009;Committer;akr;3;12;8;20;0
85d13f6165ece405b66f6c4d6771043375830c1e;Thu Jan 01 12:09:34 EST 2009;Committer;akr;2;8;20;28;0
48649d21c91a9e626ddd9d341540afb1e465953f;Thu Jan 01 12:00:13 EST 2009;Committer;akr;2;7;1;8;0
afb0581aa8710ab9af6bfe1c2dbf41820913560d;Thu Jan 01 11:55:05 EST 2009;Committer;akr;2;6;1;7;0
b9cd44cfc1dc9d2c62fa05a1ffef5baab03cc25c;Thu Jan 01 11:53:21 EST 2009;Committer;shyouhei;2;6;1;7;0
e485a566ed8d5d8670641909319161632f9647c9;Thu Jan 01 11:47:55 EST 2009;Committer;akr;3;13;8;21;0
6e4149f04a31d3347a8adff35ef7ab4f7fe7d00a;Thu Jan 01 11:18:18 EST 2009;Committer;akr;2;12;10;22;0
10bc6f8d49ab82e16e6aab39a263cdc838207154;Thu Jan 01 10:54:38 EST 2009;Committer;akr;3;17;16;33;0
175561f8dd142d6db89bc6eb8054834da26ee0d9;Thu Jan 01 10:37:41 EST 2009;Committer;akr;3;56;23;79;0
9787d4faaeff4fff798fff6803758f467cb72e7e;Thu Jan 01 08:38:14 EST 2009;Committer;akr;3;35;35;70;0
009ad25fdd60c3d3067f881dbce706735bb5b6fd;Thu Jan 01 08:27:41 EST 2009;Committer;akr;2;6;1;7;0
7454eab7013e276282c9bc282b149242b891b334;Thu Jan 01 08:03:36 EST 2009;Committer;akr;2;28;5;33;0
0c838b4947a36ea0f706dfbd131b92de9a7b18a3;Thu Jan 01 07:49:31 EST 2009;Committer;akr;5;69;47;116;0
30f3c8c70bbfab845ea8db868e961f9482bf637f;Thu Jan 01 07:13:24 EST 2009;Committer;yugui;2;12;1;13;0
89cf0ec1a611494f15076d590fd6af214d4ff5ad;Thu Jan 01 07:09:19 EST 2009;Committer;akr;3;13;1;14;0
2b3e480bef31e3a1cb30e37ec92e5a59f8b0aa7a;Thu Jan 01 07:04:31 EST 2009;Committer;akr;3;21;7;28;0
1c0e798d5c7e2c326fc3116a2f8dc259c71eea72;Thu Jan 01 06:28:34 EST 2009;Committer;akr;2;41;20;61;0
212e90ce3a056aaf5915a11c061a80e893f8e2fd;Thu Jan 01 06:08:41 EST 2009;Committer;akr;3;36;2;38;0
0d2e8c14bb187e5f5a117f6e37a6b4ab34e540e1;Wed Dec 31 22:43:41 EST 2008;Committer;matz;2;7;3;10;0
fd855a082bc0485dd2f9132a16cd91fd14ba76cb;Wed Dec 31 22:16:51 EST 2008;Committer;nobu;3;27;9;36;0
79ccc677e779b360e21ba683a1c4f93939aa7c7d;Wed Dec 31 21:56:38 EST 2008;Committer;nobu;2;7;1;8;0
aa3665e7826b6e27c43e067f0f8fb6794392319c;Wed Dec 31 15:11:33 EST 2008;Committer;akr;1;3;0;3;0
9949853c7382966f2bfb4808893cdcff6115b4e2;Wed Dec 31 15:05:21 EST 2008;Committer;svn;1;4;4;8;0
ddedc6f125e2506f539f0ed81b0e144c07c27442;Wed Dec 31 15:05:16 EST 2008;Committer;akr;3;53;2;55;0
95c474ec4dba7e919511bb0d02832a83fbb04813;Wed Dec 31 14:36:31 EST 2008;Committer;akr;1;4;0;4;0
98454a6da81685775f663587f6df9670e0de0d9c;Wed Dec 31 14:30:50 EST 2008;Committer;matz;3;16;26;42;0
a6d38b8c39d2aa135920547439d729f7f51bfea6;Wed Dec 31 11:09:27 EST 2008;Committer;akr;1;1;0;1;0
2be0eea2e876665e57afd5d4bc70fbafe0767c57;Wed Dec 31 10:38:39 EST 2008;Committer;yugui;4;25;21;46;0
f7676fd9d4bfa23e1dabf11c26f7ca47eeb4d425;Wed Dec 31 09:06:09 EST 2008;Committer;akr;1;5;0;5;0
021aaa70d6c9e10f62dacba0a9a54ef6723ea170;Wed Dec 31 08:18:12 EST 2008;Committer;akr;3;16;3;19;0
67d66b2652a955c8dfcf2377f2842e1c413e0939;Wed Dec 31 07:19:24 EST 2008;Committer;akr;3;70;4;74;0
ef2ff2776b8c7b4d73e0820e7821ee41981ee69e;Wed Dec 31 05:55:25 EST 2008;Committer;akr;3;11;3;14;0
cb4d7b1a7f5dd5749bbfb750957ca458bab3eab8;Wed Dec 31 04:52:18 EST 2008;Committer;akr;3;81;88;169;0
d5c7938eb4c6242c86852cfec1d1f208e3087384;Tue Dec 30 16:10:23 EST 2008;Committer;matz;2;8;5;13;0
84d4ce4bef7a416239d438de0a80fb195f640ac6;Tue Dec 30 16:07:19 EST 2008;Committer;svn;1;2;2;4;0
ce0cd6ad1f486040676c30034f43700096afae41;Tue Dec 30 16:07:14 EST 2008;Committer;matz;2;8;0;8;0
a413e50c415b456cc4b35ede5e3a2521d1bb48d2;Tue Dec 30 12:19:40 EST 2008;Committer;akr;3;24;2;26;0
70365e5debc95ca98d5564f196a1b49323758d82;Tue Dec 30 09:26:27 EST 2008;Committer;ryan;3;60;5;65;0
bf6c750c350b021578c3c446407315c404d6652b;Tue Dec 30 09:03:04 EST 2008;Committer;duerst;2;89;76;165;0
6961f8becccc21f21e188aac5efa382a211e3c6a;Tue Dec 30 08:05:06 EST 2008;Committer;ko1;2;6;1;7;0
9c04a0647fb99f7554cb2e04385ddbb970631e02;Tue Dec 30 07:57:53 EST 2008;Committer;ko1;3;85;1;86;0
f396a10e132aeb8e80023ee1a1515124dfa3b486;Mon Dec 29 22:27:27 EST 2008;Committer;svn;1;2;2;4;0
d0ed5a93786881e2ddda99d0c83e4d1a216a3ca8;Mon Dec 29 14:54:24 EST 2008;Committer;ko1;6;109;33;142;0
b3ff7eb3efed3b3bf5f4cb7eeaf03b96108e13d9;Mon Dec 29 14:41:22 EST 2008;Committer;yugui;3;21;5;26;0
c7e236efc17ca06d73fd17ed2edb736ed09129d8;Mon Dec 29 14:26:16 EST 2008;Committer;tadf;4;11;3;14;0
ad004644893b2f867521c3f215753cf8c04ea887;Mon Dec 29 13:40:33 EST 2008;Committer;matz;4;24;1;25;0
6bbd76a73295564871ab06f8da167ce6de0af467;Mon Dec 29 13:29:12 EST 2008;Committer;matz;3;26;36;62;0
db86fef72f2a4b54748cd6b7aa656836c3b332af;Mon Dec 29 12:39:31 EST 2008;Committer;yugui;1;3;0;3;0
292d6ee99f896a2afedc29136ff4216d948f19f3;Mon Dec 29 12:23:55 EST 2008;Committer;tadf;2;26;0;26;0
e12b44e3756216eecf413647851c47bc4de6efa7;Mon Dec 29 12:14:25 EST 2008;Committer;yugui;2;184;0;184;0
5d7f9f17214644e0726361aeb454695b1adc41a2;Mon Dec 29 11:57:06 EST 2008;Committer;tadf;1;2;2;4;0
d7b873a108e5355423a8f35f86a47eb3732f521f;Mon Dec 29 11:50:10 EST 2008;Committer;tadf;2;76;16;92;0
25c96543cccafb52f11c99a3eaa18a206afa4703;Mon Dec 29 09:26:50 EST 2008;Committer;yugui;2;7;0;7;0
bbd1a18aafe5b8ba3c1a698526fcc62a7f0af1d1;Mon Dec 29 09:26:42 EST 2008;Committer;yugui;2;21;7;28;0
af91b4235416af1ec499afafcf4524d93437607b;Mon Dec 29 09:26:34 EST 2008;Committer;yugui;5;370;10;380;0
d33298e52459045ddde4bae619a8da3c3cf7dbd6;Mon Dec 29 09:07:20 EST 2008;Committer;matz;2;31;0;31;0
95327358ce9a2c7f2c2aab68cae4446c281a655e;Mon Dec 29 09:01:38 EST 2008;Committer;matz;2;10;5;15;0
527cc9279367014d85f6fb96aebd301bdb3baf11;Mon Dec 29 08:14:35 EST 2008;Committer;matz;2;7;15;22;0
445b6d5d0169b45fe9c8a00edbc862a79f9ef492;Mon Dec 29 07:50:07 EST 2008;Committer;matz;2;4;1;5;0
272a3aa6a2ef9d2ef60288791f0e73c978367f62;Mon Dec 29 07:44:56 EST 2008;Committer;ko1;2;11;0;11;0
6dd1910a3d7b5e2057c5671f971709b4c38c1e5b;Mon Dec 29 07:32:56 EST 2008;Committer;matz;2;13;2;15;0
7be399c567c0e2ba746b63c8bbabc13e6dcb14af;Mon Dec 29 06:18:14 EST 2008;Committer;yugui;2;9;3;12;0
69b2c8cc4445cf0774247f7578a91a9e6a40ace2;Mon Dec 29 05:51:31 EST 2008;Committer;yugui;3;12;2;14;0
b2ad49565f10dfdd594680c2fa7a4af81c1027fe;Mon Dec 29 03:03:09 EST 2008;Committer;ko1;3;26;4;30;0
a928613a313e7750c7dcee824631cd6ed1690344;Mon Dec 29 02:56:23 EST 2008;Committer;naruse;2;21;22;43;0
1ebed6c6140a1c3fe0e6b157910cc1d2d1bd49bc;Mon Dec 29 02:01:02 EST 2008;Committer;naruse;3;29;21;50;0
1487d9743b6e5082676c194d023b6dabaa53085c;Sun Dec 28 22:16:19 EST 2008;Committer;matz;2;6;1;7;0
813d983154c5e237f1e4c1957917e054df6a69c7;Sun Dec 28 18:53:33 EST 2008;Committer;ko1;1;1;1;2;0
ec5283e691a31d466099bc274169d3b0568ca840;Sun Dec 28 18:45:24 EST 2008;Committer;ko1;2;35;11;46;0
f5189c3f142701ffa5c0162485650c49c50defa9;Sun Dec 28 16:10:02 EST 2008;Committer;svn;1;2;2;4;0
8cc42bc701c55a12f8659e9a5e6381cbce26507d;Sun Dec 28 16:09:59 EST 2008;Committer;akr;1;12;0;12;0
8ff550534ec5e28b6523ea9878b391f805a985ca;Sun Dec 28 13:26:27 EST 2008;Committer;yugui;1;1;0;1;0
6e658ea3928e3a538e822ba8c595e8fa0088015c;Sun Dec 28 12:42:39 EST 2008;Committer;naruse;2;7;0;7;0
f6cc65ae48d176fcc99847dbae1d39fad9ae806d;Sun Dec 28 12:13:32 EST 2008;Committer;yugui;2;6;1;7;0
28001c849d8823c8bac79b9e53705cf247b99e65;Sun Dec 28 12:13:24 EST 2008;Committer;yugui;3;23;3;26;0
00cb692395f97ee180342be2f768e8e49b42c2f9;Sun Dec 28 10:11:07 EST 2008;Committer;nobu;2;4;5;9;0
08b4f9138cd3614454d35f61478e6145433682d4;Sun Dec 28 09:51:18 EST 2008;Committer;nobu;1;3;0;3;0
ca658280142cd822f4193bd3cb80bd6f4fbed877;Sun Dec 28 09:40:04 EST 2008;Committer;nobu;2;5;3;8;0
faa2987d54426345cf2ad8494b107b697c11e781;Sun Dec 28 08:24:35 EST 2008;Committer;naruse;2;6;1;7;0
0c0e31175a4ebb0adc391d113101e493c65f949f;Sun Dec 28 08:11:01 EST 2008;Committer;takano32;1;6;0;6;0
0781d24aaa41d87802592f325ccf8ccfe9bad04b;Sun Dec 28 08:10:20 EST 2008;Committer;takano32;2;3;6;9;0
04b672f34b2ff39b90123045ccf3f67b811ff170;Sun Dec 28 03:58:02 EST 2008;Committer;takano32;2;7;0;7;0
b66af67f2190b377a418b6fc4230838c257cc7d1;Sun Dec 28 03:25:31 EST 2008;Committer;mame;2;7;3;10;0
0e41458700b19a696fe1197fdd10b2bc15ab9657;Sun Dec 28 01:39:18 EST 2008;Committer;mame;2;17;7;24;0
1cbf898172a7ea25ca2ea10503fb7f696d8db0b2;Sat Dec 27 20:51:23 EST 2008;Committer;ryan;5;95;15;110;0
4985bfdc9f3f0780b20d445ce6aa0f3bdb0aa355;Sat Dec 27 15:44:55 EST 2008;Committer;svn;1;2;2;4;0
9216dd7e320bab28ff40092ae69a643e715cb2a8;Sat Dec 27 15:44:51 EST 2008;Committer;akr;2;17;5;22;0
0c835afac0524cddd43e8a56da4efd9e45b17a83;Sat Dec 27 13:41:04 EST 2008;Committer;nobu;3;11;4;15;0
f0f281c1c16c9c34e59780e32c8e1136658594ef;Sat Dec 27 12:48:20 EST 2008;Committer;takano32;2;7;0;7;0
39c2cf2c8195e90e8a888138e7c2b96b2ed2718b;Sat Dec 27 11:28:18 EST 2008;Committer;usa;2;6;1;7;0
a94adfa245ec353883bb7f626b70d71eff25d935;Sat Dec 27 10:40:57 EST 2008;Committer;nobu;3;11;2;13;0
b5d2750bbc5b9300a7694489d5eadc6dae12fe24;Sat Dec 27 10:30:04 EST 2008;Committer;nobu;2;25;24;49;0
10af217ff3475e060a4238c3505f095a834ec0bc;Sat Dec 27 09:28:26 EST 2008;Committer;matz;2;7;1;8;0
d9be2059e55f50fb4d51f753d7b992e59f98d042;Sat Dec 27 08:08:44 EST 2008;Committer;nobu;2;14;0;14;0
aebfdbeea573c031ea690ee93f816a53ac27ca51;Sat Dec 27 07:22:01 EST 2008;Committer;ko1;2;17;1;18;0
415d59e3e43c103b7a642e511abb683c785ef9b6;Sat Dec 27 06:28:34 EST 2008;Committer;akr;2;13;0;13;0
1f8620ca22d75b1f4487975ed2012a866dca9c3c;Sat Dec 27 06:26:48 EST 2008;Committer;ko1;2;10;5;15;0
62be8b0154445e11c651434a04226cd7311baf96;Sat Dec 27 06:16:56 EST 2008;Committer;yugui;2;5;1;6;0
b19be9b1a90b9672f0866566904ad66e43440c97;Sat Dec 27 06:05:41 EST 2008;Committer;ko1;2;5;2;7;0
6c08b4522d4b9173dcbada62c6d218452d103b4a;Sat Dec 27 05:58:23 EST 2008;Committer;ko1;4;40;3;43;0
5effdad2cdd0807eca83ea2cdbddc70f4f3fe02f;Sat Dec 27 05:30:58 EST 2008;Committer;akr;2;6;1;7;0
bd96f1fe705c973af8c6e1aec92802ba692b9b52;Sat Dec 27 04:45:28 EST 2008;Committer;ko1;3;18;1;19;0
e434135ecbc8e00c9e036fb14df399224a478925;Sat Dec 27 04:12:38 EST 2008;Committer;yugui;2;43;11;54;0
b30b998966553a614f18703536b49a4dc273e0c6;Sat Dec 27 03:57:21 EST 2008;Committer;ko1;5;43;11;54;0
597220ef0c694a74663e064b73605bd48ad7250b;Sat Dec 27 01:15:56 EST 2008;Committer;ko1;9;119;15;134;0
57363127157b6a697b61f04a3ba205152135538e;Sat Dec 27 00:25:47 EST 2008;Committer;yugui;2;124;0;124;0
2d5061bd98a59fc1b9a477074f8f7a3500db8342;Fri Dec 26 20:39:07 EST 2008;Committer;nobu;2;7;2;9;0
b2e95674f6c866ad5830e28c8791fbb125777432;Fri Dec 26 16:53:18 EST 2008;Committer;svn;1;2;2;4;0
7d052b1d742f8c8ae32e106a0cf75dc0fd7b8fbd;Fri Dec 26 16:53:13 EST 2008;Committer;jeg2;2;24;5;29;0
b729ec53a240564bdb94b1a6c5ae943c67f8c49d;Fri Dec 26 09:05:47 EST 2008;Committer;akr;2;37;16;53;0
3beeeffb97386cf7c96c98e2c6b4f1fee0735c06;Fri Dec 26 08:06:33 EST 2008;Committer;yugui;2;5;1;6;0
0a23fe65728224aa42007d25634b45cd17283c51;Fri Dec 26 06:50:55 EST 2008;Committer;nobu;3;42;6;48;0
90cdbb0ed976624df6429ddac48c1542a603b762;Fri Dec 26 05:04:43 EST 2008;Committer;svn;1;2;2;4;0
b17c5eba46d608f61e6035f203f49184fc43bdd0;Fri Dec 26 05:04:39 EST 2008;Committer;akr;4;60;52;112;0
20f5c2a3ba6fe5e0468edcbd543c92ede8aa5911;Thu Dec 25 11:59:57 EST 2008;Committer;naruse;3;8;2;10;0
b0480260e244f73804ffa131bb2db3af29e79872;Thu Dec 25 11:02:09 EST 2008;Committer;akr;2;4;3;7;0
df4699320d24ee4d405c0561a62b500649fc181b;Thu Dec 25 10:43:35 EST 2008;Committer;naruse;2;5;2;7;0
bb4329becdce611519c8e6486661969ede17f704;Thu Dec 25 09:36:40 EST 2008;Committer;akr;3;22;12;34;0
d42b3e5c8875939208b3dfd0145447d15eba21b5;Thu Dec 25 08:54:51 EST 2008;Committer;naruse;2;21;11;32;0
ea6ac1c45bf11cfdd3f6b058776d063468215980;Thu Dec 25 08:07:01 EST 2008;Committer;akr;2;6;0;6;0
db0a6590123c5405f209501c27367e7818eee514;Thu Dec 25 07:25:06 EST 2008;Committer;akr;3;44;16;60;0
ad558a3a7f13ad2ad1004bf0ed44c192b98bb529;Thu Dec 25 06:55:38 EST 2008;Committer;matz;2;15;1;16;0
f20234994e8589a974bd6f2e057055b2e521f9ed;Thu Dec 25 06:08:12 EST 2008;Committer;akr;2;15;18;33;0
9541c63080623dbfa8b009eccc344920e8adac93;Thu Dec 25 05:53:22 EST 2008;Committer;usa;2;5;1;6;0
1f2d804e5e2b724e91e627faa53d1283cfe7554e;Thu Dec 25 05:41:47 EST 2008;Committer;ko1;2;11;8;19;0
c4b30b4449b0f8c843871a6468eaa416335c7024;Thu Dec 25 05:40:41 EST 2008;Committer;usa;1;17;0;17;0
dea037cc67be817ae75719ad76332c7e451c8b53;Thu Dec 25 04:33:22 EST 2008;Committer;usa;1;2;10;12;0
f29ec7ed67fb25ff998eb2f6d31ea103a2e33e46;Thu Dec 25 04:29:30 EST 2008;Committer;usa;2;18;2;20;0
a71fb38d47d910b421c56e7b28931be12a32d09d;Thu Dec 25 04:19:33 EST 2008;Committer;ko1;3;51;3;54;0
7c982059ea464cbdb951eab239afdffb2d0553ca;Thu Dec 25 03:51:35 EST 2008;Committer;ko1;4;57;23;80;0
f6e435fe878cfdb03906b1dbb2e366e9b3408b53;Thu Dec 25 03:49:09 EST 2008;Committer;ko1;2;10;1;11;0
b8db90f35abed0077458a9a6fba257664f474957;Wed Dec 24 20:53:06 EST 2008;Committer;nobu;3;10;3;13;0
934525776f60171fff0c5453e795de051fc0ab15;Wed Dec 24 20:05:12 EST 2008;Committer;nobu;3;62;72;134;0
011fc2649d99a87b06e2e31e13a74e450470d643;Wed Dec 24 16:52:38 EST 2008;Committer;nobu;2;6;0;6;0
823cfeed8911eed4491a632335e313deebd849e8;Wed Dec 24 16:11:01 EST 2008;Committer;kouji;2;29;21;50;0
60efdd5bbdeed6f63b570b18a91b3b2913f744d8;Wed Dec 24 16:03:29 EST 2008;Committer;svn;1;2;2;4;0
bd877eb7afaaec60ae49591a814b8a35a474eab2;Wed Dec 24 16:03:25 EST 2008;Committer;kouji;2;6;1;7;0
8d1689508d8b9b45decd4dd0507d46ba12dfce2e;Wed Dec 24 13:39:16 EST 2008;Committer;ko1;3;31;6;37;0
155149109a9c6d6ae79bf40398cb51e8883dad26;Wed Dec 24 13:01:09 EST 2008;Committer;ko1;2;5;1;6;0
f23e8d87c01c751094b58fc13cde1da59ed7eda6;Wed Dec 24 12:56:58 EST 2008;Committer;ko1;5;25;20;45;0
7160543aeb8a9f5d7b2f26d3c7b0d7702016f831;Wed Dec 24 12:02:21 EST 2008;Committer;ko1;3;24;4;28;0
f0da2e1657e645233faff25faeb05905dd350623;Wed Dec 24 11:47:00 EST 2008;Committer;ko1;6;43;10;53;0
8c6a26ab8e1d9ba48f904c165a175d55732a5240;Wed Dec 24 11:19:32 EST 2008;Committer;ko1;2;6;2;8;0
b8e79f34a29950102bf0db20b025cd4916da2787;Wed Dec 24 04:45:34 EST 2008;Committer;nobu;3;9;2;11;0
d1af8511af633f8bd7415f29f64c31d031b6a2af;Wed Dec 24 04:33:39 EST 2008;Committer;nobu;2;7;3;10;0
39711b631f91d58ba3a2401563e6b66f2f119e67;Tue Dec 23 21:29:34 EST 2008;Committer;nobu;2;17;8;25;0
568b743442dffb3d959b9d720816923c448215fb;Tue Dec 23 18:23:15 EST 2008;Committer;matz;2;53;6;59;0
9f8c309d6e4d8be6591e0fbeadf4de4603370b38;Tue Dec 23 15:30:05 EST 2008;Committer;matz;2;33;17;50;0
d5bc38fdbf70035bef7898ec5c4de7ce26c68643;Tue Dec 23 15:24:54 EST 2008;Committer;matz;2;6;1;7;0
19fee2e2e075950120573f4063b22fb8082fad0e;Tue Dec 23 15:22:18 EST 2008;Committer;akr;2;10;3;13;0
b54087529e8f4258068199e3a033f67ec8229014;Tue Dec 23 15:13:23 EST 2008;Committer;svn;1;2;2;4;0
5e62997245434daff576be3107086a7e81e46408;Tue Dec 23 15:13:18 EST 2008;Committer;matz;3;12;7;19;0
b317b345e89b1d8f3daa207973fc34d9b3f13e32;Tue Dec 23 13:59:10 EST 2008;Committer;akr;2;9;2;11;0
423bbf80d540ca189a87753c226c943dffda6acc;Tue Dec 23 13:15:54 EST 2008;Committer;akr;5;170;68;238;0
5677106ec905122398b330593fd9ec72df3a074e;Tue Dec 23 11:30:44 EST 2008;Committer;yugui;3;126;30;156;0
7c152e7f08b1a4f5b4fd7872443b1f18d5276820;Tue Dec 23 10:51:27 EST 2008;Committer;nobu;2;12;0;12;0
6fcaf92943879dfbf8cff0354b6ea08aacadc8ea;Tue Dec 23 10:13:11 EST 2008;Committer;akr;3;10;4;14;0
ace35ac66c3df9beec76bbff7c75b37307930678;Tue Dec 23 09:34:08 EST 2008;Committer;akr;2;10;1;11;0
12932721dc5908b2762120b8bd6573c429c7c51b;Tue Dec 23 07:50:57 EST 2008;Committer;usa;2;21;17;38;0
fbcc23a8faff983216fdf3d99614a8c4cb18c0c1;Tue Dec 23 07:24:13 EST 2008;Committer;akr;3;23;5;28;0
81031ebdcc6fb73550c91935a7c0f586a0faa1fa;Tue Dec 23 06:49:39 EST 2008;Committer;usa;2;7;2;9;0
99825ae914014a70c37a68f750ac651cb250ad9a;Tue Dec 23 06:48:42 EST 2008;Committer;yugui;2;6;0;6;0
1bd7257dc8884d7cdd80e2a2b551b9016c3b9ddd;Tue Dec 23 06:47:44 EST 2008;Committer;drbrain;2;10;3;13;0
59641944e9902912fbbe81c57504f35d652b9ad6;Tue Dec 23 06:39:48 EST 2008;Committer;yugui;2;11;10;21;0
4347580354c256bad1112ec269853460ff8b0c78;Tue Dec 23 06:34:55 EST 2008;Committer;akr;1;13;13;26;0
7d024047654d6de68f45d3b5c56bd1ba1c66cb5d;Tue Dec 23 06:30:33 EST 2008;Committer;usa;2;5;1;6;0
0c9fe2130f388e7d5dfd6362aeae1ea24a9ed581;Tue Dec 23 05:19:27 EST 2008;Committer;usa;2;6;0;6;0
b8f7b97321b6dd7ba62f6ffe6138ef906b37c57d;Tue Dec 23 05:16:54 EST 2008;Committer;drbrain;2;7;2;9;0
469d119ab9913f0f41e9c060de630426196ee3ab;Tue Dec 23 03:52:11 EST 2008;Committer;akr;1;20;0;20;0
a61a5f171d2fd8e593d7a29c3b099480944aa53d;Tue Dec 23 03:00:31 EST 2008;Committer;akr;2;6;2;8;0
e4d04b0b5599cded8d393af4281b691a432e3ef4;Mon Dec 22 23:11:11 EST 2008;Committer;drbrain;2;6;5;11;0
f2f3e60a8a208c8da7fa34250c454f0645a5326d;Mon Dec 22 23:06:47 EST 2008;Committer;drbrain;2;10;0;10;0
e7685ab82c36ab14f3883ece33c633d4f4a797f6;Mon Dec 22 15:18:17 EST 2008;Committer;svn;1;2;2;4;0
41da4d16b0bbfa12827ac772c28bf43b0b655140;Mon Dec 22 15:18:12 EST 2008;Committer;mame;2;6;2;8;0
8f79efe0becb0ca996bc9affe2476b616f91fcde;Mon Dec 22 13:19:17 EST 2008;Committer;yugui;3;19;15;34;0
c09e5abeee5e08e6c261e3618afa60020371eb96;Mon Dec 22 13:19:08 EST 2008;Committer;yugui;8;409;3;412;0
a550f2992bfbde8649e975eb345a4b478adbdd05;Mon Dec 22 12:32:11 EST 2008;Committer;akr;2;25;0;25;0
b795b5c537692cabadbb50271b0f8e7ba1c1785b;Mon Dec 22 12:29:04 EST 2008;Committer;akr;2;2;1;3;0
3a7daf882bf737c2e9a6c7a9aece2424cb3f4547;Mon Dec 22 12:27:26 EST 2008;Committer;akr;4;69;3;72;0
c8cbfe7deba037b72e2a3c8f7dd604731e43de55;Mon Dec 22 12:11:43 EST 2008;Committer;akr;2;6;0;6;0
b451955bbb53f773186c3f2b80506ef5bbf9dfb6;Mon Dec 22 10:12:02 EST 2008;Committer;usa;2;6;0;6;0
3be4523bde22f2db6a5b7c60929f8e4194ba2a92;Mon Dec 22 09:04:14 EST 2008;Committer;nagai;2;8;3;11;0
d9691f6e845034adf927732a2d425338515f0dd7;Mon Dec 22 03:26:22 EST 2008;Committer;nobu;3;11;1;12;0
3bad2b6ed996aaf9795b1c0f0fa92124a74226c1;Mon Dec 22 03:25:14 EST 2008;Committer;nobu;2;13;2;15;0
941e77dc91669f433604c33615d5764a01f3ac92;Mon Dec 22 03:07:41 EST 2008;Committer;nobu;1;1;1;2;0
9f3b77e43571744e04f2853e5e37671db2a7ddd7;Mon Dec 22 03:05:20 EST 2008;Committer;nobu;9;49;43;92;0
0f6e6c8bbc4dd37868336019669582059edfda3f;Mon Dec 22 02:41:28 EST 2008;Committer;matz;2;4;0;4;0
850df4b8e730905439bb3e33be746eda64d4e2a5;Mon Dec 22 02:35:37 EST 2008;Committer;matz;2;11;2;13;0
f77f9da445cf033a165878366e767b49458bd3c2;Mon Dec 22 02:12:37 EST 2008;Committer;matz;2;6;0;6;0
1d4c16458199f799af1335b50fcca82a678052d1;Mon Dec 22 01:43:16 EST 2008;Committer;matz;2;16;1;17;0
407ff29a6b9c7b2dc6764c25338a9de6d92144b6;Sun Dec 21 17:56:44 EST 2008;Committer;svn;1;2;2;4;0
6c650f35f90c902a6d3c2990206da8cef1ce48cb;Sun Dec 21 17:56:38 EST 2008;Committer;nagai;3;55;35;90;0
39c4d6928ba085665b5a02d9386091b81745e02a;Sun Dec 21 05:55:20 EST 2008;Committer;nobu;2;5;9;14;0
1cf4744a83c8d450619a8f60572e8d6bdb85e510;Sun Dec 21 05:49:18 EST 2008;Committer;kouji;2;34;21;55;0
8cd6a45a2a420dfb0926c659580b565e91a26865;Sun Dec 21 05:46:01 EST 2008;Committer;nobu;2;6;2;8;0
67cd02b40ceb2f1782e30f147dc14724267c2119;Sun Dec 21 04:51:43 EST 2008;Committer;kouji;2;14;2;16;0
5ad1f1d3cd1de616456fd31ba895cef729e1f242;Sun Dec 21 03:23:19 EST 2008;Committer;nobu;3;17;1;18;0
d153bd1d720568042a6a6c6b0b21a9fa25209e71;Sun Dec 21 01:45:02 EST 2008;Committer;svn;1;2;2;4;0
ee01c3e38b01fe1e270aa239d581dd8e4fd17f35;Sun Dec 21 01:44:58 EST 2008;Committer;takano32;2;6;2;8;0
7ac32d7a16734ea66de15319bcff2fd429abae7f;Sat Dec 20 09:28:29 EST 2008;Committer;nobu;4;196;202;398;0
3eb9283504351d9b47d5562b5ee29e2fbeb0b094;Sat Dec 20 03:27:08 EST 2008;Committer;matz;1;1;1;2;0
8cb4a083a44ee77fad71f12bb553a7f660f6ed8b;Sat Dec 20 02:01:30 EST 2008;Committer;svn;1;2;2;4;0
734e1dc49125b92e5403dee6fcf781b292f0d6ee;Sat Dec 20 02:01:26 EST 2008;Committer;yugui;2;8;1;9;0
63219d8a2416f75861fb93d107b1efd213829786;Fri Dec 19 08:22:45 EST 2008;Committer;matz;4;61;40;101;0
e5bfdb8391b3232c2b682e7eb19e99d85c3c1e9e;Fri Dec 19 06:51:52 EST 2008;Committer;nobu;2;5;1;6;0
0754cf1cb2b2286d9913f4e257b8fd53bb135f65;Thu Dec 18 23:42:04 EST 2008;Committer;svn;1;2;2;4;0
00856f76f790d9aa0229fd5836a7d658cb92dfb6;Thu Dec 18 23:42:00 EST 2008;Committer;matz;2;16;4;20;0
cad0fbddf8732eaded1097e551d845cc09d69f20;Thu Dec 18 14:33:31 EST 2008;Committer;akr;1;9;3;12;0
5c1bd53c92f888f45f6a843f2ef70f2fcdac077f;Thu Dec 18 13:09:26 EST 2008;Committer;yugui;12;272;108;380;0
52d481d8de7ee3e0dfaef7322d540f95223bf41b;Thu Dec 18 12:20:13 EST 2008;Committer;xibbar;4;90;3;93;0
88cab63a07aff9731026f7191d9c4263f7fe11b8;Thu Dec 18 08:05:17 EST 2008;Committer;matz;2;8;1;9;0
85bae86cb63bc564959f4649a837fcffdccae3ae;Thu Dec 18 07:54:50 EST 2008;Committer;matz;14;308;319;627;0
cd5c309542ad7c352fcbcc0abb5a0bdf3f077a4c;Wed Dec 17 23:15:56 EST 2008;Committer;jeg2;2;11;1;12;0
118eecc3611b4c15155cee23bd838c636df8f189;Wed Dec 17 15:48:25 EST 2008;Committer;svn;1;2;2;4;0
d74d2d13cbfcd858db13c25a73b49e592ca632a9;Wed Dec 17 15:48:22 EST 2008;Committer;akr;1;10;9;19;0
0a3a98aea4a168dc462e2ed770c0f2dc9c0bd902;Wed Dec 17 10:47:52 EST 2008;Committer;akr;2;12;2;14;0
8ae0a40d029efe557a6f6b7907b98b12dccaab6b;Wed Dec 17 10:38:19 EST 2008;Committer;akr;3;26;1;27;0
67d18f7ff78aa9da418f5b958e998807c15b7925;Wed Dec 17 10:25:29 EST 2008;Committer;keiju;2;15;16;31;0
8fb2235f48af6216b9b2105155dd626d8b2f771a;Wed Dec 17 06:56:42 EST 2008;Committer;matz;2;4;0;4;0
a89d928bfb89cea28dfaf566cf768cf541f7e916;Wed Dec 17 06:52:18 EST 2008;Committer;matz;2;5;1;6;0
5c0b21b7b904163761b7dd26d005026e59bb26bd;Wed Dec 17 06:37:20 EST 2008;Committer;yugui;2;8;2;10;0
3d923f01bf3db6414dc5d38fed0524a35dafd81b;Wed Dec 17 02:40:53 EST 2008;Committer;kazu;2;7;2;9;0
6bcd363ebf4fc4cde24fd94f48786d4da996e07e;Wed Dec 17 02:01:37 EST 2008;Committer;nobu;2;10;1;11;0
446bcf9a23758a5226f243ec8e2ab93e75e087ce;Wed Dec 17 00:58:15 EST 2008;Committer;svn;1;2;2;4;0
a34a6b33885ae6dcbda6eedf513e20addf164803;Wed Dec 17 00:58:10 EST 2008;Committer;yugui;2;5;2;7;0
20e35ba14b80721867077d40e864c3cbb8b5afcf;Tue Dec 16 13:56:13 EST 2008;Committer;usa;2;9;0;9;0
d85760abffbcd80548a99ab4eb201df756f1c53d;Tue Dec 16 13:52:17 EST 2008;Committer;matz;2;4;1;5;0
879d8aa079e651fa9cd621bc1644c1ca27d69ab0;Tue Dec 16 13:43:34 EST 2008;Committer;usa;2;5;1;6;0
9d049cc72941e7b3f07e5ab8a3e2ed587efacebe;Tue Dec 16 13:16:13 EST 2008;Committer;matz;2;6;1;7;0
842be2d7cbb31ced9ca5c89c72b384f25668d451;Tue Dec 16 13:10:35 EST 2008;Committer;matz;2;21;7;28;0
d8d41b2380e897fc9660f0ecb2b0a0497528ff01;Tue Dec 16 13:03:49 EST 2008;Committer;usa;2;5;0;5;0
e27fbfbc9809f473d5f681be92328b49a8cce5ec;Tue Dec 16 11:39:17 EST 2008;Committer;akr;3;90;80;170;0
3ea21e47c1c2f84e3e7865b9098137e210cd70c4;Tue Dec 16 11:25:13 EST 2008;Committer;tadf;2;44;40;84;0
56709edc8972a0de8dee523f00576f32ebefb4ad;Tue Dec 16 10:49:12 EST 2008;Committer;akr;4;68;6;74;0
ce17decdfb5c785df7ca849178bfb74be5255553;Tue Dec 16 10:44:36 EST 2008;Committer;akr;2;31;26;57;0
a04d12b188cb6e440ee5770e2b06824346fb15c3;Tue Dec 16 07:41:54 EST 2008;Committer;nobu;2;4;2;6;0
b315664f2bce61636d6f814f2a9f9adb22fb2ff2;Tue Dec 16 07:29:47 EST 2008;Committer;nobu;2;9;16;25;0
4bf5646e6466c5e16e4a627c06de4b9ed04155a3;Tue Dec 16 06:35:07 EST 2008;Committer;knu;2;2;10;12;0
963752d971d02e1d04017cf51a3201c6b1e37da9;Tue Dec 16 05:57:40 EST 2008;Committer;knu;1;1;1;2;0
8636e50873179133f1d6b34d4e667cf146434388;Tue Dec 16 04:57:45 EST 2008;Committer;knu;2;10;2;12;0
fbbfcc52f6852a1d98e4e29b2fac8c8a008cf973;Tue Dec 16 03:30:58 EST 2008;Committer;nobu;2;5;1;6;0
ef1041167e2fce8a31df2a06d7da28d2ef88e5dc;Tue Dec 16 03:26:51 EST 2008;Committer;nobu;2;6;1;7;0
bf451dbba4e96c2ad0f5cb9d8684edd9e982a859;Tue Dec 16 02:41:23 EST 2008;Committer;usa;2;4;2;6;0
6a613ba2e4f23b736934b48803bfc0288edace1b;Tue Dec 16 02:37:45 EST 2008;Committer;usa;3;8;3;11;0
587afe728b55eacb8ed8dbf8db2f092625f18063;Tue Dec 16 00:16:46 EST 2008;Committer;matz;2;11;1;12;0
c6f32ff88b4812c5323694b386991a77eace5fcf;Mon Dec 15 22:13:29 EST 2008;Committer;ryan;1;0;25;25;0
1b6432235d42b262b0fed6e6e878506001da363c;Mon Dec 15 15:36:28 EST 2008;Committer;svn;1;2;2;4;0
ca4798c4c30ce49e3491d4bd4966a9d4759c7760;Mon Dec 15 15:36:26 EST 2008;Committer;akr;1;60;0;60;0
13919e068b6f57249e3d178657e2ea877b2ffd23;Mon Dec 15 14:49:31 EST 2008;Committer;matz;2;7;2;9;0
0e20782339a5734dacbcdf4be78fd5b2745de1af;Mon Dec 15 14:46:50 EST 2008;Committer;matz;2;104;0;104;0
bfaef6a33624806be767d72b65de4644a0591215;Mon Dec 15 14:35:00 EST 2008;Committer;akr;2;6;2;8;0
4da3316ca317e2f8ec75c07aaec0de094b1db8ed;Mon Dec 15 13:48:51 EST 2008;Committer;akr;2;66;0;66;0
005e7565377af1d8403732dea8bee16d272530b9;Mon Dec 15 12:25:03 EST 2008;Committer;akr;3;8;7;15;0
67e43bfdf333fd60e2cdca69e226329fe51de25c;Mon Dec 15 12:02:09 EST 2008;Committer;akr;2;6;1;7;0
9bfd822bd1547e2e6bc549606159de1cb980690e;Mon Dec 15 12:01:08 EST 2008;Committer;akr;2;9;1;10;0
ebed0a6e9afc24d53c19222a38268a01691bac8f;Mon Dec 15 11:18:14 EST 2008;Committer;usa;2;6;1;7;0
5e7b16cd8a01bf777e16fa8a8dd8f61592872968;Mon Dec 15 10:08:48 EST 2008;Committer;usa;2;6;0;6;0
29de254722ae2e759fbb7bdeb3ff559f9743f79e;Mon Dec 15 09:14:16 EST 2008;Committer;matz;2;6;3;9;0
dff56ef2b10d2ea010d31473c63af10e7ec30311;Mon Dec 15 07:52:04 EST 2008;Committer;matz;1;20;39;59;0
bf43871dce112a8a1358039c93a8d7fcde23faae;Mon Dec 15 07:28:39 EST 2008;Committer;nobu;1;4;2;6;0
8c8d666467eb3f94920592f63f56d1d4354350a0;Mon Dec 15 07:26:48 EST 2008;Committer;nobu;3;25;1;26;0
3a5c0bbcb5615b063d32aeee35b4f0f4227fb693;Mon Dec 15 06:23:43 EST 2008;Committer;yugui;3;232;20;252;0
13aaff3e9f471e2ecdca968476c34d66778730f4;Mon Dec 15 06:13:24 EST 2008;Committer;nobu;3;7;2;9;0
465bad4147f014a406083831552b95317c019841;Mon Dec 15 06:02:27 EST 2008;Committer;nobu;2;7;1;8;0
f6147010c7bdcfae90de759003f7ffd338348bef;Mon Dec 15 05:39:39 EST 2008;Committer;nobu;2;14;1;15;0
d5b7e690320e969d77be665927fe8a493aa5806d;Mon Dec 15 05:15:26 EST 2008;Committer;nobu;3;38;38;76;0
94fc275e16390962cb06653033078894987ac76f;Mon Dec 15 02:35:29 EST 2008;Committer;nobu;2;5;1;6;0
f4032984491d328dbb6f4f7aac706ed8e21f420f;Mon Dec 15 02:32:21 EST 2008;Committer;nobu;2;38;12;50;0
23f72026a46cd9ba64f249df4ec379d64952832b;Mon Dec 15 01:00:38 EST 2008;Committer;nobu;3;8;3;11;0
43a9e10a23b173a19932f51ec7896863d13b7b8d;Sun Dec 14 13:39:33 EST 2008;Committer;mame;2;38;54;92;0
26fc24fb0b98ee82f82732ca308176a29ae1d419;Sun Dec 14 12:15:07 EST 2008;Committer;mame;2;8;4;12;0
bba7733b2030a52fe226b993296d11309b127f3a;Sun Dec 14 05:55:54 EST 2008;Committer;mame;2;5;10;15;0
cf359579a56a3bdf56c8ccb44e71af5e51fc567a;Sun Dec 14 05:37:42 EST 2008;Committer;mame;1;1;1;2;0
c4f8143b64f427dde211efddc85a6a2a80b479ee;Sun Dec 14 05:32:35 EST 2008;Committer;yugui;2;28;18;46;0
c5b86a31d5f051906797f9bc410ad24d834491ab;Sun Dec 14 04:17:26 EST 2008;Committer;mame;1;1;1;2;0
19f45f853c125ff744c53bd548f29f891c76c28b;Sun Dec 14 03:59:02 EST 2008;Committer;mame;4;366;68;434;0
529ad093d42bd6ab802449747bf08a400563e12d;Sun Dec 14 03:52:13 EST 2008;Committer;akr;1;46;0;46;0
834e3662ba8c87633d7b90640f5c4bead594d845;Sun Dec 14 00:28:10 EST 2008;Committer;yugui;2;6;6;12;0
c0bf7abb2194435a2db7d113c4bef5ae5a8b7be6;Sat Dec 13 16:40:06 EST 2008;Committer;svn;1;2;2;4;0
6e03277db0fc91b496b7f2e70640a50159797100;Sat Dec 13 16:40:01 EST 2008;Committer;akr;3;100;62;162;0
f3634e5dc82e3eacfb9078681f8f46454b3df092;Sat Dec 13 13:20:26 EST 2008;Committer;yugui;2;24;8;32;0
3d28b3bf3b965f828de09274996d9ac936b8e9ce;Sat Dec 13 10:35:06 EST 2008;Committer;matz;2;7;4;11;0
0241c6506f7380198071432520c16eb3ffddde34;Sat Dec 13 08:09:23 EST 2008;Committer;matz;2;18;1;19;0
d6023d88a2bead42ab9be0a79b651171c0b1c18b;Sat Dec 13 08:07:40 EST 2008;Committer;matz;2;6;2;8;0
87f6de3e189195392afa55f1d2d8a095ee3344f3;Sat Dec 13 07:08:56 EST 2008;Committer;yugui;2;7;1;8;0
e53990e4bdbf1fc5aa36e5f2150d118f6e324106;Sat Dec 13 06:58:58 EST 2008;Committer;kouji;2;6;1;7;0
ada58fe0130d7818bd4189a76656d2afc34f4268;Sat Dec 13 05:26:37 EST 2008;Committer;yugui;2;6;1;7;0
a6c69a7d35e23be3362d5885f93e2c979af79ac6;Sat Dec 13 04:45:56 EST 2008;Committer;yugui;2;12;3;15;0
ac6e87fc598355130a00a90d2e94343fca558f82;Sat Dec 13 04:05:25 EST 2008;Committer;tadf;3;17;11;28;0
dd2a86cf115d7e23673c75ba9f28f2699a1443f1;Sat Dec 13 03:49:46 EST 2008;Committer;yugui;2;16;11;27;0
3b1a65add329a757be6679282d3d3206e58cff2e;Sat Dec 13 03:41:01 EST 2008;Committer;yugui;2;12;2;14;0
ac6024f5221862e628d1ba201cbc422a672a9dc8;Sat Dec 13 00:22:31 EST 2008;Committer;ryan;4;22;9;31;0
0e0c53a09246b4058db69430e3701e7dee0b198a;Sat Dec 13 00:03:18 EST 2008;Committer;tadf;1;1;1;2;0
2209f072fc15c94f21ac5d801b061b11d7e8a891;Fri Dec 12 23:59:36 EST 2008;Committer;tadf;1;5;5;10;0
8729368f14b282cb64a7848ee515e0d4240ee57a;Fri Dec 12 23:40:55 EST 2008;Committer;tadf;6;29;24;53;0
b7e026fb3fffdb05b6f6915a58049c7abf1b572a;Fri Dec 12 16:15:09 EST 2008;Committer;kouji;1;6;0;6;0
86a625f8bbf940fb309ee4d027378d66fd2e82b0;Fri Dec 12 16:13:14 EST 2008;Committer;svn;1;2;2;4;0
8b123714e2f48d5aba6b48568b80352ead80d0ed;Fri Dec 12 16:13:11 EST 2008;Committer;kouji;2;15;10;25;0
75fbac3b0db735de6ff72b171096855b5ded77d4;Fri Dec 12 13:13:44 EST 2008;Committer;tadf;3;12;10;22;0
02a37bee67dd3a38fe5fa143fd27e59b563ebb0c;Fri Dec 12 12:44:08 EST 2008;Committer;kouji;2;19;10;29;0
58740ef8816557481c752889392b4ee148fe94aa;Fri Dec 12 10:35:39 EST 2008;Committer;yugui;2;17;1;18;0
63a534194cddc07af7ed2bbff56fcc061fcc2e29;Fri Dec 12 10:35:31 EST 2008;Committer;yugui;2;12;5;17;0
74ea7d93c13af0e87ab76b29c52dbdbb6ac3dbc0;Fri Dec 12 10:17:01 EST 2008;Committer;kouji;2;7;1;8;0
cfb8e8301e7be7189f2afebc5a5f3e50a55683dc;Fri Dec 12 10:04:42 EST 2008;Committer;kouji;2;16;15;31;0
1757d800765a59bd6e90fa18648b73f6dbd2a44b;Fri Dec 12 09:46:28 EST 2008;Committer;knu;2;51;177;228;0
cef2867e6653c0f607e38d20384d4305280cf598;Fri Dec 12 09:42:26 EST 2008;Committer;knu;2;839;0;839;0
303c28d49b7a0990d597b753f9976a10d1e26a2f;Fri Dec 12 07:23:24 EST 2008;Committer;nobu;2;7;10;17;0
aa06e69000ef8e1ba440925462672f359f91c48d;Fri Dec 12 05:25:39 EST 2008;Committer;yugui;4;42;17;59;0
d7f67b4970975c9fdd06d7fe9426468c2e3fef2c;Fri Dec 12 02:00:55 EST 2008;Committer;nobu;2;29;1;30;0
1eeeb00a0a9e3316e7ac881d5201e6601335dc12;Fri Dec 12 01:28:10 EST 2008;Committer;nobu;2;1;3;4;0
8e3bf17b03f823872e03c4af617c47390411f3b6;Fri Dec 12 01:20:57 EST 2008;Committer;nobu;3;6;6;12;0
dab7d5d8e3047fa309ac3dcb8496a2a271f90f0e;Fri Dec 12 01:19:23 EST 2008;Committer;nobu;2;15;4;19;0
279363b6150fb606a33a6f76386519af307cfd04;Thu Dec 11 15:11:18 EST 2008;Committer;svn;1;3;3;6;0
0d7f4ad8280aa09348488667986c656b7070521f;Thu Dec 11 15:11:14 EST 2008;Committer;tadf;2;4;5;9;0
50c1da22df2f499647bc52daab162f2aa0256fbc;Thu Dec 11 14:49:54 EST 2008;Committer;tadf;2;6;1;7;0
876e1b87e7c0f2175932d7814c4ffbd272e01471;Thu Dec 11 12:06:26 EST 2008;Committer;kou;9;86;13;99;0
7ff55ae6bbed1e508837325e35a2fadd4471aa36;Thu Dec 11 12:03:51 EST 2008;Committer;kou;1;1;1;2;0
9f37bc558c40553586b58e9e6a508612e0c2f438;Thu Dec 11 11:25:49 EST 2008;Committer;knu;1;0;5;5;0
566e7da773c9b374c5919e053c7dd420ec226806;Thu Dec 11 11:09:02 EST 2008;Committer;knu;1;4;1;5;0
e5f1572583412271d7cc6cce30f6d792a114d930;Thu Dec 11 11:05:21 EST 2008;Committer;nobu;2;5;0;5;0
cbc6a104b2a9d4dd3e171c42ac5cd28d61cb11d8;Thu Dec 11 10:40:24 EST 2008;Committer;akr;4;130;112;242;0
240378856b9db2de9bc22537bc22b664d5e0559a;Thu Dec 11 10:25:05 EST 2008;Committer;akr;2;26;11;37;0
120ab4b826c901c642fb93c06fa7ed728cb84270;Thu Dec 11 10:21:14 EST 2008;Committer;akr;2;9;0;9;0
3060c7438d99e23ee0f2e35275dce45d4684d9be;Thu Dec 11 04:40:08 EST 2008;Committer;matz;2;10;2;12;0
28d1621d100a4f0c72e5343fecfbc0d58fd3c93d;Thu Dec 11 04:36:20 EST 2008;Committer;nobu;2;82;39;121;0
31c163e4c8ad926076d90005ad18f4e964cc9c7e;Thu Dec 11 04:17:10 EST 2008;Committer;nobu;2;16;2;18;0
84b5d04bed4598d63c41389655bd060a8caed798;Thu Dec 11 02:51:46 EST 2008;Committer;nobu;2;20;5;25;0
36eed7bdfbba432b220cc4e225f20dffcabc6e4f;Thu Dec 11 02:11:09 EST 2008;Committer;nobu;2;18;0;18;0
8249d674fd1fb88c0c2abbd450712771f68a713a;Thu Dec 11 01:26:59 EST 2008;Committer;matz;2;6;12;18;0
bc53f80b3791d3c73db44c2e454c98172a84917f;Thu Dec 11 01:20:23 EST 2008;Committer;matz;4;16;1;17;0
54a722bd42a1135e4ee064137ffeac86a7784328;Wed Dec 10 18:00:51 EST 2008;Committer;matz;2;49;32;81;0
3266ec1658e77c0cfcdd5d56cf1ccdab90482150;Wed Dec 10 17:24:42 EST 2008;Committer;akr;3;112;20;132;0
b314ab3e4406ff8f9ceb7dd60b5b1a302f02e6ef;Wed Dec 10 17:18:31 EST 2008;Committer;akr;1;1;1;2;0
82c719c3376a868834d45c4c995a4a2832616aed;Wed Dec 10 16:54:43 EST 2008;Committer;matz;2;13;2;15;0
bd4d9e9a356def5be49b28be86240f5efd04489b;Wed Dec 10 16:30:40 EST 2008;Committer;matz;2;6;1;7;0
2c91d4ea9c2311a4034543893f70d4aa52089dee;Wed Dec 10 15:01:57 EST 2008;Committer;tadf;1;1;1;2;0
f335104b93aa7a1093cb43293da904d3d7f77563;Wed Dec 10 15:00:18 EST 2008;Committer;svn;1;3;3;6;0
32bc8415715c8321a8c732d80ade9856ac98ad48;Wed Dec 10 15:00:13 EST 2008;Committer;tadf;3;24;0;24;0
1e5fbe04f64e02819236cfd381790a79f87171c8;Wed Dec 10 12:34:09 EST 2008;Committer;kou;2;17;5;22;0
820c409ce99f366c524f3b77835d5629eb3635ac;Wed Dec 10 03:58:56 EST 2008;Committer;knu;2;12;0;12;0
1ed799937b3ffba6b3215c9130587a529b72ef3f;Wed Dec 10 03:49:48 EST 2008;Committer;knu;3;8;2;10;0
d433a70b5dca5c501e53d89e155f7bbba17fdbc7;Wed Dec 10 02:29:05 EST 2008;Committer;naruse;2;10;0;10;0
e8da366e042b102747ed04c9be9a5c5f93b35891;Tue Dec 09 16:29:18 EST 2008;Committer;svn;1;3;3;6;0
a091c9e18f3c705b23442066d7744df4daf1aa7a;Tue Dec 09 16:29:08 EST 2008;Committer;usa;2;5;1;6;0
a28fdecda7bfd3f5a5013fc9067c676d4c0ffb35;Tue Dec 09 09:39:25 EST 2008;Committer;duerst;9;915;32;947;0
9e8367ad464738d151ca7d607b8deca2744316c1;Tue Dec 09 07:17:10 EST 2008;Committer;nobu;1;5;5;10;0
001d3930199cd113a2fdd42c487a24a9775a4d34;Tue Dec 09 07:14:13 EST 2008;Committer;nobu;16;19;19;38;0
b2e82f2dfbb35fd643d6c4c6e0f738e5f51770ac;Tue Dec 09 04:46:54 EST 2008;Committer;nobu;1;31;31;62;0
7f3676493866c5cef084cf267f00b2bf756bfddd;Tue Dec 09 04:42:51 EST 2008;Committer;nobu;1;189;189;378;0
541915b2392bd329a8db8fdd4f3ab1e3ea11a100;Tue Dec 09 04:33:55 EST 2008;Committer;nobu;10;44;34;78;0
3cde544d476b8debc71094decb4c515d07f88679;Tue Dec 09 04:31:41 EST 2008;Committer;matz;3;54;1;55;0
fe867f47ac42604cbbefddeae18c88ceab223235;Tue Dec 09 04:25:54 EST 2008;Committer;nobu;4;8;5;13;0
47c2b02f2b6e363cdf2c1014ce139fedaa69c77a;Tue Dec 09 04:23:20 EST 2008;Committer;nobu;2;5;1;6;0
e44aeea84a9db35c0759937c22c36e0f2774a68a;Tue Dec 09 03:08:49 EST 2008;Committer;nobu;2;5;1;6;0
e41fb7d4ae6a421d0950201864817ef6cd892b82;Tue Dec 09 02:51:10 EST 2008;Committer;yugui;2;10;2;12;0
e2273eac85d03b504242c14b642778936f03f585;Mon Dec 08 18:21:47 EST 2008;Committer;nobu;2;10;6;16;0
ca138145f51e527901a4a498ef71592778fa1c83;Mon Dec 08 17:00:44 EST 2008;Committer;akr;1;16;2;18;0
b16baa9272fbc9309614a625f7a1ad4876d6c839;Mon Dec 08 16:47:47 EST 2008;Committer;matz;2;8;3;11;0
70cf909fddaa3a4b1e08c1bfb6cfa6fdb12c4c8c;Mon Dec 08 16:46:48 EST 2008;Committer;matz;2;18;0;18;0
aeec60621a5d0882d4b9864327a0b5bd49447f17;Mon Dec 08 15:54:05 EST 2008;Committer;nobu;2;13;0;13;0
a6d8d84a9ecd4c630e05d1d08bbb45c8d4641089;Mon Dec 08 15:17:52 EST 2008;Committer;nobu;4;16;6;22;0
0945f41a5fbc0f935d9fc92cf7f60720563b2695;Mon Dec 08 14:41:44 EST 2008;Committer;yugui;2;9;1;10;0
92e0f99d375648b9f12dd25a556eace54a3aa6af;Mon Dec 08 09:31:44 EST 2008;Committer;nobu;3;19;2;21;0
774f924db9bd7abc7284256704f4cc63e568e63e;Mon Dec 08 02:28:17 EST 2008;Committer;nobu;2;67;43;110;0
ba274d1f46ac76593cfff79b735c64de568cc008;Mon Dec 08 02:15:47 EST 2008;Committer;nobu;1;9;0;9;0
ecc83033ba33c15e1dc0602ee524e163d42a7fd4;Mon Dec 08 01:32:36 EST 2008;Committer;nobu;3;46;34;80;0
a41eedddd3226e21a0855f90b7c4efd995245ee1;Sun Dec 07 14:54:43 EST 2008;Committer;nobu;1;6;6;12;0
f65395f72ec0756f028d8380464f91f5a7f99cd4;Sun Dec 07 14:47:39 EST 2008;Committer;nobu;2;11;2;13;0
a2a53430330e8d010a479c6e85e9f2cf178efdf0;Sun Dec 07 14:17:36 EST 2008;Committer;nobu;3;14;1;15;0
920ea359baab9c09da72aca330eddd2a3e5cce6a;Sun Dec 07 12:35:11 EST 2008;Committer;akr;1;2;0;2;0
7c20c4ec02e5cf3da75954b17fa4a9bb303414eb;Sun Dec 07 10:34:25 EST 2008;Committer;akr;1;11;0;11;0
c0264efadda2353455ef1d009c258f1cb8fda5bb;Sun Dec 07 08:45:31 EST 2008;Committer;akr;3;37;31;68;0
0884ca04bfe1a75f5935821ab4c1442dd5f0e72e;Sun Dec 07 02:49:22 EST 2008;Committer;svn;1;3;3;6;0
1de2a15aaf80a0ce7c56caa4fe8d063a95631a74;Sun Dec 07 02:49:18 EST 2008;Committer;akr;2;68;6;74;0
0b314ffd8764f1d493c4b7246a5437557b323a12;Sat Dec 06 12:52:43 EST 2008;Committer;akr;1;24;14;38;0
82a0e61e6ed4e015cde61848cce4d8d05dac8920;Sat Dec 06 09:33:20 EST 2008;Committer;nobu;3;7;1;8;0
4b983b90c4cd84cc1d7de013268f2fbfe96edb57;Sat Dec 06 08:55:57 EST 2008;Committer;yugui;3;9;1;10;0
343deb4c39747be1a373d9ab9193d9798045f8ee;Sat Dec 06 05:37:20 EST 2008;Committer;naruse;2;12;0;12;0
83b37cfc4f03168b97fc6f224624fe1ec2414d9e;Sat Dec 06 01:05:57 EST 2008;Committer;akr;1;1;1;2;0
c087e70c22a87b17acb2e0275240a2a6b81410ee;Fri Dec 05 15:10:02 EST 2008;Committer;svn;1;3;3;6;0
41a3fbff5f7482f84c169207c04222e55b805a41;Fri Dec 05 15:09:59 EST 2008;Committer;akr;1;37;20;57;0
d5d39dd3fed5f6d3024581eabf023cd9bbee6b24;Fri Dec 05 12:47:07 EST 2008;Committer;tadf;2;27;9;36;0
2d3f41d19fae8a33deb460987ab40251a028c5e6;Fri Dec 05 12:44:06 EST 2008;Committer;tadf;2;14;4;18;0
8c07972702051ccbca16747c1dedcaebf74f08b2;Fri Dec 05 12:09:49 EST 2008;Committer;xibbar;1;1;1;2;0
415e2cbd88b1af7c81292d762f15969d78643bfa;Fri Dec 05 10:07:13 EST 2008;Committer;akr;3;166;28;194;0
1385ce5f89ddbc0660677a136fb785ab10cf08b2;Fri Dec 05 10:00:36 EST 2008;Committer;akr;1;37;27;64;0
3406ddcb335ad8ff6746b6af4d4dd7a3f8017aa9;Fri Dec 05 09:58:23 EST 2008;Committer;akr;2;5;1;6;0
5d65e0982d294e312602e3aef1f4b79c0f0cc0c1;Fri Dec 05 09:08:24 EST 2008;Committer;usa;2;17;0;17;0
f6d18c3f2acaac0071ad38e06d9de8ea50489da1;Fri Dec 05 04:05:48 EST 2008;Committer;nobu;4;51;22;73;0
ed19ff6bdb7c194212bb3bcfd013472870cf4815;Fri Dec 05 03:38:50 EST 2008;Committer;nobu;2;7;1;8;0
794eb7bc496931d8ffa3111d5723cbcbdacf7b89;Fri Dec 05 03:35:48 EST 2008;Committer;nobu;5;42;29;71;0
cc1401e50499e0a4655e1bb3e115a8812b450753;Fri Dec 05 01:01:53 EST 2008;Committer;nobu;2;7;2;9;0
5dbbef2b0219367ad98c5ae172195e0143073bc4;Thu Dec 04 23:03:53 EST 2008;Committer;akr;1;14;17;31;0
4433defb46f2324baef5a9a2e1b7b40a0391ea5d;Thu Dec 04 22:59:25 EST 2008;Committer;akr;2;5;1;6;0
8e864d1e8628a99a2187044f5c987f802dee6ab0;Thu Dec 04 18:29:20 EST 2008;Committer;nobu;5;90;47;137;0
0b10c320795e0784d9e4d269ece8f53f79ff3dd6;Thu Dec 04 16:39:55 EST 2008;Committer;usa;1;13;7;20;0
53e7e2d2a136c1aa4b859fc7e6590ef793c6bd11;Thu Dec 04 16:39:07 EST 2008;Committer;nobu;1;8;8;16;0
a9a4435e12ea2ea02d387b1599c855b28ff10757;Thu Dec 04 16:39:03 EST 2008;Committer;usa;3;61;3;64;0
c7bd98b7b8848f7d20b44cdb4878d024c3692bc4;Thu Dec 04 16:35:10 EST 2008;Committer;nobu;2;5;1;6;0
408ca7cbb1e0d7866405fe1a6b3aa6f4dc8409fb;Thu Dec 04 16:20:02 EST 2008;Committer;matz;2;6;0;6;0
80a3f22b77d1be4e06e8246d07b0eaeaaf1d8e35;Thu Dec 04 15:35:08 EST 2008;Committer;usa;2;19;1;20;0
49b10fd508850e396f181101770948aaf8517922;Thu Dec 04 15:21:32 EST 2008;Committer;akr;2;23;10;33;0
f149326740c4d684de70564ecec88263e01bd3d3;Thu Dec 04 15:17:21 EST 2008;Committer;nobu;2;30;2;32;0
bec3fed1350c3fc8e4bc34c8d3e30ef031bd77f5;Thu Dec 04 15:03:16 EST 2008;Committer;svn;1;3;3;6;0
e7562555c48bf020cfcd015cf556f09d7bb43bae;Thu Dec 04 15:03:12 EST 2008;Committer;akr;1;2;2;4;0
21d438243dd1afb335277e8cbef801eff07c0346;Thu Dec 04 14:35:19 EST 2008;Committer;akr;1;7;0;7;0
8068f497271643dea2842bcddb37bb41c5dd72fd;Thu Dec 04 14:31:37 EST 2008;Committer;usa;2;19;1;20;0
bca9bf7feff03118ebb9ab58ff57f8f8216d64c4;Thu Dec 04 14:24:54 EST 2008;Committer;akr;3;121;10;131;0
644d1e7a477ac94f0f8f353a708d39c6fe2927c8;Thu Dec 04 14:06:24 EST 2008;Committer;yugui;2;6;8;14;0
a821725ab0df0cbec2a8644498644c9f826d49c8;Thu Dec 04 13:14:25 EST 2008;Committer;tadf;3;48;1;49;0
d681d98052c9fd5060dc5fe6f1462bb27db533c1;Thu Dec 04 11:45:54 EST 2008;Committer;akr;1;50;29;79;0
87c7905bdc985a9f04b01dd5b38f44bdd6808d4f;Thu Dec 04 10:58:32 EST 2008;Committer;akr;3;327;139;466;0
a112ec787acb1ca84e1a4d6fb5a58f99718c1b1b;Thu Dec 04 10:17:34 EST 2008;Committer;akr;3;50;17;67;0
2bb4ca64f9a51a9c0830d6cf5c635db73cd00763;Thu Dec 04 07:58:55 EST 2008;Committer;matz;2;6;0;6;0
57f7d8c2cde720bcc5d2831f863ae1c8981e6275;Thu Dec 04 07:21:10 EST 2008;Committer;matz;3;99;6;105;0
8a8226fa3b5da2ce567bab9f0afaadf6db02a51d;Thu Dec 04 07:17:27 EST 2008;Committer;matz;2;6;1;7;0
c69b59c43f4b5cffada5c05347b78038e86d4529;Thu Dec 04 05:55:36 EST 2008;Committer;matz;2;6;1;7;0
f5332d6b5e79023c53c530317efe57bc12a92f42;Thu Dec 04 05:52:30 EST 2008;Committer;matz;2;3;1;4;0
782576a5199264be07fd9d5be1629eca4aa92c7d;Thu Dec 04 04:57:58 EST 2008;Committer;matz;3;14;3;17;0
ea465ecda743fdfb1fb007ef951ff352e647102f;Thu Dec 04 02:44:38 EST 2008;Committer;knu;2;68;0;68;0
f259918c81b8cbf15755a0e2ee384079fd1b9c05;Thu Dec 04 02:39:55 EST 2008;Committer;knu;2;6;10;16;0
c5d06834d2f4411362abd435fc660be988d74574;Wed Dec 03 21:09:31 EST 2008;Committer;nagai;1;5;0;5;0
694fab958cca3a0717459ba743d6de0bd7456c16;Wed Dec 03 21:03:49 EST 2008;Committer;nagai;1;2;2;4;0
57746bb6fa6e52c314f4106f7338fef37e3cfe4a;Wed Dec 03 20:10:28 EST 2008;Committer;nagai;3;10;3;13;0
ef38a43c50aa88f7e0e03f86aa5868dee91e449c;Wed Dec 03 16:43:01 EST 2008;Committer;tadf;3;20;10;30;0
28c53aabcad4ec41916ad5e72203022769ab73f5;Wed Dec 03 16:28:17 EST 2008;Committer;tadf;2;13;7;20;0
ec324872d535f22c4458b3520f392c6de703aa8e;Wed Dec 03 15:02:49 EST 2008;Committer;akr;1;19;9;28;0
a30be4c3195b8f73c64a8243a6ad6038908bd8c7;Wed Dec 03 15:02:15 EST 2008;Committer;svn;1;3;3;6;0
30b8f1ee2be229690c27e61e451c1d6b82e5eeb7;Wed Dec 03 15:02:10 EST 2008;Committer;akr;3;154;19;173;0
8c01ec883afec88ca496c9f63fd6c98cbc76c5dd;Wed Dec 03 13:54:42 EST 2008;Committer;nobu;2;8;3;11;0
6e0f413f0188e48fa68d392dcb946b693a57da13;Wed Dec 03 13:41:01 EST 2008;Committer;nobu;2;7;3;10;0
ca209c80e9ab2911793a8d348514698c3124214b;Wed Dec 03 12:33:37 EST 2008;Committer;akr;3;22;0;22;0
e98e384be0f0f0b82302b0dc4e0e1f65d1d63470;Wed Dec 03 12:19:05 EST 2008;Committer;tadf;2;4;3;7;0
13424f32fe761c8b10bd86ac8ebc2d88a21da268;Wed Dec 03 05:48:55 EST 2008;Committer;nobu;2;14;11;25;0
f71dcc1b542fc0389e4a7cf05ac4b59e8197a998;Wed Dec 03 03:24:10 EST 2008;Committer;nobu;1;2;2;4;0
aa39c4491a93992ae6f536179af447ab48e5ffa8;Wed Dec 03 03:22:12 EST 2008;Committer;nobu;3;13;6;19;0
684f94c0edfca1d2ffbb9caefca95310f4f1da31;Wed Dec 03 00:31:58 EST 2008;Committer;matz;2;18;0;18;0
7fd3ac4895af97a69e96ce303e56896e6243df41;Tue Dec 02 17:58:17 EST 2008;Committer;mame;2;7;0;7;0
181ffea5e040705d03603365ca5527d9e0676c5d;Tue Dec 02 17:53:48 EST 2008;Committer;mame;2;13;0;13;0
0863013b967b5d9c97c739a0311c3c0d9a3f6b5f;Tue Dec 02 17:26:31 EST 2008;Committer;mame;2;47;0;47;0
3e2311f66c182bbbcdfb7350ee85d9960750046f;Tue Dec 02 17:05:50 EST 2008;Committer;svn;1;3;3;6;0
0646c1e0d6fbb414203948ace6485428d28b5bea;Tue Dec 02 17:05:46 EST 2008;Committer;mame;2;5;1;6;0
852b4629c16a2a568c075d0645fee58b95788610;Tue Dec 02 10:23:48 EST 2008;Committer;akr;3;298;19;317;0
e44a6c470834afb67c596206461b66f329398962;Tue Dec 02 10:00:10 EST 2008;Committer;akr;2;28;26;54;0
db197f296fa0d8d1f3b21f8cfa644eb3e0c5971b;Tue Dec 02 08:52:19 EST 2008;Committer;akr;1;26;0;26;0
348d715eaa24989fffd02c3c073188d555969bb8;Tue Dec 02 06:34:19 EST 2008;Committer;matz;2;16;3;19;0
a01e1cfb5b56b3a9e8509d9cf04f5bcfba7caceb;Tue Dec 02 06:14:37 EST 2008;Committer;usa;1;2;3;5;0
df5e7b9dbed13f873596e7f24bf0c757f1eac796;Tue Dec 02 06:02:27 EST 2008;Committer;svn;1;3;3;6;0
14c06bd441e3540148abe929b12ea0b1a8c6f15c;Tue Dec 02 06:02:23 EST 2008;Committer;usa;1;4;4;8;0
67b445f895b2b887acec63172d012ee1f98f833a;Mon Dec 01 14:24:48 EST 2008;Committer;yugui;2;8;4;12;0
13a79948fee9877d3f946c11a0fd9b5d4366e9c3;Mon Dec 01 06:49:34 EST 2008;Committer;usa;2;9;2;11;0
a918afe05e2f3534e262d16827f94463e021f096;Mon Dec 01 03:00:48 EST 2008;Committer;nobu;3;16;2;18;0
dd9f8e5ac9fc99da0fccf0eac80ebce8ea81e3ff;Mon Dec 01 02:35:17 EST 2008;Committer;svn;1;4;4;8;0
4586802dffb1472e3b22a5c308a1bd74a6dbdbe5;Sun Nov 30 12:42:01 EST 2008;Committer;yugui;2;173;0;173;0
f8a577aa4e4fc73abc3333aaf0c5ba6a17d2d578;Sun Nov 30 09:48:30 EST 2008;Committer;yugui;1;1;1;2;0
1fe2fae259a113bd73fe55ab0853fcf220e41dfd;Sun Nov 30 09:04:51 EST 2008;Committer;yugui;2;8;1;9;0
e49315f9f3956df7db94335c3eefa809f739e30f;Sat Nov 29 15:00:53 EST 2008;Committer;svn;1;3;3;6;0
56d19a9e8bbdbd00eaa553b876db6718f641fb7d;Sat Nov 29 15:00:48 EST 2008;Committer;yugui;2;22;0;22;0
2a86c3e86a309b4fa82b22aa559a07a1e582e638;Sat Nov 29 14:26:47 EST 2008;Committer;yugui;1;1;1;2;0
f7692a33733cba872709828d505c9293684bfaca;Sat Nov 29 10:55:51 EST 2008;Committer;matz;2;9;0;9;0
23e6fc744ef584a04ad29c8fefd8886ce46bf2be;Sat Nov 29 09:30:46 EST 2008;Committer;matz;2;6;1;7;0
7701fde3b7e6c5bd2f57ea38814cc405158f88c1;Fri Nov 28 15:23:13 EST 2008;Committer;svn;1;3;3;6;0
776af67b282cea12f9256f566ab7d5543a40b453;Fri Nov 28 15:23:09 EST 2008;Committer;matz;2;31;17;48;0
46e431e3eb410a6168cd885ac0a327a4b74c9fde;Fri Nov 28 09:32:20 EST 2008;Committer;matz;2;23;37;60;0
3c6b1bfbe42623cfadc4a8ba7d4e246d023ab422;Fri Nov 28 09:00:31 EST 2008;Committer;keiju;1;1;1;2;0
157ed5c6749feb61d520cb61f661a0352026d235;Fri Nov 28 08:59:20 EST 2008;Committer;keiju;2;116;18;134;0
46e3b0fe7b1d39bd783d1bab539f5624e80d73d6;Fri Nov 28 04:19:37 EST 2008;Committer;nobu;5;273;2;275;0
4d3f3af83689790f21b344abbfbe6bbdd483813e;Thu Nov 27 17:20:08 EST 2008;Committer;matz;3;10;7;17;0
6fd76fdb142b439d697d374a74a664a61c879ce6;Thu Nov 27 16:01:58 EST 2008;Committer;svn;1;3;3;6;0
90add5db4515dd5f2c1267edcd821c6e370559db;Thu Nov 27 16:01:54 EST 2008;Committer;matz;3;7;3;10;0
ce5063c283da688ecb3d020ac218858751a0410f;Thu Nov 27 14:55:45 EST 2008;Committer;matz;2;18;6;24;0
24a6416355e2d796aff643493cb273858e91b241;Thu Nov 27 12:43:05 EST 2008;Committer;tadf;2;5;0;5;0
ab9fd5dbf79cd6316fd49e42fa57dbb77500f539;Thu Nov 27 07:32:56 EST 2008;Committer;nobu;2;19;14;33;0
550f10ca5be5018f78df5c4a7e42430ab96f7b9d;Thu Nov 27 07:12:35 EST 2008;Committer;nobu;1;8;4;12;0
079505c040dd5cbf734816ec3b656b5921c977fc;Thu Nov 27 06:59:19 EST 2008;Committer;nobu;2;17;2;19;0
7348aa6113cdc2c9ce62044ab83f2ac1db82816d;Thu Nov 27 06:05:07 EST 2008;Committer;nobu;4;131;4;135;0
fc75648baff072ec223d88fdb86b3384e22ea71f;Thu Nov 27 01:43:19 EST 2008;Committer;svn;1;3;3;6;0
5337b9b5f6c97e4b002253b83a87e88119b13cfa;Thu Nov 27 01:43:14 EST 2008;Committer;matz;2;12;1;13;0
b0f3bd5d25cc92c427baa58913bff70e792244e6;Wed Nov 26 14:30:25 EST 2008;Committer;matz;2;14;9;23;0
0434b0f0986cf6e0100f605fb27c1c871075b1da;Wed Nov 26 14:04:58 EST 2008;Committer;matz;4;21;9;30;0
527701d55ba63b20ee4379cd5ed8260f00387a6f;Wed Nov 26 13:41:59 EST 2008;Committer;akr;1;32;2;34;0
27e3cc841cb7c991f40247632a98ddb614494fbc;Wed Nov 26 06:39:14 EST 2008;Committer;kazu;2;5;0;5;0
93283e75529ad1b9ec3f2b302d5e43c394863af3;Tue Nov 25 18:19:07 EST 2008;Committer;matz;2;22;12;34;0
a426373520a0d633b23be87425b05ac86ed45127;Tue Nov 25 18:02:42 EST 2008;Committer;matz;3;70;45;115;0
20681e37cacb24ddf2d6fb39dab2ff290e6863ca;Tue Nov 25 15:28:26 EST 2008;Committer;svn;1;3;3;6;0
6099790621b5fe7c12f5b9a3b4ab5b6e3d952e57;Tue Nov 25 15:28:22 EST 2008;Committer;matz;2;11;1;12;0
405b5272766ae305c0e54267923c6950a739c262;Tue Nov 25 14:29:39 EST 2008;Committer;matz;2;10;1;11;0
446ea127c331f14701a993f404e3a930055173cf;Tue Nov 25 14:24:47 EST 2008;Committer;matz;2;14;4;18;0
a689e57283121d1e3ab2a9697459839828317b17;Tue Nov 25 04:42:11 EST 2008;Committer;matz;2;6;1;7;0
15b183c218d488f25567cf126cb379524966746c;Tue Nov 25 00:24:01 EST 2008;Committer;matz;2;10;2;12;0
9a206a80396687c9b0ed9f8c7c5b63d443837f5d;Mon Nov 24 18:49:43 EST 2008;Committer;nagai;5;189;18;207;0
012fee947633cf88ebeb6158ee140d1e2d051db0;Mon Nov 24 18:40:07 EST 2008;Committer;matz;2;14;4;18;0
4671724697312a86e9379eb253c062bcc2022e7e;Mon Nov 24 16:26:00 EST 2008;Committer;tadf;3;24;0;24;0
4d6d0a933e93fa56865f4b82131a306374f4d505;Mon Nov 24 15:08:24 EST 2008;Committer;nobu;4;18;7;25;0
361a713f9666305bfbc82bb60da0c6f10d801483;Mon Nov 24 14:29:37 EST 2008;Committer;shugo;3;30;0;30;0
3380a05bd6d5b3df1ddfba974d88b7e82a85b9ee;Mon Nov 24 14:25:45 EST 2008;Committer;matz;2;15;8;23;0
bf1d53e2e0c32af95f852f30884bd6d1fcf1a077;Mon Nov 24 14:01:47 EST 2008;Committer;shugo;3;32;10;42;0
aa498028b28b709db51408c0855163cc8adfbb8b;Mon Nov 24 13:10:07 EST 2008;Committer;shugo;3;9;3;12;0
32aed810463a40807db2192c91faa7cec2cb23d5;Mon Nov 24 12:42:45 EST 2008;Committer;shugo;3;16;4;20;0
153785583347f51faf028396c177b2421ffb122c;Mon Nov 24 10:55:00 EST 2008;Committer;tadf;4;11;5;16;0
417b288d07d9befe639428a3443af1c9abe03d0a;Mon Nov 24 09:38:05 EST 2008;Committer;svn;1;3;3;6;0
66041e3e230bd5439cd6f5337aa887cb2b1c7e68;Mon Nov 24 09:38:00 EST 2008;Committer;matz;2;33;28;61;0
0abd67ea190c4cb7deacc227c2c9e9e945ac9598;Sun Nov 23 07:07:34 EST 2008;Committer;yugui;2;9;0;9;0
7606241c6e762a992b358c08956cf63cf6debbde;Sun Nov 23 04:17:57 EST 2008;Committer;svn;1;3;3;6;0
7c9a77f88031afaba8338cf7188bfa7391f8a06a;Sun Nov 23 04:17:52 EST 2008;Committer;yugui;2;9;0;9;0
31c82916188aa9f42832b8694da7bd5fc0048e15;Sat Nov 22 14:41:55 EST 2008;Committer;yugui;1;4;4;8;0
b53d7429fcf5dcea805a33f7ddbedee3d0087253;Sat Nov 22 12:36:19 EST 2008;Committer;yugui;1;8;9;17;0
ab8114f481a1c7934f10af3a8eea37a7fd17abbf;Sat Nov 22 12:34:21 EST 2008;Committer;yugui;2;21;0;21;0
c5ce3ea019e35780473ca1156e4bdcc3a1f91322;Sat Nov 22 09:28:43 EST 2008;Committer;matz;2;6;1;7;0
89f1118329a8d0aad173baa091173428d3b3ce30;Sat Nov 22 01:43:31 EST 2008;Committer;nagai;2;6;1;7;0
2e1ee398a4871bcd5a7df4c925b543fe94c0d015;Sat Nov 22 01:37:58 EST 2008;Committer;nagai;3;13;8;21;0
1e1d2b26393d027772ae0cee429d0b6dfef4a3ea;Fri Nov 21 18:45:01 EST 2008;Committer;matz;2;56;71;127;0
564022723175351d8ff9d37453aeb88acf06962a;Fri Nov 21 18:35:52 EST 2008;Committer;matz;1;1;1;2;0
137b5ecd8d9525dbc45f372a226ccdb94a68d032;Fri Nov 21 18:35:11 EST 2008;Committer;matz;3;31;0;31;0
b58ed037598c05764a7f98038197507481959c99;Fri Nov 21 18:34:03 EST 2008;Committer;matz;2;5;1;6;0
c87f1ffa519e2aaffb8f2e131af48e2de5dcabcf;Fri Nov 21 18:27:39 EST 2008;Committer;svn;1;3;3;6;0
68a75f19e92ea664cfc62d0f8ec94ed177cf4a0e;Fri Nov 21 18:27:33 EST 2008;Committer;matz;3;43;2;45;0
a48f1bfb8115af2dcf9d3d367cef2345290a3f1e;Fri Nov 21 11:46:19 EST 2008;Committer;svn;1;3;3;6;0
3cdd85813c10ca0b8fbf987b59cba4aa2a5e3d3e;Fri Nov 21 11:46:14 EST 2008;Committer;matz;2;6;1;7;0
29927214d42105dfa82582401f9a7485c243b2c7;Wed Nov 19 22:35:40 EST 2008;Committer;matz;2;12;1;13;0
db65ddb58c68ee8254c6bbc98ac58484d9826c23;Wed Nov 19 22:28:28 EST 2008;Committer;svn;1;3;3;6;0
edcb8759429cd1302395c1008e64bd9e66900899;Wed Nov 19 22:28:24 EST 2008;Committer;matz;2;10;5;15;0
d37f45cef926e451f44242f650ad72d9c4a99f19;Wed Nov 19 08:49:51 EST 2008;Committer;matz;3;43;3;46;0
b44d5711e8e0058b1c07b003684add23436fb117;Wed Nov 19 05:15:44 EST 2008;Committer;matz;2;6;1;7;0
82493874a287d0a78260231b41e74e8e94b402bf;Wed Nov 19 00:29:12 EST 2008;Committer;nobu;1;4;4;8;0
40f859bade574835a799477010a8f4fe101fa114;Wed Nov 19 00:06:38 EST 2008;Committer;nobu;1;3;3;6;0
84f142a1fbd81fb581e397124b8e05382692c576;Tue Nov 18 18:18:41 EST 2008;Committer;seki;1;1;1;2;0
9b3e241bfccf13cd12a532f9d7bbdf0a39b724ca;Tue Nov 18 18:05:28 EST 2008;Committer;seki;2;17;10;27;0
1da55b38fab0e55201cb1d97672caac92f4cd3a7;Tue Nov 18 17:39:33 EST 2008;Committer;nobu;3;9;3;12;0
2d549dcfbd7e90e3cddca5162e006f57fe783087;Tue Nov 18 16:24:22 EST 2008;Committer;seki;2;6;0;6;0
5ecc2ee0222d1a6816082e6867c257f7905a257f;Tue Nov 18 16:19:37 EST 2008;Committer;mame;2;31;1;32;0
552d66626673b03cd74a587dfa4ce6253a319f2d;Tue Nov 18 15:12:06 EST 2008;Committer;svn;1;3;3;6;0
6ce0058aeb67509278d2cc40f4183de9d969bea7;Tue Nov 18 15:12:02 EST 2008;Committer;matz;2;33;28;61;0
256e8b9afc71ebd966396e570727634ba6163000;Tue Nov 18 14:31:15 EST 2008;Committer;matz;2;11;3;14;0
e606e7e32b5b427d3d694123670e27fb9b58b171;Tue Nov 18 12:29:25 EST 2008;Committer;matz;2;8;2;10;0
fd346f769bdd924be3a181ed96d3282b626711f9;Tue Nov 18 07:32:44 EST 2008;Committer;nobu;1;1;1;2;0
b7ac5b1262a402fce6ecbe94f12d0a381b4d0479;Tue Nov 18 07:18:29 EST 2008;Committer;nobu;3;11;2;13;0
9d2ecf3d905bf8d304b9bf42a2046f04bdf2738e;Tue Nov 18 06:58:55 EST 2008;Committer;matz;2;7;1;8;0
4ccfa1e9f8c99d28863b7de6f10eaf718cac49c7;Tue Nov 18 06:51:19 EST 2008;Committer;matz;3;8;2;10;0
ad5ff1c23758bf23bc58ec16dd7dc2152ab68c21;Tue Nov 18 00:42:18 EST 2008;Committer;nobu;3;14;4;18;0
8e6ad88737ade5526f33ba1aeda353b060ce10a4;Mon Nov 17 09:05:19 EST 2008;Committer;nobu;3;11;1;12;0
56228b4da668c917f584c20c8740e87be49ce011;Mon Nov 17 02:14:24 EST 2008;Committer;seki;2;4;15;19;0
5c759e6b1c0f4fd68c3e64a076cbbb4edc4e0776;Sun Nov 16 17:19:05 EST 2008;Committer;nobu;3;11;5;16;0
316b78a56d4649dbc2c03d3bc62a804a4039eeac;Sat Nov 15 13:46:52 EST 2008;Committer;nobu;2;6;1;7;0
1bd83c1fe042023b614cafa32b2b9205b62580e5;Sat Nov 15 13:24:06 EST 2008;Committer;nobu;3;9;4;13;0
1bd032b7a3f378b36558256f915804a610736a03;Fri Nov 14 11:31:20 EST 2008;Committer;svn;1;3;3;6;0
e1a2fec2bbaf13ec3b094b9b40dcb1a3aa049dcf;Fri Nov 14 11:31:10 EST 2008;Committer;mame;5;9;4;13;0
5136031055433d1eba6a77353fa842f5adfc3dc4;Thu Nov 13 02:31:16 EST 2008;Committer;nobu;2;7;0;7;0
31f16d772933e0faaca29256b720e944fdf060d6;Wed Nov 12 21:08:47 EST 2008;Committer;nobu;3;22;137;159;0
2228f91851a931065920598f31ea583830f500b1;Tue Nov 11 22:18:21 EST 2008;Committer;davidflanagan;2;5;1;6;0
cc7ff9d2f9b8f2562d119b4a00d78c69f40cf6af;Tue Nov 11 18:31:06 EST 2008;Committer;nobu;3;19;0;19;0
99cd3c512b78774c8c4ecb92ca4c6278577a58c5;Tue Nov 11 18:28:47 EST 2008;Committer;nobu;4;50;9;59;0
8bc28d82b44654f907c5ee468b79de2afab97e8d;Tue Nov 11 17:39:52 EST 2008;Committer;matz;2;6;1;7;0
b91220fbd5a9a6ace8216987d6b32a8d8bae0f36;Tue Nov 11 15:09:24 EST 2008;Committer;svn;1;3;3;6;0
f2077294f1cb8f95ba8d4eb032ae947fd0778c0e;Tue Nov 11 15:09:21 EST 2008;Committer;yugui;0;0;0;0;0
43463a5cb665badd20c3e3ee672bdc745845e28b;Tue Nov 11 14:14:29 EST 2008;Committer;yugui;2;29;0;29;0
e087f9ed6ade89fea17b5134104d26a99df3250b;Tue Nov 11 11:50:57 EST 2008;Committer;kazu;2;6;1;7;0
b0e3af492216f9517480208bffb99656cd122a89;Tue Nov 11 11:42:46 EST 2008;Committer;tadf;4;9;7;16;0
e644398bc6a06490e504f6ce18963431f18641ad;Tue Nov 11 10:45:21 EST 2008;Committer;matz;3;41;12;53;0
d544a3d6c721b435151a74cb00aa32142a284097;Tue Nov 11 08:54:07 EST 2008;Committer;usa;2;26;11;37;0
0d93d8125e0ae23599ea6d562d70d235171afc9c;Tue Nov 11 05:42:49 EST 2008;Committer;duerst;2;5;15;20;0
831e80438840a6665f99a7e27e7c978bd035a306;Tue Nov 11 05:26:20 EST 2008;Committer;duerst;20;2569;0;2569;0
524c766d19a7a893cd644866439fde5448a24a4e;Mon Nov 10 22:59:47 EST 2008;Committer;tadf;2;2;2;4;0
a3b9e005fd132246eb20409b496ee33f7a774f23;Mon Nov 10 22:57:05 EST 2008;Committer;svn;1;3;3;6;0
e8c67503ea26537762353d560d0b485fd40a77e7;Mon Nov 10 22:57:01 EST 2008;Committer;tadf;4;11;4;15;0
fd93c804821a1ae21d7ad32bf97ad79023b57048;Mon Nov 10 08:38:20 EST 2008;Committer;knu;2;9;9;18;0
504abcc00f81aa9f7228a758f6627205fafd69e1;Mon Nov 10 01:52:46 EST 2008;Committer;matz;2;7;1;8;0
703c1825ebcd2aa5ddd66847e93753d843d26575;Mon Nov 10 00:57:49 EST 2008;Committer;usa;2;8;0;8;0
b916aa3ff80d45dc0c4e9c3011358a81d3a80857;Mon Nov 10 00:51:19 EST 2008;Committer;svn;1;3;3;6;0
d87e2d811a1be0fa04e9c47a2198a48ca9cb333b;Mon Nov 10 00:51:14 EST 2008;Committer;matz;2;18;8;26;0
7991c5e66e5686cdcce002cefb5bafbad0e9fd6c;Sat Nov 08 19:10:36 EST 2008;Committer;nobu;2;15;8;23;0
9b139fe5892388653b1c213c633e031c778bd875;Sat Nov 08 15:38:48 EST 2008;Committer;xibbar;3;57;10;67;0
641f43de973d51a7d463b067833d4a71706d6c5c;Sat Nov 08 15:31:05 EST 2008;Committer;nobu;4;25;7;32;0
b2390fb1cc3f38ca4516394034c8680eeb01a64c;Sat Nov 08 15:03:46 EST 2008;Committer;svn;1;3;3;6;0
f22aabbaee5ce9e9bb731ccc036bd00cf2bc8960;Sat Nov 08 15:03:42 EST 2008;Committer;xibbar;2;29;25;54;0
4b9e885000865e62a717f53544177ebd5f82ed29;Sat Nov 08 14:56:38 EST 2008;Committer;xibbar;1;1;5;6;0
26862c00e998b29944d92c88393c12ca19cac844;Sat Nov 08 14:52:59 EST 2008;Committer;xibbar;3;69;2;71;0
274c3b94bfb2fc0aa5e3331761ed6d21836e0a57;Sat Nov 08 12:57:50 EST 2008;Committer;xibbar;2;4;2;6;0
b4890b598b797038e1b930e638ba384ed447b431;Sat Nov 08 12:36:50 EST 2008;Committer;xibbar;2;70;64;134;0
16285e768efee59aede057bca55cac1a185356a4;Sat Nov 08 11:09:20 EST 2008;Committer;yugui;1;8;6;14;0
877ac7236a8c509959eddc5add7ba0f10fae4804;Sat Nov 08 09:41:24 EST 2008;Committer;matz;10;37;26;63;0
75fcee4a23d5a549f407a0404732e2ccc6b949e1;Sat Nov 08 08:32:55 EST 2008;Committer;matz;2;6;1;7;0
6a638cc1960548c1e3bc5ceba6a56c1b274ae9b1;Sat Nov 08 08:17:20 EST 2008;Committer;matz;2;7;1;8;0
703fb3d9becd0626c57f343ce16635c0434f19c6;Sat Nov 08 03:15:28 EST 2008;Committer;matz;5;25;9;34;0
0042ccef2cea6fafecf2edbfee90dd160cee7ba7;Fri Nov 07 22:10:58 EST 2008;Committer;matz;2;8;0;8;0
c82769f2277a8b06ea6a104ab4e7e7c8043d658a;Fri Nov 07 22:07:05 EST 2008;Committer;matz;4;32;8;40;0
80d16e7403e64c5ba19b83046b3530aeaf4ed62b;Fri Nov 07 21:42:24 EST 2008;Committer;matz;5;77;17;94;0
551dfe9d8b9877d81b0ca87aff004c11383b698d;Fri Nov 07 20:47:02 EST 2008;Committer;nobu;4;89;21;110;0
f8cdd9907a9076b8e628060a38e9d641625f4c8e;Fri Nov 07 20:35:10 EST 2008;Committer;matz;2;7;0;7;0
b15e0697fdb6f89c93910e20296691e7fdddb8ff;Fri Nov 07 16:48:22 EST 2008;Committer;nobu;2;7;3;10;0
006be2d79020f3ad6f4ba644e35d0cec1d8d42fd;Fri Nov 07 16:42:31 EST 2008;Committer;nobu;2;10;4;14;0
1ebc4f605709b76e2364eed6757975d841e229e4;Fri Nov 07 16:14:53 EST 2008;Committer;svn;1;3;3;6;0
8da157ae51e16934fe4c0829a63ca9bb0ebf9423;Fri Nov 07 16:14:48 EST 2008;Committer;nobu;2;32;9;41;0
bd87b502735d7185d8a1dde17f9830b704cd81bf;Fri Nov 07 13:52:07 EST 2008;Committer;nobu;2;50;87;137;0
b81ccf31677b956445171f79bf1114fefdc4e6ba;Fri Nov 07 13:47:11 EST 2008;Committer;nobu;2;2;2;4;0
3899005d2ed7fc902df10e083f75d9f28a3d85eb;Fri Nov 07 13:42:36 EST 2008;Committer;nobu;2;6;1;7;0
df6ea23faff164bae0557ea551da0dfb549e8b1b;Fri Nov 07 12:23:15 EST 2008;Committer;nobu;2;5;18;23;0
4faa9ea612ce99455d2294dc0b4f02cacc5d4f33;Fri Nov 07 03:27:57 EST 2008;Committer;matz;2;6;1;7;0
10ddffb278e4a27dc6d7a4e6ecee342fe2b56741;Fri Nov 07 02:59:38 EST 2008;Committer;naruse;4;75;25;100;0
2657faae0193748c041d8311590dd5f03dd2ce0b;Thu Nov 06 22:43:30 EST 2008;Committer;nobu;2;6;1;7;0
1343680398592089929607a3d213f731847a7762;Thu Nov 06 22:36:07 EST 2008;Committer;matz;3;67;0;67;0
1d8b7bc6248931354e9e018296bb1ad1abbae6fd;Thu Nov 06 22:18:34 EST 2008;Committer;matz;2;4;8;12;0
90c6c35f2e80de05fa123ce5e28b8a1cd5241be3;Thu Nov 06 22:12:20 EST 2008;Committer;nobu;2;5;27;32;0
4f3abb93f6ec6fe127da0adfadb1485d1b9ee9c4;Thu Nov 06 19:02:35 EST 2008;Committer;nobu;2;46;4;50;0
a324863b99e90303746742157e06c8d183db8257;Thu Nov 06 17:03:40 EST 2008;Committer;shugo;3;12;2;14;0
e992737b4a56637e2fb527184a9d571d17edc84a;Thu Nov 06 16:24:36 EST 2008;Committer;svn;1;3;3;6;0
b2a9e7c85a48e590e7e78a66fea34a39bb9c2cff;Thu Nov 06 16:24:32 EST 2008;Committer;nobu;2;6;2;8;0
5732566f4d9a026fef3904f3237a9f7255ba91f2;Thu Nov 06 13:21:26 EST 2008;Committer;nobu;4;56;24;80;0
514626ad8d43b6615d396fc064344e722a6f7d21;Thu Nov 06 12:38:54 EST 2008;Committer;svn;1;3;3;6;0
696e6a9b7655c5dd32c4468c105e2a471f712cd6;Thu Nov 06 12:38:49 EST 2008;Committer;suke;5;62;1;63;0
0ca8c28e4d250e90e368a62fd2cc5edb2098cb90;Tue Nov 04 04:10:12 EST 2008;Committer;usa;1;0;1;1;0
645246d1d11eac5370dfd5f94124c0afdb79606d;Tue Nov 04 04:09:10 EST 2008;Committer;usa;2;11;5;16;0
a3fb952a4f78a2ac94f15d627a40fadad1d8affe;Mon Nov 03 23:00:40 EST 2008;Committer;takano32;2;5;1;6;0
4927a7c77a3444f3e0e9e6ff9751c75e3ee517ac;Mon Nov 03 18:28:34 EST 2008;Committer;nobu;2;9;1;10;0
88a4f331219ae0cb25afb70f2c32c8c000aba750;Mon Nov 03 16:56:49 EST 2008;Committer;nobu;4;11;5;16;0
1f4b40f44973f2567d298c147f3ea366c9680e31;Mon Nov 03 07:32:57 EST 2008;Committer;nobu;2;37;29;66;0
c2ded646534f362b9e409b5de58c5d869bc0fdf4;Mon Nov 03 04:13:04 EST 2008;Committer;yugui;2;25;10;35;0
d5c6b265b977bc617c2863cf1e27dd0d16beaccc;Mon Nov 03 04:10:17 EST 2008;Committer;yugui;2;6;1;7;0
feb25e25cd64f205d6e434b501123e8752c40173;Sun Nov 02 15:41:07 EST 2008;Committer;svn;1;3;3;6;0
1dead12e7f01a0d6e2093af4ad685e3c6e13e4af;Sun Nov 02 15:41:02 EST 2008;Committer;suke;5;85;54;139;0
f35fb72f44dda18394e2a675e3909b55591ac17e;Sun Nov 02 14:10:46 EST 2008;Committer;suke;2;8;0;8;0
2d45869c7623b166d02fa07cbb6cf8a39cc81a8b;Sun Nov 02 13:22:42 EST 2008;Committer;suke;5;307;343;650;0
510d2a7d2e6030a489409c76fd49273214e2e2c2;Sun Nov 02 13:11:16 EST 2008;Committer;suke;2;5;1;6;0
388abb698c63d713211cc90748d0f63e4c114380;Sun Nov 02 07:41:56 EST 2008;Committer;nobu;3;11;5;16;0
b3d8272a28b0000ef07f9596c57b06f61bda2ef2;Fri Oct 31 22:27:40 EDT 2008;Committer;svn;1;4;4;8;0
af0221e728742adb34aa5e2abfcefa899ccd1867;Fri Oct 31 22:27:35 EDT 2008;Committer;drbrain;5;139;9;148;0
ff5a076e7e1dbe8f255cb23a03be006fded7d277;Fri Oct 31 13:01:40 EDT 2008;Committer;kou;2;13;1;14;0
b5a0eb6754acfaf6144109319afb88f3754ee70e;Fri Oct 31 12:31:22 EDT 2008;Committer;mame;2;6;1;7;0
7ac0beaeea75376eebfc87618815a190ad77ddc2;Fri Oct 31 09:57:45 EDT 2008;Committer;yugui;2;7;1;8;0
b4729e2db343077b70ee0cba1565759858a364ba;Fri Oct 31 09:46:31 EDT 2008;Committer;yugui;2;10;1;11;0
d37df9fb13bd2cf46ddd0cafb3bfe1885ac809e9;Fri Oct 31 09:07:21 EDT 2008;Committer;duerst;6;473;0;473;0
ec280ecbe658035d8c9affa6ca46e13a255c0cbe;Fri Oct 31 04:40:34 EDT 2008;Committer;matz;2;6;1;7;0
5eacf68c2a918e245625aeac66e7895635662d30;Fri Oct 31 03:49:29 EDT 2008;Committer;wanabe;2;18;5;23;0
30887efb8a658842991fd9c8077e024962860165;Fri Oct 31 03:31:09 EDT 2008;Committer;yugui;2;10;3;13;0
b1c07ee240f4fad7f498bd7910be027d47e4894b;Fri Oct 31 02:35:41 EDT 2008;Committer;nobu;2;12;2;14;0
04e94c6ec85f15eb50296288d4d7b2b2cc58a2a5;Thu Oct 30 23:16:16 EDT 2008;Committer;nobu;4;32;16;48;0
ea4ae3302d056ec84316c0f7d3f65142bc380f7f;Thu Oct 30 12:35:04 EDT 2008;Committer;mame;2;6;0;6;0
93fa4cbf3d01c389c4f23408cacf05922583ed84;Thu Oct 30 09:19:13 EDT 2008;Committer;matz;2;15;2;17;0
86c50e39838fc5831163e3b92a9047d539fb46ee;Thu Oct 30 09:17:49 EDT 2008;Committer;matz;2;10;5;15;0
6fd14ccae523c3fab7f202664bb3ef0125e80313;Thu Oct 30 05:47:01 EDT 2008;Committer;duerst;3;143;54;197;0
5cdd7f52cc2c6cc25200e1738f53421b18698836;Thu Oct 30 01:34:23 EDT 2008;Committer;nobu;2;118;83;201;0
2db25b6ba08a6749057a367be5ec9ed232669571;Thu Oct 30 00:31:47 EDT 2008;Committer;nobu;2;16;5;21;0
2f2ca24b3e50c0ad006217d95a2db80bc069d50b;Wed Oct 29 21:23:47 EDT 2008;Committer;takano32;1;1;1;2;0
d3b9a514cb9d46bbeac8756934b135f1ac171ea0;Wed Oct 29 17:32:02 EDT 2008;Committer;mame;1;2;2;4;0
e2cb0b9766537e6db2bd515339c598d3aca438d2;Wed Oct 29 17:24:44 EDT 2008;Committer;mame;3;20;3;23;0
143f059bcd84284b54445d237ad202f1cb3e639a;Wed Oct 29 16:46:08 EDT 2008;Committer;mame;2;34;1;35;0
f27e4c045f752e09176a3c4ef0dd4ba20266fa29;Wed Oct 29 16:44:24 EDT 2008;Committer;matz;2;22;3;25;0
86ade651044cc606584e11a5b2e8d02f315d3fa9;Wed Oct 29 16:40:05 EDT 2008;Committer;matz;3;34;9;43;0
2e51b7f9dacc5420c1f269dde24cb0677cce5571;Wed Oct 29 16:35:47 EDT 2008;Committer;mame;2;4;4;8;0
6bacaabffd1e3ae004a9fee1f607d6782bc1d730;Wed Oct 29 16:30:02 EDT 2008;Committer;mame;2;6;1;7;0
86a391482556377a563a55f3a04ff38b3ea36e01;Wed Oct 29 16:17:01 EDT 2008;Committer;svn;1;3;3;6;0
85b6c69e82cbaf6056d017e3713abd866da11a1a;Wed Oct 29 16:16:53 EDT 2008;Committer;mame;2;10;0;10;0
0d83c7b6c2fb73a5464cabb010e65b25de8274cf;Wed Oct 29 14:58:30 EDT 2008;Committer;mame;2;11;2;13;0
2a3d7b5992d3389544a6596103d1068096491ff4;Wed Oct 29 14:40:31 EDT 2008;Committer;mame;2;2;11;13;0
7451e34428cbab2bd48afde0632d15976c25c991;Wed Oct 29 14:30:07 EDT 2008;Committer;mame;2;11;2;13;0
224471fd572c1818e99c66f756ce398745885398;Wed Oct 29 11:48:35 EDT 2008;Committer;mame;8;157;140;297;0
3056933cc0b7c1d68ddda1a143bfa298a92f4a0c;Wed Oct 29 09:40:38 EDT 2008;Committer;nobu;2;4;4;8;0
34c5cea9b52b7289b45ebc801a886ca8ecb613b2;Wed Oct 29 07:41:21 EDT 2008;Committer;nobu;2;11;0;11;0
2100e3b631edd4de13d272902d8330d6a64fa5a2;Wed Oct 29 06:45:26 EDT 2008;Committer;takano32;2;7;2;9;0
1b95e95ff2ad15eb88306b82c01defb288f27880;Wed Oct 29 05:36:53 EDT 2008;Committer;nobu;2;6;1;7;0
c93ac5311d954b489e81dceca4034b3061015040;Wed Oct 29 04:20:42 EDT 2008;Committer;knu;3;10;5;15;0
6955f6977a676e4b98bdc083e7f105ae36e875b8;Wed Oct 29 04:05:15 EDT 2008;Committer;knu;2;7;15;22;0
3cdf3ac9c951e0ca0cda7b2729ed10a37ac2fac5;Wed Oct 29 02:51:00 EDT 2008;Committer;nobu;2;15;1;16;0
4542baa983a4c727ea7dfb810bd6d4f87a2cfed0;Wed Oct 29 02:01:19 EDT 2008;Committer;usa;2;10;5;15;0
bc4bc3a80fb1dcb477b29ec059d81670d101c975;Wed Oct 29 00:30:09 EDT 2008;Committer;nobu;2;6;3;9;0
bd92ab89c0d368da3a5cb449431f64ccb92e8279;Wed Oct 29 00:23:04 EDT 2008;Committer;nobu;2;9;3;12;0
f68296698a88d74f322603bb78109238cf0cefde;Tue Oct 28 15:45:29 EDT 2008;Committer;tadf;2;31;17;48;0
746a09406eef8888844d90ff898af392b50b91e2;Tue Oct 28 15:27:06 EDT 2008;Committer;usa;2;8;1;9;0
f019cd5b79a06739135b52c2bea76bafd9fa5437;Tue Oct 28 15:19:53 EDT 2008;Committer;tadf;1;2;1;3;0
7006082a68e2f06e07bb6b799e65fd318e3f082f;Tue Oct 28 15:10:45 EDT 2008;Committer;svn;1;3;3;6;0
2d5a281c98b0f053101049abd34b931d24281157;Tue Oct 28 15:10:40 EDT 2008;Committer;tadf;3;65;28;93;0
b87182fa7f3a092fe133f521de407e160000ee62;Tue Oct 28 14:30:17 EDT 2008;Committer;naruse;2;28;3;31;0
d8c68028faf28aed7acdfb983ec825d596401a65;Tue Oct 28 14:18:10 EDT 2008;Committer;yugui;2;202;0;202;0
1171a940f1ad7af13dbc750427fb7a82bbe0c142;Tue Oct 28 14:14:52 EDT 2008;Committer;tadf;1;1;1;2;0
2b72e549a755dec2fbbf78199e41d4148683d025;Tue Oct 28 14:11:08 EDT 2008;Committer;tadf;7;44;3136;3180;0
d563f1680cba03335eb38bd9e7bce8b82f03e12d;Tue Oct 28 12:34:13 EDT 2008;Committer;mame;2;15;11;26;0
45ea81a4920f1bd99e253b059c665731a3d967d5;Tue Oct 28 12:03:14 EDT 2008;Committer;usa;1;9;5;14;0
7994aaa1f3ea67a9f2d940de9384d6e2d4bbfedb;Tue Oct 28 12:01:46 EDT 2008;Committer;usa;1;1;1;2;0
f3ac3e8774a09fe7b4e689b37afe2e453d957690;Tue Oct 28 12:00:42 EDT 2008;Committer;usa;2;36;12;48;0
68b9bc4201fc80fcb50afd45ab132d04810fc4f7;Tue Oct 28 11:23:52 EDT 2008;Committer;usa;1;7;1;8;0
7d934c47d12f4c1da617090ee069f38a30b6724a;Tue Oct 28 11:18:28 EDT 2008;Committer;usa;2;13;6;19;0
2f4e4a841dbee7435b48003fdd1c8e1e904cc138;Tue Oct 28 10:01:26 EDT 2008;Committer;usa;2;7;3;10;0
04e19b558749a6122ee2f0f29df41474ec70f2c7;Tue Oct 28 09:41:30 EDT 2008;Committer;usa;1;80;50;130;0
fdc4287e87488354e366db966278b4b4f8fd0710;Tue Oct 28 09:34:37 EDT 2008;Committer;usa;1;13;13;26;0
2e376a1b96dffe97895549df7ffba4ee57fdd6ac;Tue Oct 28 08:21:57 EDT 2008;Committer;yugui;2;11;4;15;0
e3e645f43a3a2382a4fc38a5420e89b351c5b0c1;Tue Oct 28 08:21:50 EDT 2008;Committer;yugui;4;13;4;17;0
b39833e1d768c5461cbf1475367677eb0ec15ba3;Tue Oct 28 07:13:39 EDT 2008;Committer;nobu;2;12;2;14;0
993a9404cbdef5d99a04fd4920e10829301e9777;Tue Oct 28 05:20:24 EDT 2008;Committer;usa;1;46;32;78;0
6714f687e392d70afb2b4ab5e0a70fc50324ca56;Tue Oct 28 03:52:43 EDT 2008;Committer;usa;1;16;0;16;0
d324a4678404ac80e5bf87f143faa59c5b05a874;Tue Oct 28 03:26:32 EDT 2008;Committer;usa;1;2;0;2;0
ed276bfc89f8b557d05292e5b5c985934e3d5bca;Tue Oct 28 02:44:09 EDT 2008;Committer;usa;1;1;1;2;0
e8d91f12136d997c5ef6798c32ae7c9cb4fd4b92;Tue Oct 28 00:52:32 EDT 2008;Committer;usa;2;10;1;11;0
26708cc4af8484b8181649362b746616c7906773;Tue Oct 28 00:20:42 EDT 2008;Committer;svn;1;3;3;6;0
4189288f2e372f03b61e7ff868a9234dde759aa5;Tue Oct 28 00:20:37 EDT 2008;Committer;usa;2;6;1;7;0
a1645803bb6d471ceb48e249f836e2bf25b86acc;Mon Oct 27 13:35:46 EDT 2008;Committer;yugui;3;318;96;414;0
46f8afdc56c29dbd5e18ed910f8418f49f854dc5;Mon Oct 27 11:07:37 EDT 2008;Committer;usa;3;12;0;12;0
85101b76259d62e03a746524bf75c77f1fb302b7;Mon Oct 27 07:30:56 EDT 2008;Committer;nobu;1;17;16;33;0
0a20a506e1ee9e47ea89bb263c31adca013bcb95;Mon Oct 27 06:58:28 EDT 2008;Committer;nobu;2;35;4;39;0
782f3bd3f9d89130e7b8486e82e2f7f270833013;Mon Oct 27 06:55:06 EDT 2008;Committer;nobu;3;7;2;9;0
1a863754faed73a0a9ff1a4ce03bf022e94788c1;Mon Oct 27 06:43:13 EDT 2008;Committer;yugui;2;12;2;14;0
a1cef995414861c8654013464840c2c707fb53a0;Mon Oct 27 06:34:23 EDT 2008;Committer;yugui;2;9;2;11;0
0a88cb504baf9d4c483de63b7efa33d58ff4bdcc;Mon Oct 27 03:13:54 EDT 2008;Committer;yugui;3;9;2;11;0
a61e734d0f4ada46930044d3fc2c5d4bf6916a1d;Mon Oct 27 03:13:47 EDT 2008;Committer;yugui;1;6;0;6;0
4e0b83e95b0720042805fd0cc885c554f821ccfa;Mon Oct 27 03:04:22 EDT 2008;Committer;kazu;2;5;1;6;0
afea4a499510483975b88491af51ed8674261489;Mon Oct 27 02:39:17 EDT 2008;Committer;yugui;2;22;11;33;0
83acdeedd834381ac996282ae3a3257bc531cd1a;Mon Oct 27 02:15:08 EDT 2008;Committer;kazu;1;2;2;4;0
db8e3024e74dafa1f76d8d43a1bddfc1270ad073;Mon Oct 27 01:03:22 EDT 2008;Committer;usa;2;6;1;7;0
52061f4ecd3b6effb6b35f1aec30061fbc9f7fdb;Sun Oct 26 16:31:15 EDT 2008;Committer;mame;2;10;0;10;0
abfddf2cd962d4a41a4e56761dd891d2edac569f;Sun Oct 26 16:08:08 EDT 2008;Committer;svn;1;3;3;6;0
f850cf28660c7b9a708767d779c16263668afe65;Sun Oct 26 16:08:03 EDT 2008;Committer;naruse;2;7;1;8;0
824e1e4265545b808a0eb9ea5a721be6f3ef5446;Sun Oct 26 13:49:10 EDT 2008;Committer;nobu;1;44;42;86;0
2b3f026b8abb2cf7061e0978fb3eca4c3e0cbeaf;Sun Oct 26 12:30:07 EDT 2008;Committer;mame;2;17;21;38;0
945faf92e69d173ccea393caefaf8c222a251bb8;Sun Oct 26 10:18:39 EDT 2008;Committer;nobu;2;22;13;35;0
b98a6b7ac06219d3e4a0a46087f1a8c2a11438bb;Sun Oct 26 09:42:21 EDT 2008;Committer;nobu;3;8;3;11;0
bcf61f58d518308658de1c208703bfdd7f79d1c7;Sun Oct 26 09:11:40 EDT 2008;Committer;nobu;3;9;2;11;0
201eb37d92b9e4729a38a1ea4a7b4cbf2654bd62;Sun Oct 26 09:07:37 EDT 2008;Committer;nobu;2;9;4;13;0
860fad971d2bdaad7b9e78adef80f6db9d8ec1cf;Sun Oct 26 09:01:23 EDT 2008;Committer;nobu;4;14;8;22;0
425dcb131eeea65293a354901b03f1fdd5c28756;Sun Oct 26 06:05:21 EDT 2008;Committer;nobu;1;1;1;2;0
0db5641dae711ccb3e34cc195e14f95571c22f90;Sun Oct 26 04:30:45 EDT 2008;Committer;nobu;2;7;1;8;0
b61d8b6045497a5b2185bf8cb61a381f179d3ecd;Sat Oct 25 22:58:43 EDT 2008;Committer;drbrain;75;427;407;834;0
17358af75b80343f7861907b9288607e67a08f61;Sat Oct 25 22:38:09 EDT 2008;Committer;ryan;4;67;32;99;0
fe7ce06150e75f524f2aaaf3198927a58873d9a1;Sat Oct 25 17:20:05 EDT 2008;Committer;yugui;4;11;3;14;0
4dd24d6ba6d1da23d708a7395ae2f3814bd5ab59;Sat Oct 25 16:44:13 EDT 2008;Committer;yugui;2;131;0;131;0
92d172e9c3814860fdec497feeb7462e874d7e60;Sat Oct 25 15:15:24 EDT 2008;Committer;yugui;5;543;488;1031;0
357a0ddc9e5c768916e70248a64d7b58a996c9eb;Sat Oct 25 15:15:09 EDT 2008;Committer;svn;1;3;3;6;0
a40899b22ca1afdafc448423e8e210aadf862026;Sat Oct 25 15:15:06 EDT 2008;Committer;yugui;1;9;1;10;0
ee1e8e1a9ba9e2232d6df7ae115b09d6dbd5ac0c;Sat Oct 25 11:10:39 EDT 2008;Committer;nari;2;7;3;10;0
520f1372e3052fc46968b3914c7a31680584327a;Sat Oct 25 09:47:54 EDT 2008;Committer;nobu;2;18;0;18;0
51067428932e6244b7127ba41a9c82ade9904a40;Sat Oct 25 02:18:53 EDT 2008;Committer;yugui;2;5;1;6;0
dfda5877ca1f224b49ed17af1d44781fb2717a31;Sat Oct 25 00:54:38 EDT 2008;Committer;jeg2;5;33;14;47;0
7222e82a8b98afdc61b9cf6ad7419068429a42e9;Fri Oct 24 23:05:28 EDT 2008;Committer;drbrain;22;115;54;169;0
da6300e8f888d0664347a5f2fb43dc749df7b5ad;Fri Oct 24 19:00:35 EDT 2008;Committer;nobu;2;5;2;7;0
5c3fe0e33916d609e3eafd03553a8ed11b07b0d8;Fri Oct 24 18:58:52 EDT 2008;Committer;nobu;2;5;2;7;0
d8267b72b5309117a71164aca2e6bf61330fd4b1;Fri Oct 24 18:56:31 EDT 2008;Committer;nobu;3;10;3;13;0
a26b7a0c82ecc73137673370baa2b882e4663c76;Fri Oct 24 18:43:27 EDT 2008;Committer;nobu;2;6;1;7;0
0ad553ce5841cda773765f5a539ac2b2a5a174ef;Fri Oct 24 16:30:09 EDT 2008;Committer;matz;2;11;1;12;0
4f577310ce38b99644f44bb464f21efd0afe3230;Fri Oct 24 15:14:44 EDT 2008;Committer;nobu;3;22;20;42;0
5660e09f08362a4146b285ca50225348d1213633;Fri Oct 24 14:05:49 EDT 2008;Committer;yugui;6;38;19;57;0
f7d4df50c004d775a296b8989bb3ac792db6e639;Fri Oct 24 14:01:21 EDT 2008;Committer;mame;2;22;0;22;0
3093546f1fd0b30cfccc8e13803126775cd70734;Fri Oct 24 12:50:35 EDT 2008;Committer;nobu;3;14;10;24;0
f953305ff547aad84ddbbbc4279f444705b5e23f;Fri Oct 24 12:20:58 EDT 2008;Committer;keiju;2;23;11;34;0
b1c14f8fbb15ddb1c44d169dee67bb32f903bfa9;Fri Oct 24 12:10:27 EDT 2008;Committer;xibbar;3;9;2;11;0
1e2b744ed2f8146816fd5b83ba85497456907c18;Fri Oct 24 11:55:07 EDT 2008;Committer;nobu;2;6;2;8;0
7e8ab850b04f19b6b2d73c78798052f78a7f52b0;Fri Oct 24 11:47:59 EDT 2008;Committer;keiju;2;23;0;23;0
23ed2fcc31cae6e95d0ed24da46d43d19136e0ce;Fri Oct 24 11:05:39 EDT 2008;Committer;xibbar;1;6;3;9;0
3896936492a92a9a63fc0206a340816e50ad5a46;Fri Oct 24 10:58:33 EDT 2008;Committer;matz;2;3;3;6;0
78d2b008931ecfc68d5bdb26803460f2267c58c7;Fri Oct 24 10:30:09 EDT 2008;Committer;shyouhei;2;5;1;6;0
5ff7af42b018aba8f0eaa36e647285d81e082e14;Fri Oct 24 10:24:01 EDT 2008;Committer;shyouhei;2;8;3;11;0
4f817e2a9d8a365b403b1ce7a75c2053b0017ef1;Fri Oct 24 09:39:53 EDT 2008;Committer;keiju;6;3123;95;3218;0
9afe0278b31be55ae59e9bb15c0c1fec08b1f328;Fri Oct 24 09:25:05 EDT 2008;Committer;matz;3;12;2;14;0
5f7be192dfe963e381724867cf4d099e104540a2;Fri Oct 24 09:09:34 EDT 2008;Committer;matz;1;2;2;4;0
aed0c718db2d50e7984f8ef4bd105828a7d3a939;Fri Oct 24 09:08:43 EDT 2008;Committer;matz;2;7;2;9;0
5443cf15177ce0566b9e66cbe317d23dcb8dedfa;Fri Oct 24 07:34:54 EDT 2008;Committer;xibbar;1;2;2;4;0
86560b12eeccdfe16550b6907096235cd4b6046e;Fri Oct 24 07:25:53 EDT 2008;Committer;xibbar;3;53;7;60;0
9e1bddfda25d9490af078c273084fc61074ccfe6;Fri Oct 24 05:22:51 EDT 2008;Committer;nobu;2;5;2;7;0
8d47e631354947c389c05ffcf569489c3a7899bc;Fri Oct 24 05:13:18 EDT 2008;Committer;nobu;2;5;0;5;0
43aedb13bbe78db7fac4d3202147002a3edf28d9;Fri Oct 24 01:28:38 EDT 2008;Committer;svn;1;3;3;6;0
2169d5d3c6babc251f058fca9b42b8af15eb74c1;Fri Oct 24 01:28:32 EDT 2008;Committer;kazu;2;6;1;7;0
6e1ed146069bc0a879277eba9ef286e2ec595147;Thu Oct 23 13:08:48 EDT 2008;Committer;yugui;2;5;59;64;0
06151d4a99e02ce9662c938d6d6d3f8e6621822b;Thu Oct 23 08:30:52 EDT 2008;Committer;matz;2;7;3;10;0
04e30e310370760db4f60660d3f3c299524b8adf;Thu Oct 23 07:21:05 EDT 2008;Committer;matz;2;8;2;10;0
409293eb09480ad5a1857496e0ad8147e2576057;Thu Oct 23 07:16:20 EDT 2008;Committer;nobu;2;9;0;9;0
5a8db29b59f5f0bd6272bbfd615d356e475c52f1;Thu Oct 23 06:53:55 EDT 2008;Committer;matz;2;38;9;47;0
472156c236c0b086bde6b26703f2f02d1be5f730;Thu Oct 23 05:08:10 EDT 2008;Committer;nobu;2;11;8;19;0
a5ea0e8c3209343063ff5943b76e8243edaa7914;Thu Oct 23 02:18:00 EDT 2008;Committer;nobu;2;12;4;16;0
538d87cf1133a603ea3e671870b0543b5d9f4636;Thu Oct 23 00:27:52 EDT 2008;Committer;usa;2;6;1;7;0
c1bb485ca06a067f10a96787604fc703f467eb57;Wed Oct 22 23:12:02 EDT 2008;Committer;matz;2;6;1;7;0
38c7a687e174e5fc7761cf05f71003ad6b728320;Wed Oct 22 16:53:50 EDT 2008;Committer;matz;3;103;26;129;0
b6807f8356c670bb3668378a796f45e3e32ba007;Wed Oct 22 16:24:58 EDT 2008;Committer;nobu;2;8;2;10;0
8a0d53ac2b0d2af06d4c5fef87d1bb5913adbb05;Wed Oct 22 15:12:07 EDT 2008;Committer;ko1;3;161;71;232;0
d1c4aefa6296d496781218a3e60e71c4b4a5e2c8;Wed Oct 22 13:23:59 EDT 2008;Committer;yugui;1;72;8;80;0
a9a23756b5c0e2a791c718da7b388c0d6ef82ad2;Wed Oct 22 08:27:48 EDT 2008;Committer;matz;2;6;2;8;0
5c0515f2e25bdebe4f27eb8d3df5761ad4304bd0;Wed Oct 22 07:28:00 EDT 2008;Committer;nobu;2;8;2;10;0
e8a71e64a15c46388e1abf293fa81df3ebfc5643;Wed Oct 22 06:03:12 EDT 2008;Committer;matz;2;8;1;9;0
4a3f2a7bc5de8e0b3c1cb18a689d21a66e289f70;Wed Oct 22 05:55:22 EDT 2008;Committer;matz;6;51;27;78;0
1d38a821eaad46cd649a911b38a7d3540d6df8a9;Wed Oct 22 04:27:32 EDT 2008;Committer;matz;2;7;6;13;0
81525af4c9a8e512db6bd8b73c6fbe5ea39c865a;Tue Oct 21 22:10:49 EDT 2008;Committer;matz;3;34;3;37;0
34d1e9bb2504d7fa0b98ad99a32c549cd0d92853;Tue Oct 21 20:59:23 EDT 2008;Committer;ko1;4;21;9;30;0
bf52a3c0c4ce5044a31e62ab6f6366e5a76103a7;Tue Oct 21 20:46:08 EDT 2008;Committer;ko1;1;7;0;7;0
3337185ed683bfc82f86641e0627021952cefa8b;Tue Oct 21 20:45:35 EDT 2008;Committer;ko1;2;18;3;21;0
fa127bbb189a88921870ccd922744a7aa14aa009;Tue Oct 21 15:52:07 EDT 2008;Committer;matz;3;37;25;62;0
73e221a1be7eca8b604992f84009829793d77e6c;Tue Oct 21 15:32:39 EDT 2008;Committer;svn;1;3;3;6;0
87fa1cdfdb07d85d138c86605d132cc22026a55a;Tue Oct 21 15:32:35 EDT 2008;Committer;seki;2;5;1;6;0
16549e33da58396d243234e5880f4f1dae6ab339;Tue Oct 21 14:14:13 EDT 2008;Committer;matz;5;21;3;24;0
c5377c2bccb7c46e4f8a958f0ddfd487c487000c;Tue Oct 21 13:57:16 EDT 2008;Committer;matz;3;14;9;23;0
42a6550027acfae936ba4038ca3b2a3e5ed479b2;Tue Oct 21 12:56:48 EDT 2008;Committer;matz;3;20;4;24;0
ac466de7ff7bb62f86e2252d479d9db8c1f98500;Tue Oct 21 12:33:44 EDT 2008;Committer;nobu;2;5;3;8;0
04f674188e423a5af7af51c074d5f531be537e1b;Tue Oct 21 11:13:28 EDT 2008;Committer;akr;2;7;1;8;0
b6ef272d025387e6707088ba2f9cef3b9031d2db;Tue Oct 21 09:18:34 EDT 2008;Committer;matz;6;356;189;545;0
d423b884b8d95b878d66de1abc2efa300f8971e2;Tue Oct 21 04:31:15 EDT 2008;Committer;shugo;4;10;2;12;0
89dfcd82f09ca83ac2fc793f6524393c6ae45fdd;Tue Oct 21 04:19:56 EDT 2008;Committer;yugui;4;472;466;938;0
5225f2c143fa69d73c1b90818a8b6a5be1175379;Tue Oct 21 02:34:07 EDT 2008;Committer;nobu;3;18;2;20;0
4442095d4cf09ce6042a4a6eb32a7b105c286733;Tue Oct 21 01:40:41 EDT 2008;Committer;nobu;2;6;3;9;0
05a157ed8a0f0c149e7b66331209ef87fe6225a9;Mon Oct 20 23:56:40 EDT 2008;Committer;nobu;2;3;5;8;0
5e7203ea220c44dea58eb96fe88517f0fb015ce5;Mon Oct 20 22:45:17 EDT 2008;Committer;nobu;2;7;0;7;0
e50a5bcef093f814ebd8d162a3c2f3665620e412;Mon Oct 20 16:57:19 EDT 2008;Committer;matz;3;29;7;36;0
b5e583f7e39b45c6fbdadafcf8d9dc76ff13eefc;Mon Oct 20 15:53:19 EDT 2008;Committer;svn;1;3;3;6;0
7d48eab26035ea6ef10c14dcb3a01475ad861065;Mon Oct 20 15:53:14 EDT 2008;Committer;akr;2;23;2;25;0
e46482f3d3dd64883b60911b12f627e9ceda3391;Mon Oct 20 14:16:54 EDT 2008;Committer;xibbar;1;17;13;30;0
225d2af65ad3b05e74b31376bc929238ddede719;Mon Oct 20 12:29:29 EDT 2008;Committer;xibbar;2;11;6;17;0
71b832dd8ec46647bdf789ee453be51300402627;Mon Oct 20 11:21:57 EDT 2008;Committer;matz;2;6;0;6;0
b348ed33442c6f3d946c0f1fc85820911a2faabe;Mon Oct 20 11:18:50 EDT 2008;Committer;matz;2;6;1;7;0
6259c87d02fce0a77ac90b6786ed1f2bc5baea32;Mon Oct 20 08:05:44 EDT 2008;Committer;matz;6;117;77;194;0
52b3e3b97f42498c1f30984cb1e174422c235c80;Mon Oct 20 07:15:19 EDT 2008;Committer;matz;3;12;0;12;0
d4e0abcec9aae83243c93efb5bcc6ec760151745;Mon Oct 20 00:48:24 EDT 2008;Committer;akr;2;8;3;11;0
27fdb77821957b5a304b1730ce9f95c899a3b5be;Sun Oct 19 23:22:10 EDT 2008;Committer;nagai;6;155;66;221;0
4ee47dcc0733493757bffc168c479594fef56a03;Sun Oct 19 18:27:31 EDT 2008;Committer;akr;1;2;2;4;0
8bb663bd49226879d9b8dc12e37a0457b6831fef;Sun Oct 19 15:59:39 EDT 2008;Committer;svn;1;3;3;6;0
8fe3d0285fce27fc206a593c7131e8df72808f41;Sun Oct 19 15:59:35 EDT 2008;Committer;akr;4;57;20;77;0
295c75cb7ccaee5d3050f60f9daff85e2f6ae050;Sun Oct 19 12:19:19 EDT 2008;Committer;nobu;2;4;1;5;0
de85d6e92ec7b7642ad02ca93cb6d5cdf75ac481;Sun Oct 19 12:12:53 EDT 2008;Committer;nobu;5;196;41;237;0
b014f1bc021702ee2800752aa37bfe7848118f2a;Sun Oct 19 09:15:37 EDT 2008;Committer;duerst;11;1265;0;1265;0
81b1fef56c864d3c0f9e654861f4a0826e33af24;Sat Oct 18 22:43:06 EDT 2008;Committer;tadf;2;15;0;15;0
c2091e37ec2fd62e82f5aa69e8d147e0c329cdff;Sat Oct 18 22:30:13 EDT 2008;Committer;yugui;12;211;199;410;0
b7be78d774daf5b9a9fdd63e6d20e30309b9efa0;Sat Oct 18 15:30:24 EDT 2008;Committer;jeg2;22;2550;2545;5095;0
54e2cb81799f0ff7e443758b50e906ea5b1833d3;Sat Oct 18 15:18:49 EDT 2008;Committer;xibbar;1;12;0;12;0
b177ff64db1fc467da736f724d196384d1e329f3;Sat Oct 18 15:16:02 EDT 2008;Committer;svn;1;3;3;6;0
5cf4f78aea2a136ab28005c7893351c7e96139b6;Sat Oct 18 15:15:57 EDT 2008;Committer;akr;2;6;2;8;0
679d83e6f2ae7ee7fb6ca2878fe8e97fd80ff183;Sat Oct 18 14:30:47 EDT 2008;Committer;xibbar;1;21;0;21;0
45e68487416bad94261f1a022e660d28b4211e5e;Sat Oct 18 13:02:23 EDT 2008;Committer;duerst;1;13;13;26;0
d3546e79ae255351808141321ef79d56e755bdca;Sat Oct 18 11:49:39 EDT 2008;Committer;matz;2;9;0;9;0
957f69d2de579d04b9e554fc70f69a097d063bfb;Sat Oct 18 10:46:58 EDT 2008;Committer;matz;1;13;13;26;0
8705e3623cb8b68d81b72a697ce20b957c9e7fcf;Sat Oct 18 10:39:41 EDT 2008;Committer;matz;2;8;1;9;0
3f0ec8887f3bc75a98fd3ec8926518b635c70b7b;Sat Oct 18 10:36:20 EDT 2008;Committer;matz;6;78;22;100;0
88aa8632741d027d1d2e58f8073d4ec90845499d;Sat Oct 18 10:32:26 EDT 2008;Committer;matz;2;17;2;19;0
fcce99c52d786e336ab0a8f8205a04841fc743d0;Sat Oct 18 10:29:06 EDT 2008;Committer;matz;3;11;2;13;0
7adbfbb7937f52a9df8792048882a93db466e52e;Sat Oct 18 08:10:57 EDT 2008;Committer;duerst;3;26;22;48;0
da1ffe490d589fddcca75f410634b73052668443;Sat Oct 18 07:41:09 EDT 2008;Committer;duerst;2;7;5;12;0
de55ffd02450e2020af9a288b950c6d5d7596fd5;Sat Oct 18 05:07:38 EDT 2008;Committer;akr;1;7;3;10;0
6fa352271f9bdfe1c86f0d29df4e56bdb2eabcd3;Sat Oct 18 04:41:17 EDT 2008;Committer;akr;2;17;2;19;0
c2fab593410a6bb9c15979114ec904e1d029133a;Fri Oct 17 16:38:54 EDT 2008;Committer;eban;2;5;1;6;0
9dd20d027ca8f3526b3f991444436baec9576087;Fri Oct 17 15:51:39 EDT 2008;Committer;svn;1;3;3;6;0
b29f3640e9ef46a520ba67853b52e9d236a9f6a6;Fri Oct 17 15:51:35 EDT 2008;Committer;wanabe;2;5;1;6;0
331cd4eed69b4b9f04590109877ef8af424bf9c9;Fri Oct 17 13:09:33 EDT 2008;Committer;wanabe;2;84;12;96;0
26b3c7a0f3bee99ce8ed31518bc8343853f5c79a;Fri Oct 17 11:56:11 EDT 2008;Committer;nobu;4;155;124;279;0
b025ce46786ced077d67c2a2bbe53af3f819f9d7;Fri Oct 17 10:46:23 EDT 2008;Committer;nobu;9;209;112;321;0
6e738bf2b19fdb8c15a00e08b417596e00452ea0;Fri Oct 17 10:42:11 EDT 2008;Committer;yugui;2;19;11;30;0
6b02097f798c27379e9e04e107507a7f54ea9a45;Fri Oct 17 09:17:11 EDT 2008;Committer;matz;2;11;1;12;0
93e4ba927c565da6c56afa6e232d7a7e4b219a44;Fri Oct 17 09:15:00 EDT 2008;Committer;nobu;3;5;3;8;0
5ef37965fc5d2e773369719744e83466dc7be119;Fri Oct 17 09:13:04 EDT 2008;Committer;matz;2;24;16;40;0
7de38fadc056e3951a2bbcf5d94655e27e01c401;Fri Oct 17 09:07:27 EDT 2008;Committer;nobu;2;8;0;8;0
5545c5aafa2204fe3b50d7c465e8fb542f338dd2;Fri Oct 17 02:50:43 EDT 2008;Committer;shugo;3;26;3;29;0
68222eb41754f5288644b5d9b07e47a17badf11e;Fri Oct 17 01:30:13 EDT 2008;Committer;usa;2;6;1;7;0
3b8bc290f4313e46b2e7d614861d053f2e114a56;Thu Oct 16 23:21:59 EDT 2008;Committer;jim;1;0;6;6;0
98e6f9a79cc74ab22eafd7cf937c7eb8e9b860d5;Thu Oct 16 22:39:04 EDT 2008;Committer;matz;2;6;1;7;0
1e8bbf315464f212ee53de3929c02de0b73c92a1;Thu Oct 16 22:21:42 EDT 2008;Committer;matz;4;25;5;30;0
4709e330cf23e91157da30c58e33017d1ff4433e;Thu Oct 16 22:21:09 EDT 2008;Committer;matz;3;12;3;15;0
c2b9d34f6266eb813de7e07f86573c26d28b5636;Thu Oct 16 16:26:53 EDT 2008;Committer;akr;2;5;13;18;0
978f8ca10a90ccf8fac5b1c7fb01f2d9c7abf187;Thu Oct 16 15:40:49 EDT 2008;Committer;mame;2;7;0;7;0
c69e178f0ce7c13f9fe124b7dea30937d70a2a37;Thu Oct 16 15:35:37 EDT 2008;Committer;akr;1;3;1;4;0
0cda4bb3bf099874662a10d1e66522369812716e;Thu Oct 16 15:25:25 EDT 2008;Committer;akr;3;32;6;38;0
f560dfdd9020e05cfbc7984217c4c63738b5fdf2;Thu Oct 16 15:18:22 EDT 2008;Committer;svn;1;3;3;6;0
ca9589aeb0ea4715edd9aa1fba9930673c30bdaa;Thu Oct 16 15:18:17 EDT 2008;Committer;mame;3;5;49;54;0
0f4ea5f3e374f5423b42b30025461e80abf214fc;Thu Oct 16 14:49:32 EDT 2008;Committer;akr;2;4;1;5;0
01cdeb8da7077b660b70155a1cd244ebbfe2a9a4;Thu Oct 16 14:38:08 EDT 2008;Committer;mame;2;8;0;8;0
ba1e27f3ca9bca11a80c906bba0627073e95f9cc;Thu Oct 16 14:28:06 EDT 2008;Committer;akr;2;15;0;15;0
338253cbe54569137cff26f6cb5dd6db379f481b;Thu Oct 16 14:24:08 EDT 2008;Committer;akr;2;20;1;21;0
0ebf9b176380e691d3505e6c96cb0e33c6d892e4;Thu Oct 16 13:55:09 EDT 2008;Committer;akr;25;138;3597;3735;0
7485e91f76b7149c421900934adb146913142f8c;Thu Oct 16 05:34:25 EDT 2008;Committer;nobu;3;17;3;20;0
483225e52199341bb313913a3fdcb5abba4ceb24;Thu Oct 16 05:30:38 EDT 2008;Committer;nobu;1;2;7;9;0
5eb2a2e117e1683e8227a85976f658ddf0898f80;Wed Oct 15 21:27:04 EDT 2008;Committer;svn;1;3;3;6;0
f71b2c94dc5379ce080b12c56f8b1ecbaf7e1709;Wed Oct 15 21:26:59 EDT 2008;Committer;matz;2;5;2;7;0
7a0acc7eeead9d0726a9b86086d4b23683fabf03;Wed Oct 15 14:12:15 EDT 2008;Committer;matz;2;75;78;153;0
55ae1d90a389c6cacb7441a79349b7854082f2d4;Wed Oct 15 13:22:47 EDT 2008;Committer;usa;1;1;0;1;0
6c4895c78afa358f56099ed98679f106b82dff51;Wed Oct 15 13:21:37 EDT 2008;Committer;usa;2;8;1;9;0
5c9dd204f5c2b5501c8df10f7ab1da7f7f71992c;Wed Oct 15 09:15:46 EDT 2008;Committer;akr;1;24;15;39;0
a917be2c281cb43b404d985875fa6cce8328de05;Wed Oct 15 07:58:42 EDT 2008;Committer;usa;2;5;1;6;0
40adf66644ed2fc900ad5b584576cc3e3b89dd46;Wed Oct 15 07:48:34 EDT 2008;Committer;matz;2;6;1;7;0
7370c38456957bd19197064199d622bc2dcbf877;Wed Oct 15 04:16:28 EDT 2008;Committer;ryan;1;11;1;12;0
3fe5cb3494b9247954129b5d883f269a9fe24049;Wed Oct 15 04:14:17 EDT 2008;Committer;svn;1;3;3;6;0
b9a41f00b7776bb21e6c94070c6444c293124578;Wed Oct 15 04:14:14 EDT 2008;Committer;ryan;1;5;1;6;0
f9c35bce1b7514234464dccef5a5afe8e9b05c08;Tue Oct 14 14:21:25 EDT 2008;Committer;matz;2;6;13;19;0
4dbc8e24542e39b627e3546a58aabf59462c9c7d;Tue Oct 14 14:08:36 EDT 2008;Committer;akr;1;6;1;7;0
80cdf946f7c3fb2e74b778f9bb2f4807d50a33d2;Tue Oct 14 14:05:11 EDT 2008;Committer;matz;2;6;1;7;0
45f505c40f97b70296aae9345cbc23067d3310c6;Tue Oct 14 12:50:43 EDT 2008;Committer;nobu;2;6;0;6;0
f457364caef3999c920a946a2d0294692a6973c7;Tue Oct 14 12:44:37 EDT 2008;Committer;suke;3;36;14;50;0
1288965f4e464686a95b701a2573f5a3cc406569;Tue Oct 14 11:45:32 EDT 2008;Committer;nobu;4;55;25;80;0
b968fa97f6ce694af0e1a102475217b627b78289;Tue Oct 14 11:33:17 EDT 2008;Committer;akr;2;10;11;21;0
40c08c9ee611fc5487a453df4e73d15e01135550;Tue Oct 14 05:11:20 EDT 2008;Committer;nobu;2;6;1;7;0
48a303c0277a8fd7c90fe0fd1cb4f908ab138e03;Tue Oct 14 04:37:10 EDT 2008;Committer;duerst;5;176;0;176;0
9639bf54eceb04b5ff4f242681c2c03dd58e903b;Tue Oct 14 03:23:57 EDT 2008;Committer;kazu;2;6;0;6;0
0e0d05d5f476df9f900e4686a940b4f5dc336133;Tue Oct 14 02:22:46 EDT 2008;Committer;kazu;3;140;1;141;0
339ceda4e8c9e58dc7451b91d17a83e816393058;Tue Oct 14 00:41:09 EDT 2008;Committer;matz;2;45;5;50;0
f143d606f19d4ce474fe806fec12fd58940933a4;Tue Oct 14 00:36:57 EDT 2008;Committer;svn;1;3;3;6;0
c196780964cfb73227575d864313b82f300ac4f8;Tue Oct 14 00:36:52 EDT 2008;Committer;matz;2;14;10;24;0
20ed75a6399ca74786984b1d6ca7ccd21eb765cd;Mon Oct 13 10:13:40 EDT 2008;Committer;naruse;2;7;2;9;0
a09a8ea86d8e9d163983f0a55adfa046010f35fc;Mon Oct 13 00:56:40 EDT 2008;Committer;nobu;1;1;1;2;0
359945ec7fe2412836a1eaccebf04008d5d9010f;Mon Oct 13 00:55:08 EDT 2008;Committer;nobu;1;2;0;2;0
80a5a3f9dca3e7e073f3e14a02c4873c30db0f0e;Mon Oct 13 00:03:11 EDT 2008;Committer;suke;3;23;22;45;0
9ed35ae7930c57b63b218cda716fcf01aa56ac88;Sun Oct 12 23:03:17 EDT 2008;Committer;matz;2;9;0;9;0
8a6a0188bcce54f13166b0e624515f156498400f;Sun Oct 12 22:52:06 EDT 2008;Committer;svn;1;3;3;6;0
284f4c8431b140898ee9ff5711cce0e41e0c2c39;Sun Oct 12 22:52:01 EDT 2008;Committer;matz;2;21;4;25;0
e64453aa697cc42bfaee51ed771b02898b142daa;Sun Oct 12 09:06:45 EDT 2008;Committer;suke;3;162;33;195;0
7215c9af95eb2375eebef478502a7a824ddd16d5;Sun Oct 12 03:28:49 EDT 2008;Committer;ko1;3;32;24;56;0
c809aaa5e1453cf74cf7e22f2468f671c2d687ec;Sun Oct 12 01:18:49 EDT 2008;Committer;nobu;1;101;101;202;0
893af1e3b6233deaf8b9113e4f313c5b3661d7bf;Sun Oct 12 00:46:59 EDT 2008;Committer;nobu;3;23;17;40;0
43f910a9aa5f65312e18902de4464ba4069e9123;Sat Oct 11 13:44:31 EDT 2008;Committer;akr;1;20;0;20;0
d9fdf58aaa0010657b486e1824f7a5cf023bc4ac;Sat Oct 11 10:49:56 EDT 2008;Committer;nobu;2;5;1;6;0
de7845773a4f555393bd7ea2b38e11a99bffbeb9;Sat Oct 11 09:56:07 EDT 2008;Committer;akr;1;9;2;11;0
3c276224fc8c508a718c912bd0f6297d2435bc7e;Sat Oct 11 01:20:20 EDT 2008;Committer;nobu;2;14;9;23;0
e9fff84b956802585b8aa706ff11fc2644f70b70;Fri Oct 10 23:51:16 EDT 2008;Committer;nobu;2;10;4;14;0
901ba06ba6e422db74787f4b80f75cbdd76dc0db;Fri Oct 10 23:30:39 EDT 2008;Committer;nobu;1;3;3;6;0
3f710785f0508d93795b316b78dc24987cf47370;Fri Oct 10 19:19:36 EDT 2008;Committer;ko1;4;29;7;36;0
254937c873d5f273519056f80ea3b1dfd0812e95;Fri Oct 10 15:09:39 EDT 2008;Committer;svn;1;3;3;6;0
7d3d3535584bd70d0a9a0f5f9abc3aeeea115c5a;Fri Oct 10 15:09:34 EDT 2008;Committer;jeg2;12;184;179;363;0
aa2797ee41a531ac05b4a92ad713a4b9f3c9f756;Fri Oct 10 13:21:36 EDT 2008;Committer;akr;1;9;9;18;0
4b5166280035371a46e06d69f288da12a7ac9d87;Fri Oct 10 13:16:58 EDT 2008;Committer;nobu;2;8;4;12;0
fb93e65c760752fd2dbd6456500adb4b9a9c6f5e;Fri Oct 10 13:07:07 EDT 2008;Committer;nobu;2;5;2;7;0
a77d088cf6a87326e5adad3d46bf70cc22861a3a;Fri Oct 10 10:21:53 EDT 2008;Committer;nobu;2;37;9;46;0
5b35f2c13788786af6813fbd9fa5db59c545ae32;Fri Oct 10 08:28:19 EDT 2008;Committer;naruse;2;8;1;9;0
c71e65e92fa2bec30390554eaa5cf2e74973919f;Fri Oct 10 06:18:44 EDT 2008;Committer;ryan;1;6;0;6;0
8673d9a5a884b6c5dd1bc7788634430cb1dbdba7;Fri Oct 10 06:15:29 EDT 2008;Committer;ryan;2;281;43;324;0
176fda7c025038aa403ea8627b661d4eb11daa37;Fri Oct 10 01:40:24 EDT 2008;Committer;ryan;3;0;1094;1094;0
7ebbb3871e473dca485993759b07a9a86d84d70c;Fri Oct 10 01:18:03 EDT 2008;Committer;ryan;6;1686;0;1686;0
30e76a6af3f1ea21552a566680a19254e1c005fb;Fri Oct 10 01:17:21 EDT 2008;Committer;ryan;21;3307;0;3307;0
3e66bda38e96a42d0cf8af22f0fc08f55d13a0f5;Fri Oct 10 00:56:29 EDT 2008;Committer;ryan;8;0;771;771;0
94355e2984dad584f409d732fea4310bbbd3588f;Thu Oct 09 18:41:35 EDT 2008;Committer;nobu;2;6;1;7;0
017ff9bfa2daadb7c27953eb1ae70c2833dfa80c;Thu Oct 09 16:55:51 EDT 2008;Committer;nobu;2;15;8;23;0
05124e6a557cc0814214803746c04a5dcffc63d3;Thu Oct 09 15:21:42 EDT 2008;Committer;nobu;2;21;12;33;0
65fcdd10b764f7c88eb4bebc3fd738f870dde069;Thu Oct 09 15:12:25 EDT 2008;Committer;svn;1;3;3;6;0
fc9c37dfc9129466cff4d35572a9a2d3ad4a61e9;Thu Oct 09 15:12:20 EDT 2008;Committer;mame;2;4;2;6;0
fd8ca75663f20bcc0648c470b18986a8ee27375e;Thu Oct 09 14:53:26 EDT 2008;Committer;nobu;2;14;1;15;0
2f67ef83328730d710d07fa69d6ee0d707c15bf8;Thu Oct 09 14:31:32 EDT 2008;Committer;mame;2;5;1;6;0
ab2868bfba0b76a12e56335a3aec626d86ce07f6;Thu Oct 09 14:24:15 EDT 2008;Committer;mame;2;5;0;5;0
270f2f15be57fd13905cad48259af45670ae9fb1;Thu Oct 09 13:16:07 EDT 2008;Committer;mame;3;24;10;34;0
ae4bc66b6412b35ac1f60d99d2402ae9293cf6ec;Thu Oct 09 13:07:28 EDT 2008;Committer;mame;2;6;2;8;0
525b4535caa65d86495e83759239f4968c430fe8;Thu Oct 09 12:18:42 EDT 2008;Committer;mame;2;7;2;9;0
3b1e5ba31ccaa39599f978af161255e7148a90ee;Thu Oct 09 07:34:56 EDT 2008;Committer;naruse;3;8;2;10;0
1339a862e582e3ce72917cd2f3b1a77b94b1ad53;Thu Oct 09 07:33:55 EDT 2008;Committer;naruse;1;9;0;9;0
c86ce094e283f400889f4f0bc97b897e84df04ac;Thu Oct 09 05:47:04 EDT 2008;Committer;yugui;8;363;152;515;0
517a1c340631ecfcb7c2d5558e864a4fe60e315f;Thu Oct 09 02:52:39 EDT 2008;Committer;naruse;2;39;0;39;0
f59b1dfbfb1f1ef39e2b4d684bb1009262fcb65d;Thu Oct 09 00:46:59 EDT 2008;Committer;akr;1;7;7;14;0
8fe2011e353f26ce188e559d4e26020265ae8713;Wed Oct 08 23:49:27 EDT 2008;Committer;svn;1;3;3;6;0
22c8e88b413d1ad2fb10a74aebc6b2a803abf0a8;Wed Oct 08 23:49:22 EDT 2008;Committer;matz;2;6;0;6;0
43f77aaf1a9ea21e7386d40dd3ea3369caa1adc0;Wed Oct 08 13:13:35 EDT 2008;Committer;akr;1;0;1;1;0
b7212ba643b8db2a580c457f6189385f00db5d99;Wed Oct 08 12:05:18 EDT 2008;Committer;suke;2;18;4;22;0
d245085630c24e7af6c47e1879b90767040110ed;Wed Oct 08 10:06:43 EDT 2008;Committer;akr;1;1;0;1;0
470a309c4ad8e6f803c06e75711c0085ac0cd8db;Wed Oct 08 10:06:16 EDT 2008;Committer;akr;1;4;4;8;0
cd9f5a1eeeeb423523940d652a4a8957be984b4a;Wed Oct 08 08:03:08 EDT 2008;Committer;naruse;2;8;2;10;0
87259f9a5f19eb5c568079c33360e5fd15772938;Wed Oct 08 06:01:48 EDT 2008;Committer;naruse;2;6;1;7;0
ccf184d9e472998365d2bd009557919dd4c00a68;Wed Oct 08 03:00:11 EDT 2008;Committer;naruse;2;33;16;49;0
fd1dc66691aeab8055069f06ff01c8d47553a874;Wed Oct 08 02:23:04 EDT 2008;Committer;nobu;1;28;23;51;0
d011b2e3effe48540d50f536dea198cd919340f5;Wed Oct 08 02:18:15 EDT 2008;Committer;nobu;2;8;10;18;0
baeeebf474cae027bc3d2e80a72a540612874ef9;Tue Oct 07 17:39:44 EDT 2008;Committer;matz;5;206;61;267;0
0b184b473b1baea42f4093f23d64b24cf4a565fd;Tue Oct 07 15:08:47 EDT 2008;Committer;svn;1;3;3;6;0
2bf7d240b81e2886e961d2ee755909a4416eebb2;Tue Oct 07 15:08:42 EDT 2008;Committer;tadf;3;23;2;25;0
84f677d2f38f596f71d6aea54ba2da68f4f60855;Tue Oct 07 07:50:43 EDT 2008;Committer;naruse;2;7;2;9;0
6d58b1e54fa9b801382e18f49aff805bba7f7c85;Tue Oct 07 07:37:23 EDT 2008;Committer;naruse;3;9;4;13;0
ddf88ea80bf1cd09bba74916a4e8836ecca71910;Mon Oct 06 07:53:58 EDT 2008;Committer;xibbar;4;15;5;20;0
73a2f671646a6f2a4097bc38060dac0583f0e1fd;Mon Oct 06 06:22:11 EDT 2008;Committer;nobu;2;5;0;5;0
5e9cfca2d4fe158a9e2c5fac699b9dfe014b845f;Mon Oct 06 03:49:17 EDT 2008;Committer;matz;2;8;4;12;0
f4d37a3ff4c3fe4dfd82710e21d0e896e36650c0;Mon Oct 06 03:46:11 EDT 2008;Committer;matz;2;9;0;9;0
b8623eab437da7c582f5687cc04424ae4d22027f;Mon Oct 06 03:42:25 EDT 2008;Committer;matz;2;6;1;7;0
f2f2cd5bc69847be2c7edcc5c61d5bbb380955fd;Mon Oct 06 03:22:56 EDT 2008;Committer;matz;3;9;6;15;0
2de01f01a700c8603858f9543d0e323e2d07df28;Mon Oct 06 00:02:44 EDT 2008;Committer;matz;2;7;3;10;0
919301c48920af0377cd2075e92e34105975ec0f;Sun Oct 05 15:43:55 EDT 2008;Committer;nobu;1;3;3;6;0
8e392570254dd7e275d0225ec0c47bebdf512e1e;Sun Oct 05 14:34:37 EDT 2008;Committer;nobu;3;8;4;12;0
4c88510849567353ff0b91920f169fba0e20fdb4;Sun Oct 05 14:07:06 EDT 2008;Committer;nobu;2;6;1;7;0
c3986f280576ec408f2b26fd9a1edeb177059d69;Sun Oct 05 12:30:54 EDT 2008;Committer;tadf;3;15;9;24;0
a64f397403c03d9d613294861c3c9b4df05dd454;Sun Oct 05 09:53:17 EDT 2008;Committer;akr;2;4;1;5;0
f09149cab5ae59d40e61787ba3cbfd95c584baab;Sun Oct 05 08:51:22 EDT 2008;Committer;naruse;2;11;0;11;0
fd898245cba1cb65c3bb883ee05f591f2b335242;Sun Oct 05 08:47:01 EDT 2008;Committer;naruse;2;23;0;23;0
5a7c5d34fbea7263c83f8136e409b559ca4007aa;Sun Oct 05 02:39:29 EDT 2008;Committer;yugui;1;1;1;2;0
5e1311da38bf0ce8d0ea99e8dc86a159542b5552;Sun Oct 05 02:26:45 EDT 2008;Committer;naruse;2;6;0;6;0
146ea3c398fb371cfad4c9abea47535e9e08eebc;Sun Oct 05 01:10:41 EDT 2008;Committer;naruse;3;10;6;16;0
e8ee99ff1ae054c4edefb60083b11db5fe1c7429;Sat Oct 04 13:57:06 EDT 2008;Committer;yugui;14;31;269;300;0
a8c3540b32d7621c183627d7cc198f4b24798387;Sat Oct 04 13:48:20 EDT 2008;Committer;yugui;48;38;3388;3426;0
642e08187927b2debaa0d84a112123043f0f7912;Sat Oct 04 13:42:00 EDT 2008;Committer;yugui;13;32;180;212;0
ae7ea3332b07c83ee050c88cd902070689fd582f;Sat Oct 04 13:33:22 EDT 2008;Committer;yugui;13;45;65;110;0
8dd118c0db80af4ff213265a2b2b475c73bb440a;Sat Oct 04 13:25:12 EDT 2008;Committer;yugui;23;67;526;593;0
bbbd9c0b7be96824e4648b551b3a66763df38788;Sat Oct 04 13:12:13 EDT 2008;Committer;yugui;20;67;697;764;0
0c0e636b19559715798dcbf6493cb4327c60488f;Sat Oct 04 10:22:15 EDT 2008;Committer;tadf;2;4;2;6;0
a6e736e09d9ef5d42aa321dfaca17b0f7e6b0583;Sat Oct 04 10:06:26 EDT 2008;Committer;naruse;2;5;3;8;0
0b18a77e7d03a0bbf06bed7b683bddbe1730d61b;Sat Oct 04 09:56:20 EDT 2008;Committer;naruse;2;39;0;39;0
5f898e44a788c1c174c7e8d92e35ea8700477bd4;Sat Oct 04 07:30:51 EDT 2008;Committer;yugui;27;1236;3569;4805;0
279c3cbdbe53c8bf88807bf2e700b67fd9e20383;Sat Oct 04 06:36:20 EDT 2008;Committer;yugui;2;12;1;13;0
bf437b73c6fbc9d5a8a80c1db7353858a5210f95;Sat Oct 04 03:28:19 EDT 2008;Committer;keiju;1;1;1;2;0
0fdc3b4bc509f7d5e532c2f5997be4c75b3bc933;Sat Oct 04 03:26:16 EDT 2008;Committer;keiju;3;16;8;24;0
ade6d076a9194995ddfd4f988f0bcebb0d1bc88a;Fri Oct 03 15:49:44 EDT 2008;Committer;svn;1;3;3;6;0
3ac20b95903facd49b1f32c0cdb40c290db82016;Fri Oct 03 15:49:39 EDT 2008;Committer;yugui;2;11;7;18;0
be93ac50db6b8dc8f3eedd8c9779a8c82fd694e6;Fri Oct 03 10:36:10 EDT 2008;Committer;naruse;4;30;65;95;0
7e752551bbe122f57eb3536077804ddf7979244b;Fri Oct 03 05:05:02 EDT 2008;Committer;svn;1;3;3;6;0
bfdadb885a95443853dafcc1aeecd26b1f4900e6;Fri Oct 03 05:04:57 EDT 2008;Committer;usa;4;17;2;19;0
10e9b638069d9e40233242693814b86c672e423e;Thu Oct 02 12:37:30 EDT 2008;Committer;xibbar;3;110;135;245;0
bd421aa2d25aa73c83642a8f5af8fa16b794a3b6;Thu Oct 02 11:46:40 EDT 2008;Committer;akr;4;45;13;58;0
255f43160bf165df350454bdf4dcf72275029704;Thu Oct 02 02:40:36 EDT 2008;Committer;svn;1;3;3;6;0
c6866f855206d2daa55324c3576ffaa7c4e95f85;Thu Oct 02 02:40:33 EDT 2008;Committer;knu;1;12;12;24;0
179b7eaa6b377c97f006342dbbadf3310cc2c3d3;Wed Oct 01 13:55:08 EDT 2008;Committer;mame;3;5;5;10;0
46321a9a313d934d23949ccecaa358c1761fd93c;Wed Oct 01 13:46:53 EDT 2008;Committer;mame;40;2245;2239;4484;0
952385b71267a843f8e71d0573f5b2fcf5709787;Wed Oct 01 12:36:38 EDT 2008;Committer;nobu;2;11;3;14;0
e5afadda03c70f4fe6b8228a0b2478ce9eed4e01;Wed Oct 01 10:21:02 EDT 2008;Committer;nobu;1;1;1;2;0
837d3aa882b80d63cea5ea0c184b83e806127f56;Wed Oct 01 10:13:57 EDT 2008;Committer;nobu;2;27;13;40;0
1d54761948e6baa4650c6bee938e4cc7f149baa1;Wed Oct 01 10:11:51 EDT 2008;Committer;nobu;2;25;20;45;0
7558136984c6c8d57f30831f1f328e7f5b3f99c9;Wed Oct 01 09:57:38 EDT 2008;Committer;nobu;2;17;10;27;0
414605560ff42c7358a61015e04c6a7fa1ca192b;Tue Sep 30 17:55:25 EDT 2008;Committer;matz;2;7;2;9;0
d370a79c6908f107dc4ff85d316ea9b523c188fe;Tue Sep 30 16:18:27 EDT 2008;Committer;matz;2;7;2;9;0
a75eadef3b53234683f6e84f7736e411dd71f0a7;Tue Sep 30 15:31:06 EDT 2008;Committer;mame;2;9;4;13;0
1625da99315c4d1a5a91e5faa91172d6e1cfa9db;Tue Sep 30 15:21:35 EDT 2008;Committer;svn;1;4;4;8;0
252255cad4e813fd0d243fb4768198936d623326;Tue Sep 30 15:21:30 EDT 2008;Committer;akr;2;8;2;10;0
888072261f87d2dedab9d3827cf88411a1de2f10;Tue Sep 30 14:13:33 EDT 2008;Committer;yugui;4;12;1094;1106;0
870b93ae9ef1641aa3bfe2bab7c2c05d380f62ce;Tue Sep 30 14:13:23 EDT 2008;Committer;yugui;23;3593;0;3593;0
1af1196616195f2283948f4f2f0d8585712f715a;Tue Sep 30 14:13:12 EDT 2008;Committer;yugui;6;14;147;161;0
1eeb3e151e40545267087530e07d3062b820d887;Tue Sep 30 08:06:20 EDT 2008;Committer;matz;2;9;3;12;0
8bfa0ac8692e0b525e92378605c63ab3a02447ac;Tue Sep 30 08:01:11 EDT 2008;Committer;matz;4;71;3;74;0
9bcbc9060543659c4ae14b64929cec33cddb60b7;Tue Sep 30 07:54:02 EDT 2008;Committer;nobu;2;5;1;6;0
852dc6d663a934aa30b4b526dcbb60394ae7d50d;Tue Sep 30 06:57:34 EDT 2008;Committer;ryan;4;27;17;44;0
b43dae5873c70ff9506e65a04dc983b78c9c28df;Tue Sep 30 04:57:06 EDT 2008;Committer;ryan;2;6;6;12;0
abf17f35866f271a8cb9f47ac9b2ed0a4cfc02a0;Tue Sep 30 04:20:07 EDT 2008;Committer;drbrain;2;5;1;6;0
9fad1aca4f67e944eb9c1c174604495c824ae607;Tue Sep 30 04:17:56 EDT 2008;Committer;ryan;2;14;3;17;0
64e2d46fa140a88b7f6769b6fc99ba685a9cc8f7;Tue Sep 30 04:14:09 EDT 2008;Committer;ryan;5;1140;35;1175;0
a42df5094dd78b883ee346cc8b48945de212aa8d;Mon Sep 29 22:48:11 EDT 2008;Committer;drbrain;4;23;0;23;0
6270b50cf6a2860a4a66bcac3a74af62617eadf7;Mon Sep 29 17:53:34 EDT 2008;Committer;nobu;1;68;0;68;0
9480a184116d83ba311e6df99584dda71b111f7c;Mon Sep 29 16:02:58 EDT 2008;Committer;nobu;2;7;67;74;0
c3fda337a0eeaae4ae06eb15c1467baa32226735;Mon Sep 29 15:51:35 EDT 2008;Committer;nobu;1;8;8;16;0
b921425c49392de00d1516c3fa772eeaf60f6d7f;Mon Sep 29 15:47:46 EDT 2008;Committer;nobu;3;9;5;14;0
eace50a9d79e1f3ec58011b8238d0b79e9a716b6;Mon Sep 29 14:39:20 EDT 2008;Committer;akr;2;8;2;10;0
0001260aaf3b69344b626c4a18faac938682cdbe;Mon Sep 29 14:13:09 EDT 2008;Committer;tadf;2;6;16;22;0
79b73a7b31919aec7397d0b5c3f2bbf28a2c9289;Mon Sep 29 13:55:39 EDT 2008;Committer;tadf;2;20;4;24;0
d2ef66df1362f38ca5b8f01a21dea6cb2e8e9f3d;Mon Sep 29 12:17:20 EDT 2008;Committer;tadf;1;0;1;1;0
ebb3ace8259e280670a2d8415b61e819f246220f;Mon Sep 29 11:56:43 EDT 2008;Committer;akr;2;13;1;14;0
9d2f9f26e8c334f679e31ea5a598f863ac030b39;Mon Sep 29 11:53:59 EDT 2008;Committer;tadf;1;4;2;6;0
1ac57f70e8f5a7f4f333792e03aca06894d53195;Mon Sep 29 11:24:03 EDT 2008;Committer;tadf;5;157;4;161;0
06df4049ed811c50062fe4a3a8c342cb2caf2a27;Mon Sep 29 11:18:37 EDT 2008;Committer;suke;3;11;2;13;0
8dcd42552feefe6b990763db0d9c24836a66da6f;Mon Sep 29 11:01:55 EDT 2008;Committer;suke;2;9;2;11;0
4e60b843c6e6349cc6c2b50a1fae2ca4ad05fe75;Sun Sep 28 16:52:56 EDT 2008;Committer;mame;2;6;1;7;0
d5e35b38faa3eac3259d22a373a8730d68cba7ee;Sun Sep 28 15:41:16 EDT 2008;Committer;svn;1;3;3;6;0
9acff4872df1ab628abfae923691f911b58d6d3f;Sun Sep 28 15:41:12 EDT 2008;Committer;xibbar;3;27;8;35;0
645a0eb8ec7c71f7635207580e3fd90837e0d8cc;Sun Sep 28 14:55:59 EDT 2008;Committer;xibbar;1;13;0;13;0
c0f84528c7d0d3a53eed497a92a91ba096affb81;Sun Sep 28 14:16:01 EDT 2008;Committer;xibbar;2;8;3;11;0
5958f6af19e7b7dc6ac26e3ee310af02b562c77d;Sun Sep 28 13:54:28 EDT 2008;Committer;xibbar;2;8;1;9;0
f2aabd1802b00ce7d23ab7733874b9a48f7495f0;Sun Sep 28 13:15:34 EDT 2008;Committer;mame;2;11;1;12;0
0e395a600215e9060cd9915940caa789b92a275a;Sun Sep 28 10:06:13 EDT 2008;Committer;tadf;10;3092;0;3092;0
f7aef0f7b1ad5fec79054ad532208d9430ec89aa;Sun Sep 28 09:41:34 EDT 2008;Committer;nobu;1;2;2;4;0
49cbbe7a8898b8bf7bfb1dc8fbd9551cd0dd31b4;Sun Sep 28 09:40:51 EDT 2008;Committer;nobu;1;4;1;5;0
6952b1a52a2bd4757b524173edf7ffa31b98fdf2;Sun Sep 28 09:39:53 EDT 2008;Committer;nobu;2;7;13;20;0
574027ba0371ab2e6fdb84e0634ec72d02cd6ff7;Sun Sep 28 07:13:06 EDT 2008;Committer;ko1;3;8;2;10;0
8d397604bf72d5efb525da5c3291f1197bcd3e9f;Sun Sep 28 03:04:21 EDT 2008;Committer;nobu;2;8;0;8;0
0b99ce1fd6276b8a0dd900ac95ac39c625e5448e;Sun Sep 28 00:41:42 EDT 2008;Committer;tadf;2;35;0;35;0
bde8a01d0a8750f9e0a7728ee9ae3a0fea3001ed;Sun Sep 28 00:06:21 EDT 2008;Committer;jeg2;4;15;9;24;0
356b051532c583e37c24c3f1f450013a1732556e;Sat Sep 27 23:41:26 EDT 2008;Committer;svn;1;3;3;6;0
f43d70f73e0d0d947afb290ba6b7ac9eba4637cc;Sat Sep 27 23:41:21 EDT 2008;Committer;tadf;2;95;0;95;0
95f9f98ac54c3ada20c049d71f8e2c0b79541ba8;Fri Sep 26 21:22:21 EDT 2008;Committer;nobu;2;13;10;23;0
605a46dd0535bc7706f3f412ee974c559e084a57;Fri Sep 26 19:28:44 EDT 2008;Committer;nobu;2;4;1;5;0
9320b5c65ff0f51d8fdc74d70476db70e40231e7;Fri Sep 26 18:57:23 EDT 2008;Committer;nobu;2;9;2;11;0
655685612ef08de21c098a5dc44076b90344edb8;Fri Sep 26 18:15:54 EDT 2008;Committer;nobu;2;5;1;6;0
34c7492e2ceb5eb65b445cd64cbf7a9a70b32a81;Fri Sep 26 18:12:43 EDT 2008;Committer;nobu;3;9;4;13;0
77a9d7c32f8a8b74c63e999af8e5c11506dee8e2;Fri Sep 26 13:47:01 EDT 2008;Committer;nobu;3;66;6;72;0
3e9276a5389c95f0d010b39bffd7c53f16197693;Fri Sep 26 12:38:38 EDT 2008;Committer;ko1;2;5;3;8;0
e97b544b5799ae86fd681a91d82cbe5a79b287b4;Fri Sep 26 12:17:54 EDT 2008;Committer;knu;1;3;4;7;0
a3bebd55645e0feac9c03d727e807080e6cd6b4a;Fri Sep 26 10:35:00 EDT 2008;Committer;akr;4;17;7;24;0
577e64a874a39ab8a3946660ac50bb3993a7e174;Fri Sep 26 10:13:57 EDT 2008;Committer;knu;1;4;4;8;0
de3b735720941048d1a5d0f3cb924c4909227282;Fri Sep 26 10:10:51 EDT 2008;Committer;knu;1;4;0;4;0
61b43de7555d2c39bc7f36d353b2fdd08a55ca1f;Fri Sep 26 10:01:50 EDT 2008;Committer;nobu;2;8;1;9;0
571b2e17b2775e40b3fe309d29dda611524625cf;Fri Sep 26 09:57:33 EDT 2008;Committer;knu;1;12;12;24;0
a2ae77350301cbefc7879151abba8569fcc864f0;Fri Sep 26 09:40:04 EDT 2008;Committer;nobu;3;31;8;39;0
00ae12834652655f9d9cf96728d1ef44bd90ef6c;Fri Sep 26 09:24:31 EDT 2008;Committer;nobu;2;8;0;8;0
3a5c011b8e1517b2ca31c56f54fda77f22b77700;Fri Sep 26 09:05:33 EDT 2008;Committer;knu;1;4;5;9;0
3cdf9d185c7c3b03c07c7fbcbc725581007bc285;Fri Sep 26 08:44:04 EDT 2008;Committer;yugui;1;1;1;2;0
2e102b151fa6c3368409d595c20974e28ad5fab1;Fri Sep 26 08:38:52 EDT 2008;Committer;yugui;2;5;1;6;0
bdd70c6109b882bfe887ff3b2be3af9277017061;Fri Sep 26 08:34:35 EDT 2008;Committer;yugui;2;11;5;16;0
140048b59d6617011666ec5f71c7324702fc954c;Fri Sep 26 08:27:19 EDT 2008;Committer;yugui;2;7;2;9;0
16c95b42ced7119ba013b52486e8e68317353b9a;Fri Sep 26 08:18:49 EDT 2008;Committer;yugui;6;166;386;552;0
9ea58e64218d55d235cb732309f2665b2d31866f;Fri Sep 26 08:06:59 EDT 2008;Committer;nobu;1;8;7;15;0
f8718692a2ee7e62e2fa3678963c8d71809abb42;Fri Sep 26 08:02:07 EDT 2008;Committer;nobu;2;13;3;16;0
3deb806a067dfcf68dd870f518a6eefe6f8794f7;Fri Sep 26 03:53:11 EDT 2008;Committer;matz;4;15;4;19;0
edebd815b00518a782f6cf01a0f39b3e8fe21b05;Fri Sep 26 03:05:47 EDT 2008;Committer;matz;4;11;3;14;0
fac096d5122fd95e4b4a7bdc711e2f411336ea26;Fri Sep 26 02:34:44 EDT 2008;Committer;usa;2;7;2;9;0
e76b1a11ca8eace6ee592722255195e2fe02ecd5;Fri Sep 26 02:07:19 EDT 2008;Committer;usa;3;20;0;20;0
4300e2a9931204ed8c282f313bd963899febe87e;Fri Sep 26 01:35:57 EDT 2008;Committer;nobu;2;34;21;55;0
07a88b713df19bd7e36bbf1576d6231cdfb955a1;Fri Sep 26 00:55:09 EDT 2008;Committer;nobu;5;43;34;77;0
18684d9f7cb64b93ec610f1c1deeabcfea364c08;Fri Sep 26 00:47:18 EDT 2008;Committer;nobu;3;96;13;109;0
3ceca921fc904e520131e81f17c66d344e117790;Thu Sep 25 21:56:30 EDT 2008;Committer;ryan;11;0;1798;1798;0
4efc3f78b0c63cc612ab8466fe9ab85326e03154;Thu Sep 25 18:04:34 EDT 2008;Committer;akr;3;8;3;11;0
2a608fed889adff42881f5b0e9ca141a42671b01;Thu Sep 25 17:42:52 EDT 2008;Committer;akr;1;12;12;24;0
ec0c394b9eb142c8e72e59bfa9061675b1167ed5;Thu Sep 25 15:42:23 EDT 2008;Committer;mame;2;24;10;34;0
a9da574d74c87d94655b2f3a3d3db312bdace0b9;Thu Sep 25 15:00:50 EDT 2008;Committer;svn;1;3;3;6;0
62390f4c9a11b2b2f9365ef522d9ea2c6d485aa1;Thu Sep 25 15:00:39 EDT 2008;Committer;akr;2;88;65;153;0
d7dbdef4e503f3ad8f9b00b91cf1b28884051402;Thu Sep 25 12:47:30 EDT 2008;Committer;akr;6;116;110;226;0
2c1c462747346b05b00a0a18f28cf098526b0c1f;Thu Sep 25 12:24:54 EDT 2008;Committer;mame;5;299;28;327;0
4ee0a8e740d4c9af11897e2999fd66c242d302dd;Thu Sep 25 12:04:34 EDT 2008;Committer;ko1;2;10;25;35;0
fee3bb664aea493ceb3186d37cc0890484bc8cd1;Thu Sep 25 11:42:49 EDT 2008;Committer;akr;1;54;10;64;0
7a86a81dccd6aa6c5268196727c86944443cb9de;Thu Sep 25 11:31:02 EDT 2008;Committer;yugui;2;13;2;15;0
6cd13d6577401706d3f008e2f80ec14339988018;Thu Sep 25 10:37:01 EDT 2008;Committer;drbrain;4;16;7;23;0
1833cfab3522d8e2e1028adc49564be75c133ef2;Thu Sep 25 10:35:07 EDT 2008;Committer;yugui;1;3;3;6;0
d478c7a7342478847cc1148f4134b5f0db04e1d9;Thu Sep 25 10:13:50 EDT 2008;Committer;drbrain;60;1841;716;2557;0
788001a9c8473130bd357846785838045387b060;Thu Sep 25 09:46:59 EDT 2008;Committer;yugui;2;26;6;32;0
dea63a4569d9fe682553f0622cd4cd4d1c3c31a8;Thu Sep 25 07:53:19 EDT 2008;Committer;ryan;1;11;3;14;0
7ab330203aa2409578bdd9f8ee5ac06b9f69eff3;Thu Sep 25 07:34:49 EDT 2008;Committer;ryan;2;2;2;4;0
ea94d40f4a44bef1801faf147c469220d1259d4c;Thu Sep 25 07:01:07 EDT 2008;Committer;jim;3;90;53;143;0
c5746c45b2f080f0ede4b69c8e94700b4ac83092;Thu Sep 25 06:57:05 EDT 2008;Committer;ryan;1;21;2;23;0
2c59d0ee7079a862f0d0ea2433286e141973afad;Thu Sep 25 06:47:33 EDT 2008;Committer;matz;1;1;1;2;0
858362e761a41e7d96efbcb9b38ae815b1e388d7;Thu Sep 25 02:43:03 EDT 2008;Committer;drbrain;54;2816;2191;5007;0
00b4a3f9c4aaf5aa038a9530ec515e1718ae1c42;Wed Sep 24 17:44:39 EDT 2008;Committer;nobu;59;284;284;568;0
48fdf59dcfbb6964d992b6f31d0eb6f023776145;Wed Sep 24 17:10:03 EDT 2008;Committer;akr;2;5;1;6;0
607b1f27870b1a2bf184ff09f8376cc4eb856873;Wed Sep 24 16:22:42 EDT 2008;Committer;nobu;3;6;2;8;0
4958c965b7f5c892a9f1a62ab81ef839da843510;Wed Sep 24 16:02:40 EDT 2008;Committer;svn;1;3;3;6;0
a7dd79c1b4050b7132f072e38b4563433c3f1fe0;Wed Sep 24 16:02:37 EDT 2008;Committer;akr;1;5;0;5;0
0f6375be69ecbeb5a98596d61ba196979e1dbe08;Wed Sep 24 14:43:05 EDT 2008;Committer;xibbar;4;16;9;25;0
3c419de10b113aceea7db10eb0d4521086696bc9;Wed Sep 24 14:27:53 EDT 2008;Committer;xibbar;3;143;12;155;0
00e9e27b69c7af6fab649c789c6698d256982046;Wed Sep 24 14:01:41 EDT 2008;Committer;usa;2;16;3;19;0
ad50e0edb93af94463219b998bfacf7ecdb5c213;Wed Sep 24 12:29:01 EDT 2008;Committer;akr;1;2;3;5;0
2fb01bc0d145f133f0c5da468b6f378787261020;Wed Sep 24 12:23:52 EDT 2008;Committer;akr;1;2;2;4;0
a69021a69961425a00a7275b1af2abec05a3bde5;Wed Sep 24 10:04:20 EDT 2008;Committer;usa;2;5;1;6;0
5b91aa974658423d2b765d3b1145e452c0d1fff3;Wed Sep 24 08:50:16 EDT 2008;Committer;ryan;1;4;1;5;0
d34a75b061c59f23da65c4d0aae31231b62cdd2f;Wed Sep 24 08:44:54 EDT 2008;Committer;ryan;1;1;1;2;0
cb723edfc89b57032f6b412479ccb12c3dbf3702;Wed Sep 24 08:44:47 EDT 2008;Committer;nobu;3;7;0;7;0
1db825a0477295ec6c8f8deba8334a58fc152abc;Wed Sep 24 08:19:12 EDT 2008;Committer;ryan;1;11;4;15;0
9aac312f77ff9cbfe357689d4b3832b9b344263b;Wed Sep 24 08:02:17 EDT 2008;Committer;nobu;3;11;24;35;0
922048adee910c0e57ca3f7a897670a3d2186fb8;Wed Sep 24 07:00:43 EDT 2008;Committer;matz;2;7;5;12;0
2798319088712b115243eaa81f420e76eb23c5af;Wed Sep 24 06:25:44 EDT 2008;Committer;xibbar;4;14;8;22;0
cdc5ebd3f2347d04785840c4903ad3d93631cf90;Wed Sep 24 05:39:39 EDT 2008;Committer;usa;2;6;1;7;0
ba73253e2bfbcaf4e0d95efcf251e116500992dd;Wed Sep 24 03:51:19 EDT 2008;Committer;ryan;1;40;35;75;0
9bf27f6b1745e7f91eb3789aba0e229950dabab4;Wed Sep 24 02:31:12 EDT 2008;Committer;matz;2;6;1;7;0
705b8b41eb5b01d6ce626e598c7116d0596bd5ba;Tue Sep 23 22:43:53 EDT 2008;Committer;shyouhei;3;8;3;11;0
187812978af1513fdb549415f7f6c1953e04e0e1;Tue Sep 23 21:44:59 EDT 2008;Committer;ryan;1;6;0;6;0
8e05c69aa1cab5cca3e725926016492aabe6f0d5;Tue Sep 23 21:39:21 EDT 2008;Committer;ryan;5;20;3;23;0
abef077ec7bbb60753f49290f90a90bb1b0a39e0;Tue Sep 23 21:36:05 EDT 2008;Committer;ryan;8;730;0;730;0
7c083f8c1f102ba2ded720567894f03e68227371;Tue Sep 23 21:34:11 EDT 2008;Committer;ryan;1;0;280;280;0
62c17944c7a07d9742b05abfddd4593b3ee6eaff;Tue Sep 23 21:32:19 EDT 2008;Committer;ryan;21;0;3307;3307;0
2e311f6bd56a6f6f380e400863a21adbfb73ddfe;Tue Sep 23 19:52:31 EDT 2008;Committer;ko1;18;536;531;1067;0
57c4acf94ad977c520a805becb47b27eaf965e1e;Tue Sep 23 19:11:06 EDT 2008;Committer;ko1;1;0;9;9;0
379bd563539f62dd918bba8d22e35443871190c9;Tue Sep 23 19:09:58 EDT 2008;Committer;ko1;1;4;0;4;0
29f5911cf54536f06697aea6e0a5c98977c536e9;Tue Sep 23 19:09:11 EDT 2008;Committer;ko1;2;6;7;13;0
ce80820c0cb75a8314d3dfa0b1cad7ee715d9adb;Tue Sep 23 18:16:14 EDT 2008;Committer;svn;1;3;3;6;0
563b6544378236252898f7489a336bd25890cfe7;Tue Sep 23 18:16:08 EDT 2008;Committer;drbrain;5;19;12;31;0
f3ba845deb749e9915bbba7e4b0d2de4ab424490;Tue Sep 23 14:40:24 EDT 2008;Committer;jeg2;2;8;3;11;0
c1759a9f18bf7349d7d8165b625deda5be5d20ca;Tue Sep 23 12:51:39 EDT 2008;Committer;akr;2;5;1;6;0
0f1a1073f7c9ab1ac67975ec45faa8fe91c22671;Tue Sep 23 12:46:17 EDT 2008;Committer;akr;2;5;1;6;0
74cb0507abebb251245a02128b767a37aa507a4e;Tue Sep 23 12:34:35 EDT 2008;Committer;tadf;4;1176;0;1176;0
e7e5b731c2033b337f4e2c9ac373f67e132694a0;Tue Sep 23 12:27:35 EDT 2008;Committer;akr;3;44;16;60;0
55783c696d97082f9163e1c6cc8241998f27b48d;Tue Sep 23 11:55:48 EDT 2008;Committer;akr;2;58;30;88;0
445e26fb00e8ce7e9f1785579abfd5662880f3f1;Tue Sep 23 11:37:23 EDT 2008;Committer;ko1;2;7;5;12;0
83abcf5a2c174bb76f258384d3a8f90cc5014928;Tue Sep 23 11:09:39 EDT 2008;Committer;matz;2;6;0;6;0
6b90013d1e4a3d0a4eee024d5f50d15560795f9f;Tue Sep 23 10:48:17 EDT 2008;Committer;matz;2;40;1;41;0
743765cd3bf7a8024b950c0e4a1a36f18092623a;Tue Sep 23 10:39:21 EDT 2008;Committer;usa;2;7;0;7;0
8b54d5812ca4d42f2fe2c53f2b29640ce22d09c3;Tue Sep 23 10:33:27 EDT 2008;Committer;tadf;5;76;268;344;0
455fbd2373cfc63b21c4fa2fcae4806710438fa9;Tue Sep 23 09:25:27 EDT 2008;Committer;akr;2;6;2;8;0
757f1b135dfa5534fe24ba0c544556b04288d503;Tue Sep 23 09:08:41 EDT 2008;Committer;ko1;2;5;1;6;0
c431879a6827ebd72ffecf6e9e21e82092ebfbda;Tue Sep 23 08:58:13 EDT 2008;Committer;ko1;2;7;2;9;0
64c35be42c436538efc25db5c6e4f037f90c686a;Tue Sep 23 08:51:33 EDT 2008;Committer;ko1;2;32;0;32;0
b9a12116fb2da007ef9059befc9b1b314bb079ed;Tue Sep 23 08:17:17 EDT 2008;Committer;ko1;4;20;5;25;0
68a533c61164392a9524d19f11f163a6c7e811ba;Tue Sep 23 08:10:20 EDT 2008;Committer;ko1;3;6;1;7;0
75b10ac6963531e60690064dbf2e40bd5cbd018e;Tue Sep 23 08:03:41 EDT 2008;Committer;akr;4;14;1;15;0
ab279b4085b19e94a69c09b95677a7937dea680f;Tue Sep 23 07:59:48 EDT 2008;Committer;nobu;2;16;29;45;0
abf97237c4bb80503f91b98cc92e00737949a1d6;Tue Sep 23 07:56:04 EDT 2008;Committer;ko1;2;7;2;9;0
7f7834abf738ab26236bea159fce7f37dea03f1f;Tue Sep 23 07:49:45 EDT 2008;Committer;ko1;15;437;405;842;0
0867b94cb9ec890d608beaa4d100a33508867727;Tue Sep 23 07:19:17 EDT 2008;Committer;matz;2;6;0;6;0
28f9e462fd71b274ec2a072ef673766739d3f277;Tue Sep 23 07:02:45 EDT 2008;Committer;akr;1;26;26;52;0
23c291da09859680c95a71686cdfdb2f9dd512e6;Tue Sep 23 06:34:33 EDT 2008;Committer;ko1;3;7;3;10;0
7440ec27fd23fc725c35049a1aea5bdc4fe9a7b3;Tue Sep 23 01:10:02 EDT 2008;Committer;ko1;6;138;115;253;0
8cd252ac6f3fd2d2eb3524880bf45767490bed70;Tue Sep 23 00:20:28 EDT 2008;Committer;ko1;23;768;860;1628;0
f398d750ea3450762c0ba10c5dea4522d4676360;Tue Sep 23 00:03:42 EDT 2008;Committer;mame;3;9;0;9;0
1c9b4b8c748d7ba8b84f2ac2c123b36c2f6ec55c;Mon Sep 22 23:38:04 EDT 2008;Committer;matz;2;4;1;5;0
3256a4dc214610884c0eb1e72b0d12242536d7e5;Mon Sep 22 23:27:33 EDT 2008;Committer;matz;2;7;1;8;0
fb014572650bc333c3c4ffe6b1179d443b7f03c3;Mon Sep 22 23:09:21 EDT 2008;Committer;matz;2;51;15;66;0
433095e50e2011974680740b2202e87854ddf56a;Mon Sep 22 17:16:15 EDT 2008;Committer;kouji;1;1;1;2;0
b043284bfe51791d39ff4a8644fcf7ab96e8619b;Mon Sep 22 17:13:25 EDT 2008;Committer;kouji;2;9;2;11;0
c3eecb35d88b92d3d0b04da963e67171dc4bf398;Mon Sep 22 17:07:26 EDT 2008;Committer;svn;1;3;3;6;0
925e6852b298e18afd30ca99b66525f1299d5c7a;Mon Sep 22 17:07:22 EDT 2008;Committer;kouji;2;14;1;15;0
2c6e46896a0542943f353aa1d9a44c54b136fc5a;Mon Sep 22 09:01:22 EDT 2008;Committer;matz;2;5;2;7;0
260c0e6a2fd3abd90e825034b736e4719c1e8621;Mon Sep 22 02:47:05 EDT 2008;Committer;shyouhei;2;6;1;7;0
a5a92315a1dcaff2220f32e8e255c85de6f6567b;Mon Sep 22 01:16:06 EDT 2008;Committer;matz;2;42;19;61;0
b6c7768be1e4d3a83004b1e8370a9ba97687f348;Sun Sep 21 17:52:23 EDT 2008;Committer;svn;1;3;3;6;0
163ac54f131d4b76e9dc0b19fc0327998e82eaee;Sun Sep 21 17:52:18 EDT 2008;Committer;naruse;2;26;21;47;0
bdf81563bf8bf7922cd8366c792478e220f76168;Sun Sep 21 12:53:40 EDT 2008;Committer;tadf;3;6;1;7;0
83b381752e21f15eb224bcf53142a3c8eaede1dc;Sun Sep 21 12:32:33 EDT 2008;Committer;tadf;1;4;4;8;0
cbae6d09113ff3ff6c07af2ae341b7384fa97667;Sun Sep 21 12:21:32 EDT 2008;Committer;tadf;3;20;6;26;0
a46544a4f9d31a2df3f9f2538de3fcb9715231fc;Sun Sep 21 09:07:25 EDT 2008;Committer;tadf;3;12;8;20;0
2897cdae9bb31a3ececa7d2175450d85ee89ce75;Sun Sep 21 04:59:53 EDT 2008;Committer;tadf;1;16;14;30;0
28a04df7bb3dbafaf9541bddbed5c562fa336536;Sun Sep 21 03:37:30 EDT 2008;Committer;tadf;1;2;2;4;0
72565402d9d0662a2fbef2e30f76b7a6621eefef;Sun Sep 21 01:30:25 EDT 2008;Committer;tadf;5;134;89;223;0
280cbe0b1fb807ee0de9ea3e862d556763e08811;Sun Sep 21 00:39:03 EDT 2008;Committer;jeg2;13;1106;172;1278;0
31eacb6ed129b7483f6f8a74034986cb7ead1836;Sat Sep 20 22:55:59 EDT 2008;Committer;tadf;2;7;1;8;0
9467d7a02430cbe76368148fe8097d7d029e6def;Sat Sep 20 22:49:56 EDT 2008;Committer;tadf;9;223;227;450;0
67526f30909c255d164d5c14d944eeda77d8d92a;Sat Sep 20 17:57:51 EDT 2008;Committer;naruse;1;1;1;2;0
55f9cc806df9d9f58917992e35e9c0ecf20e455e;Sat Sep 20 17:54:46 EDT 2008;Committer;naruse;4;14;6;20;0
e8eb95ec33334f40f3f3bbcbf16404aee07dfa8e;Sat Sep 20 17:41:14 EDT 2008;Committer;naruse;21;506;435;941;0
a91cd48aa19dd31ec5abb6e4b982f2077bedcbcd;Sat Sep 20 02:44:49 EDT 2008;Committer;mame;2;5;1;6;0
cfadd7253245525c66c467a88d9cf5d868f16957;Fri Sep 19 23:09:33 EDT 2008;Committer;naruse;3;13;10;23;0
00cdba732f4ec132947ac33479e423ae5da016cc;Fri Sep 19 23:07:22 EDT 2008;Committer;naruse;2;12;2;14;0
48aad600bab75a6b5866c9a46b5828351cc6878a;Fri Sep 19 23:05:52 EDT 2008;Committer;naruse;3;7;4;11;0
f2cb79ffee99c3561503ed7a1c107ca3ec6a48a7;Fri Sep 19 13:55:52 EDT 2008;Committer;tadf;6;40;19;59;0
396650e0bd353e30b873683f008f92e2aa498971;Fri Sep 19 13:10:54 EDT 2008;Committer;yugui;15;32;291;323;0
e6ad87c3ba2956297166a6cfcf31e30644075929;Fri Sep 19 13:10:45 EDT 2008;Committer;yugui;2;6;1;7;0
69b4c69a7298ac54427ff53f52e5526bc93131f8;Fri Sep 19 08:43:04 EDT 2008;Committer;matz;2;7;2;9;0
d7de44a8fcb6bdbcb3f6d9b97bb6164a8382dbbd;Fri Sep 19 00:33:19 EDT 2008;Committer;matz;8;19;7;26;0
a9cc553e61195f50a6d5bda5212025dbb2c6f585;Thu Sep 18 18:42:47 EDT 2008;Committer;naruse;2;21;15;36;0
eda2809b35da5ba602c1e9c0a3a266c024273d32;Thu Sep 18 16:16:49 EDT 2008;Committer;svn;1;3;3;6;0
478b14ea4fa775d6f6f1ab4e030b99e47d517ee2;Thu Sep 18 16:16:45 EDT 2008;Committer;akr;3;25;16;41;0
f0c8c9d8326605dc9537587d7a2fb95861b5c80e;Thu Sep 18 13:56:51 EDT 2008;Committer;mame;2;16;0;16;0
e040ff55308cca5d4f748c9bcc8f8889a32f9564;Thu Sep 18 13:48:21 EDT 2008;Committer;mame;3;47;5;52;0
c3e2e0e53f0e5bfd1277152fa7705c22a44bf573;Thu Sep 18 13:17:41 EDT 2008;Committer;matz;3;17;5;22;0
081c802cb9fe84d349bc4ecf26a36eceae431aed;Thu Sep 18 12:53:25 EDT 2008;Committer;akr;25;234;892;1126;0
22987dc7fe5830d8423f8153bef0310339e178f4;Thu Sep 18 11:51:00 EDT 2008;Committer;nobu;2;13;8;21;0
45880b8e7d7934c008b643bb9b99c31b97c39472;Thu Sep 18 11:38:24 EDT 2008;Committer;nobu;2;12;0;12;0
bc9c077400d42ba3cecb3da7d60e514f4a645f4b;Thu Sep 18 11:21:34 EDT 2008;Committer;matz;2;11;0;11;0
4046a1cb92094d5227bc98e7e2eec14c08b65652;Thu Sep 18 11:05:09 EDT 2008;Committer;mame;2;7;1;8;0
b11b2b498c741e08e11e8e51cf5c86dea00ff103;Thu Sep 18 10:44:09 EDT 2008;Committer;mame;2;8;3;11;0
6b050e719b116cdef93c1330f464858b8c8c1b37;Thu Sep 18 10:21:04 EDT 2008;Committer;mame;1;1;1;2;0
24733414ed2fa595b759ad7e80f7e55b8b2d84cd;Thu Sep 18 09:42:28 EDT 2008;Committer;akr;1;2;1;3;0
1cd6bce939619bc32b278800fcf41f005caf2a63;Thu Sep 18 09:39:47 EDT 2008;Committer;akr;1;1;1;2;0
2cbc7b69b7b5638edae760d57461dd4f4410622d;Thu Sep 18 09:29:01 EDT 2008;Committer;akr;2;24;8;32;0
d5ec36c486762ea99a443e76af39edb81d91b479;Thu Sep 18 08:57:33 EDT 2008;Committer;matz;11;232;222;454;0
45ee7d2e780e7c1f86cf20a1b83aaf67b0571135;Thu Sep 18 08:27:17 EDT 2008;Committer;matz;2;30;9;39;0
b7c95b923ab51753c4d48344694618b27b5ea827;Thu Sep 18 01:17:04 EDT 2008;Committer;jim;6;477;223;700;0
2fc415a166df3bf46aad2a6a80182fc2cbe5aead;Wed Sep 17 17:22:15 EDT 2008;Committer;mame;2;686;0;686;0
42c3f17021ed30536ca00d2b6925471436f59f37;Wed Sep 17 16:39:51 EDT 2008;Committer;svn;1;3;3;6;0
b09322c61a9a5b03a32115c55ad6815ecb59def5;Wed Sep 17 16:39:47 EDT 2008;Committer;matz;2;42;18;60;0
635b15d66214a441a23de6363015f1241dcb59fd;Wed Sep 17 12:50:52 EDT 2008;Committer;akr;4;57;18;75;0
d965e99b04bc250e8129f5909383ffdff53c0149;Wed Sep 17 11:00:09 EDT 2008;Committer;tadf;4;31;27;58;0
b452a519c90b539b17a92e1e465d937fe3abc7ab;Wed Sep 17 10:22:11 EDT 2008;Committer;kazu;2;9;5;14;0
4ac4e2fbc451df15b49f81e639dfb97c18e8e89a;Wed Sep 17 04:49:28 EDT 2008;Committer;xibbar;3;21;6;27;0
b27d5a7aa1438c8fe381434e21d4b838e914e450;Tue Sep 16 22:05:44 EDT 2008;Committer;tadf;1;1;1;2;0
acde7364f707cc831a79fd7a221635d4ec8648a4;Tue Sep 16 22:04:19 EDT 2008;Committer;tadf;7;47;38;85;0
d9d3781de0cfac4d0fa5e2dd9c920f7c66a77a3f;Tue Sep 16 17:02:01 EDT 2008;Committer;akr;1;2;2;4;0
87fba4c425b494d3fe42906a0eb97cc8015e0809;Tue Sep 16 17:00:08 EDT 2008;Committer;akr;2;10;5;15;0
b3d772643e9eea84f71b168771f15d41d85e7341;Tue Sep 16 16:59:08 EDT 2008;Committer;akr;2;9;9;18;0
a67d4fa01c43124048be957f7d8e4090b7255393;Tue Sep 16 16:48:05 EDT 2008;Committer;akr;24;921;212;1133;0
bad9a9ad0d211f9c0a5c0eb12bdb57e49fa900fd;Tue Sep 16 16:18:32 EDT 2008;Committer;naruse;3;11;21;32;0
a4523cd04255323f5143299d003e5934acc77079;Tue Sep 16 14:02:29 EDT 2008;Committer;xibbar;1;1;1;2;0
49f69c3f2ef75c91539ccc7e8abaaa727fbc7132;Tue Sep 16 13:30:05 EDT 2008;Committer;xibbar;3;120;110;230;0
8b31af74b7f8bff2738fd19629d8c2517d2ef67b;Tue Sep 16 13:23:16 EDT 2008;Committer;naruse;2;11;5;16;0
025bd642a738fdd6a0376836725835716dfd4738;Tue Sep 16 13:16:12 EDT 2008;Committer;naruse;2;5;1;6;0
507658bd54e638a02df562be38dd9dbdf17082f2;Tue Sep 16 12:33:40 EDT 2008;Committer;nobu;2;18;16;34;0
7c3b57b5d15e3a9a1a82523478f1b4f7035d405d;Tue Sep 16 10:21:23 EDT 2008;Committer;tadf;5;24;3;27;0
73c8f0238448cfb401b1d2e7afec44763defd833;Tue Sep 16 09:36:06 EDT 2008;Committer;matz;2;3;1;4;0
428661eccfbfe7e73c4c0b0e97db0a4a6603cb4a;Tue Sep 16 09:29:40 EDT 2008;Committer;matz;2;13;6;19;0
0df867f93355807e1f90c4311c015da88bfeea32;Tue Sep 16 03:14:41 EDT 2008;Committer;matz;2;61;0;61;0
4c467da68fa8dfd4e1231ee9f63de5735fb257e6;Tue Sep 16 03:13:14 EDT 2008;Committer;matz;2;20;8;28;0
377eb14a9f5670e69612d66f3eeb06bf9b48a0ad;Tue Sep 16 00:47:20 EDT 2008;Committer;matz;3;277;123;400;0
326bf1cac3fc782ef91e36ac08f42840ab86ebfe;Tue Sep 16 00:21:32 EDT 2008;Committer;matz;2;8;0;8;0
542f76c6cd2990737df2ef9926411e8f6d0d40e5;Mon Sep 15 23:37:05 EDT 2008;Committer;matz;2;12;16;28;0
b0c70a885659bbe373da5bc2b0aa8d5c4f27f03d;Mon Sep 15 17:05:00 EDT 2008;Committer;naruse;2;15;5;20;0
9e10d51c40a1f662eec1d762d8fb9a09fad3ec05;Mon Sep 15 16:24:39 EDT 2008;Committer;akr;1;13;6;19;0
2e0a116dd5db6601dc6119392b1eb677c5664694;Mon Sep 15 16:01:08 EDT 2008;Committer;akr;3;25;14;39;0
b73891b5f1b5d4109bc7a6afdd8ff08a0a96a247;Mon Sep 15 15:53:50 EDT 2008;Committer;naruse;2;5;13;18;0
bfdbd5a03f9c785159c3a2de31d1073787994a5a;Mon Sep 15 15:42:34 EDT 2008;Committer;svn;1;3;3;6;0
6eb3843b178c5bca28a3c8d73b8af5f58de21e22;Mon Sep 15 15:42:30 EDT 2008;Committer;akr;4;21;7;28;0
69029b90fea8a6b7e5607ead5e2184da30db9e76;Mon Sep 15 14:59:14 EDT 2008;Committer;ko1;14;42;28;70;0
b121e47b4478ea410274e2611472f7c594016508;Mon Sep 15 14:40:00 EDT 2008;Committer;matz;3;120;31;151;0
e0f064cf3c4f5b59d438e96b5fb002a984b78329;Mon Sep 15 14:38:12 EDT 2008;Committer;akr;2;8;2;10;0
a5173950563b0b5aef1a605db8298835f68b00c8;Mon Sep 15 14:29:09 EDT 2008;Committer;akr;3;9;1;10;0
db14bfe4ea7f5ab0ece77d4109bb0fb13ef9fe54;Mon Sep 15 12:02:39 EDT 2008;Committer;yugui;2;26;6;32;0
a09890a0c716c60dc74afb992798041ea84d8c82;Mon Sep 15 06:10:47 EDT 2008;Committer;tadf;1;2;0;2;0
0791d297dd31a241d7cf63a1a7dd510be2aafcb6;Mon Sep 15 05:36:15 EDT 2008;Committer;naruse;2;8;1;9;0
5fc383f9a3028922bcfa6fb04f8ad8c98c90aeeb;Mon Sep 15 05:17:18 EDT 2008;Committer;naruse;3;40;18;58;0
b140cda1d6bfec64296b2a5f12a718b03fe802b5;Mon Sep 15 05:04:09 EDT 2008;Committer;tadf;1;1;1;2;0
05ac51d2258b7681df7484a4e0ca787de84c7af9;Mon Sep 15 04:20:46 EDT 2008;Committer;tadf;5;35;9;44;0
0675246ba6456ee4bad43d0fa13b401ce92d6309;Mon Sep 15 02:11:50 EDT 2008;Committer;akr;3;10;3;13;0
1cda1058865c87d076088bb1d441891f03180e5f;Mon Sep 15 01:33:43 EDT 2008;Committer;yugui;3;25;4;29;0
c767be3039c9d511cc01541a7560896404e2ab80;Sun Sep 14 18:35:17 EDT 2008;Committer;akr;8;44;28;72;0
a3c8c0adec2ccf37ffe88fa542cd9db650aa31bf;Sun Sep 14 18:06:20 EDT 2008;Committer;akr;8;59;29;88;0
2f67b43aeca4530842db1324983a0e7a563917cc;Sun Sep 14 17:37:35 EDT 2008;Committer;nobu;3;17;1;18;0
ca36233e55625b6653e68e27e37cd9e30d11b491;Sun Sep 14 15:18:56 EDT 2008;Committer;svn;1;3;3;6;0
f3d95cce97237eff6ef8248e29e0c40062c72d44;Sun Sep 14 15:18:53 EDT 2008;Committer;akr;6;89;89;178;0
83453ab1caa08ea053627f28ca5b9d1ee72a7920;Sun Sep 14 14:36:50 EDT 2008;Committer;akr;1;5;5;10;0
09814e38e1933d470c781d73e1d2178103f7523d;Sun Sep 14 13:10:43 EDT 2008;Committer;xibbar;2;7;8;15;0
583400c15eb3bf88fb2e2f9eb62c44608297ba20;Sun Sep 14 09:35:08 EDT 2008;Committer;tadf;3;17;10;27;0
406500cc8bdd4178ed1462f89565620352d585ec;Sun Sep 14 07:15:55 EDT 2008;Committer;yugui;4;98;1;99;0
387d645af066d28624e8ed826fe8a50333a8afb4;Sun Sep 14 07:07:31 EDT 2008;Committer;nobu;2;11;3;14;0
975ecd2f3feec5623d296cfff38a779ad4393add;Sun Sep 14 04:48:56 EDT 2008;Committer;yugui;2;18;0;18;0
e4b3a817697a2ac04ecf7e6b4e62e92c54161236;Sun Sep 14 01:16:44 EDT 2008;Committer;tadf;4;56;0;56;0
19416601a0af3b7c99a570ae6993cb29e4360e64;Sat Sep 13 19:23:52 EDT 2008;Committer;akr;23;110;52;162;0
10ff0f292e9b7cd673915fcc32f5d236c95c8d7d;Sat Sep 13 18:44:53 EDT 2008;Committer;akr;4;17;8;25;0
a953d28e3c8827f40eb803876be3fdc29e8e0b30;Sat Sep 13 18:22:04 EDT 2008;Committer;akr;8;50;33;83;0
d3974573e791db91180abacae649c2d6b40e3f5c;Sat Sep 13 17:05:49 EDT 2008;Committer;akr;4;14;4;18;0
c96501058270d16b4be35c0cbc8b008182524da0;Sat Sep 13 16:40:31 EDT 2008;Committer;akr;7;26;9;35;0
d9435e0cd3b7315c63cd534728a3de020374da80;Sat Sep 13 15:44:00 EDT 2008;Committer;svn;1;3;3;6;0
956966ff8ba3dca8c95fdd706c452ed1ef76b6f3;Sat Sep 13 15:43:56 EDT 2008;Committer;akr;2;10;1;11;0
4dcf54aea12d3006cd171dbe62cc4e80cde74960;Sat Sep 13 10:28:06 EDT 2008;Committer;akr;2;11;7;18;0
0a3fc5be05c3f19eaa637628c20ab49640ae1faf;Sat Sep 13 09:52:02 EDT 2008;Committer;akr;2;12;5;17;0
d4c74738415fcc9f2d7941d4a03ddf2904b955ce;Sat Sep 13 09:21:34 EDT 2008;Committer;akr;2;15;11;26;0
8d7e774f5f505c5be1f86ad090389c93ec7ad668;Sat Sep 13 09:06:51 EDT 2008;Committer;akr;3;21;11;32;0
158284ac24c4f2402dadc11851058839d451a4d3;Sat Sep 13 02:16:05 EDT 2008;Committer;shugo;2;6;2;8;0
5ac09d7627e6934a53e1f39b59d1e67a30a2fd72;Sat Sep 13 01:55:56 EDT 2008;Committer;tadf;4;88;77;165;0
364b0834257a9109b8f07c06b163426160eff01b;Sat Sep 13 01:43:51 EDT 2008;Committer;shugo;1;0;41;41;0
cb9478ae04f648f36a38f5dee20a8eb6f4c9f622;Sat Sep 13 01:40:36 EDT 2008;Committer;shugo;1;23;0;23;0
2cc9b488a090fbd96179e5bd33d702fc0df840cb;Fri Sep 12 18:45:44 EDT 2008;Committer;akr;3;18;1;19;0
965ff82341d59088a6d417939fd48d6cba465149;Fri Sep 12 18:32:19 EDT 2008;Committer;akr;3;20;10;30;0
207ad0a285c1adabef466a5012c94ada47c53ab1;Fri Sep 12 18:00:08 EDT 2008;Committer;akr;1;12;0;12;0
76c02f05a27a5dfaac3e7b8fe4865212c57cfd13;Fri Sep 12 17:58:58 EDT 2008;Committer;akr;3;60;21;81;0
7e58885f0a56202349291ba738efe6a1d0dc531e;Fri Sep 12 17:53:26 EDT 2008;Committer;akr;2;9;2;11;0
41d3a0148637725fc6078b4bdfadae290ff0d39e;Fri Sep 12 17:30:07 EDT 2008;Committer;akr;4;30;24;54;0
248acf0025f047a731b6d6967382ce9b7675a05e;Fri Sep 12 17:13:04 EDT 2008;Committer;akr;3;151;12;163;0
cf8617633815a1baae3e4c21f4cef863dc98fc9f;Fri Sep 12 16:13:02 EDT 2008;Committer;akr;2;20;11;31;0
c6ff62d202cdd67317bcbbf028d3fbbb055df2bb;Fri Sep 12 15:39:50 EDT 2008;Committer;svn;1;3;3;6;0
aa423b931145854918a7c3ef7810030918139382;Fri Sep 12 15:39:46 EDT 2008;Committer;akr;2;14;7;21;0
c0bd38eb9432d61a22536e0ac563fbc2d9ac9368;Fri Sep 12 14:20:27 EDT 2008;Committer;akr;2;5;1;6;0
2d80b1695d9f7b6fbe99f63117078033ac40ebb2;Fri Sep 12 13:53:42 EDT 2008;Committer;akr;3;213;59;272;0
89a5c998c7297f9f565e434dfae8d03765e3c393;Fri Sep 12 12:58:23 EDT 2008;Committer;akr;2;90;56;146;0
19438eee8b6b0a51768c49e3b7b3f6070ef64c7d;Fri Sep 12 12:23:25 EDT 2008;Committer;akr;2;16;1;17;0
290ae0ea85fb958d9e0f4f0db517de7e0edb1929;Fri Sep 12 11:31:28 EDT 2008;Committer;akr;1;2;2;4;0
0de51bcc7539f3a95694f4f6b6d7047595c0165c;Fri Sep 12 11:30:53 EDT 2008;Committer;akr;1;4;0;4;0
2af2eb28da63f4a3f5c0877f7bc9eb7cedf5db12;Fri Sep 12 11:30:14 EDT 2008;Committer;akr;2;6;1;7;0
eca8de632c8e6ba7a5f96f4e1bf53a12556e1cc6;Fri Sep 12 11:02:21 EDT 2008;Committer;mame;2;8;1;9;0
d1724ecbd206091602c480081c91a7e90b54e4bf;Thu Sep 11 16:37:46 EDT 2008;Committer;svn;1;3;3;6;0
3f1a95ce65391170458b4d6015b1455e154b706d;Thu Sep 11 16:37:41 EDT 2008;Committer;mame;2;5;1;6;0
73412af59a8327923ed0f7ae91efbb6c4f0c0b80;Thu Sep 11 11:15:43 EDT 2008;Committer;suke;2;8;1;9;0
d51b0615658aeb4c62a6437e43fb6aefa5d7df9e;Thu Sep 11 10:34:59 EDT 2008;Committer;naruse;9;124;63;187;0
9886722caa675951b0d67c306ae143ecaf7ce067;Thu Sep 11 10:10:16 EDT 2008;Committer;naruse;2;10;0;10;0
63471c7c3279ba5b152b170afcce5092ea62dda6;Thu Sep 11 06:30:56 EDT 2008;Committer;matz;2;8;0;8;0
ba75344338a54c9faf4dd5663df6698998142a62;Thu Sep 11 02:40:52 EDT 2008;Committer;matz;2;8;17;25;0
5cebd7135d7c733160cfde84c92bec8adcac5048;Wed Sep 10 19:43:29 EDT 2008;Committer;akr;1;1;1;2;0
7e0b2b1d9bb86a7b5c78682ca7c6435614801faa;Wed Sep 10 18:00:36 EDT 2008;Committer;akr;2;41;30;71;0
1bd34a09c9f2d5c6f60b242ce4ee580ce90449f1;Wed Sep 10 17:45:23 EDT 2008;Committer;nobu;1;1;1;2;0
10ddce38336d50633a4968eef42000e95a0f2d0f;Wed Sep 10 17:26:49 EDT 2008;Committer;akr;3;55;25;80;0
c25f22fb79929792390881e88716323eaf63d936;Wed Sep 10 17:15:12 EDT 2008;Committer;svn;1;3;3;6;0
4e93ace24ec9ce778ba36461c987ed468f13b988;Wed Sep 10 17:15:08 EDT 2008;Committer;akr;3;64;0;64;0
a4a3c85558a3ae4cec2b920490c07fd56ea4b1b2;Wed Sep 10 14:07:13 EDT 2008;Committer;mame;2;6;1;7;0
22fe2621196c18c2afe134b51e1e367f9915275b;Wed Sep 10 12:15:04 EDT 2008;Committer;suke;3;26;15;41;0
3cf69b5d69db2249130e9b2767f745e1a71620af;Wed Sep 10 11:57:56 EDT 2008;Committer;akr;1;0;1;1;0
3da03397ce1dca2eaf21149dcdc88a212b6afdc2;Wed Sep 10 09:34:49 EDT 2008;Committer;akira;6;435;305;740;0
0bedb3e5b1e80b5fdac2086f9b0c54df56f7313b;Wed Sep 10 01:36:31 EDT 2008;Committer;xibbar;2;11;25;36;0
3293f6cfb9abebcba9b0d52aaaa16f8b5542b9ec;Wed Sep 10 01:22:35 EDT 2008;Committer;akira;2;7;2;9;0
06d8db19cba0fb26f54d28b97e22537b8483ce9b;Tue Sep 09 16:59:53 EDT 2008;Committer;akr;2;9;2;11;0
2d26208a55df9f55268bdbd80f47a365e1f1155c;Tue Sep 09 16:27:02 EDT 2008;Committer;akr;5;78;68;146;0
3cc7c9d0dd1814895a73bba41d8df15e50b6022d;Tue Sep 09 16:18:29 EDT 2008;Committer;akr;2;16;44;60;0
817a623d13b54d10f3d6492391aaeb2ce25a7f1c;Tue Sep 09 16:06:54 EDT 2008;Committer;akr;3;12;6;18;0
1a9887acc0630042d7cf9c57b7a85dcfbcf6d873;Tue Sep 09 15:02:52 EDT 2008;Committer;svn;1;3;3;6;0
baac56be36abfaef678149b1d112d1280531a6da;Tue Sep 09 15:02:42 EDT 2008;Committer;akr;4;18;9;27;0
dda64cab99c72081007f4e16ee0507af97d876b8;Tue Sep 09 14:56:55 EDT 2008;Committer;akr;3;198;32;230;0
0bbda39758ecf0eac1de04dbd039f8b29299a322;Tue Sep 09 13:09:56 EDT 2008;Committer;xibbar;6;2076;2060;4136;0
d456f7e357f8259bd4b73c1cdac74add216e4746;Tue Sep 09 12:22:43 EDT 2008;Committer;akr;5;125;107;232;0
a729be8433c2b1fb1057ca04d99b7408dd7d25a0;Tue Sep 09 11:59:40 EDT 2008;Committer;akr;2;2;2;4;0
8c2d4076f0e54c9229bc8380e569832d32af1d41;Tue Sep 09 11:57:31 EDT 2008;Committer;akr;2;22;23;45;0
8bf5284c1e280e55678bed140fae940703aa8047;Tue Sep 09 11:41:45 EDT 2008;Committer;kazu;2;10;1;11;0
40c31d5b7526bda06e01b6be82d0ff4285bc1cd9;Tue Sep 09 11:37:23 EDT 2008;Committer;akr;2;21;16;37;0
b96c3dfe6752f8635940dedef236796d0321fa6c;Tue Sep 09 11:22:17 EDT 2008;Committer;akr;2;5;1;6;0
4fcb83c06cce321fedb150663a95b6345c1292e2;Tue Sep 09 11:18:59 EDT 2008;Committer;akr;2;12;16;28;0
6eef0808a5caea71f19ba8d6aaeb85044e746631;Mon Sep 08 19:38:11 EDT 2008;Committer;akr;1;4;0;4;0
c5d9a3cc3a012fccf8323c7be55932df122fac98;Mon Sep 08 19:01:00 EDT 2008;Committer;akr;2;4;8;12;0
795bf7a665d6fb459e9bc6e8d34f1d679affee93;Mon Sep 08 17:23:37 EDT 2008;Committer;akr;4;170;57;227;0
65110d6464e40db2b45274780a009c4f4594db0c;Mon Sep 08 16:11:32 EDT 2008;Committer;akr;2;5;1;6;0
4106a7c067bb6dbadc8055a7e575180479bb08c0;Mon Sep 08 15:21:05 EDT 2008;Committer;akr;2;31;21;52;0
870a8b3903622a42e2d84c95a754c7f23797761b;Mon Sep 08 15:03:10 EDT 2008;Committer;akr;1;2;0;2;0
a7d3c7bcf28b645828dbeac04c4a005b3c86b1b1;Mon Sep 08 15:01:20 EDT 2008;Committer;svn;1;3;3;6;0
dbf04875812945c19e417c263407f9b7caad1a7e;Mon Sep 08 15:01:16 EDT 2008;Committer;akr;2;4;3;7;0
6270ad5b7fb3eb5293358096d993610dda283ce8;Mon Sep 08 14:33:17 EDT 2008;Committer;akr;12;130;82;212;0
52945b0d28785de7ce0fd456157dba216973a3ac;Mon Sep 08 14:27:37 EDT 2008;Committer;xibbar;1;1;1;2;0
a98bb55e012612d7e16c10a37eb104433af83c27;Mon Sep 08 14:08:44 EDT 2008;Committer;akr;3;12;2;14;0
be2fc605fc26a252e35240811c8d024ea96f3ba5;Mon Sep 08 13:32:53 EDT 2008;Committer;naruse;2;21;16;37;0
d166d0be91a34b8646220144e1dc78822ca8093c;Mon Sep 08 13:27:17 EDT 2008;Committer;xibbar;2;35;31;66;0
c27baaa090d038f92ea7af89cfa054412bbf8d5d;Mon Sep 08 09:17:22 EDT 2008;Committer;usa;3;23;17;40;0
1625494febb1039346613868f826d1263acc795d;Mon Sep 08 09:16:45 EDT 2008;Committer;akr;2;16;11;27;0
933eb07996f85a1080fc19e9c833286cd6018e6f;Mon Sep 08 09:14:59 EDT 2008;Committer;akr;3;12;5;17;0
80de18922eca09a36b26a21e62e754bcccbd1989;Mon Sep 08 09:09:41 EDT 2008;Committer;usa;2;7;0;7;0
9ae4b8bbfe4b10165a646724b2701a8d5f07cb62;Mon Sep 08 08:46:53 EDT 2008;Committer;usa;2;5;1;6;0
be2c236ffff51cae13acf27d5e14dffe757b2625;Mon Sep 08 04:49:52 EDT 2008;Committer;kazu;2;9;0;9;0
0de54d9aa665c38efbf846a9f3157789fdc16a00;Sun Sep 07 22:10:38 EDT 2008;Committer;tadf;3;41;28;69;0
1b2f39fa092d8084ffa85055b1c6498a993efeb1;Sun Sep 07 21:50:32 EDT 2008;Committer;nobu;2;10;3;13;0
6e36c4842eb9cf238953179f0468a67e6588ca09;Sun Sep 07 17:08:38 EDT 2008;Committer;akr;3;11;4;15;0
82a5736519578dddcb7876ebe343fd4b563b8678;Sun Sep 07 17:03:38 EDT 2008;Committer;akr;1;3;3;6;0
08c3dd54bfabc69ef235877e24b4fef1972c0d99;Sun Sep 07 16:11:40 EDT 2008;Committer;akr;2;11;1;12;0
249705229f8fa1d960af257855b44ca70668ea4d;Sun Sep 07 15:59:12 EDT 2008;Committer;tadf;4;52;19;71;0
d4832b7aac602e22d775ce1d71551759b1710f0c;Sun Sep 07 15:05:30 EDT 2008;Committer;akr;1;4;5;9;0
2403b1fe43a0b741dacb10bbf8b2f34e28a4460d;Sun Sep 07 15:05:17 EDT 2008;Committer;svn;1;3;3;6;0
7de9b108196a08f5dbee74626e06d809cb4fcd29;Sun Sep 07 15:05:12 EDT 2008;Committer;akr;3;11;5;16;0
78350a0cc6e2266d7ea7211d5e40e9c0a9380d83;Sun Sep 07 14:49:05 EDT 2008;Committer;akr;4;133;42;175;0
45d7c84f2a6193ac595145ff2f66716004e1635b;Sun Sep 07 11:07:31 EDT 2008;Committer;akr;1;1;1;2;0
a3cfd3233e6b3a98e6b47a40e3ff09c5de18f1a5;Sun Sep 07 11:03:24 EDT 2008;Committer;akr;2;13;9;22;0
faa1387484e3ac01af60c8bbca1850879aaf9b69;Sun Sep 07 10:46:30 EDT 2008;Committer;akr;3;27;59;86;0
eee75cc1a67c4360ed762f3c01df2ebe074d8d4d;Sun Sep 07 10:17:52 EDT 2008;Committer;akr;2;37;13;50;0
dcdc7579c5e9bf5596e19f52e30d1f2bcd67610b;Sun Sep 07 09:30:54 EDT 2008;Committer;akr;2;20;7;27;0
c0bec2fae1d6adf77c853457942217e89ea85bcf;Sun Sep 07 09:13:16 EDT 2008;Committer;akr;5;52;51;103;0
6bf5c34cf20002491423ca69dc3b0d037afaaefd;Sun Sep 07 08:57:53 EDT 2008;Committer;kazu;3;41;0;41;0
78543725ebbb47a1132c93e629af91891d8258ff;Sun Sep 07 08:30:32 EDT 2008;Committer;akr;2;6;1;7;0
a0d163da71e9e1dc2d78f20cde1b8ece866ff5a1;Sun Sep 07 08:02:21 EDT 2008;Committer;akr;1;4;4;8;0
a788a2e53138ca6ca85e0c09b7945c18721040cf;Sun Sep 07 03:45:12 EDT 2008;Committer;akr;2;13;0;13;0
020e681eece7359f1cfcda9871b600084507dbb1;Sun Sep 07 03:13:29 EDT 2008;Committer;akr;7;150;70;220;0
120772041e7addfc574e3b045cb4fc6a3517f4f4;Sat Sep 06 22:38:08 EDT 2008;Committer;matz;2;8;4;12;0
e39aa51dfafffc7de369247e62ce5245ed91f7f3;Sat Sep 06 22:37:17 EDT 2008;Committer;matz;2;3;1;4;0
4cbbf3bdfc27dc69ebd45ce3baa803611f4326a2;Sat Sep 06 22:36:10 EDT 2008;Committer;matz;5;860;857;1717;0
d250d79e5bf7e5d4e1239a4f135d1325ffe8cf56;Sat Sep 06 22:34:46 EDT 2008;Committer;matz;3;36;18;54;0
3f3584d6239ae3177c83523c8ac7398ce4d5e2ae;Sat Sep 06 22:33:43 EDT 2008;Committer;matz;2;7;5;12;0
ce231cdbdd21b82dd3e3753d03fc4275ec346208;Sat Sep 06 22:32:38 EDT 2008;Committer;matz;2;5;3;8;0
2d1c5d2c248938d0a957c2c811fcb40b7cf81e0b;Sat Sep 06 22:30:34 EDT 2008;Committer;matz;3;27;20;47;0
0771b987a46a7533a0af1e4e936a4339944511c1;Sat Sep 06 22:15:18 EDT 2008;Committer;matz;2;6;2;8;0
7ae76a9e6ba17c30cc049ccc3e796123675c72c2;Sat Sep 06 22:14:28 EDT 2008;Committer;matz;2;6;3;9;0
929e0b91be4ddf58b5d0791f538862a872203f93;Sat Sep 06 18:39:36 EDT 2008;Committer;matz;3;168;1;169;0
04d3593b26ccf65e930bebbc6e47cc37bfd557bd;Sat Sep 06 16:22:16 EDT 2008;Committer;kazu;1;1;1;2;0
05edaf5090f86b98f3bfc6c927851379ce62f935;Sat Sep 06 16:09:43 EDT 2008;Committer;matz;2;18;15;33;0
00759b00f829d0fcb93189c0f3515960d6d2f978;Sat Sep 06 16:04:30 EDT 2008;Committer;kazu;1;4;4;8;0
6d847ca70d21f95106c7f76185e0794c82f1f14d;Sat Sep 06 16:01:27 EDT 2008;Committer;kazu;1;17;17;34;0
bff6f0f9e4a97c54eee2a00039951a732e52d354;Sat Sep 06 15:39:04 EDT 2008;Committer;svn;1;3;3;6;0
0508672f0e31bd2b600118e9cc9fdb9a1ac423fe;Sat Sep 06 15:39:00 EDT 2008;Committer;akr;4;49;12;61;0
dd27b8f4577a96385a29d91e4bd75fb547213fc9;Sat Sep 06 14:58:11 EDT 2008;Committer;matz;2;17;1;18;0
76b306302241a9fb6411571c4cbfe701fdd56f54;Sat Sep 06 14:05:10 EDT 2008;Committer;akr;5;75;65;140;0
d98bc00582af97ad86e88efd88835d22b1f1f532;Sat Sep 06 12:38:59 EDT 2008;Committer;matz;2;30;2;32;0
003d60860a5f8a9b2f196244ef6636c81fdb4806;Sat Sep 06 12:33:53 EDT 2008;Committer;matz;1;4;0;4;0
ca3148059b2d4f1caed0b382c4fe7441cd221da8;Sat Sep 06 11:11:21 EDT 2008;Committer;akr;2;17;2;19;0
e4b70ffe43463e8723b692f1bebbdf17750be677;Sat Sep 06 11:07:01 EDT 2008;Committer;akr;2;44;17;61;0
f88c9f03f7c00402558f5b47331774b8b65fbaaa;Sat Sep 06 10:54:59 EDT 2008;Committer;akr;2;7;4;11;0
683eec7a5db10feeaef8aa1968f4d54af4fcfa9c;Sat Sep 06 10:37:02 EDT 2008;Committer;akr;2;5;0;5;0
f10af82d259687e6e96a97ebdacfdbda15fc5b2e;Sat Sep 06 09:48:32 EDT 2008;Committer;akr;3;11;1;12;0
987ec6b78778bf8c7fb0ec0eb1c0dc80bfda0d6a;Sat Sep 06 09:39:12 EDT 2008;Committer;akr;2;5;1;6;0
e490d925486bfff70eeb3630e9ab0a4dc1e6ee21;Sat Sep 06 06:07:34 EDT 2008;Committer;akr;3;33;0;33;0
34be4c1ce5c6ad39720a48a015b40f6cc4e25ca5;Sat Sep 06 05:47:30 EDT 2008;Committer;akr;4;38;0;38;0
5117020d9ee536e190e03cd8e52ddbef9148166a;Sat Sep 06 05:16:40 EDT 2008;Committer;akr;2;56;53;109;0
9f687d7be92bd5e3613c69d4a90dd8f94a835d5e;Sat Sep 06 04:43:39 EDT 2008;Committer;akr;2;5;1;6;0
27e9c48ccc113ec0955b9c0239263e24751c279e;Sat Sep 06 03:44:31 EDT 2008;Committer;akr;2;4;6;10;0
073bced3671d70f8764cdd09015648d859a0ad20;Sat Sep 06 03:38:59 EDT 2008;Committer;akr;2;6;4;10;0
393f57670fa5dd8ee09ed3fd2fefbb709ec3e874;Sat Sep 06 03:26:35 EDT 2008;Committer;akr;3;14;1;15;0
091171a28654801c533166d1819ec7e1705a53ac;Sat Sep 06 03:20:51 EDT 2008;Committer;akr;3;82;11;93;0
d90ab4c09b7f99c28fe3f475e0b085f5175ef713;Fri Sep 05 23:27:51 EDT 2008;Committer;akr;1;8;0;8;0
7a04666b3cb95c2b778b21d5dc2df70adad0c6c8;Fri Sep 05 23:25:13 EDT 2008;Committer;matz;2;9;2;11;0
c8573378f6a099ad453b5c1f4a9ba3a691b1f9c1;Fri Sep 05 23:17:11 EDT 2008;Committer;akr;1;2;2;4;0
803aafe7c4cc5e0117c33d34fcc1fe3adc6370fd;Fri Sep 05 22:55:35 EDT 2008;Committer;tadf;4;40;22;62;0
7d048a55eea828ed5265a265c9151048a1bd8820;Fri Sep 05 22:33:38 EDT 2008;Committer;akr;1;1;0;1;0
0be34e2a497ec376e3a96e95a2374abe3ad6a7c6;Fri Sep 05 22:27:46 EDT 2008;Committer;akr;3;40;0;40;0
d4384f1230af19b065f62a33b27ac21143235304;Fri Sep 05 22:26:39 EDT 2008;Committer;akr;3;62;4;66;0
a10a5ddaacb05368cee3beec82af47043aec6667;Fri Sep 05 21:29:12 EDT 2008;Committer;akr;3;127;0;127;0
fb9c53dea50fbbf7d789f0cac004a00c6d125022;Fri Sep 05 21:24:42 EDT 2008;Committer;akr;2;7;2;9;0
dc98e2528a3d553a6ea7028482df8d5c48582601;Fri Sep 05 20:37:36 EDT 2008;Committer;akr;3;13;1;14;0
c500c37fbc3950e5511d5864da075b17f15a58cc;Fri Sep 05 20:24:18 EDT 2008;Committer;akr;4;94;0;94;0
7d3598ee60264be084f8a6d15d50544e96de5afe;Fri Sep 05 19:03:21 EDT 2008;Committer;akr;2;11;3;14;0
31b6ea65bb9aa9b5ef16ff0a9ca021f66a207300;Fri Sep 05 18:24:21 EDT 2008;Committer;matz;15;113;107;220;0
80abde2c89f913da8509e6db3f1428581eb3e6a2;Fri Sep 05 18:20:20 EDT 2008;Committer;akr;2;44;17;61;0
f0d9f949e839f920fc5cc8dfc9e335ccf7c04399;Fri Sep 05 17:59:32 EDT 2008;Committer;akr;2;35;30;65;0
e93289c03f7dd955a463258fce8e8d2660d20226;Fri Sep 05 17:25:56 EDT 2008;Committer;akr;1;1;1;2;0
134ca08dd14585e30fab91cb909a254a259d6657;Fri Sep 05 17:23:49 EDT 2008;Committer;akr;3;55;0;55;0
a1892af3d6f940222d84bf53fb32f00a8cd7c97b;Fri Sep 05 17:02:38 EDT 2008;Committer;svn;1;3;3;6;0
f2fd6d3b15541e0ea66942d79e2bd3458a83b66c;Fri Sep 05 17:02:33 EDT 2008;Committer;akr;2;32;16;48;0
01acf1870403c8b925d06a0c188e52f1aedada03;Fri Sep 05 11:30:35 EDT 2008;Committer;akr;5;200;181;381;0
debeb7db7734b86ce75648ac99d144ff953ad189;Fri Sep 05 11:16:28 EDT 2008;Committer;akr;2;17;2;19;0
067b98736f7458e4c93ec3c4f7ffb6abab76b0b2;Fri Sep 05 11:10:53 EDT 2008;Committer;akr;1;38;0;38;0
12a55a6c7daf9e74f5e7f91be33384474b5722a9;Fri Sep 05 11:08:10 EDT 2008;Committer;akr;3;6;1;7;0
0153a4ea07401895ea508c39a0b0cd7403ab8d41;Fri Sep 05 10:59:58 EDT 2008;Committer;akr;2;4;2;6;0
6c2108e2acbf905833834f631597fc95a615ad15;Fri Sep 05 09:37:55 EDT 2008;Committer;nobu;3;18;3;21;0
07e08245d3db1caab2cff2864510f99bf2a84ff9;Fri Sep 05 09:16:34 EDT 2008;Committer;nobu;2;74;13;87;0
f0bf74a07b98e0c5cf8875b1a4eb258083fd991e;Thu Sep 04 18:23:27 EDT 2008;Committer;ko1;3;9;2;11;0
d803c452346a2bec2b34e2cd0502ff34f21663f3;Thu Sep 04 17:58:53 EDT 2008;Committer;ko1;2;7;2;9;0
ca253f40dbabfd4ce910155089ae5213b36340e8;Thu Sep 04 17:41:40 EDT 2008;Committer;ko1;2;4;2;6;0
205d9ef125bdc8db4dc921b539c6cd2cc688df54;Thu Sep 04 16:22:57 EDT 2008;Committer;akr;2;5;0;5;0
f549f1ae3269fbf5567eafbef8855bcd0062e27d;Thu Sep 04 15:46:18 EDT 2008;Committer;akr;3;31;24;55;0
a50b307900892347c8267aa9c112ab73c4754baf;Thu Sep 04 15:35:30 EDT 2008;Committer;akr;2;59;55;114;0
5091f1db18b465851c74e9286086fa20dcbac880;Thu Sep 04 15:06:38 EDT 2008;Committer;svn;1;3;3;6;0
40c771fd45eb7b3fd5c024bae65990faa24ddf46;Thu Sep 04 15:06:34 EDT 2008;Committer;akr;2;19;7;26;0
d44ee210fae276001993207b99c30d6d155dae34;Thu Sep 04 14:47:40 EDT 2008;Committer;mame;2;12;0;12;0
dac421a9c987b74d82a074f19f3e3e038f99cc01;Thu Sep 04 14:43:45 EDT 2008;Committer;akr;4;17;1;18;0
64b633f069e9d86bd4cc6f1786558fe900df9d1a;Thu Sep 04 14:20:14 EDT 2008;Committer;akr;2;32;12;44;0
645f25356a4455ccac6aea19b9c7e73bdee9d960;Thu Sep 04 14:09:52 EDT 2008;Committer;yugui;2;42;20;62;0
0406b0f1547d33f1f1abb39524b846c36d5e234e;Thu Sep 04 13:17:40 EDT 2008;Committer;akr;1;19;14;33;0
5da4e660ad3e3bdc8806f767234e36798426b696;Thu Sep 04 12:55:02 EDT 2008;Committer;akr;2;19;4;23;0
2494e67f16fc82834a3f6d5e04fe28f9418ec9cc;Thu Sep 04 12:48:21 EDT 2008;Committer;akr;3;66;42;108;0
f7607eff9af30e002770805f775da7a078cedaeb;Thu Sep 04 12:08:54 EDT 2008;Committer;akr;3;61;40;101;0
4780af9566c0357ca8c6e479bbb9575ac38dba2c;Thu Sep 04 12:04:09 EDT 2008;Committer;ko1;2;20;17;37;0
80843ea156b7b2849b1fcc9764e85f70811cdd89;Thu Sep 04 12:00:24 EDT 2008;Committer;ko1;4;53;75;128;0
0031967d2012896b7e86548a661cd0e1b3b52fa5;Thu Sep 04 11:31:37 EDT 2008;Committer;akr;3;6;4;10;0
b53f7a1cbf5ddac058163eea9d1c34b93a474601;Thu Sep 04 11:20:53 EDT 2008;Committer;akr;2;72;68;140;0
c56ef25cf9b6d923f2af45e536c121388c3aab75;Thu Sep 04 10:47:39 EDT 2008;Committer;nari;2;11;4;15;0
49e9f42703e4d67ab3a2e9657efe83b297e87b01;Thu Sep 04 10:22:11 EDT 2008;Committer;akr;3;25;17;42;0
45c37073038bde691ef12350277cd5a0b7796ec3;Thu Sep 04 10:15:34 EDT 2008;Committer;akr;6;34;38;72;0
1633eb7238776b94a5f162b85f225423174e4c26;Thu Sep 04 04:37:25 EDT 2008;Committer;nobu;1;2;0;2;0
c5bf9ceef62a5b645f5ec014004f2c716d138a3e;Thu Sep 04 04:22:04 EDT 2008;Committer;nobu;6;63;56;119;0
83e28e5176600760a92b724a405420a79e08b6b4;Thu Sep 04 04:01:13 EDT 2008;Committer;nobu;2;7;4;11;0
8f0f91e1559450c68a6ae30afd3e050bffec6de4;Thu Sep 04 03:33:27 EDT 2008;Committer;nobu;2;127;136;263;0
783541e0a4425a6b7523ba0d640f7227c932b572;Thu Sep 04 01:43:50 EDT 2008;Committer;nobu;2;7;3;10;0
747d9b3925b8c20ec42d994637fa9f8cc7f5289c;Thu Sep 04 01:33:47 EDT 2008;Committer;nobu;2;6;8;14;0
31b054122c0051daef2c051665014b9b3c84a105;Thu Sep 04 00:48:01 EDT 2008;Committer;akr;2;5;1;6;0
b94060024db12a343b1e2331e17939a6a806ce96;Thu Sep 04 00:05:30 EDT 2008;Committer;akr;2;8;1;9;0
dead0a4c5118a0f0836305a151ee49073fe70ad2;Wed Sep 03 19:05:24 EDT 2008;Committer;akr;1;2;0;2;0
8c321128d91fadb45c12bbbbd9637bf81f76be2a;Wed Sep 03 18:22:21 EDT 2008;Committer;akr;1;15;0;15;0
58964e324975a924947157ac933d11815f1b2483;Wed Sep 03 18:18:10 EDT 2008;Committer;akr;9;184;31;215;0
0ebcad6a7b59819f6b65e6578b28e00dd6a6a4fe;Wed Sep 03 16:34:11 EDT 2008;Committer;akr;4;176;10;186;0
c359b80127d4eb5326d5a76e2d94098ed3879d80;Wed Sep 03 16:31:14 EDT 2008;Committer;akr;1;2;2;4;0
e64711977b6a0d8f4c5c6caf8fffec129d27ce68;Wed Sep 03 16:14:17 EDT 2008;Committer;usa;2;32;28;60;0
9b6608c78d22d753870783ef918b728155d92eed;Wed Sep 03 16:02:10 EDT 2008;Committer;usa;2;12;8;20;0
71e00fd061c9933671b203991152bd3a8bb164ec;Wed Sep 03 15:27:12 EDT 2008;Committer;usa;2;5;1;6;0
56343375b81d0a4370bfe59c54364060701fe3b5;Wed Sep 03 15:11:46 EDT 2008;Committer;akr;5;103;109;212;0
b00710df4ea2039f2c99032ee7a286e6fc0ebb28;Wed Sep 03 15:06:55 EDT 2008;Committer;ko1;2;7;9;16;0
44a522c6a43fc55b3a14b1345ae1fc51f38e2ed1;Wed Sep 03 15:02:26 EDT 2008;Committer;svn;1;3;3;6;0
c309cda9037be78e835bd07cf1f2dba0c22f3653;Wed Sep 03 15:02:22 EDT 2008;Committer;mame;2;8;2;10;0
1f322f83e7c3d21c73a744f53a04c3463765b12d;Wed Sep 03 14:54:31 EDT 2008;Committer;kazu;1;1;1;2;0
65b1544649bba7ce6c3c06f55a15d33bb120e135;Wed Sep 03 14:54:14 EDT 2008;Committer;mame;2;13;46;59;0
1afc1b7bc806c66786b90cc6c6a764f71b4c251f;Wed Sep 03 14:34:09 EDT 2008;Committer;akr;3;50;42;92;0
f6441bf61cd4244aca5f465d262baf31b8872ac2;Wed Sep 03 14:12:06 EDT 2008;Committer;akr;8;167;62;229;0
fce093432eadc191b3647f116a9c2f6748efda3e;Wed Sep 03 13:57:21 EDT 2008;Committer;yugui;6;618;95;713;0
9cab7d15ca791d0b14db03217485a7c756097a71;Wed Sep 03 12:54:13 EDT 2008;Committer;dblack;3;14;1;15;0
6378201f8b202e493613d1c0936788ddbe708c76;Wed Sep 03 12:35:29 EDT 2008;Committer;akr;4;16;3;19;0
b99c31b38f883ef5dcd74dd9f791de7f1089435e;Wed Sep 03 12:21:32 EDT 2008;Committer;kazu;2;8;2;10;0
6fe24d1f1332bc79458fdac8b3c66ed2db13d390;Wed Sep 03 12:09:59 EDT 2008;Committer;akr;1;2;2;4;0
069f85f81260b2199720aebf1d13b0efc8a3a630;Wed Sep 03 12:08:27 EDT 2008;Committer;akr;2;17;5;22;0
ac5631e6f0f39e0eb64f6b344dd05f3659ee332f;Wed Sep 03 11:59:50 EDT 2008;Committer;akr;2;12;4;16;0
4277473d5b42ae87dab2e2203c5f7602e41f9456;Wed Sep 03 11:48:17 EDT 2008;Committer;akr;3;14;1;15;0
9233dc9bf4072a20f67c25df5ce181f614edccd7;Wed Sep 03 11:36:04 EDT 2008;Committer;akr;2;46;37;83;0
4406629bd6f5841db014f9ec5aed860239182e05;Wed Sep 03 11:09:25 EDT 2008;Committer;akr;4;172;0;172;0
8108417c5e4088b3b1ab6fe90a9a6d2ff9268892;Wed Sep 03 11:07:16 EDT 2008;Committer;akr;2;38;30;68;0
2eb763857dd356d62ec46fd528e466b3fc8c2991;Wed Sep 03 11:02:11 EDT 2008;Committer;akr;2;8;1;9;0
03e778757b18de631c706a6a496274bb8d025f0f;Wed Sep 03 10:28:48 EDT 2008;Committer;usa;2;5;1;6;0
cb0ade87d6d832a4d34c854d4e8164041a01b8fe;Wed Sep 03 10:19:24 EDT 2008;Committer;ko1;2;6;1;7;0
42a48c1e9d4767f0d32dcbc04822b87e3aee06cb;Wed Sep 03 08:57:18 EDT 2008;Committer;naruse;2;10;2;12;0
204929af9dfc7d483d69476325c1ceac1721e219;Wed Sep 03 08:00:05 EDT 2008;Committer;ko1;18;79;219;298;0
d644ee78a9a5a4dc76cfd6c51bfa5cda8483b4d8;Tue Sep 02 15:23:54 EDT 2008;Committer;svn;1;3;3;6;0
095ae8fd8420e3386f5c4da72653e340b27c29c9;Tue Sep 02 15:23:49 EDT 2008;Committer;mame;2;8;2;10;0
41e1933fd8df02d3244aa477f4f5a78d7ff12e65;Tue Sep 02 13:26:02 EDT 2008;Committer;akr;4;31;18;49;0
39f172f9d73d140e5e8ed914f151e130f0cb883c;Tue Sep 02 12:22:56 EDT 2008;Committer;akr;2;12;3;15;0
5cea1b07f4f468cce46367da2a27a6d1e69c68f2;Tue Sep 02 11:57:49 EDT 2008;Committer;akr;2;19;2;21;0
797faf92d96c00ba28edc9613a5205b6ff87e45b;Tue Sep 02 10:20:11 EDT 2008;Committer;akr;2;9;4;13;0
298d66296d3cf90f66a82b7f13150971a9430993;Tue Sep 02 10:12:14 EDT 2008;Committer;akr;2;4;9;13;0
01d7d1907781922e8e93a3cd8c5a4bf31923fb98;Tue Sep 02 09:35:38 EDT 2008;Committer;akr;2;9;4;13;0
7f8e24d43f3aea05332e692724a59d7295fb9360;Tue Sep 02 05:06:05 EDT 2008;Committer;usa;2;20;15;35;0
2e094d086a1f6f491f5366baec61f3d12a346b45;Tue Sep 02 05:04:30 EDT 2008;Committer;yugui;1;6;0;6;0
043d9fe44e326df4f829f11b490fb1035ce55c38;Tue Sep 02 04:59:35 EDT 2008;Committer;nobu;1;1;1;2;0
6d4a6a309be089831fc8ee9d3dbdfc84f24df00d;Tue Sep 02 03:59:39 EDT 2008;Committer;usa;2;9;1;10;0
a2ada174a51525fbadfee8e0183035a5b1f3b036;Tue Sep 02 03:39:11 EDT 2008;Committer;akr;4;87;70;157;0
11ba62be29e74a8cbe82841d3035100d8e86f42d;Tue Sep 02 03:32:32 EDT 2008;Committer;usa;2;7;1;8;0
14cf8d09ca7f4c7514bc50f6f7ee6faddb9f89cb;Tue Sep 02 02:47:38 EDT 2008;Committer;nobu;2;37;17;54;0
7247d1a857934dbaff64efd16fea9a13d0e76525;Tue Sep 02 01:51:41 EDT 2008;Committer;usa;2;6;1;7;0
2ede3bfee8d17ea8585179e5dcd121114ecc41bd;Tue Sep 02 01:36:37 EDT 2008;Committer;yugui;2;10;1;11;0
0c26c309d47c50699990972ddb356db4afcde324;Tue Sep 02 01:17:28 EDT 2008;Committer;usa;2;23;6;29;0
784ccb5806051c0fc66cc1ab12ed3ca94a1bd0ed;Mon Sep 01 19:01:27 EDT 2008;Committer;akr;2;7;2;9;0
5727e9c980873115c6acc1a725da8ee9c9083d14;Mon Sep 01 18:26:58 EDT 2008;Committer;akr;2;5;1;6;0
c5759bfb5b71517af525b1bc51fd485572344758;Mon Sep 01 18:18:50 EDT 2008;Committer;akr;5;29;15;44;0
6058eeaf0360cd5e56106db1f360a7edf3c91f1a;Mon Sep 01 18:06:28 EDT 2008;Committer;akr;4;18;6;24;0
3b090adf7c3e95997630e36074f621cc3fbc96f9;Mon Sep 01 17:49:13 EDT 2008;Committer;akr;2;5;1;6;0
7908180df1364bc6a20cdbf2cb1365f1f0da21fa;Mon Sep 01 17:40:32 EDT 2008;Committer;akr;7;40;4;44;0
6c835ee50ae152daf75d4bd3a63570b7480b1c89;Mon Sep 01 17:06:07 EDT 2008;Committer;akr;2;33;16;49;0
4bec0938a1072f850b8026fd49a733814a5f63cc;Mon Sep 01 16:51:06 EDT 2008;Committer;yugui;2;17;4;21;0
1ff83a064f06213f98e5234d91eeb2df0a5bc74b;Mon Sep 01 16:33:26 EDT 2008;Committer;yugui;2;5;1;6;0
aa029500bffb2e92572132cf3c50bfbb63b82c7a;Mon Sep 01 16:22:54 EDT 2008;Committer;svn;1;3;3;6;0
752e053a1df0446b6ca20815b1976dd322d736bd;Mon Sep 01 16:22:49 EDT 2008;Committer;akr;7;54;37;91;0
2ae7b0328e9bf0caf16411eabc924effedccfb5c;Mon Sep 01 14:33:56 EDT 2008;Committer;akr;3;15;3;18;0
edf1d608c725db1a42f884a91c7ac18b9f98aef0;Mon Sep 01 14:16:30 EDT 2008;Committer;akr;2;21;18;39;0
bf2473d86954e7a171e9f9a3e94cf3702dbcbb95;Mon Sep 01 13:55:49 EDT 2008;Committer;shugo;1;2;1;3;0
add4d16477b4332f3bddf0fca111dd5c8816ed9f;Mon Sep 01 13:44:54 EDT 2008;Committer;yugui;2;8;0;8;0
bb1d005da6115d3175d6a24bb16b93e02e3a1f51;Mon Sep 01 13:41:38 EDT 2008;Committer;shugo;4;114;0;114;0
339dfc32a7854104729f8a334b64d272550781f9;Mon Sep 01 13:21:06 EDT 2008;Committer;akr;2;19;7;26;0
03ec9b1aac4281490de9912a93892e30af5a8158;Mon Sep 01 12:52:58 EDT 2008;Committer;akr;2;17;11;28;0
b6b1931b7b9d1cda260726cd815c7ac8b844596b;Mon Sep 01 12:13:10 EDT 2008;Committer;yugui;1;7;0;7;0
9f8cf6559a9cdc6a40e80e89983d7049ed847e1a;Mon Sep 01 10:38:16 EDT 2008;Committer;akr;2;7;0;7;0
03f1a06114dc3e1581d53b55fbd134a3b8acc2cc;Mon Sep 01 09:32:40 EDT 2008;Committer;usa;1;1;1;2;0
9b1508a5ceee574946d4297f798dec4aa2a7b75c;Mon Sep 01 09:30:08 EDT 2008;Committer;usa;1;1;0;1;0
4badcec903b143689d52f4ceaa5c80907098499a;Mon Sep 01 09:28:54 EDT 2008;Committer;usa;2;7;11;18;0
8087f26de603639f4aca4c80007a825442fcf9c4;Mon Sep 01 08:31:54 EDT 2008;Committer;naruse;1;3;3;6;0
3960c2f7a73095b502d7bb3657a56d91342fb79f;Mon Sep 01 08:24:55 EDT 2008;Committer;naruse;4;18;3;21;0
cb50168eb02625e80423ebac4a2aca370eabed03;Mon Sep 01 07:48:53 EDT 2008;Committer;nobu;5;14;8;22;0
a7cdd2020404f0a9679d3f8417981e81404a90a7;Mon Sep 01 06:16:42 EDT 2008;Committer;naruse;2;6;1;7;0
7ae5e9c96010baa16a194e2ce1a9f7f70fb8431e;Mon Sep 01 05:54:36 EDT 2008;Committer;naruse;2;30;22;52;0
d7cffe9768dd89bef46c3cd7d89bd9abc0f71971;Mon Sep 01 05:45:06 EDT 2008;Committer;yugui;3;10;2;12;0
ae80b4fac22ecb01cbe1d2281f53a4281afd910f;Mon Sep 01 05:39:48 EDT 2008;Committer;usa;2;7;1;8;0
c6c4ce81c2aef709d038ef6bd8927d7bf5c58ef1;Mon Sep 01 05:37:04 EDT 2008;Committer;nobu;2;5;0;5;0
7ea3d11e22764866d70c9ec8441d9c322013d934;Mon Sep 01 05:27:48 EDT 2008;Committer;naruse;2;61;56;117;0
629da9d04903295fb3905697ab015777c590f257;Mon Sep 01 05:25:18 EDT 2008;Committer;naruse;2;12;0;12;0
a4ee7c2c3b3f025536e1b728e2f555f5b3c3193d;Mon Sep 01 05:08:44 EDT 2008;Committer;yugui;3;356;97;453;0
a107e1e998b36a956fd6c13a0a71bedfd52ac0bf;Mon Sep 01 02:31:56 EDT 2008;Committer;nobu;2;9;12;21;0
d4c52127946ebd2e6f9952d69d05cac5fe391740;Sun Aug 31 17:58:13 EDT 2008;Committer;usa;2;14;0;14;0
0f81455429732027fe04118d300c9954bacbcc3c;Sun Aug 31 17:49:08 EDT 2008;Committer;akr;2;8;4;12;0
8841969485b9d65aad60cab456e24e7f8bcbcd3c;Sun Aug 31 17:35:00 EDT 2008;Committer;akr;8;152;125;277;0
6b2efe107f8de34e75da95ec78a9dd6cb0b11be1;Sun Aug 31 17:10:45 EDT 2008;Committer;akr;2;6;1;7;0
3d8043d062cafd76d48709856c3e8039a12e6536;Sun Aug 31 16:25:38 EDT 2008;Committer;naruse;3;6;29606;29612;0
1893e19865e076694321264ed7e695051df523b0;Sun Aug 31 16:23:04 EDT 2008;Committer;naruse;28;62404;20;62424;0
e7ee4fabd428b6b8eb96159a825ad6df2ed16e24;Sun Aug 31 15:31:14 EDT 2008;Committer;akr;1;33;14;47;0
248aaa62b5f901b31c5f2670dc7bff0d64de85d5;Sun Aug 31 15:23:55 EDT 2008;Committer;svn;1;4;4;8;0
16122d1d81a0c939bc0db46f05f25dd96179565a;Sun Aug 31 15:23:51 EDT 2008;Committer;yugui;2;5;3;8;0
a017cecf42d321d69420b7f50ce7c24177a8bfea;Sun Aug 31 14:24:51 EDT 2008;Committer;akr;2;3;3;6;0
1d9a079b1c3b54da5935201c796c7cdb423ed4c8;Sun Aug 31 11:51:04 EDT 2008;Committer;tadf;4;22;2;24;0
c3434e35aca6e2f662f4aa7b059b19d96a2f3e22;Sun Aug 31 09:38:12 EDT 2008;Committer;akr;1;121;14;135;0
fea2b2538d7bfae9223f0748dc7b46c95c863526;Sun Aug 31 09:22:06 EDT 2008;Committer;nobu;2;19;10;29;0
1ca7943e1195ec3b687c9501be38053b24863ff2;Sun Aug 31 09:11:02 EDT 2008;Committer;yugui;2;7;1;8;0
69610b07c304e6ef61c108afaa525fa84cd80451;Sun Aug 31 09:08:31 EDT 2008;Committer;akr;3;41;6;47;0
6e37ddcfbddd5053655d38bf8dc827d8c2ea3379;Sun Aug 31 08:59:09 EDT 2008;Committer;nobu;2;11;5;16;0
70b98dd4af780486e2159e04db766e7f6453d7d8;Sun Aug 31 08:52:56 EDT 2008;Committer;nobu;3;19;6;25;0
11d35f6723df8cccdad82bc4db901c0908041864;Sun Aug 31 08:31:46 EDT 2008;Committer;yugui;2;12;0;12;0
7a4905583dbc3df670a77bbf5dba5fbbade6d455;Sun Aug 31 08:31:38 EDT 2008;Committer;yugui;2;20;1;21;0
94f421c9c02f8e3e9ff1c7f6a70a5cb5e571422b;Sun Aug 31 08:18:11 EDT 2008;Committer;akr;1;1;1;2;0
72ee10b19c0edab36a78c2bdc1870be5220e32ba;Sun Aug 31 08:17:48 EDT 2008;Committer;akr;3;25;18;43;0
2d71485ec1898c5c0f43d1c7e0fdb1f1442c9dd8;Sun Aug 31 07:59:03 EDT 2008;Committer;akr;3;34;2;36;0
ca6a8b1e2c9e1832ab993edff48d2d3a9234a4b3;Sun Aug 31 07:44:24 EDT 2008;Committer;ko1;7;20;11;31;0
d427cf3af8dfc1af85e6e0f3a7d8a86dd7f2d35f;Sun Aug 31 07:43:19 EDT 2008;Committer;akr;3;30;6;36;0
03b2fc9adf609e61550011f9de644209dd6ce021;Sun Aug 31 07:39:45 EDT 2008;Committer;ko1;2;8;0;8;0
d1429c3cc6405a23b10c317c0ffdac96c9a7e61f;Sun Aug 31 07:37:10 EDT 2008;Committer;akr;3;20;1;21;0
ae9af4d3337c7ad82eff221028c1d58b5f44f659;Sun Aug 31 06:07:52 EDT 2008;Committer;nobu;1;2;2;4;0
c3f55e6d486d4c5ccbc32c7c32c72fc586e99293;Sun Aug 31 05:27:52 EDT 2008;Committer;akr;3;53;0;53;0
9d2accff2b2424a00b7a397711fcddf206f18cee;Sun Aug 31 05:18:29 EDT 2008;Committer;akr;3;21;2;23;0
f3c43ae0c2d7ceb7d219a35e956600e0db6ebcab;Sun Aug 31 05:12:32 EDT 2008;Committer;akr;2;8;4;12;0
bb239558b824759d4892d13f8676861584c1d52f;Sun Aug 31 04:48:02 EDT 2008;Committer;nobu;3;15;9;24;0
1105b5ded769d63742f2de4a040dcfc4c6bd51de;Sun Aug 31 04:45:44 EDT 2008;Committer;nobu;2;9;3;12;0
1a41f6dbf48c8c54f529b303f1310db6c34cc76b;Sun Aug 31 04:42:42 EDT 2008;Committer;nobu;3;57;49;106;0
91e5f7d51af4256bb11edfba3c7918d534fc8181;Sun Aug 31 03:56:30 EDT 2008;Committer;akr;2;5;1;6;0
422d6b3d67992576e951837e5991adbc1c9b4874;Sun Aug 31 03:36:09 EDT 2008;Committer;nobu;1;2;1;3;0
5757a872c44cfb0a3abf1eb38e5871fa0af09a4f;Sun Aug 31 02:43:17 EDT 2008;Committer;akr;2;10;6;16;0
d9c5f88abc3377351d2bb8d065113dd0f1eba205;Sat Aug 30 19:39:16 EDT 2008;Committer;akr;3;10;4;14;0
97a5808a148e1aca1a8b53f57290fd8ec9ec3a72;Sat Aug 30 19:36:38 EDT 2008;Committer;akr;3;14;1;15;0
998a4ec5af091792d06a4e266b63702d1651723b;Sat Aug 30 19:27:35 EDT 2008;Committer;akr;3;7;3;10;0
5bbc51ed43e6fee737433964191b55d22497cdbd;Sat Aug 30 19:23:23 EDT 2008;Committer;akr;3;12;7;19;0
d3db454d19f2359403ad3aa90b199d67865d1d58;Sat Aug 30 19:21:18 EDT 2008;Committer;akr;2;13;10;23;0
5e222d694531a75c25bce883f4ce3ce697af8fbf;Sat Aug 30 18:45:48 EDT 2008;Committer;akr;2;15;15;30;0
3deee712f5645d269b573b127ee1dd108e5d0e90;Sat Aug 30 16:55:34 EDT 2008;Committer;akr;4;69;28;97;0
c4eb738b7458c5f38153de5552a281de04586d4e;Sat Aug 30 16:29:08 EDT 2008;Committer;svn;1;3;3;6;0
f69c1c5eda68751caa3a9ac3f8cbf081de9a8c20;Sat Aug 30 16:29:03 EDT 2008;Committer;akr;2;52;37;89;0
a2a32f9f02cf0ee90b1d7c8bb35ce6e9f9eb222e;Sat Aug 30 14:53:15 EDT 2008;Committer;seki;2;8;3;11;0
8eb12fc30e7faf824d708d0068f0f6605b76abdc;Sat Aug 30 14:39:21 EDT 2008;Committer;akr;3;15;9;24;0
74f9ec7e4f4a28da4cc57b14a2ee98e950ed91db;Sat Aug 30 13:25:48 EDT 2008;Committer;tadf;3;10;2;12;0
7b2f9d923875b1b70032192554a3aae3276ce5b6;Sat Aug 30 11:06:52 EDT 2008;Committer;usa;2;23;0;23;0
29c7201262b1ee135b5ab9f07c99f7cc06bfabcd;Sat Aug 30 10:51:40 EDT 2008;Committer;usa;2;6;1;7;0
0075a767e5c6c37d530b495906209fa8e68d1417;Sat Aug 30 09:17:47 EDT 2008;Committer;nobu;2;4;2;6;0
a442691c9d597b812765ce2c758243e9936ac210;Sat Aug 30 09:16:38 EDT 2008;Committer;nobu;2;11;6;17;0
855b594157a57be03185d6f9683383bbcbcd94a2;Sat Aug 30 07:29:41 EDT 2008;Committer;matz;2;190;25;215;0
6ada14922f6ff406f17a34192132ec17bce75ce6;Sat Aug 30 06:54:25 EDT 2008;Committer;matz;4;27;1;28;0
34e157478be78a95a3480f7bb145d639da1c943b;Sat Aug 30 05:58:38 EDT 2008;Committer;nobu;2;9;2;11;0
86e45042cb8799ae79c52f10abc660c799adf113;Sat Aug 30 05:48:09 EDT 2008;Committer;akr;2;5;1;6;0
375dbe3c7364a0c8cd1ed6d51c5f2cabe8fa001e;Sat Aug 30 05:42:06 EDT 2008;Committer;akr;2;18;8;26;0
1b80bfa4692f6dcab6505610bb27d8dc593a132a;Sat Aug 30 01:53:41 EDT 2008;Committer;ko1;2;4;1;5;0
35617676cb24f12d8daa8342cefd0b2355b137e4;Sat Aug 30 01:43:34 EDT 2008;Committer;ko1;2;4;1;5;0
b3b121496fa3ef61ad69b269e584b5b37bbddf6d;Sat Aug 30 01:42:03 EDT 2008;Committer;nobu;2;13;3;16;0
24aba0805467feda3ea23b8ea39f7b07188727f1;Fri Aug 29 23:59:32 EDT 2008;Committer;nobu;3;15;10;25;0
727625d9d43dfc816b21a6093cbd5d303e9e8247;Fri Aug 29 23:10:25 EDT 2008;Committer;naruse;2;8;4;12;0
5159f500fdab17c053075c7dd62b5050fdb80bc5;Fri Aug 29 22:50:16 EDT 2008;Committer;naruse;3;15;7;22;0
41d50725736df60e0118c337f8378b27497c7d94;Fri Aug 29 17:49:18 EDT 2008;Committer;matz;2;7;2;9;0
66529e382f93217f5655deb53c2129b200af1a55;Fri Aug 29 16:56:44 EDT 2008;Committer;matz;2;7;3;10;0
d945524057ec2ca0a0c72a90a75a80f2bb0aa712;Fri Aug 29 16:38:25 EDT 2008;Committer;matz;2;5;5;10;0
c2ba5cf9c54b0e9268617250ecd2075fbd1ddd8e;Fri Aug 29 16:25:27 EDT 2008;Committer;akr;1;11;0;11;0
31ad460358a5b1d64b1748052f26ca3c3d7433ed;Fri Aug 29 15:38:12 EDT 2008;Committer;svn;1;3;3;6;0
2ccc4304cd0a1cb12c68bc1d512f5d28bfe9563a;Fri Aug 29 15:38:09 EDT 2008;Committer;tadf;2;0;230;230;0
a5bdf63afd3fedbd902cfa3ec0bfdb17ea83d35c;Fri Aug 29 14:50:43 EDT 2008;Committer;tadf;2;3;0;3;0
5185955f3f64d53f55e34bfe4eaf059b7b347fc4;Fri Aug 29 13:41:41 EDT 2008;Committer;tadf;6;265;124;389;0
fa4c17e71283e72100c12b8824aafe176372241d;Fri Aug 29 11:22:42 EDT 2008;Committer;ko1;3;13;9;22;0
889acc818531840818cb2809bdaf2c25285b16f5;Fri Aug 29 09:37:00 EDT 2008;Committer;naruse;2;13;2;15;0
56c3432476f750c02822bd0e99d74a6035cf7c43;Fri Aug 29 09:22:17 EDT 2008;Committer;naruse;2;12;6;18;0
100d0a568eeac44c8844a3a8707a1faa460f5106;Fri Aug 29 08:24:51 EDT 2008;Committer;ko1;4;21;13;34;0
379fa42f6db7c7f88cc2eddde8326441086e7aed;Fri Aug 29 03:19:15 EDT 2008;Committer;nobu;4;21;7;28;0
7fc16c237724a5f4377cea47e3434f53d42af5f4;Fri Aug 29 02:20:23 EDT 2008;Committer;naruse;3;21;1;22;0
d2d37173e7803d6ceec22233a903eb26e0617151;Thu Aug 28 19:49:20 EDT 2008;Committer;usa;2;11;2;13;0
d4afbe49f36f35ad1bf4f5f054c180973dc7521e;Thu Aug 28 18:28:52 EDT 2008;Committer;akr;1;1;0;1;0
2c80188627712523cb29b17fe435bf50a613fd4e;Thu Aug 28 18:00:02 EDT 2008;Committer;akr;3;67;0;67;0
23d10cbb00c726571183ad96dcd26547fd6200d8;Thu Aug 28 17:46:18 EDT 2008;Committer;akr;3;67;0;67;0
ad8cfb1b945d2ec6b28be8a1bc60ed458a19075c;Thu Aug 28 17:39:02 EDT 2008;Committer;akr;3;54;8;62;0
3811bb53bdc604ec6abe1252787c3fb381a711d6;Thu Aug 28 17:13:49 EDT 2008;Committer;akr;3;28;5;33;0
63846d48a9b2044ad2fb3062ca8551de078d3508;Thu Aug 28 17:06:20 EDT 2008;Committer;shugo;4;28;2;30;0
c23ec90e813457ec4db5d02677cdb358743974b5;Thu Aug 28 16:59:17 EDT 2008;Committer;akr;2;35;7;42;0
77d7a80f9778d415165fff1c7ce0bf99b96b9ef3;Thu Aug 28 15:54:44 EDT 2008;Committer;shugo;3;40;1;41;0
9f3170663638393b60e39828b1b39e06201e8a7b;Thu Aug 28 15:21:04 EDT 2008;Committer;usa;2;6;2;8;0
2fcd15d45d983469a2a67bbdb78da2ff1fc7bce4;Thu Aug 28 15:03:38 EDT 2008;Committer;mame;2;5;0;5;0
b283b1d81303039218d3e1a68ba104241cdf57cd;Thu Aug 28 15:01:12 EDT 2008;Committer;svn;1;3;3;6;0
6a7481c38db51f1cd0818412375c76202ad04168;Thu Aug 28 15:01:07 EDT 2008;Committer;shugo;3;9;1;10;0
5ef4c56784db4b4ac6eefc865774015a75796acf;Thu Aug 28 14:55:53 EDT 2008;Committer;mame;2;13;0;13;0
846f142a17157e9a773c875e5f00857c0dde2429;Thu Aug 28 14:51:30 EDT 2008;Committer;mame;2;7;1;8;0
c543447ee0283395aa7e28f8d66139ccfc3f6f10;Thu Aug 28 14:40:53 EDT 2008;Committer;mame;2;8;4;12;0
fbfd237042fe9891660712e3853f9416b691835b;Thu Aug 28 14:36:52 EDT 2008;Committer;akr;2;178;166;344;0
503d852995a9d4df10e387d653a1128a3476a211;Thu Aug 28 14:29:31 EDT 2008;Committer;mame;2;15;0;15;0
3c8dca55c43b78c0564ad0ff93d67587a7a64bf8;Thu Aug 28 12:46:58 EDT 2008;Committer;usa;4;465;19;484;0
cf6334e1cb91bfee0f95e5ae7ea9c4a72df1f6c2;Thu Aug 28 12:08:19 EDT 2008;Committer;matz;2;5;2;7;0
84b144f6de2cb5eccb9b534217f3cf943896b613;Thu Aug 28 11:50:31 EDT 2008;Committer;matz;2;35;2;37;0
f7f0784270ce51fac9c21b58668b3e455d2ae60e;Thu Aug 28 11:29:57 EDT 2008;Committer;matz;2;8;2;10;0
a7fa5122d7c48f2bddeaa74114111b666f986a21;Thu Aug 28 10:05:35 EDT 2008;Committer;usa;2;5;1;6;0
d68321c18e416fe33be26060f0ac138616bedfa8;Thu Aug 28 03:51:22 EDT 2008;Committer;matz;2;49;7;56;0
cbd71ac426c72fc34f9ace1445808fadf6535ef9;Thu Aug 28 00:41:57 EDT 2008;Committer;naruse;1;6;0;6;0
283e57e328b8477c84ec85be2723593aae628bfe;Thu Aug 28 00:30:40 EDT 2008;Committer;naruse;5;310;0;310;0
692395b81fde0eba2578fdf22f0daf056b3b1926;Thu Aug 28 00:22:57 EDT 2008;Committer;naruse;2;150;0;150;0
f30670001b75860875d7a3d8efea824145df2a4d;Thu Aug 28 00:19:26 EDT 2008;Committer;naruse;1;177;0;177;0
5d93e408663dd85fef72cc51a49ee837cb0af45f;Thu Aug 28 00:18:24 EDT 2008;Committer;naruse;1;5;0;5;0
e2db51b2cd90c3d2af48d2f7bb584f67d92559e2;Wed Aug 27 23:09:26 EDT 2008;Committer;nobu;0;0;0;0;0
a08b97c2f6c5ef85a3d8eee0eaf73015612316b5;Wed Aug 27 17:19:19 EDT 2008;Committer;akr;3;11;8;19;0
c28edc50123f7a58666e090cf9e440b25dd44aab;Wed Aug 27 15:09:52 EDT 2008;Committer;svn;1;3;3;6;0
d05d66e2acaa67840394b332359d6aa99bcc233a;Wed Aug 27 15:09:47 EDT 2008;Committer;akr;3;19;67;86;0
f6f85ad68309508e29f30d6cc4b86d0057aac2c0;Wed Aug 27 14:43:23 EDT 2008;Committer;suke;3;16;1;17;0
ad3c6c712b48843bf12cca4bc7d5290f34b0866d;Wed Aug 27 13:39:25 EDT 2008;Committer;akr;1;8;0;8;0
4c88439a94f8ba971f2301d41c64234c15a1af7b;Wed Aug 27 05:49:28 EDT 2008;Committer;naruse;2;317;0;317;0
382b4af605eece7c9c917258d5daa3e103b0cb8f;Wed Aug 27 05:02:32 EDT 2008;Committer;naruse;1;1;0;1;0
b64fd4625d9bf215cd3db7b27e13e8f4956dbcdd;Wed Aug 27 01:40:46 EDT 2008;Committer;naruse;1;2;0;2;0
19b25eb670b2121b09eb0d89df8350286e8856ff;Wed Aug 27 01:38:23 EDT 2008;Committer;naruse;3;114;4;118;0
1366802a1f24065c9d02f47f59d9a0519f9cd516;Tue Aug 26 16:14:49 EDT 2008;Committer;akr;2;6;11;17;0
db6ec3105ea5c3b7e30e15ec0a0b4d1a5dbe0ac3;Tue Aug 26 16:09:29 EDT 2008;Committer;akr;5;82;18;100;0
99a26ac1642cbe3f27f939cc53c0bef5a0ac15a1;Tue Aug 26 15:06:28 EDT 2008;Committer;akr;3;75;69;144;0
c8dbd99790eb090d9f699fd40a75eb7a3a22f96d;Tue Aug 26 15:01:15 EDT 2008;Committer;svn;1;3;3;6;0
a68e409eaab13ed85df4308a5a3bbb045dbbd639;Tue Aug 26 15:01:11 EDT 2008;Committer;akr;3;51;41;92;0
8039100c0abc8b1c71445839ff42f2798f399ac2;Tue Aug 26 13:47:17 EDT 2008;Committer;usa;2;12;0;12;0
19ab08653eb18b18507a9c4de09327c904387d7f;Tue Aug 26 12:55:14 EDT 2008;Committer;akr;4;92;16;108;0
18b097b73b49965bed5e37c6f53b2043e50103c8;Tue Aug 26 12:45:20 EDT 2008;Committer;akr;2;6;0;6;0
2e248635499284b5dfd63e33e81c2c3dafe405cc;Tue Aug 26 10:28:57 EDT 2008;Committer;knu;2;16;1;17;0
0924bcf835596a05cfde5ca87572b8ab0385bd0c;Tue Aug 26 10:26:45 EDT 2008;Committer;knu;2;16;8;24;0
990ffbb96a91a45f40aa4b9c19001e4eb7278bf9;Tue Aug 26 07:18:35 EDT 2008;Committer;naruse;2;73;0;73;0
67515222a12dfed9e8e76ee18764cb8afeadeb84;Tue Aug 26 05:45:48 EDT 2008;Committer;knu;1;1;1;2;0
3e8c3897abe511678b1c8455b5441f95151089c9;Tue Aug 26 05:45:18 EDT 2008;Committer;knu;3;42;6;48;0
cb32985d03b2eb79ad3b9dd7a7b58312c6da5412;Tue Aug 26 05:42:12 EDT 2008;Committer;knu;4;294;12;306;0
c5e46ef397ce68fda7cc8f1c0362f663846ef383;Tue Aug 26 04:26:00 EDT 2008;Committer;duerst;2;59;0;59;0
8ec7dce8c55fe3b8364cda6c01e78dce0575a700;Tue Aug 26 02:55:43 EDT 2008;Committer;naruse;2;258;0;258;0
ae86df99f73c16a54f74358538eb8c630d930733;Tue Aug 26 02:42:27 EDT 2008;Committer;naruse;2;16;4;20;0
3c66a5b25eeee2a0b1b7768e3155048339ff5be8;Mon Aug 25 18:08:08 EDT 2008;Committer;akr;2;12;9;21;0
446a67c08e13adc3b110ba67a7714a1cf35bcda7;Mon Aug 25 17:58:30 EDT 2008;Committer;tadf;1;2;2;4;0
42307bf41f25c24f0f1177fafcaa97b40de4107a;Mon Aug 25 17:47:57 EDT 2008;Committer;yugui;3;12;5;17;0
75b2d7cbe8538c9414f579c3c56becf9b63986b6;Mon Aug 25 17:45:30 EDT 2008;Committer;akr;3;17;12;29;0
08911df3117cb9cf6625117c1c6a109cff64b1ad;Mon Aug 25 16:49:31 EDT 2008;Committer;akr;2;5;2;7;0
5c6d113a4b58a3b4c01301ac8371378dbdb81dd0;Mon Aug 25 16:30:43 EDT 2008;Committer;akr;2;6;1;7;0
873987f2e0796e04ca0ac0aed885137f8e523338;Mon Aug 25 16:27:23 EDT 2008;Committer;akr;2;27;7;34;0
1a805010ed9e9edc99f2abefa5d4431eb54b43f4;Mon Aug 25 15:58:35 EDT 2008;Committer;akr;2;25;9;34;0
6c1190d10f4cb338595a39237e0126a8b677c8db;Mon Aug 25 15:37:04 EDT 2008;Committer;akr;2;11;1;12;0
86154f63b358fe81441be9d339d6dba0054f8c92;Mon Aug 25 15:26:54 EDT 2008;Committer;akr;3;36;7;43;0
72eaacaa15256ab95c3b52ea386f88586fb9da40;Mon Aug 25 15:04:53 EDT 2008;Committer;akr;1;3;0;3;0
4e573bf068bfe7859af293a4210c5b5c65fa86ba;Mon Aug 25 15:03:14 EDT 2008;Committer;mame;2;5;1;6;0
1913c0e857253ddbed217e0bdbfae55796a30afe;Mon Aug 25 15:01:40 EDT 2008;Committer;svn;1;3;3;6;0
04860263899b34e3f7efea4a845c8b80523eca9e;Mon Aug 25 15:01:36 EDT 2008;Committer;akr;2;53;26;79;0
87746352f4463bcd4815b2287b3bea3d6b0710f0;Mon Aug 25 14:58:01 EDT 2008;Committer;usa;2;13;0;13;0
3e75a0a7638887519610ca4c96ee7b23e4592d9b;Mon Aug 25 14:47:33 EDT 2008;Committer;tadf;2;16;4;20;0
9839d737c25e1a787bc8c45774cbb235dedc8507;Mon Aug 25 14:04:09 EDT 2008;Committer;matz;2;6;27;33;0
bc3c17850915d840f136189bd3ace5d5369dde2d;Mon Aug 25 13:46:34 EDT 2008;Committer;mame;2;14;6;20;0
cba52ec37cbe5be168f00ca9568e68fb1ed4f984;Mon Aug 25 13:41:11 EDT 2008;Committer;mame;3;19;6;25;0
4da80c7d6bca4de837637f03bd366a55999c36d7;Mon Aug 25 13:32:59 EDT 2008;Committer;mame;2;5;1;6;0
aeffc67dbbb8a06297afd13a2e68edf40294b460;Mon Aug 25 13:04:16 EDT 2008;Committer;akr;3;122;3;125;0
cc3cbd2965ce1c75bd0eace89eeb3c3fe8c90735;Mon Aug 25 10:06:12 EDT 2008;Committer;matz;2;7;0;7;0
6194a7eef1338df836b27608ee2eb989887cea39;Mon Aug 25 09:47:28 EDT 2008;Committer;kazu;1;3;3;6;0
ce60bbc8519465a125f975f4169f0bb644fcadf3;Mon Aug 25 08:36:46 EDT 2008;Committer;nobu;4;13;10;23;0
10906176b4dea0444588fba36b98f4b144a25775;Mon Aug 25 08:35:42 EDT 2008;Committer;nobu;2;5;2;7;0
0d0c147f23ef526437a7904c8ce22d60fa232c95;Mon Aug 25 08:34:32 EDT 2008;Committer;nobu;2;9;1;10;0
d9a1cc2f4edcd59bd544d48e2f446d43f5121401;Mon Aug 25 05:27:46 EDT 2008;Committer;yugui;2;6;1;7;0
8c6040edcabafbebc2afd54b9da6a4e98bff863f;Mon Aug 25 01:42:36 EDT 2008;Committer;nobu;2;5;1;6;0
12e61c83cb5527fdf47d1cfd69919f003e8cf8c7;Sun Aug 24 22:10:57 EDT 2008;Committer;naruse;2;13;105;118;0
2c78899641c9f34377b67f3df32662232db801e9;Sun Aug 24 15:58:43 EDT 2008;Committer;akr;8;58;2;60;0
2a9369fcbaf7fe52b863827cef7c7533099f5f61;Sun Aug 24 15:13:41 EDT 2008;Committer;svn;1;3;3;6;0
bf5e559ce0770cffb15b4d6cde84d78757bbc8fa;Sun Aug 24 15:13:37 EDT 2008;Committer;akr;2;6;2;8;0
ae1b02a8da630762436d190355ed24ec0db0976e;Sun Aug 24 10:49:36 EDT 2008;Committer;akr;3;22;13;35;0
329729da551943645c60a9ebbfa7cbdfa7b8a043;Sun Aug 24 10:40:37 EDT 2008;Committer;akr;3;34;2;36;0
98e34b223b8a79c2984f2a6ab2296c8232dc209b;Sun Aug 24 10:32:59 EDT 2008;Committer;akr;1;34;25;59;0
7918141932ee5c440f556f272a01befd1de5a52d;Sun Aug 24 10:18:32 EDT 2008;Committer;akr;2;20;6;26;0
6f8c2ea9c425fc4e263c0327bef273595cdfb9ae;Sun Aug 24 10:11:52 EDT 2008;Committer;akr;2;7;5;12;0
c22f52c06f788d87e89320112c909ad461deceaf;Sun Aug 24 10:07:46 EDT 2008;Committer;akr;2;5;0;5;0
071319fde18d319cf5c66702aeaf66ca1a880a2f;Sun Aug 24 09:40:31 EDT 2008;Committer;akr;4;70;12;82;0
571b114708061819db35ad7c0349502196aa92be;Sun Aug 24 09:13:55 EDT 2008;Committer;akr;3;41;30;71;0
6d019ccbd0f93b6be47884f4cc814798614d284e;Sun Aug 24 09:03:04 EDT 2008;Committer;akr;2;9;3;12;0
09c7eba7b1293ec187e4acd12d11887540df41a7;Sun Aug 24 08:39:09 EDT 2008;Committer;akr;4;35;25;60;0
d7bf4546664feb3f8b4b07817978e389e9f2b381;Sun Aug 24 07:49:13 EDT 2008;Committer;akr;3;56;52;108;0
1c3d34cad5220a1c18ee2c1d781982617008c220;Sun Aug 24 07:26:16 EDT 2008;Committer;akr;1;1;0;1;0
f27b74142e3775625c4ac4506b84c20154549aa6;Sun Aug 24 07:20:21 EDT 2008;Committer;akr;4;24;28;52;0
9b8adfed222ed950b74d76a45179b3ba785c4e05;Sun Aug 24 07:12:44 EDT 2008;Committer;akr;4;53;32;85;0
b47c46106a0e2937d059e81b6fbecafe3a3d4347;Sun Aug 24 06:44:21 EDT 2008;Committer;akr;2;9;1;10;0
c6d291b003a4d5f8b12d9ff79767525d359b5733;Sun Aug 24 06:25:24 EDT 2008;Committer;akr;5;198;59;257;0
51ad3df2cec27075db72dff7291c5f8828d0c9da;Sun Aug 24 04:28:12 EDT 2008;Committer;akr;2;8;1;9;0
bc0efbc9cd875ef4582cfc421297ec7cfbbfcb78;Sun Aug 24 03:22:43 EDT 2008;Committer;akr;4;41;5;46;0
a65d2e05740d6602158dc4fdc2d53ad47cbf45fc;Sun Aug 24 03:21:36 EDT 2008;Committer;naruse;2;6;1;7;0
7c2c7ea315d3945fd68dc937a8b3ebbc529472e5;Sun Aug 24 03:03:18 EDT 2008;Committer;akr;2;5;1;6;0
8f9ed3c464fea371855792758b9e9d31ba99c0ec;Sun Aug 24 02:42:37 EDT 2008;Committer;akr;6;75;13;88;0
55742dce2d30534faa95551c7904bbf660b4835b;Sun Aug 24 02:27:47 EDT 2008;Committer;naruse;2;15;8;23;0
82dc949bba9f6345ae75c0eafc8c4fdf5dbfb1d2;Sun Aug 24 02:05:13 EDT 2008;Committer;naruse;1;1;0;1;0
cc98d3e44079f8706b63c9acd2ac1967e36bdb67;Sun Aug 24 01:58:18 EDT 2008;Committer;naruse;2;440;0;440;0
e6770d9407347ac5e0e14d2299d97678d7a9554a;Sat Aug 23 23:03:44 EDT 2008;Committer;nobu;2;6;1;7;0
29449d70be69c35302e066706e5ec04f9dae3dd9;Sat Aug 23 21:40:59 EDT 2008;Committer;naruse;2;34;13;47;0
33dd0c35f1b292623cd9d93a61c3b11beb0576b8;Sat Aug 23 21:12:32 EDT 2008;Committer;naruse;2;6;0;6;0
e8e84720582658c39e7307be303f2153cf08421b;Sat Aug 23 16:06:52 EDT 2008;Committer;svn;1;3;3;6;0
1b82d027d489c25fc93a7ec598a195ef783d4073;Sat Aug 23 16:06:48 EDT 2008;Committer;kazu;1;1;1;2;0
9c24ab3d9d0317abe98b10c2dc4b85a155c6092e;Sat Aug 23 14:29:00 EDT 2008;Committer;naruse;2;5;16;21;0
8aaf39ce803c8126e2d542bc7b264bb3c65e85fa;Sat Aug 23 11:04:54 EDT 2008;Committer;kazu;2;7;2;9;0
cefcbd24f67258ec2dc1263fa987378f1971d429;Sat Aug 23 09:30:06 EDT 2008;Committer;akr;2;5;6;11;0
2b78afebc731e3f9e447076c3cd2e53328b9e97a;Sat Aug 23 08:41:02 EDT 2008;Committer;akr;4;113;15;128;0
5378f8e5b1bc23bb8d5a9d4180582c306813f454;Sat Aug 23 08:06:59 EDT 2008;Committer;nobu;2;118;71;189;0
74cd315a505485ddddf21d7b8ca58b627e069825;Sat Aug 23 07:01:57 EDT 2008;Committer;nobu;1;2;1;3;0
400796e87b7df6f4605c4d342741511da3f855c3;Sat Aug 23 06:18:11 EDT 2008;Committer;ko1;2;5;1;6;0
d4fabf0e36946a2ac8423a0817e282efa1ee1459;Sat Aug 23 06:02:58 EDT 2008;Committer;akr;4;119;53;172;0
860c2331039537c4d0c5c8c92ae1e89395f0edcc;Sat Aug 23 02:23:42 EDT 2008;Committer;akr;3;33;0;33;0
3721df734c9ad1be0bbd64321329c1af405b289b;Sat Aug 23 01:49:56 EDT 2008;Committer;akr;2;6;2;8;0
d2cb86c532c5123d93351d4953af1f4a351a7ce5;Sat Aug 23 01:45:49 EDT 2008;Committer;akr;2;27;7;34;0
341abd3f881ce77458f62c46e6421fd6c4444984;Sat Aug 23 01:14:33 EDT 2008;Committer;akr;2;11;9;20;0
895fd7ec5e03c51c5ebc1424312967852703de38;Sat Aug 23 00:47:54 EDT 2008;Committer;akr;6;102;92;194;0
1c44355be9914291d5c42402360e1fa86786b6c5;Fri Aug 22 16:44:04 EDT 2008;Committer;svn;1;3;3;6;0
c0d3881e0e67b2fe9eeaa98c6d912ee15ea430b8;Fri Aug 22 16:44:00 EDT 2008;Committer;akr;8;420;80;500;0
0dd677da4e895e493e9ec5cd1297abbb0876a61c;Fri Aug 22 14:05:53 EDT 2008;Committer;tadf;1;1;1;2;0
8f40b265811a23eef5b8c9e0b677b7d15cd6ea45;Fri Aug 22 12:27:54 EDT 2008;Committer;tadf;8;325;307;632;0
2d302dfd40ee9a4b3183415b19dbc22cf9106ba3;Fri Aug 22 11:12:06 EDT 2008;Committer;kazu;4;37;8;45;0
122595c263d67e0a32175833ed0ad6c7482b767e;Fri Aug 22 11:00:05 EDT 2008;Committer;tadf;2;4;1;5;0
1acc8f948366d558541a0ef3e54ef1c143de1580;Fri Aug 22 10:55:48 EDT 2008;Committer;tadf;1;4;10;14;0
760ee4ec040307a54ef9aa93c70fcddc7fc87ea1;Fri Aug 22 06:48:22 EDT 2008;Committer;usa;2;21;17;38;0
ce2b7d3a58fb2cce8650d5d8809ce40e6a1e9250;Fri Aug 22 05:28:08 EDT 2008;Committer;nobu;4;212;145;357;0
5dd5311fdf839f3abbe18cef21a5f16c060cef9e;Fri Aug 22 05:12:33 EDT 2008;Committer;duerst;2;26;21;47;0
1dce3b071e35b2772e78c7cc1e16ce1069e3c94b;Fri Aug 22 03:42:09 EDT 2008;Committer;akr;2;5;1;6;0
3337c792e692f1c80ecb5df3eafd9d02f4364445;Fri Aug 22 03:32:13 EDT 2008;Committer;naruse;2;12;0;12;0
cc17cad920858b8dfb1e2e5f674e41699a8bcda6;Fri Aug 22 02:32:44 EDT 2008;Committer;naruse;2;17;8;25;0
d914071bba509bc0aa2396dc2245dd4a57fe7c61;Fri Aug 22 02:30:02 EDT 2008;Committer;naruse;2;4;1;5;0
504ed85dfefc86dd95d518e873b6493bc4693175;Fri Aug 22 01:52:42 EDT 2008;Committer;nobu;3;45;18;63;0
93ee8dea674b3935bf546665296bc328c124371f;Thu Aug 21 20:30:06 EDT 2008;Committer;akr;2;20;10;30;0
f61354c40577276ebc6ef4dee9aadcaa3b59f97c;Thu Aug 21 20:12:29 EDT 2008;Committer;akr;2;20;10;30;0
2f59e3130c0f9be681ade633bbabf41f40a5435f;Thu Aug 21 19:50:16 EDT 2008;Committer;akr;1;6;4;10;0
ae0ca36f8b6ccb767439d799f7260b980a04895b;Thu Aug 21 19:34:24 EDT 2008;Committer;akr;2;10;2;12;0
9ee7875162df5d55fcb56a36e39efa45894de6b3;Thu Aug 21 18:49:13 EDT 2008;Committer;akr;2;57;7;64;0
fbc6ea6c95f8f8fd2d6f3e6adb49f13c7031860b;Thu Aug 21 18:03:52 EDT 2008;Committer;akr;2;12;5;17;0
ddda4e5508e962a4823722f1f373894280fa529c;Thu Aug 21 17:58:50 EDT 2008;Committer;akr;2;17;6;23;0
9910ee4f5c9c97b5908ab4bba64189a9c9a39b8b;Thu Aug 21 17:44:38 EDT 2008;Committer;akr;2;9;3;12;0
32c7a56555b7099431cc98ff2bed3ca8330d5f82;Thu Aug 21 17:25:43 EDT 2008;Committer;akr;2;12;2;14;0
2de66ecbfc8c6c9c76f81db3e706b5a24af30e08;Thu Aug 21 17:10:00 EDT 2008;Committer;svn;1;3;3;6;0
dd7cf02eab10e8feb7cb4324265d6ecd81a759df;Thu Aug 21 17:09:56 EDT 2008;Committer;akr;3;32;13;45;0
a0cc5b19b7fa4207496a74d2ef8f39480eac44b5;Thu Aug 21 14:57:35 EDT 2008;Committer;shugo;4;71;4;75;0
60bc53a1615222d2ad0b111ca84975093cf6efc1;Thu Aug 21 11:25:12 EDT 2008;Committer;kazu;2;6;1;7;0
cefd28a84fb25b80d8afeea15df03ac90ac1d615;Thu Aug 21 10:20:55 EDT 2008;Committer;akr;3;11;0;11;0
61acccefb7b90ab8dcbccc216e56c0ea61f1b54a;Thu Aug 21 10:18:38 EDT 2008;Committer;akr;3;16;3;19;0
d34079b17a82ca0c3012a9eb0b99689ac65c585c;Thu Aug 21 10:07:21 EDT 2008;Committer;akr;3;287;3;290;0
3f7bed0b805fbb4cd9c88d59a1516eacd22170e5;Thu Aug 21 10:04:23 EDT 2008;Committer;akr;1;4;2;6;0
a0e3fe5d7cf067bbca1cba92f471e98e6527d138;Thu Aug 21 05:28:25 EDT 2008;Committer;shugo;3;7;2;9;0
8b7999406ef47af49a8004f054d1bfc4aff3226f;Thu Aug 21 00:41:12 EDT 2008;Committer;shugo;1;1;1;2;0
9b4d4a8a4826e13cc8794b6a478b4a58504b126f;Thu Aug 21 00:30:28 EDT 2008;Committer;shugo;3;8;2;10;0
0cae739f2d3038d8d2ac6e8ee51a9a4d926dc9d5;Wed Aug 20 23:00:01 EDT 2008;Committer;naruse;2;19;2;21;0
b9e3f3c129b39bd99b1738dbed4273985c464074;Wed Aug 20 21:12:58 EDT 2008;Committer;nobu;3;8;3;11;0
e1ebab4ed015c1c479f98595eecfc8f1bebaba6b;Wed Aug 20 21:02:54 EDT 2008;Committer;nobu;3;12;1;13;0
caf34a9305f1af057afff3f3ec48efacb52c0a73;Wed Aug 20 18:14:07 EDT 2008;Committer;akr;2;60;31;91;0
e6c300e08a0d055bbaf2a8fd95507f2544906594;Wed Aug 20 17:31:53 EDT 2008;Committer;akr;2;13;7;20;0
65337c5b2d56c70440f1677f2b175270d77ea0d1;Wed Aug 20 17:08:36 EDT 2008;Committer;shugo;3;23;17;40;0
19569c8f2596f340b821f104588c59e00b08773d;Wed Aug 20 17:03:27 EDT 2008;Committer;akr;2;7;6;13;0
4a2cd03fbd73cefdc87e9602dc3dd1cf86a5a63d;Wed Aug 20 16:57:46 EDT 2008;Committer;akr;3;34;3;37;0
1bfaed8f8d4de9eba8f5b282a18e886aed278a2a;Wed Aug 20 16:32:12 EDT 2008;Committer;akr;2;6;13;19;0
10e5d076814e99cbd5f69cf1461d657c6285e748;Wed Aug 20 16:10:36 EDT 2008;Committer;akr;2;34;30;64;0
99155ccbf20efb98ce97145b9aee95fb487262cc;Wed Aug 20 16:04:11 EDT 2008;Committer;shugo;5;22;929;951;0
22c4bdcd18036d830c1071a81139f8238f7f0ae8;Wed Aug 20 15:50:21 EDT 2008;Committer;usa;2;10;7;17;0
fef047dfb0d0250e2c3fdab7b4a156010f9e60d1;Wed Aug 20 15:30:33 EDT 2008;Committer;svn;1;3;3;6;0
1fd1e0ac040f66d16ca0930eb61c1186f03d377d;Wed Aug 20 15:30:28 EDT 2008;Committer;shugo;5;954;5;959;0
578fc840009ef7adb1f845e10cfaf451b97f9077;Wed Aug 20 14:56:23 EDT 2008;Committer;akr;2;18;22;40;0
4046ecde2f6880390f30d68570f570269f397a88;Wed Aug 20 13:32:08 EDT 2008;Committer;akr;2;14;7;21;0
9286180079614b7f953a0c6832ad38c6d5a5af9f;Wed Aug 20 13:28:18 EDT 2008;Committer;nobu;5;24;15;39;0
51e0bcb72a332b121c524e926f0b08994fc963aa;Wed Aug 20 13:24:51 EDT 2008;Committer;nobu;2;7;2;9;0
65370097cda754090f57da3d9df85f98c7725e50;Wed Aug 20 11:33:36 EDT 2008;Committer;akr;3;26;12;38;0
9074da1b4424b09916d4baf23b26c7cfae75ac44;Wed Aug 20 11:16:59 EDT 2008;Committer;akr;2;24;4;28;0
f684d04a66b08492dd61ff1a40db289cb0daeba4;Wed Aug 20 10:24:37 EDT 2008;Committer;akr;2;106;42;148;0
f58382aaf3de10a78f1c108dfafae2278abe62f2;Wed Aug 20 10:16:20 EDT 2008;Committer;akr;2;14;0;14;0
76a3923c99ed79a52ca4d04c694da079625d4180;Wed Aug 20 09:43:24 EDT 2008;Committer;akr;2;6;5;11;0
a5c0ee40b1bf98201d45f12aa040b2be1ec0405a;Wed Aug 20 09:38:43 EDT 2008;Committer;akr;2;4;1;5;0
2901137a810da7181d0626081451244d3a950812;Wed Aug 20 09:33:55 EDT 2008;Committer;akr;2;5;1;6;0
ee5c9fb9831788344a5440e9151487d6f512be2e;Wed Aug 20 07:40:03 EDT 2008;Committer;nobu;2;58;18;76;0
6523eee836cc3253253fd5a814c6784cd8b8c99c;Wed Aug 20 03:28:34 EDT 2008;Committer;nobu;2;6;1;7;0
f78380f0f1e4941119bef7661eb7b0afe2df089c;Tue Aug 19 21:10:28 EDT 2008;Committer;akr;2;8;1;9;0
297f3249d9452afc70cbd0d99eb9f707361df581;Tue Aug 19 20:27:08 EDT 2008;Committer;akr;1;9;9;18;0
a0e0e30864d292e5c173087dad15260f75d312ce;Tue Aug 19 20:20:31 EDT 2008;Committer;akr;2;73;47;120;0
608230bfa82c024ae1b89a0d4f474e22aad7370e;Tue Aug 19 19:17:46 EDT 2008;Committer;akr;2;5;1;6;0
b929da2a1e03da52fd630d71a940858051f0f456;Tue Aug 19 18:38:32 EDT 2008;Committer;akr;3;46;32;78;0
77ba9a5f56ff86d1dc014da32b9e385b92c9626b;Tue Aug 19 17:37:05 EDT 2008;Committer;akr;2;4;1;5;0
35c7e26b56b1d7ca9d5a0b255551145f85906679;Tue Aug 19 17:32:35 EDT 2008;Committer;svn;1;3;3;6;0
8f3e88c4322ee661e4813ff0fe7014d94b16ac52;Tue Aug 19 17:32:31 EDT 2008;Committer;akr;2;17;4;21;0
21ba5836e62f142c39697fc0cf6775448615e1cc;Tue Aug 19 12:51:52 EDT 2008;Committer;akr;3;6;26;32;0
074ad688b1b96d435e8c41dd16b470f3e28b28bf;Tue Aug 19 12:14:55 EDT 2008;Committer;akr;2;6;2;8;0
4bba634ae77a6c1c2877ab8952250b689ceb7590;Tue Aug 19 12:14:02 EDT 2008;Committer;akr;2;9;3;12;0
fb7be908bbfee12af0b34f9329bf71ac0f01d0a0;Tue Aug 19 09:24:34 EDT 2008;Committer;akr;2;7;2;9;0
b7643cfdcdff51f3e854b3790dedf3e5572cfc3b;Tue Aug 19 09:06:38 EDT 2008;Committer;akr;2;17;11;28;0
cf26f818e46aa64bc692cccd18d2d68d27f0198f;Tue Aug 19 08:34:42 EDT 2008;Committer;akr;2;6;0;6;0
c0d2782a0eb10c64545e5595ec423d89e3ac9508;Mon Aug 18 19:54:42 EDT 2008;Committer;nobu;2;6;1;7;0
02f43f1bd92cd8eb016b44d98a2b86173c520211;Mon Aug 18 16:33:46 EDT 2008;Committer;akr;3;20;0;20;0
20d2ecafa30f84e13242a2cf221d24bb8be5e7ed;Mon Aug 18 16:05:57 EDT 2008;Committer;akr;1;1;1;2;0
d8892979334d88c19dddd18c6717b69766d4888e;Mon Aug 18 16:04:09 EDT 2008;Committer;akr;2;15;8;23;0
93ad576b0511ee435c01bd92e31d625d29c2c22e;Mon Aug 18 15:56:38 EDT 2008;Committer;akr;3;8;2;10;0
f9e00ba03f9269cbbe4cdf51590a38eb877a85e8;Mon Aug 18 15:35:25 EDT 2008;Committer;svn;1;3;3;6;0
febc4b9923c6a20539e615b99eb59be7e2c43189;Mon Aug 18 15:35:21 EDT 2008;Committer;akr;3;24;6;30;0
1b821cb4a32b40ba6392abbba6c941aceb47e54d;Mon Aug 18 14:28:45 EDT 2008;Committer;akr;3;88;15;103;0
e32e9a06e4e05dbe38ae8d42af55db3fd1899469;Mon Aug 18 13:42:09 EDT 2008;Committer;akr;2;5;2;7;0
edc9581f16bc48310051072a4135bdcdccee1a70;Mon Aug 18 13:35:55 EDT 2008;Committer;akr;3;25;24;49;0
035d4816c3782eca70464fa553b968dc46adee53;Mon Aug 18 12:06:42 EDT 2008;Committer;akr;7;297;17;314;0
89b4f06a596e993a82630913f085a82265cb499c;Mon Aug 18 08:24:49 EDT 2008;Committer;akr;3;77;8;85;0
f7bdac01c245ed85e97655bb48f279183bf03557;Mon Aug 18 08:00:55 EDT 2008;Committer;akr;1;9;2;11;0
43a3aa5ebf64d78150621de03cb9d5bb45cc1139;Mon Aug 18 07:55:04 EDT 2008;Committer;akr;2;14;1;15;0
8372c16764acdfae376e4ff6af9bb8a6f468d88e;Mon Aug 18 04:22:31 EDT 2008;Committer;akr;2;8;0;8;0
08dcd122354a9f9f86208ea71820fdd1721e64ac;Mon Aug 18 03:47:15 EDT 2008;Committer;akr;2;8;20;28;0
6f1fe004f7090b4ae6defbe10340b3edbee3bcb0;Mon Aug 18 03:13:53 EDT 2008;Committer;akr;3;209;101;310;0
815fd8536b94b12465bbe08868c65119ef63c508;Mon Aug 18 01:40:01 EDT 2008;Committer;akr;3;163;57;220;0
f072d0464fbf53c62878a8217399f73ea4f72256;Mon Aug 18 00:41:54 EDT 2008;Committer;akr;1;19;5;24;0
4c4cb11050ca2ed6cfb45a5af541e786c569cc2a;Sun Aug 17 23:28:45 EDT 2008;Committer;kazu;2;5;1;6;0
3737f9ede13aa94510f18f9793cf8025d9d55d54;Sun Aug 17 21:10:48 EDT 2008;Committer;naruse;2;5;0;5;0
f3a42261fb1e325ab8fde99adcc4722cbb110a18;Sun Aug 17 19:41:39 EDT 2008;Committer;akr;3;49;54;103;0
0b52b491477f9bfc8aeb38612c27d7caca3385ef;Sun Aug 17 17:33:17 EDT 2008;Committer;svn;1;3;3;6;0
d4835a2703fb6f5630cbbcba68180db22d26dfaf;Sun Aug 17 17:33:13 EDT 2008;Committer;gotoyuzo;3;34;3;37;0
0ff4061ef7e3a8ffa681698fa8490740616d1aac;Sun Aug 17 12:54:26 EDT 2008;Committer;akr;3;27;20;47;0
59491ed3b06481a3991aca84aebb5e55e5a12edd;Sun Aug 17 06:58:41 EDT 2008;Committer;nobu;2;4;3;7;0
ccdf3f11628947b28ec3d490227961019f99ad32;Sun Aug 17 06:58:10 EDT 2008;Committer;nobu;4;22;1;23;0
14a87b4f498079b53d51a4b6096545a58090c03c;Sun Aug 17 05:57:49 EDT 2008;Committer;akr;1;21;21;42;0
128abaede677c9b5c885a375f4fc19e6a733172e;Sun Aug 17 04:40:59 EDT 2008;Committer;akr;3;40;0;40;0
0051d4a0778d8b81f22cdcac8a6af52fa567d5fe;Sun Aug 17 04:25:56 EDT 2008;Committer;akr;5;44;1;45;0
04bbc1df1259e70064585dc23bacc7d904063f7e;Sun Aug 17 03:05:40 EDT 2008;Committer;akr;3;88;7;95;0
21b00e0222d742b18f415d65a920e948e293ba45;Sun Aug 17 02:43:20 EDT 2008;Committer;nobu;2;94;81;175;0
067f704f640afdb77be1c7c28c867a53222d7b02;Sat Aug 16 23:40:46 EDT 2008;Committer;naruse;2;9;0;9;0
63daa7c07d6c10c1a47a4578e5fa015760967e84;Sat Aug 16 17:06:35 EDT 2008;Committer;akr;4;105;10;115;0
69f22784f21acb3aaf2f4984d614bc15ca46308b;Sat Aug 16 15:04:43 EDT 2008;Committer;svn;1;3;3;6;0
6acb0e79c810175194d644b2e37bb2bef0e9e972;Sat Aug 16 15:04:39 EDT 2008;Committer;akr;3;58;5;63;0
a4df037ffd5041b2e10857184b1340b7bcbf42ad;Sat Aug 16 09:36:34 EDT 2008;Committer;nobu;1;47;47;94;0
8b2093d3b24225e29e074bbd198e5437f6f613e2;Sat Aug 16 06:43:37 EDT 2008;Committer;nobu;1;0;1;1;0
4dff8b24286e84c1c2a2bd7e422d490327470d26;Sat Aug 16 06:25:38 EDT 2008;Committer;akr;3;27;6;33;0
7a0bea4fd327ec0f572f25a24adc7f0b2f9821e8;Sat Aug 16 05:32:42 EDT 2008;Committer;akr;5;264;244;508;0
5f9c188d978d45cdeb81ec83dfdaddffe1b8996c;Sat Aug 16 00:20:31 EDT 2008;Committer;nobu;22;35;6;41;0
c65dc8c3b1acc07ae0d2d83012a3f353635d7eb6;Sat Aug 16 00:07:46 EDT 2008;Committer;nobu;1;1;0;1;0
38280af4838c6d5fa8fe15aeb8b098b45159b6b1;Fri Aug 15 23:53:07 EDT 2008;Committer;nobu;2;25;0;25;0
a55e167b68d123866b44a14f31411eafdcb56037;Fri Aug 15 23:13:01 EDT 2008;Committer;akr;6;36;0;36;0
aafb3af52b99f5bc708ac4fd033b9a6899f1dacc;Fri Aug 15 16:41:19 EDT 2008;Committer;svn;1;3;3;6;0
c3d0206e04c36eaca9853132fd687264b8b7348f;Fri Aug 15 16:41:16 EDT 2008;Committer;akr;1;8;0;8;0
3a427c61997b513939841dfa1f7b124e9facf6d3;Fri Aug 15 14:17:11 EDT 2008;Committer;akr;3;177;38;215;0
fe091e89b73c62fd3940ff4ca9214e3935de257c;Fri Aug 15 11:02:07 EDT 2008;Committer;akr;3;105;8;113;0
a98587c0fdfc2536e94b320bf4c1b06c6628df03;Fri Aug 15 10:34:06 EDT 2008;Committer;nobu;2;5;1;6;0
7f0c5beb6f53cc057c03c74e15468282b1e52cd5;Fri Aug 15 09:33:59 EDT 2008;Committer;akr;3;14;5;19;0
131e194cec5a36ac18d6c9abcae6aad6ccd5fd1d;Fri Aug 15 09:12:56 EDT 2008;Committer;akr;4;218;16;234;0
d6d2eed78ef765f321b33ebdd2bdd9901dd5a39f;Fri Aug 15 08:39:14 EDT 2008;Committer;nobu;2;6;2;8;0
fa9a533d0baca7b4d6b582d3eb48ef3c5a2f7c84;Fri Aug 15 08:01:17 EDT 2008;Committer;nobu;1;0;8;8;0
1be7c799e6ed39f7ac41906c05db149e8c391add;Fri Aug 15 07:59:33 EDT 2008;Committer;nobu;2;4;1;5;0
3f3a0fcc8e8fa2bfdf06efca7a11ddc88957d170;Fri Aug 15 06:30:43 EDT 2008;Committer;nobu;2;5;1;6;0
e4e2ef3975a1a14e0c360d54f7c8b5578af6dbb0;Fri Aug 15 02:32:47 EDT 2008;Committer;akr;1;20;1;21;0
96ae1f008fa0072730aee64dd8d2cc30badfe69d;Fri Aug 15 00:34:16 EDT 2008;Committer;akr;2;10;4;14;0
8b04d998ae83ffaf59296b28ac3df65fb7c73477;Fri Aug 15 00:27:03 EDT 2008;Committer;akr;1;48;0;48;0
b9d5d6a13751ef0cfae10eff07f2b9fe153c386a;Fri Aug 15 00:18:42 EDT 2008;Committer;akr;1;38;0;38;0
520cd6d186fd0753e052fd153fc2c5b764cb9aee;Fri Aug 15 00:05:06 EDT 2008;Committer;akr;3;53;12;65;0
95af70c5e745f0017d5ee7b73c79d800f0a4f9c2;Thu Aug 14 16:10:57 EDT 2008;Committer;akr;1;1;0;1;0
f9ea6ed5a95057b875c19203276a6c36a6202bbc;Thu Aug 14 16:09:00 EDT 2008;Committer;naruse;2;5;1;6;0
8eda80ff2cde551e22e9a9803e932184aafdbf38;Thu Aug 14 16:06:33 EDT 2008;Committer;akr;3;17;0;17;0
c9453ecc049269a637d5d39daa927fc9b4a462b0;Thu Aug 14 15:56:44 EDT 2008;Committer;svn;1;3;3;6;0
74a36d5d1f17f1529090fb42a405d4677caa567e;Thu Aug 14 15:56:39 EDT 2008;Committer;akr;6;114;49;163;0
e0e39e0db80be635fa68e28dab84966300b4eb29;Thu Aug 14 14:48:41 EDT 2008;Committer;akr;3;43;29;72;0
ed7d1a25cb118de8a1db2c32c5e1e051ac582649;Thu Aug 14 14:35:55 EDT 2008;Committer;akr;2;91;87;178;0
c82aee31b41f0772dd0491c6bfa5cb90b47d0d5a;Thu Aug 14 14:28:10 EDT 2008;Committer;akr;5;135;58;193;0
87779b507e5b845e81e16dc597a989bc6f2183be;Thu Aug 14 13:45:54 EDT 2008;Committer;akr;3;64;57;121;0
a6daaf16b063d0a0870d1ef0e42df1d4338b02f4;Thu Aug 14 12:35:19 EDT 2008;Committer;akr;3;38;12;50;0
d46728ec0e134c47a9cf7b1f63d5a0c88902162e;Thu Aug 14 12:11:14 EDT 2008;Committer;akr;3;12;9;21;0
db30661aa9635d665c8d39592fb18bfb89331410;Thu Aug 14 11:59:47 EDT 2008;Committer;akr;2;7;2;9;0
5a4844ed6ced4c1110b29f38a25be65074671d2f;Thu Aug 14 11:56:55 EDT 2008;Committer;akr;2;4;17;21;0
be51387d55e0b9adf81ddd0d217d2ed05cd29199;Thu Aug 14 11:53:47 EDT 2008;Committer;akr;2;7;1;8;0
bd9bd5295453b4287a4c6190a2b656d2e2a6eec0;Thu Aug 14 11:31:27 EDT 2008;Committer;akr;4;193;175;368;0
dd927511043de7343fbbcac7e8daba95ebf3a2d2;Thu Aug 14 10:42:28 EDT 2008;Committer;akr;2;5;34;39;0
7db5e184c20a2a692a97b6308221d2212a290056;Thu Aug 14 10:38:41 EDT 2008;Committer;akr;1;9;1;10;0
b299bd606b8b927ea6087f9dffc2adbabea826c9;Thu Aug 14 08:58:38 EDT 2008;Committer;nobu;1;2;2;4;0
dc02325fd82602bc9f9e6d1b85b5b03425d6d43f;Thu Aug 14 08:57:07 EDT 2008;Committer;nobu;7;148;108;256;0
c710140216e3fde8130d8a583a1e1c9582be20e9;Thu Aug 14 08:46:23 EDT 2008;Committer;nobu;2;7;11;18;0
f677aae7bc778df3cb1a63ca9313ddb51481d274;Thu Aug 14 08:28:44 EDT 2008;Committer;matz;2;6;0;6;0
0cafe9e4cdc7658e80f6678e2785ebbb8623ca4e;Thu Aug 14 08:19:56 EDT 2008;Committer;matz;2;5;1;6;0
a99e6c15b8b889a133ab37233da1d7fbbb314eff;Thu Aug 14 06:35:33 EDT 2008;Committer;akr;3;59;9;68;0
012c5ca96687944e0fe2af384422acf99f708990;Thu Aug 14 06:27:50 EDT 2008;Committer;nobu;2;9;0;9;0
bcae240f193027289fd37ea2aa8c106ceab6fbaa;Thu Aug 14 06:12:27 EDT 2008;Committer;akr;4;118;8;126;0
2c20dd1473606b598d405f501a9873355abcee75;Thu Aug 14 05:57:58 EDT 2008;Committer;nobu;2;4;1;5;0
914969a0400e4df63d959c45d972d3f58e1ac58c;Thu Aug 14 05:56:51 EDT 2008;Committer;nobu;3;8;4;12;0
0c18a4b0f070f72b7d15f4263caca0085b070973;Thu Aug 14 05:55:04 EDT 2008;Committer;nobu;2;5;1;6;0
86cd6d2e98fcc025601692842d7f6c42f7d748fa;Thu Aug 14 05:14:01 EDT 2008;Committer;nobu;2;17;8;25;0
473dbc4e3fd5de34250f2adba5fb2559706548a9;Thu Aug 14 03:20:38 EDT 2008;Committer;nobu;3;12;4;16;0
a91845f5b3ec726e08501cc6597c1788b223cd41;Thu Aug 14 03:01:42 EDT 2008;Committer;nobu;5;44;6;50;0
0d8df8889342b3d235ffcea209beea5032c9a711;Thu Aug 14 02:45:11 EDT 2008;Committer;nobu;4;6;4;10;0
81be10bd853ed8a502a0a02ea706c9567b469c67;Thu Aug 14 00:40:25 EDT 2008;Committer;akr;1;57;46;103;0
ae8522ff7e6b7d60492644cbe3c1d777ba44d37e;Wed Aug 13 23:45:31 EDT 2008;Committer;akr;1;12;5;17;0
abfd87c2305a0a07bd5958be2282fcc2fa10a639;Wed Aug 13 21:26:49 EDT 2008;Committer;ko1;2;6;5;11;0
7085729de323a2c1570e9ba62a8bb4fa2de8704d;Wed Aug 13 20:38:48 EDT 2008;Committer;naruse;2;8;3;11;0
6bdb909e5fd87dd63d7fc07aa0fab0f52e946596;Wed Aug 13 17:47:42 EDT 2008;Committer;kazu;1;1;1;2;0
efdcaba2102ffbb0e3ad91b67ccb4fcd2569f6a0;Wed Aug 13 17:46:47 EDT 2008;Committer;kazu;2;6;0;6;0
fd6ad3b734933c663dbc775e0ae09cfaddcb3924;Wed Aug 13 17:45:08 EDT 2008;Committer;kazu;1;18;18;36;0
fde26b7d7abc6c17debe3e293ca9346a6110aa62;Wed Aug 13 17:24:42 EDT 2008;Committer;akr;3;112;49;161;0
e6eb8f0399a2c004ea2d3cc84e14c67fa790d299;Wed Aug 13 15:49:30 EDT 2008;Committer;nobu;1;3;1;4;0
3622cd196ca292167f05f15e1b2d993852454c4b;Wed Aug 13 15:43:55 EDT 2008;Committer;nobu;3;31;16;47;0
ca3c54c0ee3db935413b4ba70e58b15940c385fe;Wed Aug 13 15:04:28 EDT 2008;Committer;nobu;1;3;3;6;0
6733142c7184d5d422d09ded655575ac4ebe9d3f;Wed Aug 13 14:42:55 EDT 2008;Committer;nobu;2;32;24;56;0
31ad92b2f3829002aabfe27b0b4cb8dc237c03d8;Wed Aug 13 14:22:48 EDT 2008;Committer;shugo;2;7;1;8;0
cdc2278f890c7e9715b2b8cb7d7cdbdfd4200b8b;Wed Aug 13 14:09:48 EDT 2008;Committer;kouji;2;7;2;9;0
96af71a288ef97800b658b4d0cda7ce83f3f95be;Wed Aug 13 10:42:57 EDT 2008;Committer;ko1;2;10;7;17;0
38c94fa149554b354b4a25c003cae046ede7a596;Wed Aug 13 09:42:22 EDT 2008;Committer;shugo;2;5;0;5;0
9adfb3066db1b78355c810448bf451a10efe4d4a;Wed Aug 13 08:47:57 EDT 2008;Committer;akr;2;22;0;22;0
8d4086d77366501d0c04f2b36303d3e7dfd2bcb0;Wed Aug 13 08:44:17 EDT 2008;Committer;matz;2;38;0;38;0
3e7d8bf9f8bbdaad4f36819f14fb5c4cf2ea9d35;Wed Aug 13 08:36:47 EDT 2008;Committer;akr;2;11;9;20;0
e0889dbf3882f006b5cef6680afd43e817a1a63e;Wed Aug 13 08:32:53 EDT 2008;Committer;matz;2;6;1;7;0
5068e137d059a67878fbc8618a0a3cf9bd616ad6;Wed Aug 13 08:30:21 EDT 2008;Committer;knu;2;12;32;44;0
04f7390ca828ee6c2482036b0d6834ca6d86ded9;Wed Aug 13 08:28:39 EDT 2008;Committer;akr;3;106;35;141;0
8f1e7a37e520fd1b105bec102cb05d2b49acf4a2;Wed Aug 13 08:21:24 EDT 2008;Committer;ko1;4;25;2;27;0
d4b7cc796cfbc8224a387d4e906ce1e3908f4970;Wed Aug 13 08:03:30 EDT 2008;Committer;knu;8;20;9;29;0
16612b360b376d0cb3f50f966e2e671cf80fdc25;Wed Aug 13 07:53:35 EDT 2008;Committer;ko1;6;59;2;61;0
81719aff65dba5b72d14ad39eb851301bfd995a3;Wed Aug 13 07:32:34 EDT 2008;Committer;akr;1;88;0;88;0
f433d710d0ab3b367cc4a851cdfb81c5405bb7f8;Wed Aug 13 07:25:05 EDT 2008;Committer;shugo;23;369;93;462;0
55c141c6247a4d8c052c0d57f59ddaa29e3e523a;Wed Aug 13 07:14:56 EDT 2008;Committer;naruse;4;34;26;60;0
090004886d24023af8fa32e3fe589340b31eb72c;Wed Aug 13 07:13:27 EDT 2008;Committer;matz;2;16;1;17;0
0d242ac61a3a55e82a417d30940d2cc63148a822;Wed Aug 13 06:53:24 EDT 2008;Committer;knu;2;6;1;7;0
7b8e762afa1118c1758637a40277bc04206ab98e;Wed Aug 13 06:25:53 EDT 2008;Committer;knu;2;12;7;19;0
5f5b25d234e88079810e79172d25f9510456ec44;Wed Aug 13 06:15:52 EDT 2008;Committer;knu;2;7;2;9;0
4aa251999d88642e0b58a9e1d2060b8f219fd299;Wed Aug 13 06:08:56 EDT 2008;Committer;akr;3;31;14;45;0
8cb7595f7e123cb02d31bc6f91fdae7d14136a17;Wed Aug 13 05:56:33 EDT 2008;Committer;knu;2;82;35;117;0
3785eb7772014bdcd8585395b5338ded0c9b9bc5;Wed Aug 13 05:54:30 EDT 2008;Committer;akr;1;1;1;2;0
279e612973e36f167d3c431e742c2bcc5564162d;Wed Aug 13 05:53:20 EDT 2008;Committer;akr;1;4;4;8;0
a14d5eb09bc791b7ada7897a8fdb6a243babbb78;Wed Aug 13 05:48:57 EDT 2008;Committer;akr;4;72;2;74;0
74a2a7bdbfbf70febab024354fe0b7fb26300704;Wed Aug 13 05:30:42 EDT 2008;Committer;akr;5;137;23;160;0
ab0ee1d5e98183e0994765352998b5543cd7f02f;Wed Aug 13 05:00:26 EDT 2008;Committer;nobu;4;35;40;75;0
cc77f676f4a386479b6457e11993b9933412022c;Wed Aug 13 04:49:37 EDT 2008;Committer;ko1;2;61;42;103;0
eaa1bcab351e3d5e835a69687aff8dbee007bb1d;Wed Aug 13 04:09:15 EDT 2008;Committer;nobu;4;19;10;29;0
7fe95731a811ed3b8775eefe0f7da5e6bec4db93;Wed Aug 13 02:46:54 EDT 2008;Committer;knu;2;5;0;5;0
e9ebe1a16134046de49af460ca3bff3c0b98d7e7;Wed Aug 13 02:40:24 EDT 2008;Committer;akr;2;108;59;167;0
7caecdbe384b5fe6f2012a66a5dda83f08c122c3;Wed Aug 13 01:45:35 EDT 2008;Committer;nobu;2;12;3;15;0
4e15017783987d0f5fce05183cd810c48c720fad;Wed Aug 13 01:25:40 EDT 2008;Committer;kouji;2;12;0;12;0
5501d84ceb8ca479d06197d196989d41b39c61ee;Tue Aug 12 23:03:46 EDT 2008;Committer;akr;3;20;11;31;0
9d4bb3b969799e314197c70b3e33223564258bc8;Tue Aug 12 22:43:17 EDT 2008;Committer;akr;3;69;31;100;0
85c41f4fbcd58d3515a02d639f6e18b658c09034;Tue Aug 12 18:17:05 EDT 2008;Committer;naruse;6;63;44;107;0
fc6484cbf445bfaeb1b68fb48ee5dc72731ac564;Tue Aug 12 17:37:47 EDT 2008;Committer;naruse;3;9;5;14;0
edcd02cb5a2603ab549dae322974ed9d528e22db;Tue Aug 12 14:46:18 EDT 2008;Committer;akr;3;124;0;124;0
c523f6f15e9c5012a6f6c81d4e40302294be963a;Tue Aug 12 14:16:43 EDT 2008;Committer;akr;2;5;1;6;0
12096f588feb3e2ee08509bb921f2fde1703cc47;Tue Aug 12 10:11:11 EDT 2008;Committer;nobu;2;65;28;93;0
f65719e5c66f5db60c17e87540e886e7b3f92521;Tue Aug 12 10:08:48 EDT 2008;Committer;nobu;3;4;4;8;0
26bc383ef8fd3b0a7b210bcfe0bd3bbccdee212b;Tue Aug 12 10:07:08 EDT 2008;Committer;nobu;3;39;0;39;0
8938f611f065e8ec77a64c438d76fe0b33a956f3;Tue Aug 12 10:00:34 EDT 2008;Committer;nobu;1;2;3;5;0
596eecd76d28ad02039462b3d090615ed7fb01e2;Tue Aug 12 09:59:06 EDT 2008;Committer;ko1;3;45;40;85;0
456dc8bceec09a954aa0ea8f575f63c66ffb4e80;Tue Aug 12 09:56:55 EDT 2008;Committer;nobu;3;76;30;106;0
741cc678003a82df9afaca60c8027f84170460bb;Tue Aug 12 09:55:06 EDT 2008;Committer;kouji;2;25;0;25;0
608cb2ed32549cb7fd8fa33033c3482d1465acfc;Tue Aug 12 09:51:42 EDT 2008;Committer;akr;2;5;0;5;0
5643c0d69a4df96dfe5bbf1ade833dd928a6649a;Tue Aug 12 09:47:49 EDT 2008;Committer;matz;2;6;1;7;0
79cd32fe3b49ef8830ce78e9ca02eb680c53318f;Tue Aug 12 09:43:44 EDT 2008;Committer;akr;2;5;1;6;0
6d87cec02ce763dd1c26b3ba026056c037d67704;Tue Aug 12 09:42:49 EDT 2008;Committer;akr;3;33;14;47;0
d04cc54add30205e99848f9a44e08fd35efc133f;Tue Aug 12 09:35:12 EDT 2008;Committer;knu;2;10;6;16;0
6885f3b708d053ed69a19cece8e4b67ab163a061;Tue Aug 12 09:25:19 EDT 2008;Committer;matz;2;6;1;7;0
7464de7e8b135410b9f5f502749c634a5b063cb1;Tue Aug 12 09:23:19 EDT 2008;Committer;knu;1;3;0;3;0
e6058393555f5918438fe91dc46fc585020ae6d9;Tue Aug 12 09:12:24 EDT 2008;Committer;matz;2;10;2;12;0
abef7fa890df87d69e38311b7d0626d790a396aa;Tue Aug 12 08:17:27 EDT 2008;Committer;akr;2;9;1;10;0
5b3278b74a1a7edb0885b0ccbfe86ab8f3a53813;Tue Aug 12 07:24:30 EDT 2008;Committer;nari;2;18;17;35;0
5ade93542fd9ee1a11515a2fa885f2cf822833d2;Tue Aug 12 07:20:10 EDT 2008;Committer;akr;5;53;38;91;0
47c8401c5a3196b8e7ab65bce2cdad14edf6c08d;Tue Aug 12 07:09:08 EDT 2008;Committer;aamine;2;7;0;7;0
076b6a226f158e51a6683129954192537f2e3e0c;Tue Aug 12 07:06:33 EDT 2008;Committer;nobu;3;12;6;18;0
e2159ba730c387248a051f8744ac95134fcfa79d;Tue Aug 12 07:03:23 EDT 2008;Committer;nobu;1;1;1;2;0
fccc094568069e040e08ab6c8a87dbbb7712eb31;Tue Aug 12 07:02:04 EDT 2008;Committer;nari;2;24;17;41;0
71553b91f64288e5e9996a143685bf4697819d84;Tue Aug 12 06:39:08 EDT 2008;Committer;matz;2;21;2;23;0
00b129c4e41bf017e0fec3b43ba684f3fa303f7e;Tue Aug 12 06:32:50 EDT 2008;Committer;aamine;2;6;1;7;0
6d8c1483d604296a8181431f9a000112356ea163;Tue Aug 12 06:19:00 EDT 2008;Committer;usa;2;6;1;7;0
fa9ef4bf0023e540ec95997b45b542eb49c22c74;Tue Aug 12 06:17:48 EDT 2008;Committer;kouji;2;7;0;7;0
13f1418d546c3d498dcd826e82e262befdd1d9c3;Tue Aug 12 05:25:14 EDT 2008;Committer;nobu;5;53;16;69;0
ae04e36638f6f3ada402b12b9994ec404c26b184;Tue Aug 12 05:20:09 EDT 2008;Committer;aamine;2;10;1;11;0
08795f9cebf686f6caa2cd7f4791cc6b9ed8a78b;Tue Aug 12 05:18:22 EDT 2008;Committer;aamine;1;5;0;5;0
3c1fca24e2e6fc695711838a8f681132ad7bdbca;Tue Aug 12 05:15:18 EDT 2008;Committer;nobu;2;6;2;8;0
0bf6ed0fc8d7871531d44d238aa1a734667c300f;Tue Aug 12 05:08:51 EDT 2008;Committer;nobu;1;1;1;2;0
c2e85dfa8fe2531b40c097c649b3e72f676b657a;Tue Aug 12 04:35:13 EDT 2008;Committer;matz;2;7;2;9;0
61f512a3575df2ca3c894c426d47cdc27ca8d4fd;Mon Aug 11 22:49:15 EDT 2008;Committer;akr;1;11;0;11;0
94ca2d94deca939e6e50c09705873eb89c6012aa;Mon Aug 11 22:44:23 EDT 2008;Committer;akr;6;80;27;107;0
5f9b877ebe2d3d53ec44df57aef982c5ae592a7f;Mon Aug 11 22:21:15 EDT 2008;Committer;akr;2;31;20;51;0
c1361132bcf4dcd21d93bb51c5a61f9535280420;Mon Aug 11 22:00:48 EDT 2008;Committer;akr;2;9;3;12;0
425098de96b3b51bdb99090eef39134867ba32ca;Mon Aug 11 21:49:38 EDT 2008;Committer;akr;3;21;4;25;0
53fddace544b5302237b86ebeee6c1440f42beb5;Mon Aug 11 15:50:47 EDT 2008;Committer;svn;1;3;3;6;0
a2901a7c75b572d806a6720b37babd566d15e5ba;Mon Aug 11 15:50:42 EDT 2008;Committer;akr;4;297;127;424;0
96765d153f5d277734c7cc9ace394edd9299576e;Mon Aug 11 11:39:09 EDT 2008;Committer;matz;2;7;0;7;0
199a95775b4f0e8d7ecab2946b8d7c250a695f40;Mon Aug 11 11:33:44 EDT 2008;Committer;matz;4;30;8;38;0
35b6abbca2cb419aae599d04e5855e33a97935dd;Mon Aug 11 11:11:27 EDT 2008;Committer;nobu;2;34;26;60;0
9295fd4b5978dbb51aabc3981a245aacd7ffcac5;Mon Aug 11 10:00:47 EDT 2008;Committer;matz;3;47;11;58;0
130e72025328746295d2efe45a6856f8d9ff154b;Mon Aug 11 09:36:57 EDT 2008;Committer;nari;2;343;0;343;0
c5579a833d51c7d066d833067ac7384f750c3112;Mon Aug 11 09:16:28 EDT 2008;Committer;kouji;1;1;1;2;0
aa2a222f9c515d4221f07510723385ad03ae4d21;Mon Aug 11 08:31:45 EDT 2008;Committer;kouji;5;105;0;105;0
e956f28724a40de9b51b8d049e259af96dc738d5;Mon Aug 11 08:13:42 EDT 2008;Committer;matz;4;60;15;75;0
5898c07466e097955e9519d576c90486c5410cfb;Mon Aug 11 07:58:02 EDT 2008;Committer;kouji;2;134;8;142;0
2897632f163143e03f83ba47d2611c3357974c36;Mon Aug 11 07:39:52 EDT 2008;Committer;akr;13;630;612;1242;0
36dd9a222113b361492dc82a736a001f138f300a;Mon Aug 11 06:11:55 EDT 2008;Committer;akr;2;11;5;16;0
cc0114b6d0cec99dee5f71f466a3bdb333437af2;Mon Aug 11 01:06:25 EDT 2008;Committer;svn;1;3;3;6;0
bd5bf3726cd33ac084b54858edbeb3d17c29076e;Mon Aug 11 01:06:21 EDT 2008;Committer;akr;3;41;33;74;0
badd9f1efca296be0f1dce0491f8c7662434da5f;Sun Aug 10 13:37:44 EDT 2008;Committer;akr;2;23;31;54;0
4d763fb8eedb279cb8ccd1e6757ca94f9ac2d7f2;Sun Aug 10 13:25:34 EDT 2008;Committer;mame;3;8;1;9;0
436a136b4e2b983fb4875ccca466278461e0d7e3;Sun Aug 10 12:26:01 EDT 2008;Committer;akr;3;125;61;186;0
30e90a335d15a0b7766ea0f0c981a523d5ba0be8;Sun Aug 10 09:10:58 EDT 2008;Committer;akr;2;11;2;13;0
aa9457762f46fd85022130538fe962166147b886;Sun Aug 10 03:34:44 EDT 2008;Committer;nobu;2;11;2;13;0
2be9ae2f13661b10677e1eb4158b39a5da3bc02a;Sun Aug 10 03:29:21 EDT 2008;Committer;nobu;3;549;363;912;0
de0a9f726e49f6e97fd0d175675971a04e8c43de;Sun Aug 10 03:15:37 EDT 2008;Committer;nobu;2;21;21;42;0
e3d9fc76e62c8a1857abdafda948ff7d2918cfc8;Sun Aug 10 02:45:18 EDT 2008;Committer;nobu;4;17;4;21;0
2ce7aeca6edf4610d6b1d890fbe659379b4b8f9f;Sun Aug 10 02:33:05 EDT 2008;Committer;akr;2;100;96;196;0
e748ed513d1fc079513a3ae9905705f579d351a4;Sun Aug 10 02:17:56 EDT 2008;Committer;akr;3;69;10;79;0
3ba7984ef4dfc88c7a764a24dd50aad026a7b56d;Sun Aug 10 02:03:01 EDT 2008;Committer;nobu;3;6;1;7;0
50c241002a8d26d6e5ad376e286c1dff4471df10;Sun Aug 10 00:35:14 EDT 2008;Committer;nobu;2;6;1;7;0
b2718506adec191767a127ed0039f6c194d70a4f;Sun Aug 10 00:23:36 EDT 2008;Committer;akr;2;34;35;69;0
bdcb8fd07e7e4aa6097b402b9f0986e756d20308;Sat Aug 09 23:56:17 EDT 2008;Committer;nobu;3;6;3;9;0
94dc1e0b4ad27327beae4ff7e07e674ceb0a3fe9;Sat Aug 09 23:33:37 EDT 2008;Committer;akr;2;92;93;185;0
1bca9ada544813617b250d4b14572ceb5db1541b;Sat Aug 09 23:15:14 EDT 2008;Committer;svn;1;3;3;6;0
a64266a72837c350ac6552ac5cb14591b5cb2b05;Sat Aug 09 23:15:08 EDT 2008;Committer;nobu;8;32;17;49;0
0e3d10173bec301c075555e20a0fc1da853ab35c;Sat Aug 09 13:34:21 EDT 2008;Committer;akr;3;30;17;47;0
a596f3a7e600807f07d11ad6e20009f941f1216e;Sat Aug 09 12:41:50 EDT 2008;Committer;naruse;2;5;1;6;0
cf7ad7e057f675e9c0d638180b59e7d9d869dd41;Sat Aug 09 12:10:54 EDT 2008;Committer;nobu;2;17;31;48;0
b9d3995310ecb42f3cfd062e8e507d2c886501ee;Sat Aug 09 10:32:02 EDT 2008;Committer;akr;2;93;92;185;0
4bceda1125242d365558d6c870215c8e2125e29a;Sat Aug 09 07:35:28 EDT 2008;Committer;akr;3;33;10;43;0
ca3dd2d89e41234f112d23c706ad9151e6b73aad;Sat Aug 09 06:25:05 EDT 2008;Committer;akr;2;13;8;21;0
139234e1a091ac3167d3bebdfcd29b3952665334;Sat Aug 09 06:02:01 EDT 2008;Committer;akr;6;438;81;519;0
750cb61e65f35feb70ad855ab3353485cfd75b0c;Sat Aug 09 04:35:13 EDT 2008;Committer;nobu;2;8;2;10;0
1727355a22b16cd5a7e60ef995ff4277362ea0a1;Fri Aug 08 21:37:43 EDT 2008;Committer;nobu;3;7;0;7;0
94342f89f9b0139210f9b1ceb0952073090d850a;Fri Aug 08 16:12:03 EDT 2008;Committer;akr;1;7;0;7;0
6db9e77e64d41da7080b937322775813c58ba72e;Fri Aug 08 16:08:50 EDT 2008;Committer;akr;2;50;1;51;0
fbe9c1026d4b4ef9a1f115c928a84962b31b1270;Fri Aug 08 15:48:22 EDT 2008;Committer;svn;1;3;3;6;0
2833d9f95d076c09d7a4ba6b3f8ba26d33d56ef7;Fri Aug 08 15:48:17 EDT 2008;Committer;akr;7;109;68;177;0
a456f022fc22182db58a7a32b21440af2c6ca0c5;Fri Aug 08 14:30:05 EDT 2008;Committer;nobu;2;4;2;6;0
90ca8317d37d3f649e9ec52ce01b1003194c70ac;Fri Aug 08 14:27:25 EDT 2008;Committer;nobu;2;5;1;6;0
6a852b7c2b46faa1876763e46e1847cbab77b071;Fri Aug 08 13:47:48 EDT 2008;Committer;nobu;3;12;1;13;0
e6a8cc7e2bee761f0b9ab86b4888b1ae8cf2a0f2;Fri Aug 08 12:10:15 EDT 2008;Committer;naruse;2;5;1;6;0
8569904ac4ac839f550638211862a688c23a4d8a;Fri Aug 08 08:04:15 EDT 2008;Committer;nobu;1;7;0;7;0
1c22ef17053e096c18ed34e9772073c57ad3a7b5;Fri Aug 08 08:03:19 EDT 2008;Committer;nobu;4;31;21;52;0
b68b9ec6987acc0198124e5997f649ecd7f75dc7;Fri Aug 08 07:52:57 EDT 2008;Committer;nobu;2;4;2;6;0
22931710346d6e7fe292b77bb323bff6daf6c51a;Fri Aug 08 07:44:42 EDT 2008;Committer;nobu;3;14;7;21;0
62914a120961356a67a65c8ec0a3742c17ca0aec;Fri Aug 08 07:17:27 EDT 2008;Committer;nobu;1;1;1;2;0
b917553e684c685d4aba90e1b8f0a655fdd7773a;Fri Aug 08 07:15:52 EDT 2008;Committer;nobu;3;47;37;84;0
2f37e03736cb4eabc5b94544a4d1d80adf9f2f90;Fri Aug 08 07:09:03 EDT 2008;Committer;nobu;2;5;2;7;0
73d3ff007478b7e62316afd870b73d10a96a9ffe;Fri Aug 08 07:03:35 EDT 2008;Committer;nobu;2;8;0;8;0
2577fa6dccd454fe92009b306af212e7e73bf906;Fri Aug 08 01:58:40 EDT 2008;Committer;akr;3;169;119;288;0
b41a687fe6ba9e2dd898df98018ba59450376603;Thu Aug 07 19:24:47 EDT 2008;Committer;naruse;3;25;17;42;0
c6d05a63c689dd162c92dc73188a8ba041fef6bc;Thu Aug 07 15:06:41 EDT 2008;Committer;svn;1;3;3;6;0
fedc035ab81eee9ae814cb6865e34eac6afb58c0;Thu Aug 07 15:06:36 EDT 2008;Committer;kouji;5;422;66;488;0
1504652373a16c8e7eb5d59894c83572ac72b5e7;Thu Aug 07 14:53:30 EDT 2008;Committer;akr;8;432;341;773;0
05373c446902ace063b1ff5caf2236004e7bc763;Thu Aug 07 13:58:04 EDT 2008;Committer;kouji;2;380;35;415;0
16a24188cdfa81da007b0958f9dc1bf7c0778215;Thu Aug 07 11:55:13 EDT 2008;Committer;shugo;2;7;0;7;0
0ff8385bf437b346e76b860c6d8a0161fe68c778;Thu Aug 07 10:40:36 EDT 2008;Committer;kazu;1;1;1;2;0
4c6321a1f7b5c66f7917d266fc0230255b8faedd;Thu Aug 07 09:06:04 EDT 2008;Committer;akr;1;1;1;2;0
3f91366caf89e4446836a3953162b8152cc6714e;Thu Aug 07 09:04:27 EDT 2008;Committer;knu;2;7;1;8;0
380e558f33009d39b6bd85aeb619f8326463472b;Thu Aug 07 08:47:58 EDT 2008;Committer;nobu;3;7;2;9;0
2ce5ff1ac1f24f53d713090a54e959d18b3c5f7b;Thu Aug 07 07:28:56 EDT 2008;Committer;nobu;5;33;8;41;0
fa3283c7ba24ef0595bd05cd88551c617e83d711;Thu Aug 07 05:17:34 EDT 2008;Committer;nobu;2;38;16;54;0
eab4f197312bdd02a5871ee21c301c882d675368;Thu Aug 07 05:16:27 EDT 2008;Committer;nobu;4;12;4;16;0
c73a2030400df46fb60c2cc32f5e031311d2ea82;Thu Aug 07 04:14:25 EDT 2008;Committer;usa;2;7;2;9;0
99e1e0f208a6c328494b11bdde29e074f7abba7f;Wed Aug 06 21:37:41 EDT 2008;Committer;naruse;1;1;1;2;0
38751ad9ae0d49e57d06a637b140fe05ca6a6020;Wed Aug 06 21:33:24 EDT 2008;Committer;naruse;2;6;0;6;0
16ea66221c31176479c437a703b951817b529f5d;Wed Aug 06 21:07:36 EDT 2008;Committer;naruse;2;11;0;11;0
48e21d2051ea39b073c204f0359e2778ab9660e2;Wed Aug 06 20:52:44 EDT 2008;Committer;naruse;12;77;12;89;0
403d0334c16d9f854ef1ae97de1ae76cfe26fd7c;Wed Aug 06 20:44:31 EDT 2008;Committer;naruse;2;6;1;7;0
ec85af49550d968445ed8158db7c2dee86cd7561;Wed Aug 06 20:19:25 EDT 2008;Committer;naruse;2;7;2;9;0
420e61cf0ba7712026a48092fa215b5c035442a7;Wed Aug 06 20:17:55 EDT 2008;Committer;naruse;2;8;0;8;0
d8353d6b6e600f464f15529b0c9da225de7cdd3d;Wed Aug 06 20:06:05 EDT 2008;Committer;nobu;2;26;14;40;0
508b170dcd07c2bb1e9e1cb641451915fbeba024;Wed Aug 06 19:44:50 EDT 2008;Committer;naruse;3;11;7;18;0
e22b3b773dfda0c1136c11d25376587c5fce60f9;Wed Aug 06 13:42:21 EDT 2008;Committer;akr;3;13;16;29;0
7d072e2ba4c318fdd97bfcd093e160efdb8dc03d;Wed Aug 06 12:25:47 EDT 2008;Committer;nobu;2;15;0;15;0
a016b30844683df63fcb85387e6d01b49732351c;Wed Aug 06 11:57:32 EDT 2008;Committer;akr;2;6;1;7;0
faf2541c2be5e8438675a17002c8c9d4484f572c;Wed Aug 06 11:48:30 EDT 2008;Committer;nobu;3;28;20;48;0
5adb2479140a19ea446cd46f8059d9f0306ff562;Wed Aug 06 11:47:14 EDT 2008;Committer;akr;3;127;119;246;0
fc841ddc66b49367f30c5b872a03a7cca7802722;Wed Aug 06 11:44:08 EDT 2008;Committer;akr;1;0;1;1;0
45428f22577b74510b055347cb236afc1096daff;Wed Aug 06 11:43:37 EDT 2008;Committer;akr;1;6;0;6;0
8db17b30d631b5914769aceb23f56ee832742853;Wed Aug 06 05:40:13 EDT 2008;Committer;nobu;4;15;7;22;0
ce074dcf425ad93fea65114288918cbb708e05f5;Wed Aug 06 05:04:36 EDT 2008;Committer;usa;2;5;1;6;0
5d457380c2974987f4b4f09aed9ea7fc01694f7b;Wed Aug 06 04:56:48 EDT 2008;Committer;usa;1;6;0;6;0
19e2cdbd47a9124d48c9fd4f2abf7b496ba34aa5;Wed Aug 06 04:55:39 EDT 2008;Committer;usa;2;2;1;3;0
2ec44b3d7fa5ac2f76180cbae9f45853cec13036;Tue Aug 05 23:00:01 EDT 2008;Committer;akr;2;5;1;6;0
e90dd02529bbaa35890750722ecb0d716c2f698b;Tue Aug 05 22:47:44 EDT 2008;Committer;akr;3;25;9;34;0
3af2559d17bbd5b77689440d2e54c905c6cd91aa;Tue Aug 05 21:55:23 EDT 2008;Committer;nobu;2;24;5;29;0
c97a8423911be84bf4de58cd5f7c8cafdc795273;Tue Aug 05 20:31:59 EDT 2008;Committer;nobu;2;23;19;42;0
29732ed8f2cd897993e55435761a3952cca168eb;Tue Aug 05 20:26:45 EDT 2008;Committer;nobu;2;29;14;43;0
f1ff09fbf62a1db3991efef5c1d0e53feffdfb6b;Tue Aug 05 20:08:33 EDT 2008;Committer;nobu;4;12;4;16;0
0031e09170af64ff0d6ad34cc7cfefbeb6df74f2;Tue Aug 05 18:56:42 EDT 2008;Committer;nobu;7;25;55108;55133;0
11d6d904249a2a3ad29806833b468801a43566af;Tue Aug 05 18:15:57 EDT 2008;Committer;svn;1;3;3;6;0
82e89f1237212ea06c05f10334425b3c3ed3d3b3;Tue Aug 05 18:15:52 EDT 2008;Committer;nobu;3;25;1;26;0
f694ec83e885f273ac4e0535d7f9e5e1ed9a70be;Tue Aug 05 12:32:13 EDT 2008;Committer;akr;30;70745;40380;111125;0
81577c26ee741b69b1a5e7215eca9b4b0b3092bf;Tue Aug 05 09:04:13 EDT 2008;Committer;kazu;2;10;1;11;0
1498b668d2f8dc4eef3254dbdb2eb015a271fcf2;Tue Aug 05 07:42:45 EDT 2008;Committer;shugo;2;8;3;11;0
5133fc67a43b5a6d6b4dd934752ec8b8d6d85b33;Tue Aug 05 07:39:21 EDT 2008;Committer;nobu;6;29;24;53;0
49f7b3e8d1c45dd99970dd91472543bb7fb157b7;Tue Aug 05 07:24:48 EDT 2008;Committer;shugo;2;9;2;11;0
9a7def6ea9d47f6d9cb892bb4d4bb45a615b2a7b;Tue Aug 05 05:19:45 EDT 2008;Committer;nobu;2;11;9;20;0
f2aa0e5b0c0fb80f9400fae1bdc2bfccedbc314b;Tue Aug 05 03:44:09 EDT 2008;Committer;nobu;2;22;5;27;0
b84d31c524093f91932813a09853ab417f121dff;Tue Aug 05 03:34:52 EDT 2008;Committer;nobu;4;59;45;104;0
a15be57be75841e84e57894423e3cc974011f146;Mon Aug 04 18:30:01 EDT 2008;Committer;svn;1;3;3;6;0
a58e3d763b6429df710c2f3a6dd38e7339ec581e;Mon Aug 04 18:29:55 EDT 2008;Committer;nobu;5;65;17;82;0
e3707541890c1d679b8bc8e319980667e6ed2bd6;Mon Aug 04 11:44:41 EDT 2008;Committer;yugui;4;59;9;68;0
b49106dfd76d9db5cf34f795f8c89639f40e9b2f;Mon Aug 04 10:21:46 EDT 2008;Committer;nobu;3;10;1;11;0
bcf9324e68d062efcfbeb126fbb318a5433c6ba4;Mon Aug 04 08:37:48 EDT 2008;Committer;nobu;2;16;2;18;0
8d0fdce46802b6c4031da3317711e899caa8432f;Mon Aug 04 07:48:52 EDT 2008;Committer;nobu;2;49;14;63;0
76ef6fa16b7c6ec128bf05741ca2844163ed9409;Mon Aug 04 05:46:53 EDT 2008;Committer;shyouhei;2;7;1;8;0
efa2ce2d5b932c29f0a59ceddfae355537583afd;Mon Aug 04 05:09:02 EDT 2008;Committer;svn;1;3;3;6;0
3916eb783c3154f62b4c2d7d6a7b88c656281822;Mon Aug 04 05:08:57 EDT 2008;Committer;nobu;5;16;7;23;0
e231d67ee1e9fefaf51ccebb10164b184f32440f;Sun Aug 03 10:43:44 EDT 2008;Committer;suke;4;63;5;68;0
da4d9e03622f932f8b303d1e869a3f2c2fa438a2;Sun Aug 03 01:42:01 EDT 2008;Committer;svn;1;3;3;6;0
351fbaf0f76f1a73edfb6434ee7cdfae9c27238d;Sun Aug 03 01:41:56 EDT 2008;Committer;nobu;2;9;4;13;0
9b47469a25939ec7071621cc6dffbe38a28e4710;Sat Aug 02 13:59:43 EDT 2008;Committer;suke;2;17;3;20;0
b951952b40c28655dfc973c960ab594f017d269f;Sat Aug 02 06:51:53 EDT 2008;Committer;nobu;2;8;1;9;0
4de6475690f685e9003df1d53bb099340186db8a;Fri Aug 01 16:26:23 EDT 2008;Committer;naruse;2;7;2;9;0
d2af17dd727ba0caab77d9573de6f0015bbb3353;Fri Aug 01 15:04:42 EDT 2008;Committer;svn;1;3;3;6;0
7eb66d1c7b982e0888b25423ad732ea3effff18e;Fri Aug 01 15:04:37 EDT 2008;Committer;kouji;4;386;6;392;0
95cd2c11b994cd20f0a23c340127b0a424e24bdf;Fri Aug 01 14:29:25 EDT 2008;Committer;naruse;2;10;0;10;0
f1af3aed0171d100a9fcb26ed1d1b1527cb42b88;Fri Aug 01 14:27:21 EDT 2008;Committer;yugui;3;30;0;30;0
4fc3ef70e1c7aa44adf78a6346acd5d001f1cf0f;Fri Aug 01 14:17:21 EDT 2008;Committer;naruse;2;16;0;16;0
35bac2083c9bbf9dc6b7cb83c75749a91ad445b3;Fri Aug 01 14:03:14 EDT 2008;Committer;naruse;2;9;5;14;0
8a43d162722bf84a0e57f5864e4d3e0b14f48464;Fri Aug 01 12:50:17 EDT 2008;Committer;mame;2;38;0;38;0
57b9e18d71b50a707d4bc962d8ffabac0e83a18b;Fri Aug 01 12:36:39 EDT 2008;Committer;mame;2;13;2;15;0
893009f8b8e0c9509b54bd074440dfd6844e01df;Fri Aug 01 12:30:25 EDT 2008;Committer;mame;2;8;1;9;0
143b3339e621a54c0ec3de982b299a7d805304b3;Fri Aug 01 12:26:56 EDT 2008;Committer;naruse;2;34;7;41;0
20486a7f64e0e35797c77ee19b3b05ad14d3d6cf;Fri Aug 01 09:38:50 EDT 2008;Committer;yugui;3;32;5;37;0
c6fb433c3f34172e438d17885cb688ca57ce3518;Fri Aug 01 05:54:45 EDT 2008;Committer;nobu;2;5;1;6;0
00aef398d06eccb9c0f5525d25800b6634cab3db;Thu Jul 31 20:35:35 EDT 2008;Committer;naruse;3;53;18;71;0
f3730b826025f4ab28b13b7289dddf6acd4772f6;Thu Jul 31 16:02:18 EDT 2008;Committer;mame;2;9;2;11;0
e40f25ae3646aa6bc6245e241d6c8396e0c97a03;Thu Jul 31 15:44:55 EDT 2008;Committer;svn;1;4;4;8;0
e4416992d80bcfa1c1727832c07ecece5f5934ab;Thu Jul 31 15:44:51 EDT 2008;Committer;mame;2;22;0;22;0
9de7bcff88b3337a76bd21c6552f39cd4c12115f;Thu Jul 31 13:18:10 EDT 2008;Committer;mame;2;8;1;9;0
a4077a65dee8c046821942a2ec9d6d639d7c23fc;Thu Jul 31 11:08:04 EDT 2008;Committer;naruse;2;8;3;11;0
931ba3f3b7cc4bff8a8bcc11c82c581472f17a55;Thu Jul 31 10:59:39 EDT 2008;Committer;naruse;3;22;14;36;0
97fdfbacec882b9b90eda89a2aeded0faedc3ef8;Thu Jul 31 08:12:08 EDT 2008;Committer;naruse;2;9;4;13;0
31a0672306678a826bbed285e0e75d8aad100d10;Thu Jul 31 07:39:41 EDT 2008;Committer;naruse;2;6;2;8;0
0469c8d95b93e131814c9a4014eac05bc9570d98;Thu Jul 31 06:12:13 EDT 2008;Committer;duerst;2;63;0;63;0
84fd4181fcbc28ca92f9f62c5cb50ffad4cdb3c0;Thu Jul 31 04:19:01 EDT 2008;Committer;mame;2;6;1;7;0
1c30bc4cca5a3f02f42f1c857c0ee74bb13a2d09;Thu Jul 31 03:23:55 EDT 2008;Committer;nobu;2;5;1;6;0
42a483d392e5c36182be99716618d139841903b3;Thu Jul 31 02:31:33 EDT 2008;Committer;nobu;2;4;2;6;0
18caf715c94bf0d95cb0fa3425653179f74f8497;Thu Jul 31 02:30:46 EDT 2008;Committer;nobu;2;8;1;9;0
8a6c699282f975faff73d9e3bbf4d45af6fd8935;Thu Jul 31 01:51:44 EDT 2008;Committer;nobu;5;14;4;18;0
368d9446213cdffd336c186a821f94ce49f725c1;Wed Jul 30 17:22:16 EDT 2008;Committer;mame;2;9;2;11;0
ea79b2360acf87a0b0c3a45831d1b3fd11b3afd1;Wed Jul 30 16:25:46 EDT 2008;Committer;nobu;2;6;2;8;0
cf0866114160d00a2ad8121b50a5713be13fa920;Wed Jul 30 16:18:40 EDT 2008;Committer;mame;2;5;1;6;0
d07b0842393d12fcfe2e2b217dc16e31e69b6c1c;Wed Jul 30 16:09:54 EDT 2008;Committer;mame;2;8;3;11;0
e7207d040463ede18d9060c2c4661cee88348869;Wed Jul 30 15:58:36 EDT 2008;Committer;nobu;2;15;13;28;0
c5e1d8c3d58b7478b189c3e5c5e9ce03e37372b9;Wed Jul 30 15:11:14 EDT 2008;Committer;svn;1;3;3;6;0
85da6ca572bfa75985f2bef0d09ba2f931ccf815;Wed Jul 30 15:11:09 EDT 2008;Committer;mame;2;5;1;6;0
728b09244232e058a52d7cfd3d5321d1a5d93be8;Wed Jul 30 13:19:34 EDT 2008;Committer;mame;2;5;3;8;0
84769be72723ae30c509b879ddeaf401d9a7ce87;Wed Jul 30 13:13:57 EDT 2008;Committer;akr;2;28;12;40;0
52bb9bb2d4e71fc0e87c5d251bca619540959d29;Wed Jul 30 13:07:16 EDT 2008;Committer;mame;2;5;5;10;0
bd0b40206a80e43022ec1559e05fa8b1d0308a22;Wed Jul 30 12:33:13 EDT 2008;Committer;mame;1;6;2;8;0
2d1981b91f896a1bbc7ac11f87303fe3bc8059b5;Wed Jul 30 12:30:28 EDT 2008;Committer;mame;2;8;1;9;0
0df6cb496a814b5b108c7cbf69c8237243d76ef0;Wed Jul 30 12:08:28 EDT 2008;Committer;mame;2;7;0;7;0
99f8f86354b0dcad46d498821c50d1c849885244;Wed Jul 30 08:48:37 EDT 2008;Committer;svn;1;3;3;6;0
807fcf9d13fbb30773944cde4f18f11b0a26a8a7;Wed Jul 30 08:48:31 EDT 2008;Committer;nobu;4;69;13;82;0
be9994a03ae32b5cd4a799b20ed96c3aaaba97b7;Tue Jul 29 14:38:44 EDT 2008;Committer;mame;3;54;9;63;0
d866ba69a1605a390155fe5401f11fdc0f010668;Tue Jul 29 13:56:24 EDT 2008;Committer;mame;2;85;57;142;0
995e44e050e78925594e5cbc2181e467bb6dd3d4;Tue Jul 29 12:38:33 EDT 2008;Committer;mame;2;5;1;6;0
8da30b8928d70e7bf11291ca5fe256189b68a355;Tue Jul 29 12:36:28 EDT 2008;Committer;mame;2;6;1;7;0
7e5be7e1314cde91c2c05702eff3da8083925172;Tue Jul 29 10:31:31 EDT 2008;Committer;naruse;2;5;2;7;0
9bd616a3d3c2ca0b33afcfd56b20b936c70e0353;Tue Jul 29 08:36:41 EDT 2008;Committer;nobu;1;3;2;5;0
f783b8d204e4124f1c7be9c92e6289aeb971b8a5;Tue Jul 29 04:21:32 EDT 2008;Committer;naruse;2;8;3;11;0
e7d2f303b737a33b99c9f93a093dad029bc1c24e;Mon Jul 28 20:38:04 EDT 2008;Committer;nobu;2;23;6;29;0
78b5fdd5a88b001c7576f23df49ed6cdd030229e;Mon Jul 28 17:42:32 EDT 2008;Committer;naruse;3;39;3;42;0
54da95b9e1f25d02d1580578fdf21e7cf8001e31;Mon Jul 28 17:12:55 EDT 2008;Committer;svn;1;3;3;6;0
2f1908b1cf5c19ca1d506a181e872c12e85d3dca;Mon Jul 28 17:12:51 EDT 2008;Committer;akr;2;13;38;51;0
bac3ea1fca1ed30098e74dd7296836aee413c31a;Mon Jul 28 12:33:44 EDT 2008;Committer;kou;4;16;21;37;0
a73ba1def712921b5ab6d13dd8055cbb687c4641;Mon Jul 28 12:27:43 EDT 2008;Committer;usa;4;34;25;59;0
517fd61e142698f8001aec80a61c0d3a139b5cef;Mon Jul 28 12:00:43 EDT 2008;Committer;mame;2;13;1;14;0
8d56defa55fe826f8bb8d549a0f50c8b51ada315;Mon Jul 28 11:17:43 EDT 2008;Committer;mame;3;14;10;24;0
13e0d5bc917612c13134e8dd00fbdc28431874d7;Mon Jul 28 09:59:12 EDT 2008;Committer;mame;2;5;1;6;0
31aa0986b8f42f377cddd493d6be9f5519a1380a;Mon Jul 28 09:15:48 EDT 2008;Committer;nobu;2;32;55;87;0
66660a893a9c43f465d0761336d9a1a721d406bf;Mon Jul 28 09:14:14 EDT 2008;Committer;nobu;2;16;4;20;0
d2f72cca6e5d31236408c1eb0a3df90adbb9b940;Mon Jul 28 07:49:56 EDT 2008;Committer;nobu;2;8;3;11;0
009db87ce270709bd1873eda085586d7ae7b573b;Mon Jul 28 07:07:12 EDT 2008;Committer;usa;2;10;6;16;0
9b3aade1b6e848e22114e987e7f1d07c859e37c1;Mon Jul 28 07:02:07 EDT 2008;Committer;usa;3;16;10;26;0
99c8c71243dafbbe29e12cea325d65b180687e8e;Mon Jul 28 05:29:56 EDT 2008;Committer;nobu;2;6;2;8;0
a95b2fde601ac0adc1285f1d206f8b9ef45eb279;Sun Jul 27 15:20:05 EDT 2008;Committer;svn;1;3;3;6;0
d76ab40bea1532214e8f22c46da7109b9e4c4766;Sun Jul 27 15:20:01 EDT 2008;Committer;mame;4;34;33;67;0
787cde7f9ab12edafe7559f501a8e21d89e72d72;Sun Jul 27 14:33:05 EDT 2008;Committer;mame;2;7;3;10;0
99c3a01dc7053dcc91b74cbab0c7505310ff302f;Sun Jul 27 13:24:18 EDT 2008;Committer;naruse;2;8;2;10;0
845e5766dcf9f47b440ba522fc81f1c10c9a24fc;Sun Jul 27 13:08:02 EDT 2008;Committer;ko1;2;17;8;25;0
60be3dc560d1bd61344c328ee6a939ec9cffa537;Sun Jul 27 05:59:32 EDT 2008;Committer;ko1;6;103;51;154;0
c30616378e04578a3bfe8650b3c98caf7968b458;Sun Jul 27 00:15:31 EDT 2008;Committer;nobu;4;11;5;16;0
92c2f654db6b522449700c3ddecbf786589ad1c2;Sun Jul 27 00:04:43 EDT 2008;Committer;svn;1;3;3;6;0
0098caf510e6241982fe3c04068d8fa58d839fec;Sun Jul 27 00:04:38 EDT 2008;Committer;seki;3;156;91;247;0
232e6592149d8fae60b148797fcb5d315472f7e5;Sat Jul 26 14:19:50 EDT 2008;Committer;yugui;2;21;17;38;0
1f9fce063fe800a7954e607c51fb2041237f9e66;Sat Jul 26 12:49:25 EDT 2008;Committer;suke;1;40;0;40;0
2e400ad1b8a7e424b72bb2841e6a9bef7d6fba1c;Sat Jul 26 12:27:57 EDT 2008;Committer;suke;3;192;61;253;0
b403a1760c01413f1791bb3eee01db8eddcca7bc;Fri Jul 25 22:48:30 EDT 2008;Committer;svn;1;3;3;6;0
69974821405a751cad5395b632653d5f4062fc03;Fri Jul 25 22:48:25 EDT 2008;Committer;suke;2;5;1;6;0
0841c2e67bc6917e4184326a93888b439e08b502;Fri Jul 25 14:49:53 EDT 2008;Committer;nobu;2;84;84;168;0
f421f68484a8f101057793a3c7e74a7f319d2cae;Fri Jul 25 14:48:12 EDT 2008;Committer;nobu;2;32;10;42;0
1181a092af921b79d952c5d6dc735bc41203a351;Fri Jul 25 14:35:21 EDT 2008;Committer;nobu;2;10;12;22;0
65aa393ae7e3b81174398746d8aacd20bb662c36;Fri Jul 25 12:56:36 EDT 2008;Committer;mame;3;26;22;48;0
148d57526496579d6711bbec0d7d76c3ea59466b;Fri Jul 25 12:13:57 EDT 2008;Committer;suke;2;9;9;18;0
87f80a7dd7ab801e6645a22a33d3a818daa861e4;Fri Jul 25 11:59:53 EDT 2008;Committer;suke;3;92;1;93;0
4aec73e1edfdd743828c0172a66f655223100c38;Fri Jul 25 11:49:28 EDT 2008;Committer;suke;3;110;38;148;0
f37a49e8c8f76eacfc8a5ce66040cc017dbe34ff;Fri Jul 25 10:50:52 EDT 2008;Committer;nobu;2;8;0;8;0
7c8ad088f5ca528fd47138bb8f6fed19201dca59;Fri Jul 25 06:56:23 EDT 2008;Committer;ko1;2;8;1;9;0
20796c9000f19f3dc353d67e00950a7649a5bade;Fri Jul 25 05:48:32 EDT 2008;Committer;nobu;1;1;0;1;0
3e53486295797ef5a2df6a4d684381d6f7d4af66;Fri Jul 25 01:01:38 EDT 2008;Committer;duerst;2;13;7;20;0
32eca113251515c013934bfcd7994b7c18a13004;Thu Jul 24 19:15:56 EDT 2008;Committer;naruse;1;1;0;1;0
b7464f8513d5a2160cfe98951fe8187c275fc71b;Thu Jul 24 19:14:47 EDT 2008;Committer;naruse;2;8;1;9;0
59f23bd421656f8d754e43be6a62824d0b9824ac;Thu Jul 24 17:47:34 EDT 2008;Committer;mame;3;65;58;123;0
a930fd9b8583de58745254ca544202d19cd82a1f;Thu Jul 24 15:10:36 EDT 2008;Committer;svn;1;3;3;6;0
d81ffff0e88530445eed662ae32e66bc82005d08;Thu Jul 24 15:10:31 EDT 2008;Committer;nobu;2;26;0;26;0
846584710acd41e20e537ebcf67480dc22952b13;Thu Jul 24 07:33:00 EDT 2008;Committer;usa;2;50;16;66;0
f92478c0fb900491deb35c7bad7cd6c6ac1e9f8c;Thu Jul 24 07:05:49 EDT 2008;Committer;usa;3;26;15;41;0
f8f7f884c1ee39359fac439023322840ad564501;Wed Jul 23 22:01:46 EDT 2008;Committer;svn;1;3;3;6;0
7481463bf6379bc668c3e6aff7571ee890afcd99;Wed Jul 23 22:01:36 EDT 2008;Committer;nobu;2;44;24;68;0
a0895f84b06b33cebac976214c807a4dbf483e92;Wed Jul 23 14:25:32 EDT 2008;Committer;mame;2;9;9;18;0
ae7e1482562e4132ea2b3a37eefd124a343b9fc4;Wed Jul 23 12:38:49 EDT 2008;Committer;mame;2;13;0;13;0
ec6c4abdba820541180b7d297dc40ee011a2dc8a;Wed Jul 23 12:36:24 EDT 2008;Committer;mame;2;7;0;7;0
ed9a65c4f609afcabf0a2d7254453592ba0cf243;Wed Jul 23 09:27:49 EDT 2008;Committer;nobu;5;54;44;98;0
7b9b1f45d35ffeb055c509cba3e9775790d2206b;Wed Jul 23 08:04:25 EDT 2008;Committer;nobu;2;9;0;9;0
391f0a726fcf5e8787191446db29e1acc5dc9c4b;Wed Jul 23 04:53:39 EDT 2008;Committer;nobu;2;5;2;7;0
4c3799ec1df43f72e2b50b5eb4e3eb5ad0df24a2;Wed Jul 23 01:09:50 EDT 2008;Committer;kazu;2;6;0;6;0
e64c1cc0269de20e1f33bc2b96241190783f2bbd;Wed Jul 23 01:09:19 EDT 2008;Committer;kazu;1;1;1;2;0
d5d402ebf5dab881d4c79deea1862f6990a37f83;Tue Jul 22 21:25:49 EDT 2008;Committer;nobu;2;2;2;4;0
9049de7875eedcba33fa909fbf6f6de08129039d;Tue Jul 22 21:12:00 EDT 2008;Committer;nobu;9;23;24;47;0
e35550c3e7784921734dc3a8128cf7c0f94879c9;Tue Jul 22 18:19:34 EDT 2008;Committer;nobu;2;11;6;17;0
5c0dcf52fd376d4b075e9ec0d402369a449fa441;Tue Jul 22 18:02:12 EDT 2008;Committer;nobu;8;76;57;133;0
a0dfa4819afc91f82c04c1c02ff03ed273fdbf07;Tue Jul 22 15:34:29 EDT 2008;Committer;svn;1;3;3;6;0
6c0f54029816b7df0ce67b78f0dbe382546953da;Tue Jul 22 15:34:23 EDT 2008;Committer;nobu;31;190;195;385;0
d56885b43df3b4e9e67fc4a39cbaaaea6961d5d8;Tue Jul 22 14:04:10 EDT 2008;Committer;mame;7;27;17;44;0
09a5952737052a7c4f6d3eb5f7b9963ee275da85;Tue Jul 22 12:55:36 EDT 2008;Committer;nobu;1;0;1;1;0
7771f6c0ee3b65406d6a860afae2ceda20354a3d;Tue Jul 22 11:43:38 EDT 2008;Committer;mame;3;18;2;20;0
08bbb08c5fa272f0baabd14975e2586000d1ba3c;Tue Jul 22 11:34:23 EDT 2008;Committer;mame;2;5;1;6;0
ba3fe885d5b5f8d1b8be43e11a9c484f6831bb9c;Tue Jul 22 10:39:30 EDT 2008;Committer;duerst;2;6;2;8;0
818e1de104e0e9a2dfa676f3bc5ba7c17ab556e5;Tue Jul 22 09:09:41 EDT 2008;Committer;usa;3;28;10;38;0
0acca9a8261fb33f720d941fd5113f046bda2d70;Tue Jul 22 08:53:34 EDT 2008;Committer;nobu;8;69;91;160;0
ee560dc68f363f0502349cd35f1fd06a05693c9e;Tue Jul 22 08:22:32 EDT 2008;Committer;usa;2;23;18;41;0
70b317b9dababf3527deba01544e157f1c87375d;Tue Jul 22 07:48:00 EDT 2008;Committer;nobu;6;115;39;154;0
e4d911fa98c598774408051ac984d8c67accf62f;Tue Jul 22 07:09:34 EDT 2008;Committer;usa;2;8;3;11;0
9654ea62cce8e49341e13d2065772771d11145fb;Tue Jul 22 07:05:17 EDT 2008;Committer;nobu;1;1;1;2;0
784ddb80d257ca1ca5a75a26917f584c029c7686;Tue Jul 22 02:17:15 EDT 2008;Committer;kazu;3;10;1;11;0
51596d4ac214b8cf75d857b485bcc54d04de56f6;Tue Jul 22 02:15:54 EDT 2008;Committer;kazu;1;16;16;32;0
1bcbc29d9554030b6e681ed6f1b111b26a7f3738;Tue Jul 22 00:51:35 EDT 2008;Committer;nobu;2;102;46;148;0
56e28fcf98feea4dbac057a716002af15ac36cf8;Mon Jul 21 20:26:25 EDT 2008;Committer;nobu;1;2;0;2;0
5ffd0cc80fda095b69660fb4ae72ffd227e9f7b7;Mon Jul 21 19:26:18 EDT 2008;Committer;nobu;3;16;2;18;0
cd9e9c6debcf893ea5fa70e42dc1875afaf0066f;Mon Jul 21 18:35:14 EDT 2008;Committer;drbrain;19;460;285;745;0
c62db0676bbb8051dac4f462240962e044db6cd4;Mon Jul 21 17:51:49 EDT 2008;Committer;nobu;3;39;20;59;0
2ef807cc3442c0b18d8955e15d8a3ace140d453c;Mon Jul 21 17:50:57 EDT 2008;Committer;svn;1;3;3;6;0
791bdf07b53c393b0c9e2db47aaaa9b3802b52df;Mon Jul 21 17:50:52 EDT 2008;Committer;nobu;3;17;2;19;0
4fb4516af8c64e711601bc34db8b0a702019b073;Mon Jul 21 08:16:34 EDT 2008;Committer;akr;2;6;1;7;0
6ccce7e3f521c04bd3ef83f6d19e534bb7d266bb;Mon Jul 21 06:29:35 EDT 2008;Committer;nobu;3;12;5;17;0
2bd1599caf09fda03bbce9d1fcd71da01b0f044a;Mon Jul 21 04:55:40 EDT 2008;Committer;nobu;3;15;0;15;0
c98b3a7e193a8a3a930938431c26a6fe1f709bd9;Mon Jul 21 01:25:55 EDT 2008;Committer;nobu;2;9;1;10;0
1b16c560e4941fe1505a92d1cf1c8873134014bb;Sun Jul 20 19:57:56 EDT 2008;Committer;akr;2;9;2;11;0
0f673a177a661e88d54a375a14e523125ee1dedc;Sun Jul 20 19:44:10 EDT 2008;Committer;svn;1;3;3;6;0
fe80d63d68cc2a09e2af0d01c540546d5d221f2d;Sun Jul 20 19:44:05 EDT 2008;Committer;akr;2;6;1;7;0
16ab763b1fb762eb8d837267ba6e7c7939d7d6db;Sun Jul 20 13:50:14 EDT 2008;Committer;nobu;3;29;0;29;0
4e554319ddcf1e7026641aad4a6197afb9df03c0;Sun Jul 20 07:05:20 EDT 2008;Committer;suke;2;12;5;17;0
8ceaf90948efa2561bfec11739c234b859a9b5a2;Sat Jul 19 16:28:27 EDT 2008;Committer;svn;1;3;3;6;0
a9b125cf204810a27e9a71d0ae186fe1907ff2da;Sat Jul 19 16:28:23 EDT 2008;Committer;suke;2;22;9;31;0
535f17f30bf0c61cfd3b22586a30b11c81aed0bf;Sat Jul 19 00:35:38 EDT 2008;Committer;suke;2;76;6;82;0
71b4ecb3d3068c23809983e1ce556056c0d2172a;Fri Jul 18 21:10:47 EDT 2008;Committer;drbrain;5;86;34;120;0
dbd68031e02e0933601d6f247581aeb2d08766e5;Fri Jul 18 15:32:36 EDT 2008;Committer;usa;1;2;8;10;0
2513550e28e9cb47d581e652c68b89095f615f71;Fri Jul 18 15:29:22 EDT 2008;Committer;svn;1;3;3;6;0
404d0ad40fd654a6429d896fef3601f934d11786;Fri Jul 18 15:29:17 EDT 2008;Committer;usa;2;20;14;34;0
305b347ae5fac1e4d64f80d62adc69911603c700;Fri Jul 18 14:28:37 EDT 2008;Committer;suke;2;50;16;66;0
068dd60372d659c97a76224dfce38ed96984cb6f;Fri Jul 18 05:59:46 EDT 2008;Committer;usa;2;186;97;283;0
1f98b69efc4a86c247850dbacc89abe4faf7ee8f;Fri Jul 18 00:46:23 EDT 2008;Committer;svn;1;3;3;6;0
fd25f74d64c69d636764ea11aa5a809b85e58f69;Fri Jul 18 00:46:16 EDT 2008;Committer;drbrain;47;8683;6128;14811;0
0af4a490b48bb6fef8d4f392d0c0b215db8e06f9;Thu Jul 17 14:46:15 EDT 2008;Committer;mame;2;5;1;6;0
d80a9afb186028c13e5087b2e6d3a2a0ccfe98b8;Thu Jul 17 12:09:21 EDT 2008;Committer;mame;2;8;3;11;0
df5604ce5d5e01b064378eb886a72c939f82e2c4;Thu Jul 17 11:42:17 EDT 2008;Committer;mame;2;7;2;9;0
871c83dddf8132d2668249cc0917320bb86712fd;Thu Jul 17 11:36:54 EDT 2008;Committer;mame;2;7;2;9;0
fae330b3b90572ef55f6ffd9b67c2c6fa7f5f526;Thu Jul 17 07:49:51 EDT 2008;Committer;usa;2;5;1;6;0
b85504f0e9b9f9797fffc75d9cf4c688a78035c4;Thu Jul 17 01:55:58 EDT 2008;Committer;drbrain;2;6;1;7;0
6852eaaf0d69bc8f1b394cd63f2742e8da5cb67b;Thu Jul 17 01:23:35 EDT 2008;Committer;usa;2;24;10;34;0
c60b57ade0f4b31c2177615dca9839d40baaa49d;Wed Jul 16 19:33:15 EDT 2008;Committer;nobu;24;942;942;1884;0
47e3f4e1aed4b71816e05fe608e97c523ea7ccfd;Wed Jul 16 19:19:36 EDT 2008;Committer;nobu;4;73;58;131;0
aba40d1a3897c56056ffc7ec96957c38b6b9fce8;Wed Jul 16 19:12:41 EDT 2008;Committer;nobu;1;2;2;4;0
bb09f09ba6ec7c4c054816df4c3c523659d8cb5f;Wed Jul 16 16:30:16 EDT 2008;Committer;svn;1;3;3;6;0
27bf963fa8280fff32691466993ee6eaf0a4afd9;Wed Jul 16 16:30:12 EDT 2008;Committer;mame;2;5;1;6;0
1b2af065a2b8beb5500676833e1ac9e7f7c54881;Wed Jul 16 09:04:37 EDT 2008;Committer;nobu;2;14;11;25;0
5198897802c8e171a6f9f80bdae9a8a80b70d0ef;Tue Jul 15 15:26:09 EDT 2008;Committer;svn;1;3;3;6;0
eafe85f603e0db7caee9d719a55bfe3173f9061b;Tue Jul 15 15:26:04 EDT 2008;Committer;mame;15;572;873;1445;0
e74af2cf41d3fc3accbcf153d0a73454f29a1c7f;Tue Jul 15 13:34:49 EDT 2008;Committer;usa;2;15;7;22;0
3e7b91eebd1e30ba0cc12e35757ac3abba75c2ce;Tue Jul 15 12:58:23 EDT 2008;Committer;nobu;5;15;9;24;0
e3cc2ee1ed8d16f7920459641ad66f0f1afbb8d9;Tue Jul 15 12:48:47 EDT 2008;Committer;knu;4;9;5;14;0
c9eba6932be3ad3e43bb002ca1c4e2375e5b6d1c;Tue Jul 15 12:34:58 EDT 2008;Committer;usa;1;27;8;35;0
6bc480e059b0b9a6a24dceaa96e2d0717cceca51;Tue Jul 15 12:33:28 EDT 2008;Committer;knu;3;27;5;32;0
a6efdc47f9aa169894739f152ae37bdd6600fe6f;Tue Jul 15 09:26:05 EDT 2008;Committer;usa;1;4;4;8;0
57331140f6084525a566b93ec6b52ef4870802d0;Tue Jul 15 09:17:22 EDT 2008;Committer;usa;2;28;30;58;0
ad99950263d04c0c47bc65b465d0d136b808a7d1;Tue Jul 15 09:14:14 EDT 2008;Committer;svn;1;3;3;6;0
25498d24c808346a90a55ca967138083402bc160;Tue Jul 15 09:14:09 EDT 2008;Committer;usa;3;19;0;19;0
598fdcb73083360d2d844d8e07771de4235e41d5;Mon Jul 14 11:38:09 EDT 2008;Committer;suke;2;6;2;8;0
94ed51b2810af40964fc040bd70bb2beed1de52c;Mon Jul 14 09:47:33 EDT 2008;Committer;nobu;4;27;57;84;0
ae875579164e18fe9f0cb924ef46b1af82e8c80d;Mon Jul 14 08:40:17 EDT 2008;Committer;kazu;2;11;1;12;0
ef62472e44f921f5a03bf2bf8367e9291fe75a6f;Mon Jul 14 06:27:26 EDT 2008;Committer;naruse;2;91;5;96;0
641d6ece1ef85af7f1bfffdaa6defc4e5a8c9228;Mon Jul 14 06:17:36 EDT 2008;Committer;kazu;2;14;0;14;0
878a3f60b633aca65c5db954720fe230a7a67b33;Mon Jul 14 04:37:21 EDT 2008;Committer;usa;2;10;0;10;0
bd232e1578e990293dec4daa01ee29027241b109;Sun Jul 13 21:02:35 EDT 2008;Committer;svn;1;3;3;6;0
bd4c28afbd26e7a575acfd1bee17564d24d22a37;Sun Jul 13 21:02:28 EDT 2008;Committer;nobu;2;6;0;6;0
6e0ed5570ec963b357e82b82a09d239fea17dee8;Sun Jul 13 12:36:26 EDT 2008;Committer;suke;3;167;6;173;0
b7000ccfa0a81d8cf6349b46ab618316552f3338;Sat Jul 12 21:57:11 EDT 2008;Committer;nobu;2;9;3;12;0
eb43e44cd02aac650d5601569b395cf97c74fd83;Sat Jul 12 20:39:07 EDT 2008;Committer;svn;1;3;3;6;0
a0fe21b36273acdb74156b9190c4da41d6518b5c;Sat Jul 12 20:39:02 EDT 2008;Committer;usa;4;19;2;21;0
2d46553ffaba8ef7da4921a955ea9ffa8a7d178e;Sat Jul 12 14:58:07 EDT 2008;Committer;usa;2;8;1;9;0
97208f2b34ad675d661938c865bb2202f52ff76c;Sat Jul 12 14:25:52 EDT 2008;Committer;akr;2;8;4;12;0
4fd8cbe484a80bc2d68b66c3964de7a59c3b6616;Sat Jul 12 13:41:42 EDT 2008;Committer;nobu;2;10;6;16;0
73653014707ab292212a703edab2c82fadf7c2b3;Sat Jul 12 13:30:46 EDT 2008;Committer;nobu;5;32;5;37;0
f94f8f351eb1088a2c5571ef5563ec6503fa1b44;Sat Jul 12 13:17:29 EDT 2008;Committer;nobu;7;65;29;94;0
2c0a3f226a048570e76b27d997d3fd5342af5a59;Sat Jul 12 07:02:40 EDT 2008;Committer;nobu;2;6;0;6;0
6c62eafc7ce029f45ed44ff9bfdac10d6b338ff6;Sat Jul 12 00:31:32 EDT 2008;Committer;suke;2;32;0;32;0
3400b01ec1c3fe69ed02f807e253eb4dc962c100;Fri Jul 11 16:55:18 EDT 2008;Committer;svn;1;3;3;6;0
dde090583006604fe9eeb84a4c8793bf32311b7a;Fri Jul 11 16:55:14 EDT 2008;Committer;usa;2;9;0;9;0
dfd0d6a5ca865d589f943f57c29f2a6a6e2260d6;Fri Jul 11 14:06:19 EDT 2008;Committer;mame;2;12;0;12;0
7a89495bebbd7cdcaa39cf5be5e07defee54a078;Fri Jul 11 13:59:05 EDT 2008;Committer;mame;2;6;0;6;0
bf050c3cd663f0e6e942d03d7025c75bf407fd92;Fri Jul 11 13:10:29 EDT 2008;Committer;usa;3;22;17;39;0
f3fcd2e4a0b7680fa1ba813b8f7eb257cce41ec7;Fri Jul 11 11:51:39 EDT 2008;Committer;nobu;5;53;16;69;0
4532c0d81ef7aeb6d75d7bbe099682ef90165e29;Fri Jul 11 07:18:29 EDT 2008;Committer;usa;2;11;4;15;0
e9db21d9cf4067ec8c0da8d4a32e675b166f37d8;Fri Jul 11 05:43:03 EDT 2008;Committer;usa;2;6;1;7;0
db093f2d39553fcb8bea0f3feeeff3054169bb14;Thu Jul 10 21:16:28 EDT 2008;Committer;nobu;2;5;1;6;0
989d3ef272f1f15981c5eed59bd0a29075fd43b1;Thu Jul 10 20:09:38 EDT 2008;Committer;usa;2;6;1;7;0
df91d39c943333ea39be83cdcc0efb5ee1fb943d;Thu Jul 10 15:58:07 EDT 2008;Committer;ko1;3;10;5;15;0
5c91367675ffc3e7b1a2214d354e518c3565e776;Thu Jul 10 14:52:24 EDT 2008;Committer;akr;1;1;1;2;0
d238b7c62732edf0a0374043e7da16baa40533e2;Thu Jul 10 13:06:03 EDT 2008;Committer;nobu;2;6;1;7;0
4f1b06aabd54b86f08cac13498c73fcb0237fe05;Thu Jul 10 12:22:16 EDT 2008;Committer;suke;6;40;0;40;0
86714f5b160a5342f6ed9564fe9db30be120100c;Thu Jul 10 10:45:51 EDT 2008;Committer;wanabe;2;5;2;7;0
2026580dc20c4afe8f4daaa62fb53c0b6be8d0d0;Thu Jul 10 09:31:03 EDT 2008;Committer;wanabe;2;6;2;8;0
52a3897f4f84cc53f1d258916a132a0ab04a6dd8;Thu Jul 10 08:22:04 EDT 2008;Committer;usa;2;5;1;6;0
04969c4a8612e78a9d96a978f703d61c9fc354bb;Thu Jul 10 05:09:08 EDT 2008;Committer;nobu;2;5;0;5;0
3b9329e98467e01224bafc258ddac556332d3986;Thu Jul 10 03:42:02 EDT 2008;Committer;nobu;2;10;6;16;0
1a5f1a8c6966a973b26b85cb6e1e65ad0c5a5ed1;Thu Jul 10 03:10:00 EDT 2008;Committer;nobu;6;23;15;38;0
7ad9faa5280b0f6e87ef658bc209ffe24fdac85c;Thu Jul 10 03:09:23 EDT 2008;Committer;nobu;2;29;24;53;0
a0e291f697a198c6be1d0b73f4c1b57edb924982;Wed Jul 09 18:05:36 EDT 2008;Committer;svn;1;3;3;6;0
34131e6ea372eecac20384a5833bba125ef218b6;Wed Jul 09 18:05:32 EDT 2008;Committer;akr;1;5;0;5;0
5bdf57905d4aca60ea9589361968ef0c13779bd8;Wed Jul 09 13:47:51 EDT 2008;Committer;nobu;1;1;1;2;0
a14682906f063617ce22969dd100a512fe63ba33;Wed Jul 09 13:41:19 EDT 2008;Committer;nobu;4;48;42;90;0
6372357ad51ccbf909d36c6516229d3be0f30043;Wed Jul 09 12:01:08 EDT 2008;Committer;akr;2;8;1;9;0
0d37d00b294b90ca6b6975638701d6374369942e;Wed Jul 09 11:36:37 EDT 2008;Committer;nobu;1;2;1;3;0
7df7982b47671dff7a84782e57b85df931b39761;Wed Jul 09 11:35:06 EDT 2008;Committer;nobu;3;40;5;45;0
a2ec2f8b592ae36596ab4c1608a5854414a9bd7a;Wed Jul 09 11:18:52 EDT 2008;Committer;nobu;3;31;5;36;0
a534e39a87b81804ca58dc0b765d338b83f0a96d;Wed Jul 09 09:17:09 EDT 2008;Committer;nobu;4;10;3;13;0
71b1673229c57cd44b2ffe79bb094cfb986fbeca;Wed Jul 09 02:13:41 EDT 2008;Committer;nobu;2;6;1;7;0
8dfc2f81c000e732ffd1d7bdb7facac3e280c9de;Wed Jul 09 02:11:21 EDT 2008;Committer;nobu;2;18;8;26;0
ec18fc70a3d4636d7ddfcdf3fc1065a02114b982;Wed Jul 09 00:50:37 EDT 2008;Committer;naruse;2;6;2;8;0
6e0b5f40cc708f93013262c55991a6ab4e115823;Tue Jul 08 16:38:40 EDT 2008;Committer;nobu;3;24;8;32;0
1d1a3fb75a0e4b0f492d67226653c77965d35fcf;Tue Jul 08 15:13:27 EDT 2008;Committer;svn;1;3;3;6;0
91c07a5ac67bc7dad114a84697f3abc32ed78318;Tue Jul 08 15:13:22 EDT 2008;Committer;mame;6;94;42;136;0
485754369101514e6230f4cd0a68922016f29b0e;Tue Jul 08 14:05:38 EDT 2008;Committer;suke;3;143;103;246;0
caf3933babe1be5bba95b271b567caec92855cdb;Tue Jul 08 13:57:06 EDT 2008;Committer;mame;4;43;9;52;0
7e16f9e7777781a4969537b5d9f659b1356b2786;Tue Jul 08 13:28:57 EDT 2008;Committer;ko1;4;9;9;18;0
92afa0522205ba0589d4c3d6e03837802a2c83fd;Tue Jul 08 12:45:50 EDT 2008;Committer;mame;2;5;1;6;0
6c32d10c0186a1aebe212f0f61c940204d7f1e73;Tue Jul 08 11:13:09 EDT 2008;Committer;suke;3;99;3;102;0
f1d967c6ee0560eee1d728a70903534992adb6cd;Tue Jul 08 04:44:44 EDT 2008;Committer;ko1;1;6;0;6;0
8b3969f8b3c069a5b7fc0eccf65fe8e919fa4c70;Tue Jul 08 04:43:02 EDT 2008;Committer;ko1;2;9;2;11;0
2db158667ae995c2685eb0eb48a5b6430e112e07;Tue Jul 08 02:44:12 EDT 2008;Committer;usa;3;81;53;134;0
933d553de00aca76b93230cf9c37780cbe788693;Tue Jul 08 01:52:11 EDT 2008;Committer;naruse;2;5;1;6;0
64cfcd7c63c2166fff473afc2c274182cce5926f;Mon Jul 07 23:00:58 EDT 2008;Committer;naruse;2;28;16;44;0
0ad460dde8b91ebda10df52ba54b512b98429a4e;Mon Jul 07 17:29:44 EDT 2008;Committer;naruse;4;104;158;262;0
f10c88827e2a63ea306527d00ef0377488806ac1;Mon Jul 07 15:23:01 EDT 2008;Committer;nobu;3;16;3;19;0
6aff4b8eaa7e2b8bc0bb458dd1882d4b1b197a04;Mon Jul 07 11:49:14 EDT 2008;Committer;suke;3;143;15;158;0
1d6e2caf10b477739012f92e3c08be23d8459363;Mon Jul 07 10:46:13 EDT 2008;Committer;naruse;2;6;1;7;0
e12e0b337d9d86d43dc4677ab299a7b6c992c586;Mon Jul 07 08:12:23 EDT 2008;Committer;nobu;2;7;1;8;0
4b843da8697445005f18cef2103b68ad32923433;Sun Jul 06 16:24:45 EDT 2008;Committer;nobu;2;6;1;7;0
15743791437f8cc8d7bbf4afa5f92c72f1e03fc0;Sun Jul 06 15:59:44 EDT 2008;Committer;svn;1;3;3;6;0
fc5746681e31307d55c3a4718883b9f8b4f0f67b;Sun Jul 06 15:59:40 EDT 2008;Committer;nobu;2;13;0;13;0
2754e843b6e38ec9f91070e202abff41e88d4c6f;Sun Jul 06 14:49:00 EDT 2008;Committer;nobu;1;213;150;363;0
7d82b3dc3cb1524a82e2161a039511824adc119b;Sun Jul 06 14:48:08 EDT 2008;Committer;nobu;1;5;0;5;0
0753c79be2edbc9fbb7238cf33e15b9dc62feb01;Sun Jul 06 09:36:25 EDT 2008;Committer;suke;2;21;1;22;0
692ea1bb836016fa39d2c1b67e110cc6802854fc;Sun Jul 06 01:13:20 EDT 2008;Committer;kou;2;6;1;7;0
67b0ca4947bc5bc20b322879671a7b9122dcb323;Sat Jul 05 15:58:50 EDT 2008;Committer;svn;1;3;3;6;0
890aa092be342fc5589509903de248d06d48e9fc;Sat Jul 05 15:58:46 EDT 2008;Committer;akr;2;16;6;22;0
d375b7735243edab13498b4f2f9dc6e06420b5e2;Sat Jul 05 14:47:06 EDT 2008;Committer;akr;2;11;4;15;0
7b52d32bd7b373b56aea19127846ad9f01144f50;Sat Jul 05 14:14:43 EDT 2008;Committer;akr;1;7;3;10;0
b279bf427070c0eb6e8fe5280174ac72acd55692;Sat Jul 05 14:12:53 EDT 2008;Committer;akr;3;9;8;17;0
8b59b1cb983b84f259d09d41e150124345169f5e;Sat Jul 05 13:38:46 EDT 2008;Committer;akr;2;32;17;49;0
6bbbf9889d8638b6b11e199b1cb0ec15a7170a13;Sat Jul 05 13:22:29 EDT 2008;Committer;nobu;4;16;10;26;0
2ca7298386fe83c2477870b7020dca593b865733;Sat Jul 05 12:33:55 EDT 2008;Committer;akr;1;5;3;8;0
b89bf3f05a17a934cc94365fee3b20e0a4f5ed08;Sat Jul 05 12:25:33 EDT 2008;Committer;akr;1;4;0;4;0
f18120b8a0bcc5735d7d9f7b2a39c8da7175c0e2;Sat Jul 05 11:54:06 EDT 2008;Committer;suke;2;56;25;81;0
52f780c07f6499bc04961fe7bada72a1d08ea49d;Sat Jul 05 07:15:41 EDT 2008;Committer;nari;2;129;246;375;0
1890ae7aa957f75c7aeb64e4213c1a58c65b80d0;Sat Jul 05 01:01:01 EDT 2008;Committer;suke;3;45;1;46;0
1a32af4e7a1527ebe6b4b1205c522fa9ebd56344;Fri Jul 04 23:50:33 EDT 2008;Committer;akr;3;24;3;27;0
3d0bd1c6269a7945dc1da22e212d47600942715d;Fri Jul 04 23:33:09 EDT 2008;Committer;svn;1;3;3;6;0
54c984a8983c4ca3330d842520f24d3a98675f20;Fri Jul 04 23:33:04 EDT 2008;Committer;akr;3;30;0;30;0
7a05bfaaab03375783f6e91bec6032c7edaecb78;Fri Jul 04 14:19:01 EDT 2008;Committer;suke;3;48;2;50;0
7d166d26a5fbe66cdd7974314104f85dd29977ab;Fri Jul 04 13:19:24 EDT 2008;Committer;akr;5;38;11;49;0
28b216ac45262819f8bc7be0b1417a707974f94b;Fri Jul 04 11:44:05 EDT 2008;Committer;nobu;4;118;107;225;0
75d3a3d0dfac771054346519c588112b43a6f4bc;Fri Jul 04 08:52:51 EDT 2008;Committer;usa;2;14;4;18;0
62dc500faf5d485b2dc8bf177d6e595eef94c342;Fri Jul 04 05:17:25 EDT 2008;Committer;nobu;2;6;5;11;0
5b72919469f87d74e4f5f833b8c78e385372cb5c;Fri Jul 04 02:18:17 EDT 2008;Committer;nari;2;18;7;25;0
f8ed3b245ac977526295cf0d7eab55ec7059e016;Thu Jul 03 20:04:35 EDT 2008;Committer;usa;2;16;8;24;0
17df532792cc2902496c27d32a4cb357a09bb91e;Thu Jul 03 17:22:34 EDT 2008;Committer;svn;1;3;3;6;0
fc64f8c5fe0bdbd69b2b55bfb8d1ade653714f53;Thu Jul 03 17:22:29 EDT 2008;Committer;usa;2;9;8;17;0
ae3a03eb07e1f6c5a008ec9d9fe2a81e21205026;Thu Jul 03 14:27:43 EDT 2008;Committer;mame;7;76;17;93;0
da1263d2ac7063ddd6b68ac460a9f9a45ab8993b;Thu Jul 03 13:16:43 EDT 2008;Committer;akr;1;1;1;2;0
f08581c7b6cfeb3c843257385e9c2611cd473806;Thu Jul 03 12:55:12 EDT 2008;Committer;mame;11;99;41;140;0
16519f1ff9bfd74474f5c4177795feaba7765d0c;Thu Jul 03 12:21:11 EDT 2008;Committer;mame;2;5;1;6;0
55b95b0169fee1cf10f8c67ead1c93e16a686194;Thu Jul 03 12:10:30 EDT 2008;Committer;akr;1;15;0;15;0
1aa2d2976fac9a8ec46e3cb7ec5d92dae8f0c61c;Thu Jul 03 12:06:22 EDT 2008;Committer;nobu;2;5;1;6;0
854d955393b62b89222abe085c31f07865d211f5;Thu Jul 03 10:48:02 EDT 2008;Committer;suke;2;4;1;5;0
53329fb62200a58bcc334e86aa280fe3988eb55e;Thu Jul 03 08:50:23 EDT 2008;Committer;akr;1;1;1;2;0
f8348e1124cd9b268acb758344cc1ffac87590fa;Thu Jul 03 07:22:06 EDT 2008;Committer;akr;2;28;0;28;0
3819f8d15655356ffe06d92490ae3bf4bcedec9d;Thu Jul 03 03:54:25 EDT 2008;Committer;matz;2;10;3;13;0
f0816c0dffe057603b551a214a58f7ba28bfd99b;Wed Jul 02 22:06:05 EDT 2008;Committer;nobu;2;5;0;5;0
bb350b04e5f7714aec5dc783993e6b91cba76cd7;Wed Jul 02 22:02:58 EDT 2008;Committer;nobu;4;11;3;14;0
7f637ab96f841a7d03f5b544f1efae50920cc0bf;Wed Jul 02 19:39:33 EDT 2008;Committer;nobu;2;4;10;14;0
f5e45d00eba0807048491cc7d122bd0723ebafe4;Wed Jul 02 16:45:05 EDT 2008;Committer;mame;2;11;6;17;0
104e841390f81471841387fff1c30f8cec8924e4;Wed Jul 02 16:24:11 EDT 2008;Committer;mame;5;26;0;26;0
ac6fd9384d05d20d2acbda789e06335468589c6d;Wed Jul 02 16:02:52 EDT 2008;Committer;mame;2;4;1;5;0
b892e3dd1bc531bd0b53fd8999454a658f18e715;Wed Jul 02 15:35:04 EDT 2008;Committer;suke;3;123;1;124;0
d2926df7756c8d78a2720138acf31f89c06bb063;Wed Jul 02 15:18:48 EDT 2008;Committer;svn;1;3;3;6;0
8519afcb41f13dd03eeaf503493b3ca90bff961b;Wed Jul 02 15:18:44 EDT 2008;Committer;suke;3;25;0;25;0
5c72ffe769b5552d7abb5fe050aba555b37c7278;Wed Jul 02 01:19:25 EDT 2008;Committer;nari;1;1;0;1;0
9f2208b40cc1b1d901399f6a3df8ca43c57d34a3;Wed Jul 02 01:07:12 EDT 2008;Committer;nari;1;5;0;5;0
8bccb5f2662f8bce023714a68786f401046557bc;Wed Jul 02 00:49:10 EDT 2008;Committer;nari;1;240;124;364;0
9e2a51ccb687501ab904f323da1f1ec8350c4ca7;Tue Jul 01 18:43:25 EDT 2008;Committer;mame;2;29;14;43;0
9a61579c1658502a87f62c857ec29cd831d5db41;Tue Jul 01 18:13:22 EDT 2008;Committer;ko1;5;41;31;72;0
ab109c36f19aeaef088e975fa1de3ca6e6cce6f0;Tue Jul 01 17:11:35 EDT 2008;Committer;ko1;3;8;2;10;0
6d625e4b6e1281c59c69165b58eb70430fee9b90;Tue Jul 01 16:59:20 EDT 2008;Committer;usa;2;6;1;7;0
47db28bc7bb45c89b58416411200858bec9c63e5;Tue Jul 01 16:55:35 EDT 2008;Committer;svn;1;3;3;6;0
5874de95e8df1d051001cf53614c1d245c1ac5ae;Tue Jul 01 16:55:30 EDT 2008;Committer;mame;11;200;18;218;0
498324c5d3cd08c2c306a4f91e3a11b7fda22835;Tue Jul 01 12:33:11 EDT 2008;Committer;mame;6;95;43;138;0
807fbd69403bcae4bc38138a8f8a4bba5914dcda;Tue Jul 01 12:19:00 EDT 2008;Committer;ko1;6;39;26;65;0
1b62e5ec370a5e442effad9b5012cb3373a839ff;Tue Jul 01 12:13:13 EDT 2008;Committer;shyouhei;2;8;1;9;0
982450e24fb275644664499cea197deae3f5722b;Tue Jul 01 11:59:50 EDT 2008;Committer;shyouhei;3;9;4;13;0
a056546f0dfa9af3d358c70e2e66bbaf5b4fef8f;Tue Jul 01 11:46:48 EDT 2008;Committer;ko1;2;5;1;6;0
bf903214d5523f0a64e4a7ae123242875b06c34d;Tue Jul 01 10:36:22 EDT 2008;Committer;shyouhei;3;8;2;10;0
5b7dfb7c131627728aee5871bb1a029ab5918b9b;Tue Jul 01 10:05:48 EDT 2008;Committer;naruse;2;6;1;7;0
0ef21e44e7fac96f0919e7d0ef2bf30c47eb2128;Tue Jul 01 09:50:30 EDT 2008;Committer;shyouhei;30;112;56;168;0
1316830179636fc100e88c9a14314d5e1ece5931;Tue Jul 01 08:56:37 EDT 2008;Committer;nobu;2;5;1;6;0
40612c5bb554241537067e46984aada23e6f7365;Tue Jul 01 08:51:33 EDT 2008;Committer;usa;2;5;1;6;0
5669377a571b992a25c4ee98c7685e8c7d4c6ec0;Tue Jul 01 08:44:32 EDT 2008;Committer;nobu;5;13;7;20;0
53cffba8cb3ee3e38eaed5b5679d9bdc5bc8a11e;Tue Jul 01 08:39:10 EDT 2008;Committer;shyouhei;4;58;51;109;0
ddc5f561e7df66a8f50df81686586f1e1c6b2c72;Tue Jul 01 08:31:55 EDT 2008;Committer;shyouhei;2;9;5;14;0
3e69e83a62be745e1ace41cb0293ec0692baaeb6;Tue Jul 01 08:27:58 EDT 2008;Committer;shyouhei;10;32;11;43;0
4f572663c8ef0dd4274bf935e3385c454e0ddaf5;Tue Jul 01 08:21:44 EDT 2008;Committer;nobu;9;66;54;120;0
6f88631baa65b121c9f580db18d26162b1f65ff6;Tue Jul 01 07:59:21 EDT 2008;Committer;shyouhei;2;7;1;8;0
a739f593591e6bf00f69bb53033e9d4175e79d72;Tue Jul 01 07:56:51 EDT 2008;Committer;shyouhei;3;15;4;19;0
c274c6fabf8772d9fc94be8d1c1c4dc8dd98babd;Tue Jul 01 06:01:15 EDT 2008;Committer;nobu;4;39;9;48;0
d3b61c079e5bc944d0ee2298dfb79936c467ce71;Tue Jul 01 04:20:49 EDT 2008;Committer;nobu;1;4;2;6;0
365f1cd57e4d8d9416c28bf61cd984e796ece646;Tue Jul 01 04:19:47 EDT 2008;Committer;nobu;2;7;3;10;0
eb33f91cb7a763331e210bc10fbdefa037366496;Tue Jul 01 03:05:58 EDT 2008;Committer;ko1;8;148;86;234;0
5c8ab4d9c2931c0e0f1ee58e516c91f1e9a47486;Mon Jun 30 18:46:21 EDT 2008;Committer;drbrain;3;11;2;13;0
fd77e489f27bccec42844ff3da9e654e049de900;Mon Jun 30 16:07:19 EDT 2008;Committer;nobu;2;6;1;7;0
5f8e0b66330ece522adb41c1e5d09babdb0cf7d2;Mon Jun 30 16:03:41 EDT 2008;Committer;akr;2;8;1;9;0
4c4357c6986e80d7b78d2cdb103e827a89373090;Mon Jun 30 15:49:17 EDT 2008;Committer;svn;1;4;4;8;0
01a025d2d73f3f71427027deda4c2f88708c1a05;Mon Jun 30 15:49:13 EDT 2008;Committer;nobu;2;15;7;22;0
3ac2c3472af0dfce9a79ed3ffa6ed720caaf98e2;Mon Jun 30 14:15:48 EDT 2008;Committer;mame;2;17;7;24;0
895c7cb3c4f5d3c72e999d204a7eaa88e800b2be;Mon Jun 30 14:05:20 EDT 2008;Committer;akr;1;1;0;1;0
1971a0c853a7c6460fa6961a1fecaf28dc50d96c;Mon Jun 30 14:01:53 EDT 2008;Committer;nobu;2;79;136;215;0
32c8d5c4119b44b1811eea151f79acfb388c7f04;Mon Jun 30 13:58:35 EDT 2008;Committer;mame;2;11;2;13;0
4b60da90f90afac03a74c9f4d3592b4f0617049f;Mon Jun 30 13:50:18 EDT 2008;Committer;mame;2;7;2;9;0
cac79cc38886da8674f95b717ecc108961df3a02;Mon Jun 30 13:50:13 EDT 2008;Committer;akr;1;8;0;8;0
fce76df67ce82cca43f7bffae1dd1fdf7b433cae;Mon Jun 30 13:30:39 EDT 2008;Committer;nobu;2;5;2;7;0
9e3e19cd1fd923dc27fbbdfdde5fe88f1d0e106b;Mon Jun 30 13:30:11 EDT 2008;Committer;mame;2;7;2;9;0
c93f203e5392aef68d0e7b6e71a778bc13b558f5;Mon Jun 30 13:22:10 EDT 2008;Committer;mame;2;5;1;6;0
ac388541c4c32a9199af0bf6f2d91fc9aadee9df;Mon Jun 30 13:12:49 EDT 2008;Committer;nobu;2;12;3;15;0
d0f211f3942278e3158450b237fbb44ea1a6fa45;Mon Jun 30 09:57:07 EDT 2008;Committer;nobu;2;27;22;49;0
dd0b79b3c3f8d41e373bb588794d8cbb9aca9802;Mon Jun 30 09:56:45 EDT 2008;Committer;nobu;1;15;13;28;0
eedb3dc3a3fcaae9cedf345b0469d5e4100aaacd;Mon Jun 30 05:42:34 EDT 2008;Committer;usa;2;7;0;7;0
244e32db0dcb273a307e5de78fe9d7bdb70e7ef0;Mon Jun 30 01:30:32 EDT 2008;Committer;matz;2;13;0;13;0
7edda76f1597a92a3d07ab8b1f3ba7f1dee8798c;Sun Jun 29 18:02:24 EDT 2008;Committer;mame;3;10;2;12;0
04d83114a616daa8e1586f8d2cc71b209beac3d4;Sun Jun 29 17:33:01 EDT 2008;Committer;naruse;3;14;1;15;0
9ebf6473ebfd76e64c33904bb555b5fc8435dc66;Sun Jun 29 17:26:16 EDT 2008;Committer;ko1;8;35;24;59;0
002fb8f747933409b05b805a9903dcbc7a72abbd;Sun Jun 29 17:13:37 EDT 2008;Committer;ko1;2;7;3;10;0
2b2683b732813769eb5340b457bd64a6002ddd1d;Sun Jun 29 16:53:53 EDT 2008;Committer;svn;1;3;3;6;0
7fef733b9de3300b1b46a101a723f8a9548d6b03;Sun Jun 29 16:53:49 EDT 2008;Committer;mame;2;4;48;52;0
2950c7a919aecaf892446d7d2edf5ad85b8369ae;Sun Jun 29 14:03:38 EDT 2008;Committer;akr;2;6;1;7;0
39a241cec6a1761c7d4dccc5c155a2a83f7b6143;Sun Jun 29 09:05:21 EDT 2008;Committer;kou;1;2;1;3;0
8ee383397d39cecc3cdf4dc30526907a208c46ce;Sun Jun 29 09:02:32 EDT 2008;Committer;kou;3;38;4;42;0
1695dd0f023a1171148ef8e6f854acaab3ed32e2;Sun Jun 29 08:44:53 EDT 2008;Committer;kou;2;20;3;23;0
94031b9628f4a5e02df018a29111051a97a7a2cb;Sun Jun 29 08:42:46 EDT 2008;Committer;kou;3;40;20;60;0
7556f66e9cd2eaca3c7cc114f56be732c8845086;Sun Jun 29 08:38:11 EDT 2008;Committer;kou;5;17;13;30;0
f6c7804c16e019bda446bebc17f32049880277cd;Sun Jun 29 08:34:40 EDT 2008;Committer;kou;3;31;7;38;0
b9f895e9c8e5d27922ba8883dad622a3ef8a44ca;Sun Jun 29 08:32:10 EDT 2008;Committer;kou;3;7;2;9;0
7d2829e9d8ad81874bd8c24b1342a57ee11bb643;Sun Jun 29 02:36:51 EDT 2008;Committer;mame;2;5;0;5;0
285fb001952a688f5213596ded1c244469092353;Sun Jun 29 00:43:12 EDT 2008;Committer;nobu;2;19;6;25;0
e47ebfe5187a19a1d379b97810cd8684de8cc339;Sat Jun 28 23:00:58 EDT 2008;Committer;suke;2;7;4;11;0
214bb567f2c0a1ec370b0866bf52ce286586d6cd;Sat Jun 28 17:10:53 EDT 2008;Committer;akr;1;20;20;40;0
980d7e0cd08bf18036cbd46140fd67d3cd0388ea;Sat Jun 28 16:53:59 EDT 2008;Committer;svn;1;3;3;6;0
ff27b33044e8618ab290735bd3b3a5530b956233;Sat Jun 28 16:53:56 EDT 2008;Committer;akr;1;5;1;6;0
340cd503a7d0f73bb1ca6446f78793f968a5d5bf;Sat Jun 28 12:25:45 EDT 2008;Committer;akr;6;69;49;118;0
4c766e1713eda038b5118e1ebfbb6e26545966cd;Sat Jun 28 12:15:55 EDT 2008;Committer;nobu;2;22;6;28;0
54b64e2096eacbfd5e868cf47c5fec6b9defbaa4;Sat Jun 28 11:50:38 EDT 2008;Committer;nobu;2;6;1;7;0
1318dff1a87af926428958a4cdf181d415836439;Sat Jun 28 05:15:25 EDT 2008;Committer;akr;1;10;0;10;0
c8ab5d2dd9caca93f97857acf7d9e945384b2b20;Sat Jun 28 04:13:08 EDT 2008;Committer;akr;2;10;3;13;0
dd024197601d884b145edbd240707b91ceda95d8;Fri Jun 27 23:43:57 EDT 2008;Committer;suke;3;79;21;100;0
d080d174f5cd7d001bacdc8e53f4d42596ca86b9;Fri Jun 27 16:10:51 EDT 2008;Committer;svn;1;3;3;6;0
6e90749f807a42265e0346aa9db806723a07c7de;Fri Jun 27 16:10:46 EDT 2008;Committer;akr;3;20;0;20;0
e509574dea10ee5122ee6e7c56ebeeddc7e4d21c;Fri Jun 27 12:59:00 EDT 2008;Committer;akr;1;1;1;2;0
dfbf04166afce5162f7f66ec72c90b2953b5f0b3;Fri Jun 27 12:56:45 EDT 2008;Committer;akr;2;20;11;31;0
4bcf877beb7bc1b61f5e6c542619c7991fb5e399;Fri Jun 27 12:19:11 EDT 2008;Committer;nobu;3;15;5;20;0
8f03e4d2c574a46c81a9c9a59472d650345de64a;Fri Jun 27 09:35:53 EDT 2008;Committer;matz;2;6;1;7;0
f0bb63782a2102cf5d353f9b0828370bb5ad85c6;Fri Jun 27 08:48:24 EDT 2008;Committer;kazu;3;35;4;39;0
7a6cafc88e3b41e94d6473683580b36a39f59be1;Fri Jun 27 05:25:54 EDT 2008;Committer;nobu;2;6;0;6;0
f1d4745627f5f33fc0aa91904efca7fb26614ee8;Fri Jun 27 04:29:29 EDT 2008;Committer;nobu;2;3;3;6;0
2983df49d5d7b7747056c7be0a3553537b3cc5eb;Fri Jun 27 04:18:54 EDT 2008;Committer;nobu;3;15;0;15;0
73567dc1037735de8c8abb7b5412ba52bedd767a;Fri Jun 27 03:29:00 EDT 2008;Committer;nobu;2;55;16;71;0
3d5cfe9a3211de22c959ae39ecabb61f230c52b4;Fri Jun 27 02:06:08 EDT 2008;Committer;nobu;2;9;0;9;0
285066dd0bc256fc6b197ac6e55c51b39a574924;Thu Jun 26 21:53:40 EDT 2008;Committer;ko1;3;8;2;10;0
d4cddaaa4ce60dd5d35e85da4436236a287a622b;Thu Jun 26 21:52:44 EDT 2008;Committer;ko1;2;11;4;15;0
d7a87286a718cc1415b9e4816753de4d36ac5f03;Thu Jun 26 15:00:31 EDT 2008;Committer;svn;1;3;3;6;0
de1527370242686697e0b06f301df543319ed0c9;Thu Jun 26 15:00:16 EDT 2008;Committer;nobu;2;7;2;9;0
478d1da7fa024606ffbea869118d26710945c81d;Thu Jun 26 14:58:59 EDT 2008;Committer;mame;2;14;14;28;0
94dc6bdd7a524d5a4acf344b1e1e3608d7d140dd;Thu Jun 26 08:47:30 EDT 2008;Committer;matz;1;1;1;2;0
4524572f79fcb3167b347e4ab80373d78486b36b;Thu Jun 26 08:44:59 EDT 2008;Committer;matz;2;6;0;6;0
8b424513fd43c398aaeea5dede8bbc5c51602773;Thu Jun 26 02:06:00 EDT 2008;Committer;drbrain;29;513;238;751;0
dbf3fb3d8e6e10e2ac2af19937e0016a4815ca50;Wed Jun 25 15:49:21 EDT 2008;Committer;svn;1;3;3;6;0
d8c930dd06254f155e06872b64a6529cdb0232ab;Wed Jun 25 15:49:17 EDT 2008;Committer;matz;2;12;0;12;0
89080e02549b607d737f81e5868ff3396d537d97;Wed Jun 25 12:55:47 EDT 2008;Committer;matz;5;21;5;26;0
d02ef8342cb24af29aff64ff7985594845989bdb;Wed Jun 25 06:28:53 EDT 2008;Committer;nobu;2;7;2;9;0
f94c46a7454c50311654579c90108ea8de4ef07f;Wed Jun 25 04:44:32 EDT 2008;Committer;naruse;2;10;5;15;0
30e263fc07fb66bb0a545da5540fecaf37d8c071;Wed Jun 25 03:10:57 EDT 2008;Committer;naruse;2;5;1;6;0
8eb4988a033509c1dcf5a2f315cd92a98d8e53b6;Wed Jun 25 00:33:11 EDT 2008;Committer;naruse;3;8;3;11;0
f32f40cc495d9372cc71a1131ee8298e6bb46cd1;Tue Jun 24 13:16:44 EDT 2008;Committer;mame;2;8;0;8;0
238738f31494c3bb88d6762efca170a89c1801b4;Tue Jun 24 13:11:21 EDT 2008;Committer;suke;2;25;4;29;0
ac531a8aa8aff6776c0525fc25381d5d4a483753;Tue Jun 24 08:20:42 EDT 2008;Committer;nobu;2;68;58;126;0
a0e7746d78b22585b7f3efd3bc7aa298305c567c;Tue Jun 24 08:05:06 EDT 2008;Committer;usa;2;5;1;6;0
404dda971615ce4ab6ced7ba8eaf0fedd5d29497;Tue Jun 24 07:54:05 EDT 2008;Committer;usa;2;6;6;12;0
5bf133eb50127e757f56442c8594a914728140aa;Tue Jun 24 02:37:51 EDT 2008;Committer;usa;1;13;2;15;0
d3a0ef8198bf3257f37cf1149553b77981b85eab;Tue Jun 24 02:14:00 EDT 2008;Committer;usa;4;43;4;47;0
b6cab6e8f1a443d4b8c56b4936cc454fa75c28f4;Tue Jun 24 01:26:54 EDT 2008;Committer;usa;1;7;5;12;0
1a13281ab7d03cea082e4c6fbf2a9d5d12f7a177;Tue Jun 24 00:41:38 EDT 2008;Committer;usa;2;8;0;8;0
59e103794e793682eb431349280fb62871e9ba9e;Mon Jun 23 15:23:12 EDT 2008;Committer;mame;2;8;2;10;0
a1c3a776e8d3a80e7eb9c3f9107a61870a4a4e26;Mon Jun 23 15:12:38 EDT 2008;Committer;svn;1;3;3;6;0
266a84c90492835c819581ac96bd2dcb52605025;Mon Jun 23 15:12:29 EDT 2008;Committer;wanabe;2;6;8;14;0
6b20b1e464905630f1085b5b55f7d3a728137d9f;Mon Jun 23 03:36:29 EDT 2008;Committer;svn;1;3;3;6;0
473acf0a319a4d5b83285cb21f2bf633b68c0820;Mon Jun 23 03:36:25 EDT 2008;Committer;matz;2;5;44;49;0
3f1f29037d2fb138a6f645823906320790bee95f;Sun Jun 22 05:16:30 EDT 2008;Committer;nobu;2;18;9;27;0
fa57f78b9b1c5a1e80ddc5114949479791e02872;Sun Jun 22 00:51:17 EDT 2008;Committer;nobu;2;11;0;11;0
3381bd94d175bc5cc369bb3aeb210be24da49d3f;Sun Jun 22 00:24:45 EDT 2008;Committer;shyouhei;2;8;0;8;0
275c6951cc2cda02810d5f023e3d61dc10f3984d;Sat Jun 21 16:12:00 EDT 2008;Committer;usa;1;2;1;3;0
0463e736d85114efe8c962ab87b8f62a16fbdd9d;Sat Jun 21 16:10:59 EDT 2008;Committer;eban;1;0;2;2;0
c6f664fbf222acbfbacecf015bf556f62e64ad8f;Sat Jun 21 16:09:31 EDT 2008;Committer;svn;1;3;3;6;0
2d305a251dc91f07cf5bccabcf67c05767ee49ee;Sat Jun 21 16:09:28 EDT 2008;Committer;eban;1;1;0;1;0
eedf67a8af1582a15c9fbadc154e0dbb1ade77c5;Sat Jun 21 16:06:39 EDT 2008;Committer;eban;1;21;4;25;0
2712b6827204267d858a65af8d0b33eb0a9ba144;Sat Jun 21 16:06:03 EDT 2008;Committer;svn;1;4;21;25;0
02aa4bb020c22594521ef3fb9ea1b059df6f16aa;Sat Jun 21 16:06:00 EDT 2008;Committer;eban;1;1;0;1;0
00e6cbb0a890a3a8adda6874fba534a250b4eaf3;Sat Jun 21 16:01:41 EDT 2008;Committer;eban;1;21;4;25;0
15bb75646ac70f5de3c1e1fa0e903b4691b20d96;Sat Jun 21 16:00:41 EDT 2008;Committer;svn;1;4;21;25;0
6852497a13f7b7e347a056f6e35bc01a35200b6e;Sat Jun 21 16:00:38 EDT 2008;Committer;eban;1;0;1;1;0
b12d241ab07df8a042b9e7232271e3c28e2debd6;Sat Jun 21 16:00:02 EDT 2008;Committer;eban;1;21;4;25;0
88a0e3c0d4f1b0e6f0db7e3ad2bcc81785937d97;Sat Jun 21 15:55:37 EDT 2008;Committer;svn;1;4;21;25;0
e30a62f1ff2f7ffc9240b2dbe5b948bf5a5de1ea;Sat Jun 21 15:55:30 EDT 2008;Committer;eban;1;1;0;1;0
19861f925a6f959551768a4d0e77582110aab9cc;Sat Jun 21 15:49:38 EDT 2008;Committer;eban;1;57;0;57;0
f977e38f3cacecbe36c907b3e2cb51cba9d8d84b;Sat Jun 21 15:45:20 EDT 2008;Committer;svn;1;0;40;40;0
7c936bcbb7f39894c429a40f0ca2199b4b8ebbf0;Sat Jun 21 15:45:16 EDT 2008;Committer;usa;2;21;3;24;0
8fc91349e91bdcf3484ebc617ee3179228663a85;Sat Jun 21 15:41:03 EDT 2008;Committer;svn;1;4;21;25;0
d8bac5578899248771355ca9b6b02255af5e932f;Sat Jun 21 15:40:59 EDT 2008;Committer;usa;2;9;0;9;0
56ae14a4f7e4e310d65da437260b21979a06b21b;Sat Jun 21 15:18:04 EDT 2008;Committer;usa;1;16;16;32;0
a9730c786e52db80a19c62e30a567739bdf45c41;Sat Jun 21 15:08:57 EDT 2008;Committer;usa;2;27;0;27;0
5f2183f6b37dd24ece0f06636fd83c894d060f84;Sat Jun 21 08:34:42 EDT 2008;Committer;usa;2;4;4;8;0
8724448ed5eacc86f903f85b6eb87895714b8569;Sat Jun 21 07:48:29 EDT 2008;Committer;usa;2;10;0;10;0
d2c3d9dd0b9ed4d587654ce68bdbc8663a77b9df;Sat Jun 21 07:29:05 EDT 2008;Committer;nobu;2;11;78;89;0
a2b83212d6cf280d13cc2e00d613fa5fe140a5c1;Sat Jun 21 07:21:10 EDT 2008;Committer;nobu;2;14;5;19;0
47f5c15e8d6a6c78703b363e9fd351ac44b616e1;Sat Jun 21 06:57:28 EDT 2008;Committer;nobu;2;11;2;13;0
3d9c550bf91da943f196e71c821953c20ca601dd;Sat Jun 21 06:54:58 EDT 2008;Committer;nobu;2;62;0;62;0
7ae9072fdf5856abb3197e08dac030bbcb5cad52;Sat Jun 21 06:31:18 EDT 2008;Committer;nobu;2;139;99;238;0
50d48fcfc889361483af53d14f69d38457c2fe2d;Fri Jun 20 23:39:45 EDT 2008;Committer;nobu;2;10;7;17;0
b8b6c4894acd51b9f21a2a792ef0a710d2c5dc35;Fri Jun 20 19:41:29 EDT 2008;Committer;matz;2;3;1;4;0
09f4a8643c63c67eb7aeada1da5461b9167b2fbc;Fri Jun 20 19:39:36 EDT 2008;Committer;matz;3;9;4;13;0
a889f3405f15bc2996dc307c5593a538986816ff;Fri Jun 20 16:02:21 EDT 2008;Committer;shyouhei;3;18;7;25;0
7ba5c4e83b90a2e66ca3b3b7619b5d4565eaec4b;Fri Jun 20 14:00:35 EDT 2008;Committer;akr;2;33;14;47;0
e1a45b10b6165c8fec505180a52c4ce58fb21e91;Fri Jun 20 06:42:07 EDT 2008;Committer;nobu;2;30;46;76;0
72dd5fdc47e1ec78055cd4028b032ea62d50d8c9;Fri Jun 20 06:40:10 EDT 2008;Committer;nobu;1;7;0;7;0
a54cbe65a9e35fdea4f9989017dcd87ebb2e68a7;Fri Jun 20 03:40:02 EDT 2008;Committer;nobu;3;23;2;25;0
79bb49b61ba9a614a401e22b4563a5ee7e2a5725;Fri Jun 20 03:29:19 EDT 2008;Committer;nobu;1;1;1;2;0
feb400081b5411213e7fe6f653c9be92891edfef;Fri Jun 20 03:19:38 EDT 2008;Committer;nobu;1;3;2;5;0
6b33d77c4be3d5471be60f95ec65f94aaab2dd4f;Fri Jun 20 03:14:23 EDT 2008;Committer;matz;2;16;9;25;0
04739ba61744046ac145b384aa9053429c80142f;Fri Jun 20 02:46:17 EDT 2008;Committer;akr;7;107;18;125;0
3af6dda231c26524b65a02f8212d91ce37618aa9;Thu Jun 19 23:12:46 EDT 2008;Committer;shyouhei;3;26;8;34;0
a556543f74d2b35be8b3a67208ff68e758b7253a;Thu Jun 19 18:27:14 EDT 2008;Committer;usa;2;5;1;6;0
56dda0e6056af8db8b738684d5640e23565a3a49;Thu Jun 19 18:20:30 EDT 2008;Committer;mame;3;16;9;25;0
08837d081d764af01a30d325007c3c9527e383a6;Thu Jun 19 18:15:26 EDT 2008;Committer;drbrain;10;82;9;91;0
4394ffe521ca03b22761ce4d4afed6645a62ea3d;Thu Jun 19 18:02:40 EDT 2008;Committer;mame;2;9;2;11;0
e76afc29d8ab491bd69a86504315c4a5dde9616c;Thu Jun 19 17:17:29 EDT 2008;Committer;matz;2;5;1;6;0
5336cbdfd33b90c92069f55d8c0ba6df4cf66a0e;Thu Jun 19 17:11:55 EDT 2008;Committer;matz;3;22;19;41;0
e929f49e564dab959e6df43bb7e3621d74e8c3c5;Thu Jun 19 16:08:16 EDT 2008;Committer;ko1;3;11;8;19;0
e7dac48a9190169a241865cd706566b52e07b3b7;Thu Jun 19 15:43:25 EDT 2008;Committer;ko1;3;28;0;28;0
af94c81302cd778d5e62ddae714e52c891f69d38;Thu Jun 19 15:19:38 EDT 2008;Committer;ko1;3;8;4;12;0
8d4f4e25e5d4bdaf70e84e1615e6db227c1a96b4;Thu Jun 19 14:49:39 EDT 2008;Committer;mame;2;6;0;6;0
da3be0f3d323771b5dcfbc828375067ddc4ee611;Thu Jun 19 14:47:04 EDT 2008;Committer;mame;3;86;79;165;0
4b645dc8f3cb6c3a58ccd9b85962f743399dc797;Thu Jun 19 14:18:46 EDT 2008;Committer;mame;4;84;25;109;0
b44d0b98d8f63385da9d3744c3e0a58f8f0dfa4e;Thu Jun 19 13:26:37 EDT 2008;Committer;akr;1;8;0;8;0
8aa74a17efa7d576d0d39cff3a3ca19392d9a24b;Thu Jun 19 12:43:57 EDT 2008;Committer;nobu;1;5;10;15;0
88a374f59fbda367c2c6e18c9fefd229bc8e4e83;Thu Jun 19 12:38:10 EDT 2008;Committer;nobu;1;4;0;4;0
0a3b48750445f1fe18b05ee3fae4910de43f421d;Thu Jun 19 12:35:35 EDT 2008;Committer;nobu;2;88;22;110;0
2bcb0a1a353f6b1ce0e2f1be6eb11e5af69ae546;Thu Jun 19 11:42:05 EDT 2008;Committer;kazu;2;8;4;12;0
350e6ed84b4ee661b2da255d298b9060991375ee;Thu Jun 19 08:45:25 EDT 2008;Committer;matz;2;9;6;15;0
c3ab4a4b1bab1dd8276c97306195361021822357;Thu Jun 19 08:39:03 EDT 2008;Committer;matz;2;12;7;19;0
768380583a4a2527994fa33e78fdcfbeee20b6a8;Thu Jun 19 08:25:50 EDT 2008;Committer;matz;2;12;4;16;0
363b0bddde815a459f04e1d167d56bd1f498275c;Thu Jun 19 07:51:46 EDT 2008;Committer;usa;2;14;0;14;0
6bb934c482e360b1713ca692301c30a6277f4bd3;Thu Jun 19 07:08:06 EDT 2008;Committer;nagai;2;14;9;23;0
1bc6479a8830f26c821003de1818f4750ab5cc26;Thu Jun 19 02:49:28 EDT 2008;Committer;ko1;2;5;0;5;0
c3e619c83dcd3223cb6d17d5a1884039b5d0cc4f;Thu Jun 19 02:46:02 EDT 2008;Committer;ko1;4;57;16;73;0
33e5cfee7b90ec800e4546c6a0c0a73c2a66d73c;Wed Jun 18 15:34:46 EDT 2008;Committer;mame;3;14;6;20;0
87d053f0002ebf9a3927412a85ea0a09bd06f705;Wed Jun 18 14:09:33 EDT 2008;Committer;shyouhei;2;8;0;8;0
29ad22694f6f105de4d0322548d6551ecdadbb26;Wed Jun 18 12:08:16 EDT 2008;Committer;nobu;2;10;4;14;0
80243ab3869c9f317eba4d608168e21c3813cfce;Wed Jun 18 11:36:59 EDT 2008;Committer;kazu;1;1;1;2;0
19e22ae8f415441190837956f50e64ae07ccff52;Wed Jun 18 11:36:42 EDT 2008;Committer;kazu;1;2;2;4;0
6f7e284257fc89dbc7d9a967e889d84cfddf7353;Wed Jun 18 11:28:27 EDT 2008;Committer;usa;1;3;3;6;0
3dd2370e04c44c0b136ce73ebebd4b5de6271102;Wed Jun 18 10:40:05 EDT 2008;Committer;naruse;1;1092;0;1092;0
dccf0183e9015396d92c02cb4c162476639f7f57;Wed Jun 18 10:23:25 EDT 2008;Committer;usa;1;4;4;8;0
2c66adba64c82c5c328c909c6b2c2dabf0f954c4;Wed Jun 18 10:22:06 EDT 2008;Committer;usa;2;7;1;8;0
18abca0e68a53478b475ef39e3127a943ba5d8d3;Wed Jun 18 09:45:41 EDT 2008;Committer;usa;1;2;1;3;0
ad24701cceb53750abae8b0a86db44bc86a8c746;Wed Jun 18 09:32:03 EDT 2008;Committer;usa;2;21;2;23;0
32c63d1f3567a8b096c13ebf1c77621abc0a8d78;Wed Jun 18 09:10:04 EDT 2008;Committer;usa;2;14;5;19;0
6874320d20763fdc77d915aac71cfe7ecdd1a000;Wed Jun 18 07:28:24 EDT 2008;Committer;usa;1;25;11;36;0
58d694fcdb247ca3ba66e12eb0cae97a3dda4cea;Wed Jun 18 06:07:38 EDT 2008;Committer;naruse;2;8;1094;1102;0
a966b61fd2064241c9a0c9624c7329b5b1569c81;Wed Jun 18 05:52:32 EDT 2008;Committer;usa;1;8;3;11;0
235df5064824ab4e84f89d2208bc7437cd490ed5;Wed Jun 18 05:31:35 EDT 2008;Committer;naruse;2;5;1;6;0
844952338be1dcc2fc2e726af14cdc76c3b7ac94;Wed Jun 18 04:51:08 EDT 2008;Committer;usa;2;7;1;8;0
02337b089e76a70ffc269beda8d778a175d575d3;Wed Jun 18 03:05:33 EDT 2008;Committer;nobu;4;22;14;36;0
3c48ebce0b2f68c8c7637cc1824610301daf3935;Wed Jun 18 01:18:13 EDT 2008;Committer;nobu;2;7;2;9;0
215fbc639fc63d4300a91ae4c8e30865f6a03f3c;Tue Jun 17 23:59:31 EDT 2008;Committer;drbrain;10;77;81;158;0
9d4f37f51fb2ffdef5e318afb3cb81516dcba4f7;Tue Jun 17 22:04:18 EDT 2008;Committer;drbrain;71;3721;1083;4804;0
f98e6b91dec68ddd010ccb3bad651a18e7dca338;Tue Jun 17 19:29:38 EDT 2008;Committer;ko1;3;19;15;34;0
00e4fd42f36fa23de04cccb9cea3c3e5d14c9ae9;Tue Jun 17 19:27:24 EDT 2008;Committer;ko1;5;125;23;148;0
e2f37fb9c6c9df54b2be78d09de00aa7da0d694f;Tue Jun 17 16:53:46 EDT 2008;Committer;nagai;2;9;3;12;0
fcf931c0e5992bb7fbb7b8b18ce78bb2cd899cf8;Tue Jun 17 15:05:50 EDT 2008;Committer;usa;3;10;6;16;0
b2c5258b854e6a19306300428718d5c83303a85b;Tue Jun 17 14:04:48 EDT 2008;Committer;jeg2;2;7;2;9;0
3e30cdad087fb4cb7a6e320f1934937e9688c919;Tue Jun 17 14:02:20 EDT 2008;Committer;nobu;2;11;5;16;0
d7baa40cac61f9d3af3c5a8b615ca0dd303cb8c2;Tue Jun 17 13:06:34 EDT 2008;Committer;mame;4;16;6;22;0
42eabfcca25d988b764412e18c3dec5208864a7e;Tue Jun 17 12:58:31 EDT 2008;Committer;nobu;1;4;2;6;0
a9934cb0982095dc68b2bf952775f658c2a691f8;Tue Jun 17 11:32:40 EDT 2008;Committer;nobu;2;19;13;32;0
c6e2c05b2083439e87af1faecc47edb967246a1c;Tue Jun 17 09:41:05 EDT 2008;Committer;ryan;2;43;39;82;0
5e54153132d4bee7e9e484143f7b984663c37feb;Tue Jun 17 09:11:28 EDT 2008;Committer;usa;2;5;1;6;0
62617789ed43d4d584dc38bdfb80f3cc1cade7d8;Tue Jun 17 08:31:41 EDT 2008;Committer;usa;2;6;1;7;0
124aab6ad4b33ac3871d25865fd82fdf30617dbc;Mon Jun 16 22:29:05 EDT 2008;Committer;naruse;2;111;16;127;0
e3aa138e53287212fbf1e8528b58850c8a2c7f21;Mon Jun 16 21:31:56 EDT 2008;Committer;naruse;2;97;20;117;0
2755479bd9224d8cdbe9b58790cd8a38fc38d1cd;Mon Jun 16 21:28:03 EDT 2008;Committer;naruse;3;23;0;23;0
aaf1b728730be8012b915ce498e4f793586ec46b;Mon Jun 16 21:25:17 EDT 2008;Committer;naruse;3;8;3;11;0
77773831db5234d1cdcb25a5325f475aa11afa36;Mon Jun 16 18:50:53 EDT 2008;Committer;nagai;2;2;2;4;0
5ebf7049532575d8e57677a4e5bf61753c0c35e4;Mon Jun 16 16:54:50 EDT 2008;Committer;nagai;4;31;9;40;0
1723931102da715e5d9c8e5fbc8ab3756eaa1151;Mon Jun 16 14:56:14 EDT 2008;Committer;nobu;1;2;2;4;0
51fbc0699cb972d6f328b15ddfd2173bb8cebe70;Mon Jun 16 12:58:41 EDT 2008;Committer;nobu;2;5;2;7;0
82543dbc999091c921cd1ce76ed84ff79e306937;Mon Jun 16 09:52:50 EDT 2008;Committer;nobu;2;6;1;7;0
3929de6982f84b87424a0b5c873683296134a1a2;Mon Jun 16 05:46:28 EDT 2008;Committer;nobu;2;5;1;6;0
a938a521265d77aee40f45a1c4cb0bc16cb8e705;Mon Jun 16 00:49:25 EDT 2008;Committer;knu;3;13;7;20;0
959383cb10a0e0bda3352fd426aa1c91b2ebafc4;Sun Jun 15 22:14:51 EDT 2008;Committer;nobu;2;8;1;9;0
faa93e847da75c0b8f5bae70f8362f22865388a6;Sun Jun 15 16:50:37 EDT 2008;Committer;ko1;4;44;28;72;0
1c4f7a4c642f539f0bfc6db4234dde99d19c2b16;Sun Jun 15 16:49:19 EDT 2008;Committer;ko1;2;5;1;6;0
9ead0d771ba70c87f434748bf6309f839a4a3f90;Sun Jun 15 16:48:02 EDT 2008;Committer;ko1;4;16;11;27;0
818bb6dd219691dc3964124008eb2856b6f8ce27;Sun Jun 15 09:42:32 EDT 2008;Committer;naruse;2;8;0;8;0
9b45b336ee97477b9c8a81143ee47c52d801412b;Sun Jun 15 09:17:06 EDT 2008;Committer;nobu;7;43;10;53;0
e7a660a3cfe9a8747b0a5f5b0c88019f5a19bbce;Sun Jun 15 02:18:06 EDT 2008;Committer;akr;2;2;2;4;0
2e35696bbec28b0f0252292191ba38d8164da3a2;Sun Jun 15 02:13:16 EDT 2008;Committer;akr;1;43;1;44;0
1a155ee7f697f8dd791bda46afc2be2ebe806207;Sat Jun 14 13:52:41 EDT 2008;Committer;nobu;2;6;1;7;0
1df1cb307ee5dbd8096e3d284f98a8358f5adce3;Sat Jun 14 07:56:06 EDT 2008;Committer;nobu;2;8;3;11;0
fc3c60f6081d85f6274986a7a08b59db1515fcb5;Sat Jun 14 02:59:19 EDT 2008;Committer;nobu;7;163;106;269;0
436b02b3322d6809c2bf4cbadbe8b324a53e07e4;Fri Jun 13 22:57:41 EDT 2008;Committer;akr;3;16;4;20;0
4641b801664008c7ae509a79354da1bc84b6fc1c;Fri Jun 13 15:09:22 EDT 2008;Committer;nobu;4;23;10;33;0
e0d427e855e514c758ffc8f776539abe70ad12d4;Fri Jun 13 12:59:22 EDT 2008;Committer;tadf;2;11;0;11;0
c7f4ebc8b703bc5d674752299e8190f424e92189;Fri Jun 13 12:29:50 EDT 2008;Committer;tadf;4;44;16;60;0
05093ae437c8c45849c66f010ab24b32236dfb6a;Fri Jun 13 09:10:44 EDT 2008;Committer;akr;2;12;2;14;0
6fc17f1f7b792579360aa9eab2b3b574071bc0d6;Fri Jun 13 08:22:13 EDT 2008;Committer;wanabe;2;13;3;16;0
01d715215735fc836485e97dd2c4d5f8fcfb22a2;Fri Jun 13 08:16:12 EDT 2008;Committer;wanabe;2;10;1;11;0
26f26890aae734fba47ae06903da8692e874249a;Fri Jun 13 05:56:51 EDT 2008;Committer;usa;2;10;1;11;0
074a876df50f2c42563683713eb1df4b8be4bc4b;Fri Jun 13 05:46:48 EDT 2008;Committer;usa;2;30;13;43;0
32ef17fe7b69417d0c1d54b94105e3603fafe832;Fri Jun 13 05:24:40 EDT 2008;Committer;nobu;2;4;2;6;0
847786069403bce010d42e0da6f6b80223dd02b9;Fri Jun 13 05:19:01 EDT 2008;Committer;nobu;2;7;3;10;0
97c8c1fa0e2770973c5911ef24708d13fb8a34b4;Fri Jun 13 04:02:36 EDT 2008;Committer;matz;3;14;5;19;0
283826f751e9447485bd322ea108daf8b9b824d4;Thu Jun 12 16:51:12 EDT 2008;Committer;nagai;3;12;6;18;0
bbcd6dfc96c0273f4bf83e89286eed03ccd2b045;Thu Jun 12 15:42:14 EDT 2008;Committer;mame;2;26;0;26;0
5734e59aed24ba2f6f77949778a29e0d9faa4f40;Thu Jun 12 14:33:07 EDT 2008;Committer;mame;2;5;0;5;0
4b022866eec600f3ed03ed57d5f7b05f09946b10;Thu Jun 12 13:20:55 EDT 2008;Committer;usa;2;10;4;14;0
6f5aaff73b2b4e17666308dde93e1ac4edb3927d;Thu Jun 12 13:01:38 EDT 2008;Committer;mame;7;294;40;334;0
2b66844f487574e2bcce1e3697883452d1f5d7fc;Thu Jun 12 12:41:17 EDT 2008;Committer;tadf;3;85;180;265;0
42144753314a7e3ff65e0107e18ed2b7401a6b00;Thu Jun 12 08:21:38 EDT 2008;Committer;matz;2;6;1;7;0
69fa5eea6a2b1f658ed21263f17699393b04bc6e;Thu Jun 12 04:46:16 EDT 2008;Committer;akr;2;6;1;7;0
53f0a8ade14ff8bb82cc1c7cd4c28139acdd4734;Wed Jun 11 23:52:20 EDT 2008;Committer;matz;3;16;10;26;0
d222472299a9c2ce8fc094c162f1acd2f4199403;Wed Jun 11 17:50:03 EDT 2008;Committer;mame;3;8;2;10;0
9e412b83a0d3476b100ba7f46e9c22c8417c1d6c;Wed Jun 11 17:43:52 EDT 2008;Committer;mame;2;5;4;9;0
1d09b69f62d1f779f4f446a743036b6fe8c5d59a;Wed Jun 11 17:25:57 EDT 2008;Committer;nobu;4;16;3;19;0
cf508bfedad6613d69b1d784a3a804538eae55d0;Wed Jun 11 15:56:22 EDT 2008;Committer;nobu;6;108;283;391;0
a999490fe3832b0706816890eccfe6699b4737aa;Wed Jun 11 14:54:23 EDT 2008;Committer;matz;2;21;1;22;0
2dc5f35a3a1baabeed4d13bfee1ee6b504d45cf9;Wed Jun 11 03:16:28 EDT 2008;Committer;akr;2;23;3;26;0
8ec04b569e49a082262d6c877519babc184f263f;Wed Jun 11 00:27:36 EDT 2008;Committer;usa;2;5;1;6;0
aaa90dddfb0ca864f4bf5f6fa319f8a76539855a;Tue Jun 10 23:23:36 EDT 2008;Committer;akr;1;1;1;2;0
3863e54bbf9777d9d929b59ed1d5f183ab960ff0;Tue Jun 10 23:21:26 EDT 2008;Committer;akr;1;1;0;1;0
9e324fdd3ef0b858f6c5dfea1d0055d77979a3a2;Tue Jun 10 21:46:43 EDT 2008;Committer;ko1;17;241;190;431;0
e6697a6405f1330ef071220396b8afef1cd1079a;Tue Jun 10 20:59:10 EDT 2008;Committer;nagai;220;7100;1265;8365;0
af0c875e26280869f216f69608919a8c721e4c68;Tue Jun 10 18:41:25 EDT 2008;Committer;knu;2;7;0;7;0
ed4139e39bb3ceda2985b2ea2ebd9a91479d25da;Tue Jun 10 16:33:51 EDT 2008;Committer;ko1;8;56;22;78;0
8b7a284b65cdc1ebb71cff34db473af1b17390d1;Tue Jun 10 12:08:45 EDT 2008;Committer;kazu;2;7;0;7;0
e585bc3c2f58588b00a3d75563b6522785e0c9ec;Tue Jun 10 11:56:23 EDT 2008;Committer;tadf;2;5;2;7;0
f95521702822e8bdbe10a03f2e796dab0370aeba;Tue Jun 10 11:13:58 EDT 2008;Committer;nobu;2;10;3;13;0
6f8bf830b44c9394a6afed4b02ecd4bc6b960342;Tue Jun 10 09:12:19 EDT 2008;Committer;nobu;2;7;1;8;0
dd6f7fbaef4be05435870399a44ae98356ea1399;Tue Jun 10 08:44:30 EDT 2008;Committer;matz;2;5;1;6;0
25de6b00875034e12773609a309df7f3c3391d5c;Tue Jun 10 08:30:21 EDT 2008;Committer;nobu;2;7;0;7;0
1f0cad56f94b9b9ef12159da49d91728730d339f;Tue Jun 10 08:03:16 EDT 2008;Committer;wanabe;1;1;1;2;0
eff06d7ae640aa541b74b6ee24adcd2503b68bc3;Tue Jun 10 08:01:09 EDT 2008;Committer;wanabe;2;7;0;7;0
4fd154d05e4de3d2c369281576c872bd180f7bd9;Tue Jun 10 06:15:10 EDT 2008;Committer;matz;2;5;2;7;0
ad494f67ddebcb21b2a0f5a1b8f1a3d17ef9f39a;Tue Jun 10 03:58:09 EDT 2008;Committer;nobu;2;5;1;6;0
a31f177eaa0bdf610d2af3967111adfba334ff1d;Tue Jun 10 03:43:33 EDT 2008;Committer;nobu;2;8;4;12;0
7799fe9e9f63065263710ac773c178a6c5c8b856;Tue Jun 10 02:25:18 EDT 2008;Committer;nobu;2;6;1;7;0
53ea4c0cbdefeec9f257da577b689368a9de767f;Tue Jun 10 02:24:45 EDT 2008;Committer;nobu;3;8;8;16;0
f2400eca0b30cb60273c9526b4501dbe4bcca50f;Mon Jun 09 15:52:51 EDT 2008;Committer;mame;9;41;14;55;0
4879ae65fde1f7cd9b6133fe9e732d0ddcfadc12;Mon Jun 09 15:13:45 EDT 2008;Committer;tadf;2;20;14;34;0
52654587548e5acacffd34d403b6a10ffaca9989;Mon Jun 09 15:11:38 EDT 2008;Committer;akr;2;5;1;6;0
58496686946ee56978256a7fba35800ad762e6e9;Mon Jun 09 14:25:39 EDT 2008;Committer;akr;2;4;1;5;0
62b6a462d733a5c0cf2ea947e2f13efce15fd06b;Mon Jun 09 13:49:16 EDT 2008;Committer;wanabe;2;8;6;14;0
fc0babb4c2ce8eaff3549f4502fb32d056482b31;Mon Jun 09 12:17:29 EDT 2008;Committer;nobu;2;7;1;8;0
e2958af0b78c2431b6127e8bc7f4397cf0b123b3;Mon Jun 09 12:15:53 EDT 2008;Committer;ko1;4;114;108;222;0
ce29c1787731c8172b5210479459e772aef03bc8;Mon Jun 09 12:14:39 EDT 2008;Committer;nobu;3;12;0;12;0
fe54190f68fa3326ea933bacc100f88878031797;Mon Jun 09 12:10:43 EDT 2008;Committer;ko1;4;117;108;225;0
a20cf402cfa15e0f078e2750dc0fc17c44b529f6;Mon Jun 09 12:02:29 EDT 2008;Committer;tadf;3;37;26;63;0
f8ef02adc40e364107bb7629cf9eca1e9097309a;Mon Jun 09 09:51:21 EDT 2008;Committer;nobu;1;6;6;12;0
5a647a3f5fd011f8558c7f9e90cd65e70e73eb40;Mon Jun 09 09:25:32 EDT 2008;Committer;nobu;32;141;85;226;0
250dd0702111d5c2086f007b1b31ecc1e36ade40;Mon Jun 09 08:58:30 EDT 2008;Committer;knu;2;39;3;42;0
507f89d33fb2c3fb7180dfda1a27364819f67f32;Mon Jun 09 08:48:41 EDT 2008;Committer;akr;2;20;4;24;0
3854be4322afc4c90dafef6f7907354b7bbd83d7;Mon Jun 09 06:41:06 EDT 2008;Committer;matz;2;10;6;16;0
66054b9e3d3c5cfe05db0fbda565fc2b05b72a5e;Mon Jun 09 06:40:02 EDT 2008;Committer;matz;2;5;1;6;0
e39b93b86e0e5c6da6865b1dae3e099ef3d4eae3;Mon Jun 09 05:42:04 EDT 2008;Committer;nobu;2;10;8;18;0
85976cf893ea57d33bb3d1b34d58f1482720ec6e;Mon Jun 09 05:39:57 EDT 2008;Committer;nobu;1;6;4;10;0
6cdc89332e183d16061c0216ed158cb11a0629c6;Mon Jun 09 05:18:03 EDT 2008;Committer;nobu;6;40;10;50;0
9fb521515d8ba0fb22c75e82573afdb419d22876;Mon Jun 09 04:20:07 EDT 2008;Committer;nobu;4;66;52;118;0
efe5422e6a5497af6c7423bbbd7c5b0058fdfad4;Mon Jun 09 02:58:23 EDT 2008;Committer;nobu;1;2;5;7;0
10bfa5d49fd4b795999245fcfa3c358ed8c21f2b;Mon Jun 09 00:54:23 EDT 2008;Committer;nobu;3;7;1;8;0
ddf83922a2644adb320c8cff26bfaa5a6b4acedd;Sun Jun 08 23:16:46 EDT 2008;Committer;wanabe;4;10;15;25;0
7e6c9db4e22fd949e8a19ac1711f345529e9ebaa;Sun Jun 08 18:13:09 EDT 2008;Committer;ko1;3;19;123;142;0
ecc1dedabbb91ef3a8b14983c48fcb1b49a9be42;Sun Jun 08 17:35:41 EDT 2008;Committer;knu;3;11;3;14;0
a5fdfa5884e56ecb700c0b241e8e57a8afa3b34f;Sun Jun 08 13:24:13 EDT 2008;Committer;wanabe;4;23;6;29;0
65ec3ed9ca7c74b0ac66abdf576720ddc6549717;Sun Jun 08 12:51:25 EDT 2008;Committer;mame;2;581;2;583;0
9393cc45c21ce536a3985b49b76ea5698fe79011;Sun Jun 08 11:18:54 EDT 2008;Committer;wanabe;2;7;1;8;0
a99140631cefb87bd2c443573f4e0de116072080;Sun Jun 08 10:27:06 EDT 2008;Committer;ko1;2;125;52;177;0
72ba13aa8e86eb7f12bd17737a689ad2ec214036;Sun Jun 08 10:01:40 EDT 2008;Committer;ko1;40;133;118;251;0
4a7311e12977ca2cd388f609c3c705ba219bfee5;Sun Jun 08 03:01:55 EDT 2008;Committer;akr;1;4;2;6;0
cd6414267feba67f039d0a419ae91ae50ea26cd7;Sat Jun 07 16:19:47 EDT 2008;Committer;akr;3;15;5;20;0
aaaab31d8b49244c0df11302788e8c5014909e23;Sat Jun 07 14:57:16 EDT 2008;Committer;knu;2;10;3;13;0
b5490da26bebca87d8bc7baa6b3d97e4b6f580c8;Sat Jun 07 13:15:04 EDT 2008;Committer;nobu;2;9;3;12;0
0455e8ea9a6a8d33840249806b03d75ea25820d8;Sat Jun 07 12:38:03 EDT 2008;Committer;nobu;5;15;5;20;0
126abc5c47a2467949021b493b2c742828224b30;Sat Jun 07 07:06:19 EDT 2008;Committer;nobu;2;6;2;8;0
c7144179bbd4a8349bee677e2d9c89b1df52f445;Fri Jun 06 16:26:05 EDT 2008;Committer;usa;3;14;7;21;0
bf4626ed723a122c43a9edf73d68873ed4ca56d5;Fri Jun 06 14:48:07 EDT 2008;Committer;ko1;2;89;80;169;0
12cec48616032e92c640614d45cc01843bb3db17;Fri Jun 06 12:52:30 EDT 2008;Committer;usa;3;16;1;17;0
76fc93643275b55d147f9fc685ccb7c60e72e992;Fri Jun 06 09:25:46 EDT 2008;Committer;nobu;5;15;21;36;0
6d5e291f7d25ae0f9b53ff7b94e09610fb55ccc7;Fri Jun 06 07:43:45 EDT 2008;Committer;usa;2;5;0;5;0
f6ec71fc4c0d149ed1682b574c06ab75f125b5b1;Fri Jun 06 06:05:44 EDT 2008;Committer;akr;2;9;4;13;0
8471463a4afba2a4e19ffdb87b72002862bed333;Fri Jun 06 03:21:43 EDT 2008;Committer;nobu;2;3;4;7;0
f1296598a2097e1e355307e16752b549f0f6b24c;Thu Jun 05 15:08:12 EDT 2008;Committer;akr;2;10;1;11;0
00aae60f73bd800d2789501a732cb6ab7c44e528;Thu Jun 05 14:57:05 EDT 2008;Committer;mame;4;59;0;59;0
5e9b9ff9cb1f7897eb08c1d4f22ae0e206340f49;Thu Jun 05 14:41:41 EDT 2008;Committer;mame;3;11;0;11;0
437af4f46fdc54cd348779f65bc12d2c962f1b18;Thu Jun 05 14:33:01 EDT 2008;Committer;mame;3;444;0;444;0
cbbc06dcf78ab65c60261805504d5a1adda9462c;Thu Jun 05 14:27:09 EDT 2008;Committer;mame;3;11;4;15;0
18d4c1f044a4422fde5dde381e0812296bf2b619;Thu Jun 05 13:52:02 EDT 2008;Committer;akr;2;20;5;25;0
eef10d71ddff0c5e6f7f5fe8f55d57a77075ebc9;Thu Jun 05 12:47:48 EDT 2008;Committer;mame;3;10;0;10;0
55fece63794c94af83cae9509211e680bde32961;Thu Jun 05 11:36:55 EDT 2008;Committer;knu;4;25;3;28;0
83b4c1c4248680697e39847aa68fe0b89a49fbaa;Thu Jun 05 11:24:40 EDT 2008;Committer;mame;2;5;1;6;0
7493685b3b9d9dfc980e8639422bb64ff2530cd5;Thu Jun 05 11:22:32 EDT 2008;Committer;mame;3;10;3;13;0
7e9e152526d3e5e2ee187d532f5e0ba9f4e63aa3;Thu Jun 05 05:35:00 EDT 2008;Committer;nobu;4;20;6;26;0
5d75d9bf3d3476a92d54d63b5080a59e615fdd9b;Thu Jun 05 05:03:46 EDT 2008;Committer;nobu;2;11;1;12;0
b35b33c7516d398e9e93e3e8309b9e5bb29a5267;Thu Jun 05 04:58:41 EDT 2008;Committer;nobu;5;143;27;170;0
28c5fe3c6cc1a55507916bcc0f777dc83e208b30;Thu Jun 05 01:58:49 EDT 2008;Committer;nobu;1;27;0;27;0
9eec758a1e574edbee84797463a00b832c5fcbea;Wed Jun 04 23:13:27 EDT 2008;Committer;ko1;2;5;1;6;0
d6ada9f14b4726b61f292a1f6d104bf297db1f74;Wed Jun 04 16:48:07 EDT 2008;Committer;mame;2;19;0;19;0
4a14d3c04b61851abffbf020bcdc82f5276a3d12;Wed Jun 04 16:30:03 EDT 2008;Committer;mame;3;148;3;151;0
c9977b82a83562d6b873095237cb1e8a95488ddf;Wed Jun 04 14:11:06 EDT 2008;Committer;mame;2;5;1;6;0
a690ad46989e47f8f5b3b0a97ca0136332b094d9;Wed Jun 04 09:55:14 EDT 2008;Committer;matz;2;20;2;22;0
e6c1752137349537c72f4438d34c990b26d0c71d;Wed Jun 04 09:37:38 EDT 2008;Committer;matz;58;96;91;187;0
106e48e5d86d20a4a288fd432d973ed69874b6d5;Wed Jun 04 08:52:25 EDT 2008;Committer;nobu;2;33;20;53;0
9812a3a49812af438ba15705933e7474f0d242b2;Wed Jun 04 06:46:54 EDT 2008;Committer;knu;2;9;4;13;0
205e542a89c6150edf440d53f82267163526fb93;Wed Jun 04 06:04:38 EDT 2008;Committer;akr;1;8;0;8;0
a76288cfc730e0a556e298e7316c5526e292095a;Wed Jun 04 04:07:01 EDT 2008;Committer;nobu;3;16;5;21;0
0ecd8c8bc2efe152b90023404fb3bd75c9706b13;Tue Jun 03 14:07:50 EDT 2008;Committer;mame;2;9;4;13;0
e6c7da504fac54fe5911503ee73f193cae8fd2e0;Tue Jun 03 13:37:59 EDT 2008;Committer;mame;2;5;1;6;0
9f42dfa0123a704a2144727af7a14d0b5a17b431;Tue Jun 03 13:34:48 EDT 2008;Committer;mame;4;219;0;219;0
87050da59fb29e098f32f5b941ea4091685c79ba;Tue Jun 03 13:26:38 EDT 2008;Committer;mame;2;131;0;131;0
a96cf7a7a5d984dcc3b87f297c3f55ff31fd308d;Tue Jun 03 12:43:45 EDT 2008;Committer;knu;4;61;0;61;0
3064bb9f8d74321ab79d2f37dd40a07d720f4edd;Tue Jun 03 11:04:18 EDT 2008;Committer;nobu;2;6;1;7;0
7e7cbad17eb6fc3b22f65ed98ea1c4d28afd2904;Tue Jun 03 10:34:45 EDT 2008;Committer;knu;2;11;1;12;0
552d3a5bcc9a78b460f75e190915331238fa1ef2;Tue Jun 03 07:06:23 EDT 2008;Committer;nobu;2;21;19;40;0
3bd80329185c4596ae069fbfa655417d8caae2bf;Tue Jun 03 06:13:22 EDT 2008;Committer;knu;2;5;1;6;0
54fbbb48847b4e98c64bcce37eff2349a594baae;Tue Jun 03 06:04:54 EDT 2008;Committer;knu;1;3;1;4;0
489bf84b9f95f45e6f1b232403f02939a93d159d;Tue Jun 03 06:01:29 EDT 2008;Committer;knu;2;6;20;26;0
ea40df71fcd67a1fa16205299ac25c803ab331e2;Tue Jun 03 04:42:32 EDT 2008;Committer;knu;2;39;3;42;0
a5c99283201bb66f61c216955dbfbffe683598e5;Tue Jun 03 04:36:28 EDT 2008;Committer;usa;2;6;1;7;0
10ffed17c992558fe51a146612df415a2b390714;Tue Jun 03 03:58:30 EDT 2008;Committer;knu;2;23;6;29;0
10451cd8d466dbe18567c988a705ab8d497ee825;Mon Jun 02 16:22:47 EDT 2008;Committer;mame;2;14;0;14;0
41a1a4ed7633e02965dc1de593d16b7e1635c129;Mon Jun 02 15:29:11 EDT 2008;Committer;mame;3;14;8;22;0
65670f9400fc16c0cb900b9b0f6851c3af93df2b;Mon Jun 02 13:30:38 EDT 2008;Committer;mame;16;699;3;702;0
e58dc6a96818c17dd32b3929fc0d9ad2b3a2bbd9;Mon Jun 02 12:57:18 EDT 2008;Committer;mame;4;22;0;22;0
7eb625425c3acb33ea712bc36bbe17302cfbca94;Mon Jun 02 12:45:42 EDT 2008;Committer;mame;5;94;11;105;0
8a5dd664e7dd66f63fdf7bf7b6ff2fdef715db3a;Mon Jun 02 10:18:38 EDT 2008;Committer;akr;2;13;0;13;0
eaa3ffbae8f20ddae208747db5310b113ffbbf71;Mon Jun 02 09:51:30 EDT 2008;Committer;nobu;3;41;1;42;0
c14780690131bf598c0a20dba58791f8d1c93881;Mon Jun 02 07:29:03 EDT 2008;Committer;knu;2;8;2;10;0
5b7464b047069a71cd37ea5f86b5f86c3d009702;Mon Jun 02 07:15:12 EDT 2008;Committer;knu;2;9;6;15;0
92623d3db8446d3033716af1ea85146a06b119ff;Mon Jun 02 07:10:35 EDT 2008;Committer;knu;3;20;9;29;0
edcbe2ac457af9e1937544a2f5590d4fa691c5a6;Mon Jun 02 05:49:33 EDT 2008;Committer;knu;1;0;3;3;0
dc6b616656f9152dd32c95bfd71157eec234af2a;Mon Jun 02 04:07:07 EDT 2008;Committer;usa;2;5;0;5;0
6a62b8e8037c3721e7f70dbe106da50df6fbfc37;Sun Jun 01 23:47:02 EDT 2008;Committer;nobu;2;9;5;14;0
7c5e3348f7d4902ad8eb94d84a0a3595fbcd2ce2;Sun Jun 01 19:55:25 EDT 2008;Committer;nobu;10;61;42;103;0
5397015d2e8c904dfbce3cc4a0884c9cbb47d8b2;Sun Jun 01 19:36:28 EDT 2008;Committer;naruse;2;8;0;8;0
8f05f7fe05154dada9988d704be3fac0229cbd62;Sun Jun 01 18:52:15 EDT 2008;Committer;nobu;2;5;0;5;0
9c13fc7d899582fe8b0612c609595917c42d68a6;Sun Jun 01 18:29:08 EDT 2008;Committer;naruse;2;21;1;22;0
ccb61351eab257e9b31ae6c7718febb237027ee8;Sun Jun 01 18:23:10 EDT 2008;Committer;naruse;5;18;11;29;0
9256f94d9a27c7a3adf9292b085141e32a4bc247;Sun Jun 01 03:23:50 EDT 2008;Committer;naruse;5;34;19;53;0
cf0109cff7f77901a6923ac85cfb4d85b8ee7386;Sun Jun 01 01:32:54 EDT 2008;Committer;akr;2;7;0;7;0
afbf678a91b3a849724326b3371e78346efaad9f;Sun Jun 01 01:24:35 EDT 2008;Committer;akr;1;0;1;1;0
2b9f74d578ffbccb0935eae98101b2f127cb21ad;Sat May 31 14:34:23 EDT 2008;Committer;knu;3;12;0;12;0
fa58f951cf6cfc60ab49bdecf93f6dc70228b7ed;Sat May 31 14:03:23 EDT 2008;Committer;akr;3;22;0;22;0
c6bac86887b810aff612673fc6027504ac8e4d44;Sat May 31 11:28:49 EDT 2008;Committer;mame;2;11;0;11;0
0682fab6a2ad52f51a440336e99a9abe28e7c050;Sat May 31 10:14:38 EDT 2008;Committer;naruse;3;17;17;34;0
075530a6850ebf899e8874d7675fd900577c9554;Sat May 31 09:28:20 EDT 2008;Committer;nobu;31;65;61;126;0
1b039e2a922db417e7fd7e5175476497fb083e7e;Sat May 31 09:27:42 EDT 2008;Committer;matz;2;6;0;6;0
ccaed588ccd35fac6be0124c095663ac961dbf0e;Sat May 31 06:58:11 EDT 2008;Committer;nobu;3;11;1;12;0
1a192e2b29e9a7fa91632f1fbbffefb3ecdd1b63;Sat May 31 06:17:45 EDT 2008;Committer;nobu;5;48;6;54;0
7981720812b73175c27a90d1d653c5e127e439ff;Sat May 31 05:55:34 EDT 2008;Committer;nobu;2;10;8;18;0
17fe6a652f2e6e465f862a2054c1f294a2d16ed5;Sat May 31 03:03:24 EDT 2008;Committer;akr;2;8;2;10;0
f76ee7201393a3d2f80fe7c1abdeab8b5af5f4cb;Fri May 30 14:56:56 EDT 2008;Committer;kazu;2;7;1;8;0
c6c0d7671fd47690513d413d8d6b3e92db07e2c8;Fri May 30 13:47:54 EDT 2008;Committer;mame;2;49;10;59;0
76f2fc8b46d17eea228e10f34020947acb7fd201;Fri May 30 13:42:23 EDT 2008;Committer;mame;2;104;0;104;0
bd9030438e59e7b11c9182988e05e6cc1e5a882a;Fri May 30 13:32:39 EDT 2008;Committer;mame;2;23;4;27;0
5e6fc71d96cd3d8e7442307c4d9343c6c5468364;Fri May 30 13:18:17 EDT 2008;Committer;mame;4;11;3;14;0
e0a264a9ef5f15e41f8109117d3372e69ae73181;Fri May 30 13:15:03 EDT 2008;Committer;mame;2;6;10;16;0
6a734c810c09a1eb40ed1382bfda59fc7d389cb2;Fri May 30 03:18:45 EDT 2008;Committer;nobu;5;17;26;43;0
df456060b93c445308a02ac6ed175ce05279fb7f;Fri May 30 01:55:45 EDT 2008;Committer;nobu;1;9;0;9;0
1b63d7bc927ace82f91704d6472d90511209f944;Fri May 30 01:52:38 EDT 2008;Committer;nobu;4;34;23;57;0
b9ff5a2fd6d24ce828184729addc40d2825a8896;Fri May 30 00:54:20 EDT 2008;Committer;nobu;1;5;0;5;0
d6025a3be43e29e7cea49378ebeec5954c025954;Thu May 29 22:12:57 EDT 2008;Committer;naruse;2;14;0;14;0
3a3e250975d0ce34b0e5628a2fc2a3bfa7722188;Thu May 29 19:18:54 EDT 2008;Committer;knu;5;42;8;50;0
cd5eb03b58f270cd1200a9914103a0b6a19b9397;Thu May 29 18:15:50 EDT 2008;Committer;knu;2;7;2;9;0
2745d527b34b7f87ab7684b1451465e5e2ed8880;Thu May 29 17:41:56 EDT 2008;Committer;knu;6;28;12;40;0
9df121034a09aced529bf50e0ae2226baaaeb925;Thu May 29 17:08:48 EDT 2008;Committer;mame;2;6;0;6;0
1f97d48800a1bc4f4831036100857b491d36680c;Thu May 29 16:00:49 EDT 2008;Committer;mame;3;33;3;36;0
595ad416f3187661c3f17b7738a66756827c7ebb;Thu May 29 13:51:52 EDT 2008;Committer;mame;2;25;0;25;0
1e90c8ceb37dac03692562fd24b72a1de8f40d8b;Thu May 29 13:50:59 EDT 2008;Committer;knu;1;1;1;2;0
256edc39b0586f0251e80d2b181cbd14f2ee6d9e;Thu May 29 13:49:15 EDT 2008;Committer;knu;1;1;1;2;0
88c1862edbcf1578537ba47114bdb2d9336d5cda;Thu May 29 13:48:54 EDT 2008;Committer;mame;3;1367;0;1367;0
47cc870a5ace622f0f28d397a35c428214127a21;Thu May 29 13:44:29 EDT 2008;Committer;mame;1;1;1;2;0
8fefe64adcde2d470ae137eac98ce86c28852aa6;Thu May 29 13:42:20 EDT 2008;Committer;mame;2;5;1;6;0
17248a467e6af5e1c55c91668c2fe2fae9b6d54d;Thu May 29 13:30:09 EDT 2008;Committer;mame;2;13;2;15;0
441be3ca066e92f83f5db5fcc6a1ae311ca3d57e;Thu May 29 08:52:31 EDT 2008;Committer;nobu;1;2;2;4;0
8f706b2d44256d9f37631887a40c769d524374db;Wed May 28 09:12:28 EDT 2008;Committer;knu;4;7;54;61;0
e2db8af8a3c3968466a4d6c66db08ab342274b75;Wed May 28 09:10:50 EDT 2008;Committer;nobu;1;8;1;9;0
a9396fd580a40ab02d50b65fe38c7d4c35ebe3cd;Wed May 28 08:50:41 EDT 2008;Committer;nobu;2;42;22;64;0
23c2cf545c3302aa65cde911d0492475a6ad2bec;Wed May 28 08:41:52 EDT 2008;Committer;nobu;4;13;12;25;0
72eb7e2a41b40b344e5cc6c8927485da6de106cd;Wed May 28 08:37:37 EDT 2008;Committer;usa;2;5;0;5;0
fbf3e22a3d4c365b0a4ce2f4349bcffd9d182850;Wed May 28 07:52:34 EDT 2008;Committer;knu;2;6;0;6;0
d27c31e0411f2c934e0173492a9f856e91566cd3;Wed May 28 07:13:04 EDT 2008;Committer;knu;2;11;0;11;0
22088e3423413167a5ca6cc944e824959b2fefbb;Wed May 28 06:54:18 EDT 2008;Committer;usa;2;5;1;6;0
1dc20d9d15cf73d2b1c2994d7d5a64ba7defaed5;Wed May 28 06:32:10 EDT 2008;Committer;nobu;1;1;3;4;0
e02270d85d58664ef9c1e6a99c1126afd349611e;Wed May 28 06:18:18 EDT 2008;Committer;nobu;2;30;26;56;0
3ab17047f5b57a86272c3f8320ac159b748b478e;Wed May 28 04:35:59 EDT 2008;Committer;naruse;3;45;18;63;0
de9d25c5448d9ec50c882f2b5b3cfd6a5f8623fc;Wed May 28 03:52:44 EDT 2008;Committer;nobu;3;22;14;36;0
85f554594a5d54050e7015894f9ab8b079c07780;Tue May 27 23:43:46 EDT 2008;Committer;akr;2;8;4;12;0
1cdd1249e82ef4870fd60f5e46cbf639a36cf771;Tue May 27 13:10:46 EDT 2008;Committer;nobu;2;8;3;11;0
bcb57421cb140e708a78911ddf4cd553d6b60d52;Tue May 27 12:53:51 EDT 2008;Committer;nobu;2;6;0;6;0
77446d45a819cdaede88300f33e1b4c859a1163c;Tue May 27 12:51:28 EDT 2008;Committer;matz;3;16;4;20;0
8a3f0ce44aaa67675f8da477b11c17af767879ed;Tue May 27 12:47:14 EDT 2008;Committer;matz;2;18;1;19;0
5342ed85f9c0d130d15540e042f739255ca05ab5;Tue May 27 12:44:52 EDT 2008;Committer;matz;2;10;12;22;0
c3e7816a7834d7361a2b1f394e6992962f9924f3;Tue May 27 11:18:50 EDT 2008;Committer;knu;2;9;2;11;0
0d3d7c3a1ce7dc4007b5e1b6cd803db137bd04b9;Tue May 27 10:12:46 EDT 2008;Committer;nobu;4;23;6;29;0
f15c0dd7dd28bfcd53a3c68dc4c726595d207d3f;Tue May 27 10:03:23 EDT 2008;Committer;knu;2;29;2;31;0
f7213e1c521095a66606d31023b6a1cfea3079b7;Tue May 27 08:55:59 EDT 2008;Committer;knu;2;6;1;7;0
c26af9e7ec49145864fe1e9d4acdef3b4af06c4f;Tue May 27 04:27:09 EDT 2008;Committer;knu;1;4;46;50;0
fc19d23c5db514049293a621e0997fbecdcff08d;Tue May 27 04:15:44 EDT 2008;Committer;knu;2;37;5;42;0
abfb5cca430d7ca45c24ae195b95496ef7eb5344;Tue May 27 04:14:47 EDT 2008;Committer;knu;1;0;1;1;0
e33e3ed2c663e655dd1bc4cb3f87f1dbf404ab22;Tue May 27 04:13:58 EDT 2008;Committer;knu;2;8;0;8;0
16ddb4f68980632114c3ca11155d65a1746ef634;Tue May 27 03:25:51 EDT 2008;Committer;knu;1;33;33;66;0
ea16f7dfc9b6510f46bfe2255f9025ea9dc0aa3d;Tue May 27 03:07:55 EDT 2008;Committer;usa;3;13;7;20;0
c3b10e7fcbc4bc49f5efc30ec4813bf6b586f65a;Mon May 26 09:24:56 EDT 2008;Committer;nobu;2;16;12;28;0
71b059e0703db9406a04d2f7c04a4823a1013ccf;Mon May 26 08:49:08 EDT 2008;Committer;knu;2;14;7;21;0
224efac3404e0a41993dc420c8249e985c74d083;Mon May 26 08:25:44 EDT 2008;Committer;usa;2;13;1;14;0
c2257734e34b0077719fa2b7ff62aaefc20614e9;Mon May 26 07:51:46 EDT 2008;Committer;matz;3;3;5;8;0
cf5cf236d727e56e4558f5e30366130413574863;Mon May 26 07:51:21 EDT 2008;Committer;matz;2;9;1;10;0
3ecb126e9275b8a071e66f6bc4b784b61281bc7e;Mon May 26 07:45:49 EDT 2008;Committer;usa;2;8;1;9;0
701890adfc4f64dd369c82b8cee46df6cdd23074;Sun May 25 22:16:04 EDT 2008;Committer;nobu;2;7;1;8;0
ac6ce30aec2971e7a12e839fe67f7035ddb95be2;Sun May 25 16:19:05 EDT 2008;Committer;akr;2;9;2;11;0
80b0ef570662dce04a72e7d89a7d038a3b75ae63;Sun May 25 16:06:00 EDT 2008;Committer;knu;2;10;10;20;0
49cd41757853adc85715c4eea1fa3f0aa513bcda;Sun May 25 15:42:14 EDT 2008;Committer;knu;3;8;4;12;0
a93136879e5bdfa4ac59669f9e25a0b9cf6c44f5;Sun May 25 08:55:09 EDT 2008;Committer;mame;2;6;0;6;0
8742de6f10aaf1f06347b3291b307e425bf07d7b;Sun May 25 08:52:57 EDT 2008;Committer;mame;2;6;0;6;0
74ae098a5d32d666ab016336935d1bb65e7c0431;Sun May 25 01:12:12 EDT 2008;Committer;nobu;1;1319;1319;2638;0
5c669c26c57b82abc70693f7b4ac6a8a8c63a26e;Sat May 24 19:31:30 EDT 2008;Committer;mame;2;6;1;7;0
87665465cd97b672237754e2ea967a4adc87cf48;Sat May 24 18:55:44 EDT 2008;Committer;mame;2;15;4;19;0
ed68367f9e583e01d8bb89a4b668b62c83e80cda;Sat May 24 18:25:26 EDT 2008;Committer;ko1;1;1319;0;1319;0
59c061235f7bb39d6a33b7e2b7fb4e3db57305db;Sat May 24 17:50:17 EDT 2008;Committer;ko1;19;1300;2613;3913;0
582da7dac70c7fd9c9927cd57587e0cebfebfb3d;Sat May 24 13:39:57 EDT 2008;Committer;matz;2;15;9;24;0
8707a6ff4b380790549aee1d7c6f023461580f6c;Sat May 24 13:39:18 EDT 2008;Committer;matz;2;6;0;6;0
956dead48069a07eb1211283ae5b276ef45f6768;Sat May 24 06:29:48 EDT 2008;Committer;mame;4;26;18;44;0
f52d9a169ba5129554f02cbf0a68f48a3c288b1e;Sat May 24 01:57:02 EDT 2008;Committer;akr;1;5;0;5;0
e3562616ade6ac6b18413405dd06ce29af418982;Sat May 24 01:48:21 EDT 2008;Committer;akr;1;72;0;72;0
796d005a23c5f8acc5dc954afd1ba001809d76c7;Sat May 24 01:34:37 EDT 2008;Committer;akr;1;5;0;5;0
327515a95b40b0bcd5e4e435cf0f131a2540990f;Fri May 23 23:15:14 EDT 2008;Committer;naruse;3;8;7;15;0
08dbc8902b191b3732c4415362a0f86b4d7030e3;Fri May 23 17:46:34 EDT 2008;Committer;akr;1;1;1;2;0
7c52f1ed7a25b61d6efda6d4a005ab9c1da541c6;Fri May 23 09:01:19 EDT 2008;Committer;knu;2;14;4;18;0
efa115e451f3c5f0b354a6a961041614430578f8;Fri May 23 07:47:54 EDT 2008;Committer;knu;2;6;0;6;0
4baf5c4da61994e634ae66cdac25db1d2f1dcd8e;Fri May 23 03:25:30 EDT 2008;Committer;nobu;1;2;2;4;0
59432db7f7c5a4408dc413e476eeb48904b977ad;Fri May 23 03:23:08 EDT 2008;Committer;nobu;4;19;6;25;0
39a86bf60a2bf8f69e4385e9a593c4ca7749a1c5;Fri May 23 02:38:02 EDT 2008;Committer;nobu;1;0;5;5;0
87c828e39eb49269ca367f1adaec9d07bfed8f4a;Thu May 22 21:15:23 EDT 2008;Committer;nobu;2;5;1;6;0
7413b9dced99461466252b4822df9ff7045cd26e;Thu May 22 19:30:17 EDT 2008;Committer;kazu;1;1;1;2;0
9832ab36631b1f241eb646c936e801c0ff4d0cb9;Thu May 22 17:31:15 EDT 2008;Committer;ko1;2;8;4;12;0
a45cd8a01ce1d51cd124f0f87d9d56b6d3d60da8;Thu May 22 16:19:14 EDT 2008;Committer;ko1;9;185;208;393;0
846ea1727fd34b4eb7c5a9b9d2643d04567c8f86;Thu May 22 14:45:54 EDT 2008;Committer;mame;3;19;3;22;0
2b791b2ddd65241d8e95d6bca25eeb770d244570;Thu May 22 11:20:56 EDT 2008;Committer;nobu;2;36;0;36;0
6dbf55f1ba2d58640cbede440e81d0367dd008da;Thu May 22 11:16:40 EDT 2008;Committer;mame;2;9;0;9;0
6f04138f75d0a0aaa3ceb891030c8277164052cc;Thu May 22 10:01:32 EDT 2008;Committer;nobu;2;7;3;10;0
571883a217da5e947baff016f49d934e01618668;Thu May 22 09:55:36 EDT 2008;Committer;nobu;3;23;14;37;0
5fa02c5951496d9c34f2cc09d097b0181729b021;Thu May 22 08:41:07 EDT 2008;Committer;akr;1;14;0;14;0
f73c84542c5a7462c12118ec56b459660636f903;Thu May 22 08:19:04 EDT 2008;Committer;akr;2;5;1;6;0
da5e82f5a353745c17d726a86379c17797e7be73;Thu May 22 08:13:19 EDT 2008;Committer;akr;1;6;0;6;0
477c0db2bdca336b498e92708d7c99479860f16e;Thu May 22 06:22:41 EDT 2008;Committer;usa;6;50;37;87;0
00e28c26a77b2141df351f646fa4de5e6cca1864;Thu May 22 05:20:59 EDT 2008;Committer;nobu;1;2;2;4;0
559d021d200a2e5457fa89a8ddbaf15ab1aeecb9;Thu May 22 04:28:13 EDT 2008;Committer;ko1;6;138;119;257;0
dc217e2d25d1994aadaaaac98179d374fc9c3366;Thu May 22 03:52:22 EDT 2008;Committer;akr;2;5;1;6;0
feead4dca593de620a555dff4f7884a891ba5b67;Thu May 22 03:40:57 EDT 2008;Committer;nobu;3;24;2;26;0
a85b247171373d079d98eeef42c6014980062609;Thu May 22 02:40:50 EDT 2008;Committer;akr;3;39;4;43;0
9d27c792c25174237ad4d47e5d409efd72d57342;Thu May 22 00:57:47 EDT 2008;Committer;matz;2;6;0;6;0
1ef64a66247260a4ecdd150154632bb6766db718;Wed May 21 21:41:09 EDT 2008;Committer;nagai;2;6;0;6;0
404de438af644e7ae575e9712b511514751d674f;Wed May 21 21:23:51 EDT 2008;Committer;naruse;2;21;17;38;0
989c8ed00a724eb11e774995c00b12a9ec835429;Wed May 21 20:47:26 EDT 2008;Committer;matz;2;7;1;8;0
79fdbe0519f39a04ccc728a242718f22e6b1e01c;Wed May 21 17:47:33 EDT 2008;Committer;shugo;3;64;7;71;0
2c8dd794e9c86846f5989569b76c8c8006b18853;Wed May 21 15:31:15 EDT 2008;Committer;mame;4;285;0;285;0
4c094940aa8544e3ee149dee57ec294a47f3099d;Wed May 21 15:18:15 EDT 2008;Committer;ko1;4;112;97;209;0
a16e394bbf85c4e3a1920a7f4ddf46f9561c4a77;Wed May 21 14:22:24 EDT 2008;Committer;ko1;2;6;2;8;0
5dd3a0e2dd508abfad893475efc9706381465d8a;Wed May 21 08:48:10 EDT 2008;Committer;naruse;2;6;1;7;0
f827d9568507ed7b0f562be605a798a4ff0cf6f0;Wed May 21 07:50:27 EDT 2008;Committer;matz;2;9;3;12;0
a5bbd5b8a55f855609b61afd7a97c50175a6e2a7;Wed May 21 01:52:15 EDT 2008;Committer;nobu;1;33;3;36;0
19337db49778988768a5c040413b768b08a026d5;Tue May 20 22:50:01 EDT 2008;Committer;naruse;1;1;1;2;0
102f94455c87eb63ac137217b366be9f60e844d7;Tue May 20 22:48:49 EDT 2008;Committer;naruse;2;13;8;21;0
fe8bb861255035f7903c6f332f3cc87368a9c410;Tue May 20 22:26:14 EDT 2008;Committer;naruse;3;13;6;19;0
13f20ccda7aeb82750b020d2c8bf4f8c6fc72d37;Tue May 20 19:21:26 EDT 2008;Committer;naruse;3;18;2;20;0
1de486b6001f36525e8cd8d536f7dfd876a7213f;Tue May 20 16:48:32 EDT 2008;Committer;usa;4;16;10;26;0
95698ff2a414f6c212377ab321225bdcebd11a9f;Tue May 20 16:37:13 EDT 2008;Committer;naruse;4;28;8;36;0
c051ec7bc0987f137911072152f09961c0711922;Tue May 20 14:26:33 EDT 2008;Committer;mame;2;20;6;26;0
5eb4d70c5f2f775307063bb16024e7b90cd2995e;Tue May 20 13:10:28 EDT 2008;Committer;naruse;3;2530;2376;4906;0
8405033139bc3ee4cbdf1b1c415910f7df38ebfd;Tue May 20 07:59:33 EDT 2008;Committer;matz;3;52;16;68;0
7992fabaf40f8635653d267592f591d9cc4c511e;Tue May 20 04:20:53 EDT 2008;Committer;nobu;3;24;32;56;0
75aa81b79d078ba7d02e097cf53e629d851d874c;Tue May 20 04:19:27 EDT 2008;Committer;nobu;1;2;0;2;0
8afd39ad09c7a7f9e7cf61c4791d38e6270cc616;Tue May 20 03:13:52 EDT 2008;Committer;nobu;2;30;1;31;0
0343750b62b11edfee151cf22675c10f19742db3;Tue May 20 02:36:09 EDT 2008;Committer;nobu;3;19;1;20;0
d457fdad2dbcba31eee20f491deae3120db11dec;Mon May 19 18:47:56 EDT 2008;Committer;ko1;6;105;52;157;0
e07663ec1fa3f03031fd6e074446857490767983;Mon May 19 16:47:42 EDT 2008;Committer;ko1;2;7;2;9;0
2d9135f7a8a67e7794fa74a185bbe99ab229a8a2;Mon May 19 16:14:30 EDT 2008;Committer;mame;3;11;4;15;0
b001dbad6e57919560caf5066f6be6524a970440;Mon May 19 14:36:13 EDT 2008;Committer;ko1;2;24;9;33;0
a4195fc99bc267da58612407737c91498f9d5f6d;Mon May 19 14:21:15 EDT 2008;Committer;mame;2;7;2;9;0
67d0fbd03f46edcc0a6fb2a65409ebfa6be25534;Mon May 19 12:09:14 EDT 2008;Committer;ko1;2;9;4;13;0
3c95aacfcba7ba30006d128d0f944fce85a79dd7;Mon May 19 09:27:55 EDT 2008;Committer;knu;2;7;1;8;0
44cd8e457b808173147c499408ffc5e908f236dc;Mon May 19 08:25:03 EDT 2008;Committer;matz;9;115;69;184;0
48a42a0387a0924955c8cf31f880bdecbf6023a8;Mon May 19 07:30:41 EDT 2008;Committer;akr;1;4;0;4;0
950ee3e0a6f716b12c18d993c2d8b086eda1ba6e;Mon May 19 05:33:45 EDT 2008;Committer;ko1;2;5;1;6;0
39fcd1cdf295d310c1bfd220324fef5b2f725230;Mon May 19 05:20:21 EDT 2008;Committer;ko1;11;140;122;262;0
888c93593003282257849e7af84b73e1ac0f0d8b;Mon May 19 04:26:43 EDT 2008;Committer;usa;2;11;0;11;0
385f0e8af657b1334e477e6837b0846cc14fa00d;Mon May 19 03:08:50 EDT 2008;Committer;ko1;18;228;338;566;0
2e5e857a0bea7f0d784448550e9182c4cc477ee2;Mon May 19 02:56:54 EDT 2008;Committer;knu;1;1;1;2;0
581ec6f87d653e5955bb78af8afb9db324b9df82;Sun May 18 13:54:04 EDT 2008;Committer;gotoyuzo;2;37;0;37;0
8ee3267d26b4f87a9797573caa3dafb28e6945ee;Sun May 18 13:33:24 EDT 2008;Committer;gotoyuzo;7;152;33;185;0
a0e236f6065e5dfd68ac8a45ad1ca690042d47b9;Sat May 17 17:56:41 EDT 2008;Committer;mame;4;24;3;27;0
04351d95585db8baee7cbcf0cf6939cb3cbeaf6c;Sat May 17 14:54:07 EDT 2008;Committer;nobu;2;12;4;16;0
9aceaa1129d18f03891521b6220addf7c9b5388a;Sat May 17 09:14:24 EDT 2008;Committer;yugui;2;5;1;6;0
9afd5465e216f4795bf952a072aae5b315a66d8d;Sat May 17 05:01:52 EDT 2008;Committer;nobu;3;17;1;18;0
02838f35084a801d0fa2cf5573ce6703d0075123;Sat May 17 03:37:37 EDT 2008;Committer;yugui;2;13;1;14;0
8676f8baf2d41c8a630abfc9d1a64e564f35ea90;Sat May 17 02:44:38 EDT 2008;Committer;nobu;1;13;0;13;0
166f8d6d0b5aac3c67f573184dfd9b646580dbd7;Sat May 17 02:39:43 EDT 2008;Committer;nobu;1;5;1;6;0
34c96140f3e767e0a3bd9e82db55e46593d4f3b8;Sat May 17 02:29:13 EDT 2008;Committer;nobu;3;17;2;19;0
c39e8c6e854032645b0f2b799294d3e96d066697;Fri May 16 18:27:01 EDT 2008;Committer;matz;5;53;28;81;0
03ed3bde9af8fab61476f506eab146d9e387c38b;Fri May 16 08:08:06 EDT 2008;Committer;nobu;1;52;6;58;0
f970ffedaebf447da3617c1825b5365ce45a40fd;Fri May 16 04:17:45 EDT 2008;Committer;matz;6;32;14;46;0
b8118e9645ca5e656975b6dae9ac88219fecee23;Thu May 15 14:37:18 EDT 2008;Committer;mame;5;288;5;293;0
41bf214fd7273b2156e96dd600d57a578481daf1;Thu May 15 14:03:21 EDT 2008;Committer;mame;3;16;5;21;0
42389bd7361dc0e16687ef473c7a0d4a45c31dce;Thu May 15 13:38:21 EDT 2008;Committer;usa;2;5;5;10;0
1d53405b313631315b38a0c524cf9ff02589bfb1;Thu May 15 10:48:10 EDT 2008;Committer;matz;3;10;3;13;0
880a96c795d30d95497cb216c8bfc7fa1b3b5387;Thu May 15 10:45:58 EDT 2008;Committer;matz;2;33;19;52;0
a8a1114efe98f44aa851078891663b1fccc1f9c1;Thu May 15 09:44:38 EDT 2008;Committer;matz;4;69;14;83;0
22361a3d1ce3a9bcc1c52237f93ec30f19e89860;Thu May 15 06:34:02 EDT 2008;Committer;nobu;6;227;36;263;0
40a98ca132b3f95097b76eca50c8131f10c845b5;Wed May 14 13:10:02 EDT 2008;Committer;mame;1;5;1;6;0
f09f597422b4130727638e41b1332edac1514642;Wed May 14 12:52:17 EDT 2008;Committer;mame;11;882;0;882;0
e4f8e61dddb18f29fe71392a464f87b612d7eb5c;Wed May 14 09:11:10 EDT 2008;Committer;nobu;1;32;29;61;0
10b1c8298a42f149354c3f842f0dc0e0bdfbed83;Wed May 14 03:50:47 EDT 2008;Committer;knu;1;43;47;90;0
a6bec144712bb5ae9168eb336147f71bcdd5f4a8;Wed May 14 03:48:39 EDT 2008;Committer;ko1;2;8;8;16;0
921fb6ae2593d07d35df0f1f487b9d64a0db9520;Wed May 14 03:46:37 EDT 2008;Committer;knu;3;57;0;57;0
5e4edb43a2a3183931b3d891b1c4bd6031b73560;Wed May 14 02:31:28 EDT 2008;Committer;ko1;3;32;31;63;0
86294fad68d33767a153acddf6d3c2044e7ec36f;Wed May 14 00:01:24 EDT 2008;Committer;akr;1;1;3;4;0
0e0229f3026c50df1c0ac5b66b4a26b6b8aedb60;Tue May 13 22:53:01 EDT 2008;Committer;matz;2;12;2;14;0
759c6d2a89a955d43694a98a47b12cde2e26d14c;Tue May 13 17:16:03 EDT 2008;Committer;akr;1;4;0;4;0
1951ceeed731938663b85939b7b9c7002ad4e34b;Tue May 13 15:57:22 EDT 2008;Committer;mame;9;25;16;41;0
4bb3fa6982a0b6c8fa68869e068041e1909bc39f;Tue May 13 15:49:38 EDT 2008;Committer;mame;3;11;6;17;0
1072cb65c996e672b23878839fac27c47d722f73;Tue May 13 14:32:46 EDT 2008;Committer;nobu;2;36;54;90;0
74430e8679e193c515ee5bdf8e5e3eeb504327e2;Tue May 13 06:10:56 EDT 2008;Committer;knu;2;17;10;27;0
ec1f2095a1e0b600e5225b86558f31472f76a6fa;Tue May 13 04:21:33 EDT 2008;Committer;akr;1;3;1;4;0
5f0e8f582bb1b84ac67d45f8c4e1637cb184b626;Tue May 13 01:13:55 EDT 2008;Committer;matz;3;9;4;13;0
20f4f5f82cf27f297d67621fb42b2562927cb99c;Mon May 12 23:27:17 EDT 2008;Committer;akr;2;12;3;15;0
18e46b81fffb7c675515b151deed0f8b2a3a2c64;Mon May 12 14:42:17 EDT 2008;Committer;mame;3;14;3;17;0
9c504ea8111fb44b46e3011c0417045720334f43;Mon May 12 14:27:00 EDT 2008;Committer;usa;1;1;2;3;0
9416fedc282b6bd96fe1f150833db3e365029767;Mon May 12 14:15:32 EDT 2008;Committer;usa;6;152;23;175;0
fe7dae730f070b6fe0e49d41179ff4d86008cca6;Mon May 12 13:24:38 EDT 2008;Committer;akr;2;7;3;10;0
e67e71d36ad07e53277225ccb768d61bf0569a16;Mon May 12 12:35:37 EDT 2008;Committer;usa;2;6;1;7;0
d34ad36c52ad753e2cc01fb0e23144d77e9daa1f;Mon May 12 12:26:15 EDT 2008;Committer;matz;1;0;21;21;0
d701d21dbe479a037251c00208aeae934a753b12;Mon May 12 11:21:39 EDT 2008;Committer;knu;2;168;50;218;0
8d72d7bd2a96426943b675a2a3d49cf0c418eebf;Mon May 12 10:07:00 EDT 2008;Committer;usa;2;7;0;7;0
ad72d1d3a2952446b2808e137961353100f0d3ce;Mon May 12 09:17:58 EDT 2008;Committer;usa;2;16;8;24;0
430cabfad89206e286f2950b392cdf8d37755082;Mon May 12 06:28:43 EDT 2008;Committer;akr;2;13;5;18;0
ab24f2b07729dc022cd954355d6797b48f1b1552;Mon May 12 06:09:53 EDT 2008;Committer;matz;4;17;6;23;0
b15fe02d194990c0eba875b733b41ae598e90211;Mon May 12 05:05:50 EDT 2008;Committer;matz;2;7;0;7;0
6c1e664bb1f7492db8dc3af02e8d159969c6bec0;Mon May 12 04:44:13 EDT 2008;Committer;akr;3;6;1;7;0
e17c10a3911cc698e538e936f025053c1efe87d1;Mon May 12 03:47:12 EDT 2008;Committer;akr;1;10;0;10;0
21140756e12e79b153adf129bba2923544e6bafa;Mon May 12 03:41:48 EDT 2008;Committer;akr;1;7;0;7;0
10fc0eb781b3d551740056ba2ea966bc93a1f1a2;Mon May 12 03:37:58 EDT 2008;Committer;akr;1;25;0;25;0
bdfe8eab49040a2221083fac223ee7302724b750;Mon May 12 03:32:12 EDT 2008;Committer;nobu;2;5;1;6;0
2c012e01db6c80abb336ec27207b9f978b1f2da7;Mon May 12 03:30:34 EDT 2008;Committer;akr;2;6;1;7;0
63cb03494e6cd6f8fc3a800305e5e12399e11e5c;Mon May 12 03:28:10 EDT 2008;Committer;matz;1;4;0;4;0
183970f49e3d015732f63af3ca1549072bf3b118;Mon May 12 02:34:37 EDT 2008;Committer;yugui;1;4;0;4;0
7c104f88eb97ba97c2061e6387284f180e4752cf;Mon May 12 02:15:55 EDT 2008;Committer;yugui;1;14;15;29;0
294a1d2270e875c11b7f92176ac954c130d69a8a;Mon May 12 01:52:53 EDT 2008;Committer;nobu;3;7;6;13;0
669d43780e16fd861b64dbf90d817fdeffa761fd;Mon May 12 01:51:47 EDT 2008;Committer;nobu;3;16;5;21;0
8481c848da553c3f2822e9f24407f3a23118d129;Sun May 11 14:19:41 EDT 2008;Committer;nobu;2;12;16;28;0
93df43f8ae5c15444554c53c1e1db7ac8492a089;Sun May 11 14:10:20 EDT 2008;Committer;nobu;1;110;110;220;0
589a164abcd9ee6117c3e0af065f426a1659ef75;Sun May 11 13:54:04 EDT 2008;Committer;nobu;2;10;7;17;0
b7a1480540d401704f12132b52f04aea6fdf42c3;Sun May 11 13:39:35 EDT 2008;Committer;nobu;2;6;1;7;0
7467524ca29657897f8439c75fcde65a0b2c3b6c;Sun May 11 10:53:52 EDT 2008;Committer;kazu;1;1;1;2;0
8b817f1a4e1426b2df1376a027e84611a3f5509d;Sun May 11 10:25:47 EDT 2008;Committer;akr;1;1;1;2;0
c030326a09e5b46f5d0223fb8506723a055953e3;Sun May 11 10:06:58 EDT 2008;Committer;mame;2;21;0;21;0
65d1a419d9b11cf386b92ad0394d6e8ddf9cba70;Sun May 11 09:58:46 EDT 2008;Committer;akr;1;19;19;38;0
435ac5e58dccad2cfc104583ac658bb2b2920a7e;Sun May 11 09:01:31 EDT 2008;Committer;akr;2;30;8;38;0
121ae83741eac7c823681736851e6d20dd3279c4;Sun May 11 08:57:40 EDT 2008;Committer;nobu;3;6;3;9;0
e389ce0676d8538dee44e47949bfdef1b81da85f;Sun May 11 05:44:36 EDT 2008;Committer;akr;3;64;31;95;0
14a97fd48aad077f7e239a20dd30cad41c0f6d8f;Sun May 11 04:15:29 EDT 2008;Committer;akr;5;55;3;58;0
427347626599135f6b9aa84018df8ac23685c35f;Sun May 11 01:40:30 EDT 2008;Committer;kazu;2;3;1;4;0
e45b87f282eba212d911c3e1c01684ed606869b6;Sat May 10 23:02:30 EDT 2008;Committer;yugui;1;2;2;4;0
4aa34546074ee4d8cfdb35b092de93c1c4910d19;Sat May 10 17:10:46 EDT 2008;Committer;matz;2;3;1;4;0
e08f245464fe13fec4162b6d4852e31a7535d656;Sat May 10 17:10:10 EDT 2008;Committer;matz;3;7;4;11;0
ef14215c5168186dc87716314ebfa1a598a9f033;Sat May 10 13:15:13 EDT 2008;Committer;matz;2;8;1;9;0
9139a48f0e661cb6342f05102fa8afe53fbc0960;Sat May 10 09:17:59 EDT 2008;Committer;matz;3;17;6;23;0
332529d45ac100ffaa1e31ec4c498a70dc5bf143;Sat May 10 03:00:56 EDT 2008;Committer;akr;2;7;0;7;0
7d82d98d56250b27f586e4ad12f895e1e098333b;Fri May 09 10:18:02 EDT 2008;Committer;matz;1;1;1;2;0
0f1baad5a38d279cc03ff9a5a83dca12b9fb26a6;Fri May 09 10:17:15 EDT 2008;Committer;matz;2;17;3;20;0
1165304a5dc5c4a2b8fce26f09e9bbeb8f0b43fc;Thu May 08 22:48:38 EDT 2008;Committer;matz;2;6;1;7;0
2acb400eb1fdda72608a0d9fa59382666af84026;Thu May 08 15:54:32 EDT 2008;Committer;matz;4;45;6;51;0
65b55c26a15d1b7bf3387e7f31a44f0a669431d0;Thu May 08 09:18:47 EDT 2008;Committer;matz;2;24;3;27;0
b745b792e6ed67a714bad1604968947d95f1dbf7;Thu May 08 08:44:15 EDT 2008;Committer;nobu;4;6;5;11;0
279b358d00264f5bb7034142aab51753edfe36de;Thu May 08 08:29:24 EDT 2008;Committer;nobu;4;6;5;11;0
b938618359ba93b7b90633cd28a1a9977db697c1;Thu May 08 07:46:30 EDT 2008;Committer;akr;2;8;0;8;0
f3ad9bf9b3009ef1ac13222adc0aba5d7c156876;Thu May 08 07:41:23 EDT 2008;Committer;nobu;6;17;3;20;0
714cd205ccaf326abc1b275923dccaa58cfec6c3;Thu May 08 07:03:44 EDT 2008;Committer;matz;1;5;0;5;0
7ce9ab664d5b52bae8a4b70f2f69ff07b0ddafc9;Thu May 08 06:59:38 EDT 2008;Committer;matz;2;10;18;28;0
611e2874982afa0e9a684159ca3d228563a813c0;Thu May 08 06:59:03 EDT 2008;Committer;akr;3;18;0;18;0
9f48c67236f7cca1972519676ffcfac511a594f0;Thu May 08 06:56:59 EDT 2008;Committer;nobu;2;22;9;31;0
265e855ca72bcebfcd8b89d07481199d3b4e2417;Thu May 08 06:14:36 EDT 2008;Committer;nobu;2;7;0;7;0
6aa73e6caba9d1e5675fd5b344ca61478fcbfc57;Thu May 08 04:19:20 EDT 2008;Committer;nobu;2;6;1;7;0
5abd77d9259a25983eebb3c92c204de806ad19fa;Thu May 08 01:46:07 EDT 2008;Committer;matz;1;4;4;8;0
12a498ff49df781c435ec1243b1e0fc6a7a869fd;Thu May 08 01:44:50 EDT 2008;Committer;matz;2;7;2;9;0
f8cb9c861ad95f081c97a18e8f7df4e5f623db6e;Thu May 08 01:04:20 EDT 2008;Committer;nobu;1;19;0;19;0
4c2b10e0d6b966246f4ca71837720df552fbfdca;Thu May 08 00:51:55 EDT 2008;Committer;nobu;2;10;5;15;0
68c67143b2bf1655bcde6e19bff75a55a9e3f05f;Wed May 07 23:56:33 EDT 2008;Committer;nobu;2;16;2;18;0
4264ca9436a7b1496dbd6c9ca6e2e043f0c48630;Wed May 07 21:43:54 EDT 2008;Committer;nobu;6;56;19;75;0
86afcfe4021d3ee7a9d290f2b351ae9e7aa52021;Wed May 07 21:27:34 EDT 2008;Committer;nobu;3;8;5;13;0
60219a0aa3c80ff6843c350ae1078ad54985bab0;Wed May 07 16:15:45 EDT 2008;Committer;matz;4;71;44;115;0
10f263c10e8a22dfad49a573a87810416b53f4fa;Wed May 07 13:24:55 EDT 2008;Committer;matz;3;17;8;25;0
98ad27497471cc85cb249ffd7693cd5547c886d5;Wed May 07 13:24:03 EDT 2008;Committer;matz;2;9;2;11;0
274c6471b870cb36475c9e6ca3ef6e82a8250187;Wed May 07 13:23:24 EDT 2008;Committer;matz;2;6;1;7;0
ffd4bf96cc26a767e3ab10548cd5ddd5c1782712;Wed May 07 11:25:23 EDT 2008;Committer;usa;2;13;5;18;0
640a62ea716e05601089e8de6d463af6fd295d31;Wed May 07 09:18:06 EDT 2008;Committer;matz;3;9;56;65;0
9757c5450ce440384931965bec959a72da251867;Wed May 07 08:43:24 EDT 2008;Committer;nobu;2;9;3;12;0
42981462c99c28ae1b87adfb148dee67e83c540d;Wed May 07 08:41:16 EDT 2008;Committer;nobu;2;8;2;10;0
c4d11b0525748343d3bd4827b2d884d2c1a937a2;Wed May 07 07:28:41 EDT 2008;Committer;nobu;1;0;5;5;0
fa161103263f001ba009cecfbc25ed336757ede7;Wed May 07 04:14:57 EDT 2008;Committer;matz;6;44;59;103;0
f7b3f1c528260e50db430a0dcd3678d447308d89;Tue May 06 15:59:41 EDT 2008;Committer;matz;1;2;1;3;0
86dfbd3c47ce88107922052280c0fb613eda6a54;Tue May 06 15:56:21 EDT 2008;Committer;matz;3;10;3;13;0
4500a5207da7b626f8c568afcaaa731d1cecd4d0;Tue May 06 00:02:01 EDT 2008;Committer;akr;1;0;2;2;0
786e7aba7fcc1fbce5b4f8bacacf1fd008b8341f;Mon May 05 17:18:09 EDT 2008;Committer;akr;3;24;7;31;0
3b1371473805058fb41760a6f7628e12823f80e6;Mon May 05 15:30:07 EDT 2008;Committer;matz;2;13;3;16;0
837c76bd7baee9aaeebd94b4c0719094e1463ff5;Mon May 05 15:01:42 EDT 2008;Committer;matz;4;15;5;20;0
6b1924b176a7a056ba8c703cb2cf2146ab081327;Mon May 05 14:51:02 EDT 2008;Committer;matz;2;5;1;6;0
d7f6b873da0885e771515aff8bfa1aafecff90df;Mon May 05 11:12:17 EDT 2008;Committer;matz;2;7;2;9;0
58967f4fcd38b3b9946fe7c07614d3d01e417d2c;Mon May 05 11:01:10 EDT 2008;Committer;matz;2;12;1;13;0
0fb8126bbf9e458f93ba80caa9adf91a47f6d984;Mon May 05 10:52:44 EDT 2008;Committer;matz;2;15;5;20;0
50c2a48b8502e96cfc399e80bcae939243d95395;Mon May 05 08:19:35 EDT 2008;Committer;akr;2;12;1;13;0
b998a6dbe8e932c1922b69dfe3455e5602b52818;Mon May 05 06:48:34 EDT 2008;Committer;akr;1;4;0;4;0
a7d8042774c4850f91947711f7a85067a2e7af01;Mon May 05 03:13:32 EDT 2008;Committer;matz;2;8;0;8;0
646988189a1e3768ac9247de84f32b6460b2cfbb;Mon May 05 02:40:13 EDT 2008;Committer;matz;2;6;1;7;0
a823fc5d8bb87d978b3027b5efe3c76e08e9e4ae;Mon May 05 02:27:29 EDT 2008;Committer;matz;5;33;26;59;0
3e8e963837c27554d393dcde695c7fc2a43d79e9;Sun May 04 17:25:38 EDT 2008;Committer;akr;2;26;20;46;0
d3677c3d05c2a216c547e65d02b42a0a476209f2;Sun May 04 12:10:13 EDT 2008;Committer;akr;2;6;2;8;0
c415a5d66b0bbea62c378088af7df2afffa14c88;Sun May 04 07:49:32 EDT 2008;Committer;akr;1;9;0;9;0
04752225a796afba738d55c9556c67f520b24f71;Sun May 04 07:05:26 EDT 2008;Committer;akr;3;11;1;12;0
f587eab23cdb70890f233d02eea7186ac05a21b1;Sun May 04 05:30:08 EDT 2008;Committer;akr;3;14;1;15;0
7ef9aba753191632da2289e0d14f3bc1723816f6;Sun May 04 03:59:01 EDT 2008;Committer;akr;2;7;2;9;0
47dcf6702ac2f6e8b6b5bbf1f5f0c965421e7723;Sat May 03 13:29:11 EDT 2008;Committer;akr;1;3;0;3;0
091333f9eaddeb3302ee4ae5a4cfc14a62695653;Sat May 03 11:57:55 EDT 2008;Committer;akr;3;46;0;46;0
724d6ffd5469d2cb75f98b8ed2470b5cb2b2643c;Sat May 03 10:54:43 EDT 2008;Committer;akr;1;7;0;7;0
74697788d4e93eafabc652657ecb477a39b75507;Sat May 03 09:12:13 EDT 2008;Committer;akr;2;20;9;29;0
e5248cfd79f61f9bb73bd755632aa28d8a1b97f1;Fri May 02 16:35:38 EDT 2008;Committer;akr;1;9;0;9;0
5d49e1b3094f5e5131408d0d8fa0a271e8b50278;Fri May 02 16:29:41 EDT 2008;Committer;akr;1;5;1;6;0
5fbb3a819cf06197c27fe3cb7b16b825802a0d27;Fri May 02 16:18:26 EDT 2008;Committer;akr;1;7;0;7;0
96b0b1cf82bf3df9d44ba08fc314d19ee0e82b34;Fri May 02 14:59:28 EDT 2008;Committer;nobu;2;16;12;28;0
3a0a3f4ea22b88286b835518d7ec5d2d5308f34a;Fri May 02 14:57:23 EDT 2008;Committer;akr;2;13;1;14;0
f099a94afaa5a8e3871e7de8fa89c97ce016dd54;Fri May 02 08:31:04 EDT 2008;Committer;matz;2;8;0;8;0
3330ec6cffd7fc128e23b6021689e6a58851bfd0;Fri May 02 07:52:01 EDT 2008;Committer;akr;1;14;0;14;0
7f31465bb51a54b55985e7bbe7b20d70b3e06aae;Fri May 02 07:15:28 EDT 2008;Committer;matz;2;10;19;29;0
546d98b7e89d24ce920b9d1d05382607e8a97747;Fri May 02 06:21:09 EDT 2008;Committer;matz;1;2;2;4;0
f145325797ef784b633ada53034abc4735e7912c;Fri May 02 06:01:13 EDT 2008;Committer;matz;2;17;18;35;0
494f6fcfcf66c8d880318d44edc3245d46f8be61;Fri May 02 05:22:17 EDT 2008;Committer;matz;2;8;1;9;0
f34a75657d74c046eba3befe06700e0334023c7a;Fri May 02 04:57:19 EDT 2008;Committer;matz;3;7;5;12;0
66f98ad5b8fc10d8e45fdeb69fe5ac429d91b5ed;Thu May 01 17:07:46 EDT 2008;Committer;nobu;1;5;5;10;0
3eda51975154526d49ccdac55fb53cdf2f81dca1;Thu May 01 15:05:31 EDT 2008;Committer;jeg2;1;6;0;6;0
b5f2df6b9e4540c87b873f86883d48e99263e890;Thu May 01 15:00:01 EDT 2008;Committer;nobu;3;18;11;29;0
582983c224f6ef199040ddd2b1bc106d901403b4;Thu May 01 14:57:40 EDT 2008;Committer;jeg2;1;7;0;7;0
7b2c68fd32ea4300131c34a6dfd346649fe78383;Thu May 01 14:43:24 EDT 2008;Committer;nobu;2;8;3;11;0
0a32f9a43faba89f8aa7b43f524ab3552570ce65;Thu May 01 14:35:13 EDT 2008;Committer;nobu;2;6;1;7;0
de0561684c66b1537c316a6ed502eb893307d08d;Thu May 01 14:20:15 EDT 2008;Committer;nobu;2;14;1;15;0
69c213fbc72dc33d1a884660ec6c67b134a796e9;Thu May 01 14:04:38 EDT 2008;Committer;matz;2;7;2;9;0
78008d342e7bd31d706f6c71465505e912209a3c;Thu May 01 12:47:07 EDT 2008;Committer;matz;4;15;6;21;0
a60856f0100caffc22c0ae16ee6797b2120e2d13;Thu May 01 09:12:09 EDT 2008;Committer;akr;2;7;0;7;0
30aa6b99cafa63269b8845e335290cb4f4f046b5;Thu May 01 07:10:23 EDT 2008;Committer;nobu;2;6;0;6;0
3943e48fcc08ccb79c8e55d995c1ce381b61515a;Thu May 01 05:11:29 EDT 2008;Committer;akr;1;1;0;1;0
577cb7c53c9a082de4c63721944c67d2272e1567;Thu May 01 02:02:49 EDT 2008;Committer;akr;2;620;607;1227;0
43798843718172339f94ce31793152ea2ceb1ace;Thu May 01 00:25:45 EDT 2008;Committer;usa;1;4;4;8;0
f78965d0c048298e12fca8d17223c5393d7f562b;Wed Apr 30 22:43:51 EDT 2008;Committer;matz;1;10;4;14;0
e4dda7015ac3a900fc757c328ab525c16dec353d;Wed Apr 30 14:29:58 EDT 2008;Committer;akr;1;5;1;6;0
b72ef21cd3459c67761f6295670802c00a179a41;Wed Apr 30 12:40:52 EDT 2008;Committer;seki;3;32;15;47;0
b104173c4c7ebee13ddd869d7285f601a0ef8722;Wed Apr 30 12:38:47 EDT 2008;Committer;akr;1;68;0;68;0
e1bc480e989c331267a42f88514f5dbaa391bfb5;Wed Apr 30 11:14:52 EDT 2008;Committer;jeg2;2;16;3;19;0
01b773a0931901948a5099a6f5e95dc10d0a1c03;Wed Apr 30 09:03:03 EDT 2008;Committer;nobu;6;54;27;81;0
cc88283badde1cac04463a990659aa33fb33ca79;Wed Apr 30 08:47:23 EDT 2008;Committer;nobu;2;7;1;8;0
2de3f183190732710ba8859c3259551c628eeda4;Wed Apr 30 07:12:37 EDT 2008;Committer;mame;2;7;2;9;0
5adabb40103a7ef96bba2e8552bedfa233e4af19;Wed Apr 30 06:17:28 EDT 2008;Committer;akr;1;82;123;205;0
d7e28fd0fec9f7909fafb47855884698997d4596;Wed Apr 30 05:58:17 EDT 2008;Committer;usa;1;3;3;6;0
36cb003300b53d47b7a8e28e3a870d85fd2b3999;Wed Apr 30 05:40:19 EDT 2008;Committer;akr;5;36;7;43;0
01e712d78685d17654cbf87d9aefeff75de87e4f;Tue Apr 29 02:24:26 EDT 2008;Committer;akr;1;41;0;41;0
a851d05175b0a181d7bb5bd94d5197d148e59382;Mon Apr 28 11:45:18 EDT 2008;Committer;tadf;1;1;1;2;0
420a5c994c747806b45b337f9d1cd13bf1c83ddb;Mon Apr 28 11:28:55 EDT 2008;Committer;tadf;2;19;9;28;0
cb2bfadd2d111e3818d02c8d86a3e36ace7dece2;Mon Apr 28 09:35:09 EDT 2008;Committer;matz;2;5;1;6;0
6f63456ed78fc6a512e850fb00ad2b713c6aaddc;Mon Apr 28 08:27:58 EDT 2008;Committer;akr;1;6;0;6;0
3341152da84af4c119b3f34745801f5f51a56655;Mon Apr 28 05:45:37 EDT 2008;Committer;akr;1;9;0;9;0
c4eb7b916f23d2cadb40c1409e8b1427949724f2;Mon Apr 28 05:42:34 EDT 2008;Committer;akr;1;117;32;149;0
e2551558e4b5c1176f59802bb3199a18f20ce631;Mon Apr 28 05:31:28 EDT 2008;Committer;akr;1;2;1;3;0
6daf55634550c612dc625f5093fc02b9b91f9f8b;Mon Apr 28 05:25:03 EDT 2008;Committer;akr;3;42;1;43;0
6837681a4cb9405da1560dbfc3c1bcc97a7d1177;Mon Apr 28 03:50:14 EDT 2008;Committer;usa;2;5;4;9;0
1414a7a8e2a031697020f8b0a5a3e02c301ac2e3;Mon Apr 28 02:13:24 EDT 2008;Committer;akr;2;5;1;6;0
3d751cde0fbfceea1c92a8bdaf5ad8401f19e0e6;Mon Apr 28 02:12:21 EDT 2008;Committer;matz;5;13;8;21;0
59ba2bf0b676c288491b334c49886d6ba04b7dd3;Mon Apr 28 00:11:46 EDT 2008;Committer;akr;4;125;105;230;0
de999ae1fc87ce096144954c9d3746363ff04b4d;Sun Apr 27 10:02:19 EDT 2008;Committer;tadf;2;5;5;10;0
3de80833a23b6aa07f698bf20fffbba25d6fe79d;Sun Apr 27 06:28:08 EDT 2008;Committer;ko1;3;26;1;27;0
80b1f7b50ea10fa7aa841bc642b714411d1fc62b;Sun Apr 27 06:10:35 EDT 2008;Committer;akr;1;197;2;199;0
09007ccbaa14f81202dfd4c85177241dc2be9f15;Sun Apr 27 03:20:35 EDT 2008;Committer;nobu;5;249;138;387;0
f30a5223d3d4a83759c0458bc50636835ec867b2;Sun Apr 27 02:17:24 EDT 2008;Committer;akr;1;5;0;5;0
2b14633bf7a15d14541fb3e5d58829bfb8f794c5;Sun Apr 27 01:16:26 EDT 2008;Committer;akr;1;17;0;17;0
fe0446cc01423dfb84d1b350b8cddadb55d11a1d;Sat Apr 26 23:08:38 EDT 2008;Committer;naruse;3;10;3;13;0
d95d20903361bbdb62cec068ab6afd7e850b1ce5;Sat Apr 26 16:47:30 EDT 2008;Committer;akr;2;20;42;62;0
c42a631063e79fab2369c1983a6f2a075b584f62;Sat Apr 26 16:14:19 EDT 2008;Committer;drbrain;17;1062;447;1509;0
2142a5af51ce882641a060e69bc58c7322ff5188;Sat Apr 26 15:39:09 EDT 2008;Committer;akr;1;131;108;239;0
514715250a2a4d69ea0a4ce3123e2e2f558f3109;Sat Apr 26 12:52:25 EDT 2008;Committer;akr;5;41;0;41;0
6fb36ebab0644f2b724b144b0a163148c87298aa;Sat Apr 26 11:54:13 EDT 2008;Committer;akr;1;5;2;7;0
4ce308d6a4076c783ac91c861da6173ce3ae9e4f;Sat Apr 26 11:25:40 EDT 2008;Committer;akr;1;3;0;3;0
87e4ad0a236217fb27c3a0a22a1c3b4937f29771;Sat Apr 26 09:36:35 EDT 2008;Committer;nobu;6;26;13;39;0
c7451eb7255a534182caa0f2c27beda0b140f741;Sat Apr 26 08:42:34 EDT 2008;Committer;nobu;3;34;23;57;0
52ee83940959e5923b02cdce4956803bd6886110;Sat Apr 26 08:35:23 EDT 2008;Committer;nobu;2;7;3;10;0
9d0a5d8e96644394bbd0c344fb5d26098b7919c4;Sat Apr 26 08:32:23 EDT 2008;Committer;ko1;3;38;37;75;0
c59277cf39c0e4a6c9b5689e5ebaa464991dcdf8;Sat Apr 26 08:31:13 EDT 2008;Committer;nobu;2;26;24;50;0
e615e3ce302e92c868b2f7b5a71fa628186497ec;Sat Apr 26 08:30:22 EDT 2008;Committer;nobu;6;23;13;36;0
61234dab9c43eb409ae85a4652ed50b9595b9cf5;Sat Apr 26 04:03:59 EDT 2008;Committer;akr;2;54;29;83;0
8e8095dd885466fc379c2b033334c3d0f04ae507;Fri Apr 25 17:01:57 EDT 2008;Committer;akr;1;15;10;25;0
e72b9cbc44d896ab2bc54cdf42f7b0962bb90dde;Fri Apr 25 15:55:54 EDT 2008;Committer;usa;1;3;3;6;0
fe9b92f14902e9a7521d1da8467ec9d932a5ce65;Fri Apr 25 15:50:24 EDT 2008;Committer;akr;3;38;7;45;0
4d93af26df1c322515e535d60cd5b0a66dcc222d;Fri Apr 25 09:03:32 EDT 2008;Committer;matz;2;150;55;205;0
0023e168656ed842821c80edbbca2b08594d7d5b;Fri Apr 25 06:35:48 EDT 2008;Committer;nobu;2;9;0;9;0
d90fe02fb69b94fb372dd6bf973c541d4fd78f0d;Fri Apr 25 05:45:28 EDT 2008;Committer;nobu;1;8;0;8;0
a4c08752f8f556dbf3bc391a36e4692b7740f10c;Fri Apr 25 03:37:57 EDT 2008;Committer;nobu;2;6;1;7;0
62da750abea80bad64465791e897bcb4c24d5f9a;Fri Apr 25 01:55:22 EDT 2008;Committer;usa;3;18;0;18;0
963941b156a38aed362421b6eb6247d1d5c977f0;Fri Apr 25 01:35:36 EDT 2008;Committer;usa;1;3;3;6;0
b50eaa73b3928c4a92a320ad96c2d072596e574d;Thu Apr 24 15:57:44 EDT 2008;Committer;akr;1;3;6;9;0
70c177c5f7c8139d0f6212739c6a8d5d93e5bd06;Thu Apr 24 15:34:15 EDT 2008;Committer;akr;1;1;1;2;0
34bb79c031e886cf6a3bf11060195918b93401e4;Thu Apr 24 15:16:38 EDT 2008;Committer;akr;3;6;2;8;0
278b63a3e459993c44aa0515239970fde517642a;Thu Apr 24 14:46:39 EDT 2008;Committer;akr;6;1629;101;1730;0
9b694aaa8588a1f43fd0ae8c1142c7a854a3f6c6;Thu Apr 24 14:02:15 EDT 2008;Committer;mame;3;21;13;34;0
c8d27afcd6b5cee8cc0d5aac1f67e81fdc2971ac;Thu Apr 24 13:38:01 EDT 2008;Committer;mame;2;71;0;71;0
ae6782315a0e14949259e3b6c8ce544e5e774ba5;Thu Apr 24 08:20:56 EDT 2008;Committer;matz;3;7;2;9;0
86bab63d237260dc77c65a8b6c6d5ed1f9bb3bff;Thu Apr 24 05:15:13 EDT 2008;Committer;nobu;2;26;20;46;0
bf310cb64fff5b45c513d97a4c375f52ecb862c9;Wed Apr 23 15:27:09 EDT 2008;Committer;usa;2;7;3;10;0
f7ef694a712d8deccfba67a4860b0272e335f17a;Wed Apr 23 15:22:13 EDT 2008;Committer;mame;6;417;50;467;0
c0d8e6cbf9d7e068e98ff2053bff18ee13e338df;Wed Apr 23 06:32:16 EDT 2008;Committer;kazu;2;7;2;9;0
e7f65f6ba796c5c88fd180193d0572ed02d4410e;Wed Apr 23 02:58:46 EDT 2008;Committer;knu;2;12;5;17;0
67acbe3954a49278f7c92f4e62f9b6827839dfac;Tue Apr 22 15:36:36 EDT 2008;Committer;mame;2;12;1;13;0
77f987376cb2489807c23e5192bae69b233acdea;Tue Apr 22 15:23:01 EDT 2008;Committer;kazu;3;21;9;30;0
4bf25bbe203c42d0108a5d0aa66a84daa5b87367;Tue Apr 22 14:41:07 EDT 2008;Committer;matz;1;0;1;1;0
89c408704bc7034c06cb465ad8ba9b25f32de301;Tue Apr 22 13:49:43 EDT 2008;Committer;nobu;6;15;23;38;0
f07ca6b1c40fdeb2f37e6e425b0f667a1cae8cdb;Tue Apr 22 13:42:28 EDT 2008;Committer;matz;2;8;2;10;0
f80616b6d25865e9e6f84fd06e5a6d2e40d09437;Tue Apr 22 13:17:04 EDT 2008;Committer;nobu;2;262;236;498;0
9f9a532d98f599d9aa05393cf56e8d1cae1d2966;Tue Apr 22 13:15:56 EDT 2008;Committer;nobu;2;7;0;7;0
29934eed9d10ab20ea69f6e9aced11b2f140f8b9;Tue Apr 22 13:04:10 EDT 2008;Committer;kazu;1;1;0;1;0
0beaddc4e23a381e056bd637f5abb87d3c283f96;Tue Apr 22 12:20:36 EDT 2008;Committer;naruse;3;16;5;21;0
17123b2958563b5a1563e3264f806c8faebc9904;Tue Apr 22 11:54:50 EDT 2008;Committer;naruse;2;5;1;6;0
80467678ddedd41a37724ae6cba1e25f0242823a;Tue Apr 22 10:36:31 EDT 2008;Committer;knu;2;7;26;33;0
5e2aeec8ce6fef9fa678053a233dc3c1a0378c44;Tue Apr 22 08:55:41 EDT 2008;Committer;shyouhei;2;6;1;7;0
d4439ce2db9b8370c0e3e3287b0e0698c0e4c012;Tue Apr 22 07:25:28 EDT 2008;Committer;shyouhei;2;14;2;16;0
6a7afe4247eea57969e5d00dfaf7b296a1d41bc4;Tue Apr 22 07:18:32 EDT 2008;Committer;nobu;2;5;1;6;0
322d8dfb0ecb23a908ea3bb1be7efcff08bddb42;Tue Apr 22 07:08:41 EDT 2008;Committer;shyouhei;1;1;1;2;0
31049a6fd6648b26e1210f1eb482f6efc94ad5a2;Tue Apr 22 07:03:32 EDT 2008;Committer;shyouhei;1;2;4;6;0
df5b0f317bbddd326f87fe94730c1d582e7bd8e4;Tue Apr 22 06:25:05 EDT 2008;Committer;nobu;2;8;2;10;0
707c50d3417f4e4c2e8bfb6ee3454e4c83d0062e;Tue Apr 22 04:26:44 EDT 2008;Committer;matz;4;11;4;15;0
9c7707629608304a2eaf674a72af16c95ebc4f52;Tue Apr 22 04:13:01 EDT 2008;Committer;nobu;3;76;9;85;0
62aa7aae51004bddf9e0c9c6bcdf2d6fe88840e8;Tue Apr 22 04:11:13 EDT 2008;Committer;akr;1;4;0;4;0
a0f487921e21dff86de25aa79cf1e102fc90ad3e;Tue Apr 22 03:03:51 EDT 2008;Committer;nobu;2;7;2;9;0
11fbd724cc14895ad17e015ba5f0ab967ca3b35d;Tue Apr 22 00:58:51 EDT 2008;Committer;usa;2;9;5;14;0
915b5c55084762d88ace671c6d255a5f7d2ba8ca;Tue Apr 22 00:58:04 EDT 2008;Committer;usa;3;10;5;15;0
b1166a04694766f24385a5a91e028e39f7bd2461;Mon Apr 21 10:09:33 EDT 2008;Committer;akr;3;42;1;43;0
ffc456d0ed1acf478ff991c88e35b2038dccb402;Mon Apr 21 08:48:33 EDT 2008;Committer;knu;9;77;0;77;0
eeceb720a9589bd9a0acf47db9da05668d7a5865;Mon Apr 21 08:19:19 EDT 2008;Committer;nobu;1;1;1;2;0
11f2fa4ade2176188dcbb6da7bf536104e5484db;Mon Apr 21 08:01:46 EDT 2008;Committer;nobu;2;6;1;7;0
59b08c22b5b9e6179cbed15620dd0f7b8cef0742;Mon Apr 21 07:07:39 EDT 2008;Committer;matz;2;12;5;17;0
7243069d29354f64e5749f2aba674d27c792b88a;Mon Apr 21 02:02:26 EDT 2008;Committer;matz;2;17;0;17;0
6a45f0a50e6009b4e0e01ea67c1598c2395b3dcf;Mon Apr 21 01:07:00 EDT 2008;Committer;matz;2;5;0;5;0
7dd42a48e10ce0b5bec57b7f0833aec0f7c0693a;Mon Apr 21 00:59:43 EDT 2008;Committer;usa;2;8;1;9;0
fd8734a64d3de5a6d94061633ed719f068c1e723;Sun Apr 20 23:55:09 EDT 2008;Committer;usa;3;8;4;12;0
45acd59d2db8ec12a0a048b1c79ebb8acf68b995;Sun Apr 20 22:32:06 EDT 2008;Committer;technorama;5;218;36;254;0
d657d4feb3c7c81557e2fe39fc6a669a4b6be5d4;Sun Apr 20 12:01:27 EDT 2008;Committer;knu;3;6;1;7;0
3537b97bc1b22d93eb8e824c395b97f917abedee;Sun Apr 20 11:58:44 EDT 2008;Committer;knu;2;21;9;30;0
935933d0d360dd535c33110f64b8e753877ec829;Sun Apr 20 11:30:43 EDT 2008;Committer;akr;1;4;1;5;0
6aee0a5bca81903f0b67f949a57a698755ab891b;Sun Apr 20 06:44:41 EDT 2008;Committer;akr;1;62;59;121;0
5e433ffc6c368146a7d646c45e69b8f6978b9d38;Sun Apr 20 06:19:28 EDT 2008;Committer;nobu;1;5;3;8;0
d92efa3c0b8b995f5bd95ec4099db81a97480632;Sun Apr 20 06:14:49 EDT 2008;Committer;nobu;2;10;0;10;0
ae2921ae67e849f8d28c0a3ae170d38c6ac36d03;Sun Apr 20 06:13:17 EDT 2008;Committer;akr;3;89;89;178;0
64a16b9ede4dfc72f8c4b486ebce148f519e60dc;Sun Apr 20 06:01:28 EDT 2008;Committer;nobu;3;6;3;9;0
36f984b65eaa2f78130cb6435c6498fa727dd0cf;Sun Apr 20 06:00:51 EDT 2008;Committer;nobu;2;5;2;7;0
9ddb37f071688be901c8e0b4e914d15313cdc900;Sun Apr 20 05:58:59 EDT 2008;Committer;nobu;3;13;8;21;0
f4f95b98d4ca0608f5b5c59d1ece23a4dccd6011;Sun Apr 20 05:44:47 EDT 2008;Committer;nobu;3;48;29;77;0
01c433b58ccdbde5b488901e2accda87d931abd9;Sun Apr 20 04:59:04 EDT 2008;Committer;akr;3;35;12;47;0
f0fbfeda519f7e0365996255c80f78c4b14d6037;Sun Apr 20 04:12:32 EDT 2008;Committer;akr;1;2;4;6;0
a16e0c29db3d5c7555362956ba62ea8f84f00cc7;Sun Apr 20 03:51:57 EDT 2008;Committer;akr;3;122;52;174;0
9579647fe18b29d946d7905f0d233bd37463a504;Sat Apr 19 19:47:16 EDT 2008;Committer;akr;3;97;8;105;0
24197c48d27625233b4141fa99aa67191eeeb2bc;Sat Apr 19 19:09:22 EDT 2008;Committer;akr;1;1;4;5;0
3e9af6da10f0a48b536cfb6c19b422e3d382f37b;Fri Apr 18 11:58:30 EDT 2008;Committer;mame;2;272;0;272;0
6b5e24a61a7488344c3560dcd1527c8257870e34;Fri Apr 18 08:37:50 EDT 2008;Committer;nobu;2;10;3;13;0
38af102cccd76913172bf5843097965946ed6077;Thu Apr 17 15:22:18 EDT 2008;Committer;usa;1;3;3;6;0
73713cc1f05afdc1f5ba155a39bc98cf9b83aec4;Thu Apr 17 15:09:06 EDT 2008;Committer;yugui;1;1;1;2;0
30128a68c410823c5438eaec7b7572b817434d76;Thu Apr 17 14:52:14 EDT 2008;Committer;yugui;1;22;3;25;0
0a2053713beb7bfec84d1ef5c024223ed726181f;Thu Apr 17 13:22:40 EDT 2008;Committer;mame;7;20;14;34;0
6f4fb0981db5cce2a14d38d089c4eb68d0e2a988;Thu Apr 17 11:13:34 EDT 2008;Committer;mame;2;18;8;26;0
f23828fa126235f7c758817e628a9ba4a33c1d71;Thu Apr 17 07:07:14 EDT 2008;Committer;nobu;2;54;27;81;0
4133458deea151c67d0001af9e822c2dbbc04ef0;Wed Apr 16 15:48:54 EDT 2008;Committer;mame;4;493;9;502;0
6cdd421a9b5445512ab554155362d0c979a2a556;Tue Apr 15 17:40:46 EDT 2008;Committer;nobu;2;9;0;9;0
73437c05f57aec9dd1d2438ed8e8962f28415505;Tue Apr 15 17:26:29 EDT 2008;Committer;nobu;3;18;11;29;0
17ea268764744446d003c2c8e7dd299e61ebd0fb;Tue Apr 15 14:10:18 EDT 2008;Committer;kou;3;109;2;111;0
5a4c8a1ad7c3e700001714db6952e215cd4df06b;Tue Apr 15 10:21:01 EDT 2008;Committer;matz;2;5;2;7;0
639c3a8962c7d859441dc35fabff6a432fcd02fe;Tue Apr 15 09:02:19 EDT 2008;Committer;nobu;3;5;5;10;0
1ea2f2a492ffb62dfb872efb976bc7fc327f4798;Tue Apr 15 08:55:17 EDT 2008;Committer;nobu;2;4;1;5;0
8cb17727c423baefc792f3066b53f9f65680922a;Tue Apr 15 08:12:30 EDT 2008;Committer;kazu;4;8;3;11;0
bf52f99b6bc47beae34b5abe0276c5d20f282de2;Tue Apr 15 07:46:38 EDT 2008;Committer;kazu;2;7;0;7;0
6a98d417f01e43f5217f37d2142651b50fd41986;Tue Apr 15 06:38:13 EDT 2008;Committer;nobu;2;34;12;46;0
d1263ff544a0734a884a668739e4e8c3925cc152;Tue Apr 15 04:29:48 EDT 2008;Committer;nobu;1;0;2;2;0
978943472e4c83ed83ace4dfba4436e8fa5697ef;Mon Apr 14 22:33:50 EDT 2008;Committer;tadf;1;1;1;2;0
6d02a4857d569bf91e3e9faca1acd557406aa122;Mon Apr 14 22:30:45 EDT 2008;Committer;tadf;4;33;6;39;0
fee4ed204f78a5476be61aa61716a293425d7c6a;Mon Apr 14 15:47:51 EDT 2008;Committer;matz;4;74;51;125;0
71263844e25ab69259257328f4f180b5a7ecbd7a;Mon Apr 14 14:26:51 EDT 2008;Committer;mame;2;20;0;20;0
755a86b87a38fa55d3380e657f19eca63dfee0e0;Mon Apr 14 13:45:26 EDT 2008;Committer;matz;2;6;2;8;0
ac5b69acb8ccc578ea780701da4efb26f278ca48;Mon Apr 14 08:31:38 EDT 2008;Committer;knu;2;12;3;15;0
6866bce75736c176aba9788dd90cc344a57754ee;Mon Apr 14 05:34:04 EDT 2008;Committer;nobu;7;172;88;260;0
6be73862186f958638776b7b8545f26f7010f97b;Mon Apr 14 03:58:35 EDT 2008;Committer;matz;2;10;2;12;0
b2dde8243ba18a68010e4b1f3b720c093a7c48a3;Mon Apr 14 03:52:27 EDT 2008;Committer;nobu;3;9;64;73;0
01f468d1383109ac8da474eba9f3512f7119b925;Mon Apr 14 03:47:04 EDT 2008;Committer;nobu;2;72;26;98;0
a39883b74a9e9ff872708e49191249b434c707a2;Mon Apr 14 03:44:15 EDT 2008;Committer;nobu;2;4;67;71;0
db0f83ffc383e72bac72fbfa11dc899c890419d5;Mon Apr 14 02:20:47 EDT 2008;Committer;matz;1;4;4;8;0
0327a222c40058918134034d161a3bdfc66fd9f8;Sun Apr 13 15:52:14 EDT 2008;Committer;mame;3;872;3;875;0
181f815591030e9659643f8d6802eb5397ddac86;Sun Apr 13 14:59:55 EDT 2008;Committer;knu;3;57;19;76;0
31a060f7bd55a845824883b87700ca5bb39f7ab0;Sun Apr 13 09:52:29 EDT 2008;Committer;nobu;3;21;12;33;0
db0c3eb8c02ef6a1c280c88260e10fb5c3f5be23;Sat Apr 12 14:51:09 EDT 2008;Committer;matz;1;45;0;45;0
6b36f117f2c35474aa2e63ef56edba338e124d9d;Sat Apr 12 14:50:18 EDT 2008;Committer;matz;12;17;20;37;0
7b4a171158fffbb984378a094e7195072b0a5b05;Sat Apr 12 03:41:51 EDT 2008;Committer;nobu;8;57;97;154;0
e72b71d56a1f369cb7eb3892c61715460bac8109;Fri Apr 11 20:57:02 EDT 2008;Committer;drbrain;31;272;888;1160;0
0ae6c7f816cbc3ba0cdd97f609b9ffcbf49bf9bb;Fri Apr 11 18:13:40 EDT 2008;Committer;nobu;2;14;2;16;0
23bb4d7898bcafad7b2b46339994b650aef60a42;Fri Apr 11 18:12:18 EDT 2008;Committer;nobu;3;11;3;14;0
3734fd0e7906c964c1a11910a0a1affb703d758a;Fri Apr 11 08:36:47 EDT 2008;Committer;matz;2;5;1;6;0
f9c5484cc51899bc84edc12daab6c0d14aaa26dd;Fri Apr 11 08:26:45 EDT 2008;Committer;knu;2;30;33;63;0
f79e9281ff757e8c8c8ccc566c76ea3b2a86de7d;Fri Apr 11 08:06:31 EDT 2008;Committer;matz;2;11;2;13;0
033a32b4c136033299a027416f9039b68b32065a;Fri Apr 11 07:58:06 EDT 2008;Committer;knu;4;56;15;71;0
3f0387830924822fde321e3613ced1607ffc27c6;Fri Apr 11 07:43:31 EDT 2008;Committer;matz;4;103;3;106;0
4a407ec3a7be0b6d92b9a9b68c5d10b041f1120e;Thu Apr 10 23:10:49 EDT 2008;Committer;matz;3;10;4;14;0
1e8ec51e8fafc27f170241f93868528dd22861d4;Thu Apr 10 14:10:19 EDT 2008;Committer;matz;3;26;5;31;0
df033c0632fb59f6120d8d03dbcd371bf39a16ab;Thu Apr 10 13:41:21 EDT 2008;Committer;matz;2;2;4;6;0
8d321f00e18f3430b134a9767878e515ffe2957a;Thu Apr 10 11:39:25 EDT 2008;Committer;knu;1;1;1;2;0
69327a9d2e77675a7bd6257c81412d41a9611c91;Thu Apr 10 11:37:46 EDT 2008;Committer;knu;2;6;136;142;0
4a1d5cfafeed360b969a6bcd67c87ab939824e80;Thu Apr 10 11:36:29 EDT 2008;Committer;knu;1;2;1;3;0
b93bb68a3a6f3963552bbe602b88976fe8e4b0f9;Thu Apr 10 10:42:14 EDT 2008;Committer;knu;2;6;0;6;0
e8b41deead821d254377dcf8233c56e8cc42eeaf;Thu Apr 10 10:34:49 EDT 2008;Committer;knu;1;2;2;4;0
c04ad1d7e4ec54781b2eb9b07d4eaf7d4cd21c44;Thu Apr 10 10:25:44 EDT 2008;Committer;knu;2;19;9;28;0
7132a4f9798eada290b3bd22184ca7e43c551ccf;Thu Apr 10 08:41:46 EDT 2008;Committer;akr;3;28;15;43;0
1d63f4eead83814d0881ad75373c64ade01d139f;Thu Apr 10 07:12:41 EDT 2008;Committer;matz;3;279;75;354;0
db4a767d25cca429ea9cb6e34c64a1a756367bbf;Thu Apr 10 06:06:49 EDT 2008;Committer;matz;2;4;385;389;0
eb18a827fb0498888a6666cd72d4a53a41cc8ca9;Thu Apr 10 01:27:25 EDT 2008;Committer;nobu;3;8;4;12;0
69352c0d4d98a16f82ae388297ecfff940747ae2;Wed Apr 09 05:43:29 EDT 2008;Committer;nobu;2;17;25;42;0
5098d7ae0dcef98c82e64280d2aded2676738c3b;Wed Apr 09 03:12:03 EDT 2008;Committer;nobu;4;133;3;136;0
0852b7743b523fb25348eacd8d9396772d370b3a;Tue Apr 08 12:38:57 EDT 2008;Committer;nobu;1;4;1;5;0
d7b8efd872571bdf815540c902da254c3e6ea3a4;Tue Apr 08 12:36:42 EDT 2008;Committer;nobu;2;23;4;27;0
298d20c25bb2cbd9b9b26180d971f6c4463c3b85;Tue Apr 08 02:01:07 EDT 2008;Committer;matz;2;5;0;5;0
1dcbd6921e21e7188dc24cdf37c9b5c07269c062;Tue Apr 08 01:53:35 EDT 2008;Committer;matz;2;6;3;9;0
502e19fd10f08898d76f31f43b3f332a3f05e1a2;Tue Apr 08 01:40:49 EDT 2008;Committer;matz;2;7;2;9;0
7dc26509c69a1801a11c0ad07607faf858aee4fc;Tue Apr 08 01:30:31 EDT 2008;Committer;nobu;3;12;4;16;0
2d9e9c3fd743e07833e2954474e9da1b4e5c33d2;Mon Apr 07 23:33:01 EDT 2008;Committer;nobu;1;31;4;35;0
37504dc560792ccd3e32d637d2fcaf5f0ac0a1ca;Mon Apr 07 18:39:28 EDT 2008;Committer;nobu;5;45;6;51;0
0c8bc11d3d21611e996f3ed11493e984c22a3f18;Mon Apr 07 14:18:50 EDT 2008;Committer;tadf;1;2;2;4;0
4e046758f5684f1441a51589594d2e34310a7d64;Mon Apr 07 13:52:26 EDT 2008;Committer;tadf;4;63;38;101;0
1369cfd16e35d53f3f85c860473ece572c733d1d;Mon Apr 07 06:51:33 EDT 2008;Committer;nobu;10;76;58;134;0
3f3fdb4869350554bffcabcac7bf59ab866a8ddf;Mon Apr 07 03:28:23 EDT 2008;Committer;ko1;2;17;0;17;0
4653fedd0c47e0ceb88fb7dacc2e837268f65664;Mon Apr 07 03:15:26 EDT 2008;Committer;nobu;2;9;13;22;0
55724945247c3dde3cf3b96a16ed83c1b25847a2;Sun Apr 06 17:19:11 EDT 2008;Committer;matz;2;5;3;8;0
bdc00ba604b74646fbf551a544d973466ce39558;Sun Apr 06 17:11:50 EDT 2008;Committer;matz;6;54;34;88;0
a06fc80da67570a53c4790f7d7e053222aeef2a5;Sun Apr 06 01:22:21 EDT 2008;Committer;nobu;1;1;1;2;0
0b3a667f5319f130dba70c538d82d0ab9f110838;Sun Apr 06 00:45:02 EDT 2008;Committer;nobu;3;8;4;12;0
968e827e15286db5b527695115adb33a723d8ce7;Sat Apr 05 14:26:43 EDT 2008;Committer;tadf;1;0;224;224;0
c08b5dfb81c5a79e0c4965ff1a8da07f040c5820;Sat Apr 05 14:25:40 EDT 2008;Committer;tadf;7;270;133;403;0
be710a03919604a1b7776043aecc5cf0914da01c;Fri Apr 04 21:16:19 EDT 2008;Committer;drbrain;5;17;5;22;0
3467a1754c83c0f4061f345a7ee965f60d16fca5;Fri Apr 04 14:26:19 EDT 2008;Committer;naruse;2;10;4;14;0
2b8af7d624d98743ccf605941f1c91c301a858fa;Fri Apr 04 05:13:06 EDT 2008;Committer;matz;3;9;4;13;0
3d09c87ab5db304ad797795d6f0d19e1d12e3765;Thu Apr 03 20:59:51 EDT 2008;Committer;matz;2;7;0;7;0
c69d2005c3eafda3bf56c16ad35354fafd42c640;Thu Apr 03 16:04:31 EDT 2008;Committer;matz;2;6;4;10;0
228f30be3a96d078179eb1e1773a226c50c4e1a2;Thu Apr 03 16:01:16 EDT 2008;Committer;matz;7;27;89;116;0
5d6602c44e95862d28e05591798d790d0ad80dfb;Thu Apr 03 12:55:27 EDT 2008;Committer;tadf;3;33;64;97;0
b916c39db4adeea4816d99935e253abf1eb48fc7;Thu Apr 03 11:57:23 EDT 2008;Committer;matz;2;8;1;9;0
ccf20a6d3fca0ae3a6817387622892c4db340032;Thu Apr 03 10:59:44 EDT 2008;Committer;nobu;3;23;8;31;0
9729ba32d0d07f7395205b65faacf0cffdbc0b5e;Thu Apr 03 05:44:29 EDT 2008;Committer;usa;2;8;2;10;0
11b693504939d45ff1e39649adf14f5987c2d6e5;Thu Apr 03 04:49:20 EDT 2008;Committer;nobu;1;1;1;2;0
2c485c409db33bbad9313e044e8add2b7c86c105;Thu Apr 03 04:20:40 EDT 2008;Committer;nobu;2;16;16;32;0
b0c77fe85bd58cf33da252960b0365e2600c0f04;Thu Apr 03 03:56:07 EDT 2008;Committer;nobu;6;14;6;20;0
5c1926ac82b9a9c20b2ea7f7707622b4d8dc3ecc;Thu Apr 03 00:00:48 EDT 2008;Committer;nobu;8;36;25;61;0
48206485212c2ba0d18b44a2afa34c483bed3c05;Wed Apr 02 21:18:59 EDT 2008;Committer;nobu;1;1;1;2;0
c3d2e4d381a06f262c3096b3bdad87ce3948c677;Wed Apr 02 14:13:53 EDT 2008;Committer;matz;7;85;76;161;0
f67f196b1d89753af958249ffe7458aa2e3f42b6;Wed Apr 02 13:31:42 EDT 2008;Committer;matz;3;26;57;83;0
339dca41fc7e4b0203e0d916eab84693f2a4187e;Tue Apr 01 21:54:16 EDT 2008;Committer;matz;2;15;0;15;0
a4d6f2265a98feba2d336c9d6faa7df38fe630d3;Tue Apr 01 21:30:36 EDT 2008;Committer;matz;4;22;11;33;0
ddf9b405add8ee0ad080888e67fd395cf032bae5;Tue Apr 01 12:21:33 EDT 2008;Committer;matz;2;5;4;9;0
e31a69562e2257cd5651e1dd823ccbdf7ce8c383;Tue Apr 01 07:40:23 EDT 2008;Committer;nobu;2;58;4;62;0
05da1ec22d6850a7325490f2bf0e918c16f54098;Tue Apr 01 05:43:40 EDT 2008;Committer;nobu;2;4;2;6;0
6b808e66af319fe79d1d9c338ea4454bfb7f4ea5;Tue Apr 01 04:07:25 EDT 2008;Committer;nobu;1;1;1;2;0
54e792ee6f8f24c6ca13cad04df023a24abf8110;Tue Apr 01 02:36:21 EDT 2008;Committer;nobu;2;8;2;10;0
5bf63ffcaaee7c78d6ae2c6f7cc90b8004dd57b1;Tue Apr 01 00:42:06 EDT 2008;Committer;usa;3;11;1;12;0
283be20b27567b0d040979ac2c860450b8a760b7;Mon Mar 31 22:55:00 EDT 2008;Committer;drbrain;1;0;610;610;0
8cc45aae947d453acca029e13eb64f3f5f0bf942;Mon Mar 31 22:40:06 EDT 2008;Committer;drbrain;82;5619;2771;8390;0
dc8359969ec71ece10357ba9396430db7f029e45;Mon Mar 31 18:20:42 EDT 2008;Committer;nobu;2;4;4;8;0
b39676f6a9b699f204d4313ae5589b71d436d4e5;Mon Mar 31 17:58:41 EDT 2008;Committer;nobu;5;72;17;89;0
29b538fa7146f899775b001a55bf1716c486b293;Mon Mar 31 16:55:54 EDT 2008;Committer;nobu;5;21;10;31;0
597179bb95812dcf90b75520d3dd17d94ac16d51;Mon Mar 31 16:42:24 EDT 2008;Committer;tadf;3;1897;1873;3770;0
459aa9f1c5c22cd0fb9c7c4390158a43d0653ede;Mon Mar 31 15:19:39 EDT 2008;Committer;tadf;2;5;1;6;0
88a4961cb2bf52186d188bb8feaed9465c8acddc;Mon Mar 31 10:14:42 EDT 2008;Committer;matz;5;15;11;26;0
b2acbb2c67e8d9dc5eaf4823f5e547c57832c443;Mon Mar 31 09:58:41 EDT 2008;Committer;usa;4;22;0;22;0
9a421e5b7ee330db3eb93affad9ba910dddc8f11;Mon Mar 31 09:42:44 EDT 2008;Committer;nobu;2;7;1;8;0
839dc7f9ab081582d8dc45bfec9ec90bee536dd7;Sun Mar 30 19:16:29 EDT 2008;Committer;naruse;3;50;29;79;0
70153a6a73e45a612921908f0f185b4b01d835da;Sun Mar 30 15:39:00 EDT 2008;Committer;yugui;1;23;12;35;0
ef260b085eea729efaa46e93ac71d08a3fa210c6;Sun Mar 30 15:00:12 EDT 2008;Committer;matz;9;227;137;364;0
3730710d79aa0bde6ab5b36e18c734dd9718aac0;Sun Mar 30 14:50:55 EDT 2008;Committer;matz;11;143;227;370;0
c8ac4a209bcccfe38239ff3e6e853cf01e424537;Sun Mar 30 07:35:09 EDT 2008;Committer;akr;1;1;1;2;0
0ef84dcefce47cab974f8763abd7cbb3a7eb6d98;Sun Mar 30 06:38:05 EDT 2008;Committer;akr;5;840;2;842;0
a367738381708064e7636f70f75a3777cda5a5bc;Sat Mar 29 12:42:31 EDT 2008;Committer;nobu;1;3;3;6;0
debfdb311ab440ee32847cc689fccac9c677eed5;Sat Mar 29 05:52:43 EDT 2008;Committer;nagai;1;1;1;2;0
3024ffdc3a5fdb115de651edae9e3d7a335a6614;Sat Mar 29 05:25:12 EDT 2008;Committer;nagai;121;7867;2206;10073;0
b62af05a98bc3ebbbca546270e7efa5abd3a17f5;Fri Mar 28 11:37:02 EDT 2008;Committer;yugui;1;9;1;10;0
a099df6bbfe4be9ee455d86e3a2e93ab3e55500b;Fri Mar 28 11:23:08 EDT 2008;Committer;usa;1;3;3;6;0
4aa9be0f5c8d9135a9f67aa96c1667e017cdc587;Fri Mar 28 10:58:31 EDT 2008;Committer;yugui;1;108;35;143;0
d4f5cb67d4284ba994ccda6b465ddd61883c5292;Thu Mar 27 11:48:00 EDT 2008;Committer;tadf;5;101;113;214;0
69ad92d9cabbe83f3f6fe7ebb936b1d2c317f44b;Wed Mar 26 12:50:21 EDT 2008;Committer;tadf;2;3;3;6;0
c4247b5216de2650ed2af7dd853f2a76ff86d571;Wed Mar 26 09:13:54 EDT 2008;Committer;matz;2;7;2;9;0
7e6dd6142e30e09976307e2626fd1ae9a36ab83e;Tue Mar 25 15:56:36 EDT 2008;Committer;mame;2;41;0;41;0
43a2aaea2f307ed50fa059affa797a01ba62320d;Tue Mar 25 15:30:56 EDT 2008;Committer;mame;4;240;4;244;0
2d656b7d2851df5cae8052f906150b01983cb32b;Tue Mar 25 10:35:20 EDT 2008;Committer;mame;2;37;0;37;0
b6c9957058c02541a38e9c5057bd5cc4f3823172;Tue Mar 25 10:13:03 EDT 2008;Committer;mame;4;40;7;47;0
f6001be537623a52513919ee1890b2bbccc119f0;Tue Mar 25 07:32:58 EDT 2008;Committer;nobu;2;9;3;12;0
708e5ddde62fc424a40f61f8c73b6909e33f6da3;Tue Mar 25 06:26:32 EDT 2008;Committer;nobu;2;50;52;102;0
f2025c33ffa71480cde4d7d4edce47c21191fceb;Tue Mar 25 06:09:38 EDT 2008;Committer;nobu;3;32;28;60;0
76865ca0ec2227ea2c6ed1b64a029cb94fbd3f68;Mon Mar 24 13:34:13 EDT 2008;Committer;tadf;2;110;110;220;0
9bfc01ea1704933e10c2662f8ef9e1247ec5c1bb;Mon Mar 24 10:43:56 EDT 2008;Committer;knu;2;9;5;14;0
1b6572295ade3f9a2a461004e72834030d613fae;Mon Mar 24 01:25:56 EDT 2008;Committer;nobu;3;8;4;12;0
30d2565b4eddb15dd6a24617f0700d0173b63df0;Sat Mar 22 17:53:07 EDT 2008;Committer;akr;2;5;1;6;0
6e383d9fa285df5c787fe85ba691bd5ae003bdca;Sat Mar 22 17:31:08 EDT 2008;Committer;tadf;5;43;38;81;0
fa09f2ff029a46bc556d80b2d4523d6e0b8130bc;Fri Mar 21 19:54:28 EDT 2008;Committer;ryan;1;1;1;2;0
068ce364540ef3cbe310570d282f5766c8c0b39a;Fri Mar 21 12:32:33 EDT 2008;Committer;nobu;2;44;9;53;0
439089327a865a756dfd4fa1414cb2fc5495d9e1;Fri Mar 21 12:27:00 EDT 2008;Committer;nobu;4;13;3;16;0
47d42038b373a96ed2daf2b9117e4712d213e553;Fri Mar 21 12:15:06 EDT 2008;Committer;knu;5;25;1;26;0
d728efc96d8080dbb932c38c05a76d7321b7da07;Fri Mar 21 06:51:21 EDT 2008;Committer;nobu;1;1;1;2;0
12f927df8d23e2f5b6905681079408ea561674e2;Fri Mar 21 00:24:30 EDT 2008;Committer;nobu;2;17;8;25;0
fa59ec2f684ace2aa0c4f324d111e18427346574;Thu Mar 20 23:30:34 EDT 2008;Committer;tadf;2;12;5;17;0
3aede677ba35a8dc027ce76f2b0f21e6026e22d4;Thu Mar 20 21:45:01 EDT 2008;Committer;nobu;2;5;1;6;0
b9fd3e4e8504572e6bcd71f51c0432809f8f25cc;Thu Mar 20 16:41:51 EDT 2008;Committer;mame;3;9;5;14;0
d0c2b919ed4b89af01e8a960ef40ef633ad060f3;Thu Mar 20 16:22:03 EDT 2008;Committer;mame;2;5;1;6;0
2029a832e5305b885bc75c2f3ae7b070074bf45d;Thu Mar 20 12:46:35 EDT 2008;Committer;nobu;2;8;3;11;0
5723a8eeb5e8f3db0c2a8ce0e40b8492b4125918;Thu Mar 20 12:26:58 EDT 2008;Committer;tadf;4;2173;120;2293;0
890b0352dd96848b63fb9b3957710ac59c433712;Wed Mar 19 15:29:09 EDT 2008;Committer;nobu;1;16;16;32;0
a130e925822508b887170365cfa3799708dda302;Wed Mar 19 15:21:15 EDT 2008;Committer;nobu;2;37;11;48;0
42522ee2a61259f907fd20585c6aa06d6223a2a1;Wed Mar 19 15:14:01 EDT 2008;Committer;nobu;3;24;18;42;0
bdfe0b8f18dc5642fbd8d50561c8e930cc18645d;Wed Mar 19 14:52:43 EDT 2008;Committer;nobu;2;12;1;13;0
a3c76eb0c7d7b6d9ff51d42269486d59e5ac809f;Wed Mar 19 13:29:04 EDT 2008;Committer;tadf;3;20;75;95;0
1484d1c32a81dc90dd4372defe43445ae1ac0aaa;Wed Mar 19 11:06:25 EDT 2008;Committer;tadf;1;4;0;4;0
80aa946f911747d28f1acf3f442c712dc164d194;Wed Mar 19 09:37:39 EDT 2008;Committer;tadf;2;39;43;82;0
1ee96f770921c151cb8c3e3abe7c18b2c2866987;Wed Mar 19 08:32:30 EDT 2008;Committer;matz;2;6;2;8;0
3f5792a1c64d9f972aaba5a5fc84670a36099eef;Wed Mar 19 05:53:11 EDT 2008;Committer;nobu;3;53;39;92;0
2188bbced38b801bac2c7a342f50975a591bd512;Wed Mar 19 05:36:43 EDT 2008;Committer;nobu;3;10;4;14;0
555eb7ded4e1fb54c434dcdd3c8348881a2a6765;Wed Mar 19 05:08:49 EDT 2008;Committer;nobu;2;7;1;8;0
149a03bdfbaffe39a454a695c5b4c531951193c7;Wed Mar 19 02:50:12 EDT 2008;Committer;usa;2;5;2;7;0
f55963c939144d39f6bd2a8bf75a7751a922f0ba;Wed Mar 19 01:19:29 EDT 2008;Committer;matz;3;12;5;17;0
91a761b4d0929a5055945ccca4797ff57353cac0;Tue Mar 18 07:24:55 EDT 2008;Committer;nobu;2;17;3;20;0
e58adeae0f384a562bbcb295b0a25026842625ca;Mon Mar 17 19:04:29 EDT 2008;Committer;naruse;7;157;31;188;0
89afc5431b10e20689bcaac33a9e81a12d1b2b95;Mon Mar 17 13:28:46 EDT 2008;Committer;mame;3;118;0;118;0
c97735b53c8b1c9f76543c9d802dde097b0f4e7a;Mon Mar 17 08:11:15 EDT 2008;Committer;nobu;2;7;1;8;0
a4394e3f49eceade8b88db6f3dfd2da89da2accc;Mon Mar 17 07:41:12 EDT 2008;Committer;nobu;3;17;3;20;0
a1bebebed1ab4e86f930e2b3c106d6dc72caf124;Mon Mar 17 07:35:11 EDT 2008;Committer;nobu;1;1;1;2;0
2e7815dd8000dc4d3ef7f2443bf5fd045812ee9e;Sun Mar 16 09:09:53 EDT 2008;Committer;duerst;3;27;16;43;0
9e202f9398d683c0b4538810d21257fd4bca9de9;Sun Mar 16 08:31:00 EDT 2008;Committer;naruse;3;8;4;12;0
073ee1756764b81ebe83a7d3c814570fbc5c9b25;Sun Mar 16 00:51:11 EDT 2008;Committer;tadf;2;2;2;4;0
6125552c27b40a8da9e162af2655feca82ac16d3;Sun Mar 16 00:23:43 EDT 2008;Committer;tadf;16;4938;1051;5989;0
2694b2f937681526550b8aabf798f033fa557049;Sat Mar 15 09:19:38 EDT 2008;Committer;matz;4;19;9;28;0
8ead07182897bc4f70f2a74833e50ac8ab700fa9;Fri Mar 14 08:08:51 EDT 2008;Committer;matz;2;16;6;22;0
657429b75b32a9554195e571668465a55f38a5bc;Fri Mar 14 08:04:45 EDT 2008;Committer;nobu;4;10;8;18;0
7476940582efa1add1471bd4ef88d9c83a9fa084;Fri Mar 14 07:59:25 EDT 2008;Committer;nobu;2;19;24;43;0
e5fb40c4fa7f2b637f5cf0843ae5595f8a0a7bdf;Fri Mar 14 06:49:08 EDT 2008;Committer;nobu;2;7;3;10;0
5a182154069edc763ff7b0186e20a17e76b1391b;Fri Mar 14 05:24:17 EDT 2008;Committer;nobu;2;8;0;8;0
d6ca5fefd0807c05cd2e05d7397af2ed6e78d11e;Fri Mar 14 05:03:28 EDT 2008;Committer;nobu;1;1;1;2;0
bc8c8e90d5be190c33ab67a95d66864127ad3b57;Fri Mar 14 02:35:24 EDT 2008;Committer;usa;3;21;10;31;0
05eeb60259d4f601f6b780bd965687fcab893b25;Fri Mar 14 02:24:32 EDT 2008;Committer;nobu;2;17;4;21;0
668af7e99d8458e3033d3641b25656ab8401ad74;Fri Mar 14 01:47:02 EDT 2008;Committer;naruse;4;67;25;92;0
4b31c84daedaeb6ae802e30c1652a5546f977ac0;Fri Mar 14 01:12:32 EDT 2008;Committer;nobu;2;15;8;23;0
c0b8e8229657658e9c0cfeb4c460bde847546b34;Fri Mar 14 01:04:02 EDT 2008;Committer;nobu;2;5;1;6;0
1319ad22d84145eeb7dc2e7c405d413d47cf09f6;Thu Mar 13 16:40:33 EDT 2008;Committer;matz;3;8;1;9;0
92f510a9d9014afdaa2f26a04ff250455ea35162;Thu Mar 13 16:39:45 EDT 2008;Committer;matz;2;8;1;9;0
020d4e4d38beca71cdf9000356ec56ffb390a30d;Thu Mar 13 16:38:56 EDT 2008;Committer;matz;2;5;4;9;0
1d2078824fa527c4bdc9b7a78a5f2b6c245d1367;Thu Mar 13 16:38:23 EDT 2008;Committer;matz;2;3;1;4;0
c7bea6f6e7a17150424d30439f5548e2176bd2b2;Thu Mar 13 16:37:54 EDT 2008;Committer;matz;3;25;14;39;0
cb912bc64d7ad55f7180ca8039923489eb6bfa06;Thu Mar 13 10:58:32 EDT 2008;Committer;usa;3;8;1;9;0
fab87736fd2b421f94196dee7bda4a745a1f20e9;Thu Mar 13 05:14:21 EDT 2008;Committer;nobu;3;15;6;21;0
4514a6bee646262b62db7438cc149a7ff651adb4;Wed Mar 12 18:13:48 EDT 2008;Committer;matz;4;31;6;37;0
db49143cdaa0ff3504531bd32297be9ecb9a2bc3;Wed Mar 12 16:45:28 EDT 2008;Committer;nobu;4;125;10;135;0
c3cbb209caf8ac434063f0a1cc6370b92da63a58;Wed Mar 12 08:33:37 EDT 2008;Committer;nobu;2;5;1;6;0
c7e829292abb39da31509db8846f290ae1bdb304;Wed Mar 12 08:01:08 EDT 2008;Committer;nobu;1;3;0;3;0
96240c6d2d09bb186ebfba2f414348663b806010;Wed Mar 12 05:47:10 EDT 2008;Committer;nobu;5;29;24;53;0
8c36abe23a9c9e980e398171c860a6756716e124;Wed Mar 12 03:52:52 EDT 2008;Committer;nobu;1;10;9;19;0
434b820f5153373f1b8053f894f9cd075dd3ccb0;Wed Mar 12 03:49:55 EDT 2008;Committer;nobu;1;5;5;10;0
2b1b74a099c7c12bcb0ffa847deeeaabecc6f3c9;Tue Mar 11 16:20:44 EDT 2008;Committer;matz;2;44;3;47;0
8f14847366d5e47ad5bde75b84f836177f11ec07;Tue Mar 11 16:15:14 EDT 2008;Committer;matz;3;12;5;17;0
83c017d7af594df9e10a1ba5fbccb063f491bb25;Tue Mar 11 10:48:12 EDT 2008;Committer;nobu;2;24;9;33;0
12043d728d73ac79e218d4fd136371c77ca8aa1f;Tue Mar 11 08:04:27 EDT 2008;Committer;nobu;1;0;5;5;0
dfae30035706a7a78c9a4e57d3a56f5065e48e1b;Tue Mar 11 08:03:26 EDT 2008;Committer;nobu;1;5;0;5;0
6a76630b3c7e85cfd97af77f288321a2f80dcc27;Tue Mar 11 03:39:55 EDT 2008;Committer;nobu;4;7;3;10;0
3e5171559644a5a07bb43fc0cc8735b0614cb2a1;Tue Mar 11 01:20:25 EDT 2008;Committer;matz;2;37;113;150;0
923a661a7ac19ce5e06f80bc6fd1f09172418b5f;Tue Mar 11 00:55:02 EDT 2008;Committer;matz;2;12;4;16;0
eb1f89015e9c8de8e4f084aadb0f0811fd54371d;Mon Mar 10 15:48:35 EDT 2008;Committer;matz;4;10;3;13;0
8149168db64344e483a2b8febb72895494284e24;Mon Mar 10 15:47:47 EDT 2008;Committer;matz;3;8;6;14;0
2a07423f9cb22672cc989b82afd61444dddba7df;Mon Mar 10 06:53:50 EDT 2008;Committer;nobu;2;5;1;6;0
16f09af48ba67239b13a6119de6c8cf1b0272c51;Mon Mar 10 01:40:21 EDT 2008;Committer;nobu;1;120;120;240;0
f55b10c001fd492604b926fc6e60fd072727726c;Sun Mar 09 18:51:46 EDT 2008;Committer;naruse;3;9;4;13;0
eb5789e2ac699a04d34f27fafb342f2a78832e5a;Sun Mar 09 10:16:20 EDT 2008;Committer;akr;1;5;0;5;0
74a1543645dd9b5f3ca59456f90cb4c5f7840a41;Sun Mar 09 04:52:53 EDT 2008;Committer;drbrain;2;13;7;20;0
861219ce4a8c91a6d94c0d138c2f2bf2b3c2337e;Sun Mar 09 01:04:46 EST 2008;Committer;akr;21;114;122;236;0
0d3f9dbfe1ab1696d1c9b1ef46c9da4af786e629;Sun Mar 09 00:59:23 EST 2008;Committer;drbrain;4;16;4;20;0
31b604a3f38a612f28738fd70dde952dc234e001;Sat Mar 08 09:51:00 EST 2008;Committer;nobu;2;10;7;17;0
a39feece851a048320ade466dec0a4abb0342a18;Sat Mar 08 09:05:34 EST 2008;Committer;naruse;4;49;38;87;0
b7d7519b18ec83d5069238a9648f6e3d56504bcd;Sat Mar 08 06:10:22 EST 2008;Committer;akr;1;2;0;2;0
6f8d578b8a42352948e42b5177eefb40660cf35e;Sat Mar 08 05:56:03 EST 2008;Committer;akr;1;0;223;223;0
fddbc2738f98781577a3411ef118453b6434a9d0;Fri Mar 07 12:28:57 EST 2008;Committer;mame;2;96;92;188;0
a6267179eedbd84392a13349a1515f42d9f46af2;Fri Mar 07 12:14:17 EST 2008;Committer;mame;2;10;10;20;0
2bbf4707f75be6dc2bd57e30e4bacdba789be6af;Fri Mar 07 11:30:07 EST 2008;Committer;nobu;2;5;1;6;0
983aea463f0a27d7728655b3d158b494a727f4ca;Fri Mar 07 10:56:13 EST 2008;Committer;nobu;2;125;2;127;0
643d2bad07ee14fbf0e53ba38ebf1df96a24a359;Fri Mar 07 10:22:10 EST 2008;Committer;usa;1;3;3;6;0
7a23e865880658d90a459c1709a00815734eabd9;Fri Mar 07 10:18:18 EST 2008;Committer;akr;1;1;2;3;0
67151cd7af01f97524f0a14cf5abd9567f856155;Fri Mar 07 08:31:41 EST 2008;Committer;akr;2;165;49;214;0
fbe88bb2138ae64b80314972a1f2fc02d8d45207;Thu Mar 06 15:46:18 EST 2008;Committer;akr;1;60;30;90;0
ec2205b2052ddf72685e6e6f1c25d0b3c19de831;Thu Mar 06 08:26:55 EST 2008;Committer;nobu;2;7;0;7;0
fe2a671fdb1333914a2b751fefc6191c2c3c28e9;Thu Mar 06 08:04:18 EST 2008;Committer;akr;1;5;0;5;0
7b8d61c2edfa4f815066a2a1a993d157ce41a553;Thu Mar 06 06:50:41 EST 2008;Committer;akr;1;8;8;16;0
c1e0cb08f212eb91da1bf915d34435fd2e06fa19;Thu Mar 06 06:48:15 EST 2008;Committer;usa;1;3;0;3;0
ed6b1829bad6c30c00b68d5efdf4c2f1af12cc80;Thu Mar 06 06:44:41 EST 2008;Committer;usa;2;2;3;5;0
774aebb3ce3ef856789a7c60e0839f93a393fe6a;Thu Mar 06 06:40:56 EST 2008;Committer;akr;1;1;1;2;0
7a62e3ea5996c1c33e017692f73caa70ace0b870;Thu Mar 06 06:21:07 EST 2008;Committer;akr;1;1;0;1;0
16d0ad48996eaf76b240cff2d8af02defe29e327;Thu Mar 06 06:20:48 EST 2008;Committer;usa;2;7;1;8;0
591503c0ab7a4d6bf9f90b8bdf317ee5cfa13d03;Thu Mar 06 06:11:43 EST 2008;Committer;nobu;3;18;32;50;0
6aac0579d1920fe3be0a12cd2a0775036d576220;Thu Mar 06 06:08:37 EST 2008;Committer;usa;3;9;2;11;0
d1cd806372d04675e9f646f1c1e01ef97e103ecc;Thu Mar 06 05:53:03 EST 2008;Committer;akr;3;10;1;11;0
d2797c33bd41382c7dd6dbccdb4f2b08044d0cf9;Thu Mar 06 05:30:48 EST 2008;Committer;naruse;2;18;13;31;0
be36a1b138a311cb4356e5ad64641eb9598c4dcc;Thu Mar 06 05:06:30 EST 2008;Committer;akr;2;13;5;18;0
53577db05b027787b190bd1934ec72ae045b7df1;Thu Mar 06 02:14:17 EST 2008;Committer;nobu;2;38;8;46;0
6b10829b22b2919fb8e8cea895c5fb56c3760127;Thu Mar 06 02:12:31 EST 2008;Committer;nobu;2;7;2;9;0
bececd35c5e177de014a0faf83da03db119a825c;Thu Mar 06 01:33:56 EST 2008;Committer;matz;2;6;1;7;0
98cbcf1bd7909306d2ba542aaff2eceb71ccb5c1;Wed Mar 05 19:34:15 EST 2008;Committer;naruse;4;28;14;42;0
579f16d9851fc220a1dda9a0d65e611cc37aeb14;Wed Mar 05 16:24:09 EST 2008;Committer;akr;1;263;8;271;0
8c889459cf17b4d5b664fa98062e83f10da3d33b;Wed Mar 05 15:34:02 EST 2008;Committer;nobu;2;6;1;7;0
79cdf2ffa201b3b9f1108d77231a7adae2c4e3bb;Wed Mar 05 15:31:42 EST 2008;Committer;nobu;3;10;8;18;0
fff981ee6de1c91392105aeef60bd17f2b88af70;Wed Mar 05 13:54:36 EST 2008;Committer;naruse;2;45;35;80;0
e34480c33006c4acc20d8f276c06a1f29f2bf26b;Wed Mar 05 13:31:06 EST 2008;Committer;akr;1;4;0;4;0
12551ae5732e83e8ba77cf68c3501529d608c282;Wed Mar 05 08:53:08 EST 2008;Committer;nobu;2;6;2;8;0
08631278ada7a6fd2bafb3ab0f0447b1f6d58790;Wed Mar 05 08:45:51 EST 2008;Committer;duerst;3;29;10;39;0
39787ea14db33dd4265d7f6271cd2d59ccaeff37;Wed Mar 05 05:22:17 EST 2008;Committer;matz;15;106;54;160;0
413db1b036083f76a2b34895af3c8a3204e174f2;Wed Mar 05 02:52:43 EST 2008;Committer;matz;3;22;7;29;0
772c19298d6046b69917035f56253c99c77a4c35;Tue Mar 04 12:37:05 EST 2008;Committer;matz;3;13;2;15;0
a110ef359aea39502990eba1a01952411b55cda7;Tue Mar 04 10:19:55 EST 2008;Committer;matz;2;5;0;5;0
f8c5b8ec90cec4a8db42bd07f97c475ba6353b10;Tue Mar 04 10:14:40 EST 2008;Committer;matz;2;12;6;18;0
6c76a2577ab2ae9ecaf846a908be4b35206b3d69;Tue Mar 04 07:29:38 EST 2008;Committer;matz;2;5;1;6;0
70b55c5dcfb237ebab92523bba66cd4c3a25f944;Tue Mar 04 05:36:08 EST 2008;Committer;naruse;2;25;3;28;0
8e1d6b214a696333290df5d54dcc9a472d4b2df6;Tue Mar 04 04:42:31 EST 2008;Committer;akr;2;7;2;9;0
fd847f79a0c5e9e61860ff4133665f7099bc85cf;Tue Mar 04 01:21:06 EST 2008;Committer;nobu;2;37;19;56;0
8ac9b7c2ed7b0da6b7c9380e9977fda46c6d24f8;Mon Mar 03 20:34:58 EST 2008;Committer;naruse;3;9;8;17;0
10a0d4b61dd575be73c2e2b6223f1bf7d34c63ea;Mon Mar 03 14:31:30 EST 2008;Committer;gotoyuzo;3;88;2;90;0
7c9e815d940c0b8de7b4a212301c8b1cef62ae2d;Mon Mar 03 08:54:31 EST 2008;Committer;akr;1;4;0;4;0
384e8e668065f975487665e99a11434c99348c4f;Mon Mar 03 08:27:43 EST 2008;Committer;matz;2;35;7;42;0
bbc2f80a32b52b79586829e46ec97781456f9080;Mon Mar 03 08:22:18 EST 2008;Committer;matz;3;5;3;8;0
9b2dd1e20d91af8dc88b300c942a8fb9c5d28c58;Mon Mar 03 07:14:27 EST 2008;Committer;nobu;3;14;6;20;0
3b5d60c0b1602d4aa2b1183d9842cace91d26a07;Sun Mar 02 14:04:02 EST 2008;Committer;nobu;2;6;4;10;0
6a9bfa23bf686b29e85d78a1566950a533e4b8a8;Sun Mar 02 01:13:15 EST 2008;Committer;nobu;2;8;0;8;0
601616d6ff9b6ed2420e6b122f8ed48d5406b175;Sat Mar 01 16:16:46 EST 2008;Committer;akr;1;54;0;54;0
655fd2dc372929a7d6250a5c8150bbc447798b6e;Sat Mar 01 16:05:10 EST 2008;Committer;akr;1;1;0;1;0
374fac74822f817172adda3799ac006b0ce45f0b;Sat Mar 01 15:51:04 EST 2008;Committer;akr;1;3;0;3;0
b4b3180bfab8c1027a3a082013f5ebd9c8fb6775;Sat Mar 01 15:08:13 EST 2008;Committer;nobu;4;23;12;35;0
b8a733d0b87ae6b1425375a0cdeec37406f6e2f6;Sat Mar 01 08:59:04 EST 2008;Committer;nobu;3;270;134;404;0
cce9eb092b7a8be2259c8fce5f286d183535ad3b;Sat Mar 01 08:51:37 EST 2008;Committer;nobu;2;8;2;10;0
e31eeedb9473f831cd233d612c31c4bef6f0b1ad;Sat Mar 01 08:45:04 EST 2008;Committer;nobu;1;2;2;4;0
ffd3954d31190f7ae20052952777830b8c7e2b1d;Sat Mar 01 05:15:34 EST 2008;Committer;matz;1;4;0;4;0
22dc58bf973a78675b1f98eafe052fe614471d72;Sat Mar 01 05:13:28 EST 2008;Committer;matz;2;11;4;15;0
00bf4e8a84c59f051b87c1a613fe8544b86c5aa6;Sat Mar 01 04:12:13 EST 2008;Committer;akr;4;119;28;147;0
fe7d645eed6eef0eb0132982e2b1f4e286163eb5;Sat Mar 01 04:07:26 EST 2008;Committer;matz;1;1;1;2;0
adad6e030038587bd8c5bd9240f9e20215865be8;Sat Mar 01 03:42:58 EST 2008;Committer;matz;1;10;0;10;0
88d9f7aeac3b438561bfaedeb0d2b9173160dfda;Sat Mar 01 03:42:06 EST 2008;Committer;matz;2;6;1;7;0
207b8292ba0bf13b60a1ad745dcb438015d38bfc;Sat Mar 01 03:36:33 EST 2008;Committer;matz;4;19;11;30;0
32c4aa1d144f6895d0e4d2c62b384d22c3fb4860;Sat Mar 01 01:42:32 EST 2008;Committer;matz;1;1;1;2;0
4c7d380a81644567142895b88e126ee12dd75d8f;Sat Mar 01 01:33:17 EST 2008;Committer;naruse;2;9;5;14;0
840723e523cd54689b41bdc94abad6e63a991c6f;Sat Mar 01 01:22:45 EST 2008;Committer;matz;2;5;5;10;0
79f1b9e93b251da509766d99022689bd040e0e2b;Sat Mar 01 01:09:43 EST 2008;Committer;nobu;2;19;25;44;0
d5fec27d8e1fe31c38b199c1803db9dbdfaa7da7;Sat Mar 01 01:02:30 EST 2008;Committer;matz;2;11;3;14;0
18e70b266f05faa7963c159842202e5c1ad4cc15;Sat Mar 01 00:38:33 EST 2008;Committer;matz;3;16;8;24;0
4e6e5a431641056c6554c79a288a4f4ec175ad96;Fri Feb 29 17:44:15 EST 2008;Committer;nobu;1;2;3;5;0
4a65cba488e02f00a66d430aee24a9e1bcc04cb7;Fri Feb 29 17:35:11 EST 2008;Committer;nobu;3;16;0;16;0
cd89edc065296409f55ab15a45c4dd580950829f;Fri Feb 29 15:29:09 EST 2008;Committer;nobu;3;15;6;21;0
99de7f24f76a0ea1dc61a404a815611801107e0e;Fri Feb 29 14:57:04 EST 2008;Committer;matz;3;12;3;15;0
21c9bd1b33b122fafb310147e565b792d62c8241;Fri Feb 29 14:36:39 EST 2008;Committer;akr;1;9;0;9;0
fa0f42d4b95dff414e953668258ec7d6486432a4;Fri Feb 29 13:44:50 EST 2008;Committer;matz;2;7;2;9;0
2d97d3ddac90777a9df4edea9c445155e42f30b7;Fri Feb 29 13:33:26 EST 2008;Committer;matz;4;86;31;117;0
daa622aed079b4434e607820d7577b4a7d4f2bfc;Fri Feb 29 09:19:15 EST 2008;Committer;matz;6;47;5;52;0
deff2a3e247d9dd42ac55d9ecfeb7f567aac9fd4;Fri Feb 29 06:19:21 EST 2008;Committer;matz;3;13;3;16;0
d14c3eb4b8dda24c6cce082da550941540d159c0;Fri Feb 29 06:12:46 EST 2008;Committer;nobu;4;10;2;12;0
b4be9b0bb1b42e5bc591a2c384224e56886cb341;Fri Feb 29 05:16:39 EST 2008;Committer;nobu;1;1;1;2;0
2f866a3666b3e768a07d4a780f7ff20375b82d21;Thu Feb 28 18:32:17 EST 2008;Committer;naruse;2;7;1;8;0
50a860d00635c6de5e32fe753b3adae596192f6d;Thu Feb 28 18:13:45 EST 2008;Committer;naruse;5;16;10;26;0
3cb57fb1c3c2b25bd94660c099f52489a1564354;Thu Feb 28 17:27:41 EST 2008;Committer;nagai;7;56;27;83;0
3e1c54defd58609ae284a78b3bc5501105d332e6;Thu Feb 28 14:38:33 EST 2008;Committer;akr;2;12;5;17;0
5eafc201d8d27394f2bde9cd08f03c1dac36bbb8;Thu Feb 28 13:22:29 EST 2008;Committer;naruse;2;6;1;7;0
6f99342c92055f8a891d889fb99ab7f131962977;Thu Feb 28 11:58:11 EST 2008;Committer;naruse;4;13;5;18;0
1f262b3ef4e00fe8a7e84ab524ba53deeae1a07c;Thu Feb 28 09:10:32 EST 2008;Committer;akr;2;27;1;28;0
2f12678bcfde0b5cc2628cbba316ec0b6e89d888;Thu Feb 28 09:03:43 EST 2008;Committer;akr;1;4;0;4;0
198e1d074c187d2a4e8b9d1bb378a714b2d6001b;Thu Feb 28 06:30:38 EST 2008;Committer;naruse;2;10;0;10;0
51411c1f882e8d455249de2768366c25ba3a9b50;Thu Feb 28 05:59:13 EST 2008;Committer;nobu;1;2;2;4;0
7bb2b2f43159355487971808d274bc5add30868b;Thu Feb 28 05:38:16 EST 2008;Committer;naruse;2;4;12;16;0
ecd35c0d9692704c7c1298ef9d38a73687d383fb;Thu Feb 28 04:52:01 EST 2008;Committer;nobu;4;33;17;50;0
5848032ce5784083e230c608b3b63d9072fa40f8;Thu Feb 28 02:43:59 EST 2008;Committer;nobu;2;9;2;11;0
586f727b8c37630d36618f8f09765b92098af8a0;Thu Feb 28 02:25:14 EST 2008;Committer;nobu;1;1;1;2;0
9a68795300cf21d983c3ce6eafb8529353e37edd;Thu Feb 28 02:23:52 EST 2008;Committer;nobu;1;4;0;4;0
d3545f0d3c0addb01d80ec6949db96af008d6190;Thu Feb 28 02:19:53 EST 2008;Committer;nobu;2;5;2;7;0
c015c6fa8e11f3d8ca206151487e9a0ee6d3bed8;Thu Feb 28 02:13:51 EST 2008;Committer;nobu;4;20;10;30;0
343a1504e32c9910316182258bd8a7dfd13d2c9b;Wed Feb 27 20:56:03 EST 2008;Committer;naruse;1;2;2;4;0
ee695fb164796dc203306f1585c4f6dd74f06806;Wed Feb 27 18:44:31 EST 2008;Committer;nagai;88;844;464;1308;0
4dd9fd71b34cd21613404a2900085868dfac5cd4;Wed Feb 27 15:19:22 EST 2008;Committer;naruse;4;75;4;79;0
9d014dc2546bdcc9bf899e734e7df73ae5735a2b;Tue Feb 26 18:56:00 EST 2008;Committer;nobu;5;38;25;63;0
99e8314b3bac2fa842817b67f749974beb721b9f;Tue Feb 26 07:53:40 EST 2008;Committer;matz;2;6;1;7;0
3b0f5058fa3b97a88cec5be0d1ce9699862cfa62;Tue Feb 26 07:41:34 EST 2008;Committer;nobu;2;15;2;17;0
525b2e78e5ba3d6d76bdd9b2db747abad799a705;Tue Feb 26 07:38:13 EST 2008;Committer;nobu;2;5;1;6;0
161b45f59ccb1d220a0b7741d4d3e1be6134944a;Tue Feb 26 07:07:26 EST 2008;Committer;technorama;7;26;33;59;0
43b1b0e16a6ced5ba337a0f3f120f5d21f9abf8d;Tue Feb 26 06:50:12 EST 2008;Committer;nobu;2;13;0;13;0
fbee9ba6ea90e881a3341caaa2114df4f5aa16d9;Tue Feb 26 06:44:53 EST 2008;Committer;akr;2;8;6;14;0
eccb4ca2e71611ecca616f8c57bc087898a17c91;Tue Feb 26 06:30:38 EST 2008;Committer;nobu;2;44;19;63;0
c4693e62afaa5547be208b60b8b7fe79acc58aa5;Tue Feb 26 06:10:45 EST 2008;Committer;usa;1;1;1;2;0
116b15765d20cf36991f3865620d644ee46bb77c;Tue Feb 26 00:09:17 EST 2008;Committer;usa;2;4;4;8;0
b58e36da4aaddd8d62c8750c1727c5849c56dc89;Mon Feb 25 16:18:18 EST 2008;Committer;akr;6;51;38;89;0
f0ca4e868d1385282195ab8103b980e947690aef;Mon Feb 25 13:39:49 EST 2008;Committer;nobu;1;3;3;6;0
3ec97f3732ff78aff36ca04153a7a4b4a82bf2c2;Mon Feb 25 08:51:18 EST 2008;Committer;technorama;3;51;124;175;0
1ccaaf1ad5e534463524ed2e17c7fa28f4c20701;Mon Feb 25 06:35:22 EST 2008;Committer;usa;1;1;0;1;0
07de01ca3b14d2a6900bf15293d9170e097bb4c1;Mon Feb 25 06:34:38 EST 2008;Committer;usa;2;11;2;13;0
84c9041f9bd6f0331592be1a6dc105f822e3e01c;Mon Feb 25 04:58:47 EST 2008;Committer;akr;2;15;7;22;0
ad3577b59b7ba2b3f533bfcb697492fc9f56762f;Mon Feb 25 01:42:47 EST 2008;Committer;duerst;2;8;3;11;0
42097d7ac1f86fda389eb66f6cbe5c57fc5ead9e;Sun Feb 24 15:01:06 EST 2008;Committer;nobu;2;5;1;6;0
a4a0080a4187eb5a00e98d95e258c4230d25cef7;Sun Feb 24 14:40:01 EST 2008;Committer;nobu;2;6;1;7;0
59a1754a643082d12f9e0347a50d5bbe2ca3d271;Sun Feb 24 14:29:51 EST 2008;Committer;nobu;5;10;8;18;0
b676e2671eaf82b7d1c71988d3f951183eef612b;Sat Feb 23 21:49:15 EST 2008;Committer;nobu;2;31;15;46;0
552badf29f3aa5e9b76d02716f93f37b94ba8353;Sat Feb 23 21:13:05 EST 2008;Committer;nobu;5;106;29;135;0
b3b3ff29b5e266c1fb9d2c5b5581614155b60f60;Sat Feb 23 20:25:29 EST 2008;Committer;nobu;2;13;13;26;0
f11ac55489d81744f162036b402dc8d3b4ebcda9;Sat Feb 23 20:09:46 EST 2008;Committer;nobu;2;6;1;7;0
f468e000ce3ed8c5158af06600a0724bf9619c4b;Sat Feb 23 19:03:32 EST 2008;Committer;nobu;1;1;4;5;0
fe80dd73b9a5021e2e2cfe61cda87512f8ee4c53;Sat Feb 23 18:53:00 EST 2008;Committer;nobu;3;13;12;25;0
fa222ced64da91f92a21aee780f915c2114e1b88;Sat Feb 23 12:36:51 EST 2008;Committer;usa;2;5;0;5;0
bad85e520274fbe2ae7c5117a9b3a781925e9f17;Sat Feb 23 11:21:02 EST 2008;Committer;naruse;1;1;1;2;0
c1d34650810cdc2285e153ec446b7a0941b0c92e;Sat Feb 23 11:18:07 EST 2008;Committer;naruse;2;13;12;25;0
386aa4c0a137949df4b20148451843d53ea9b41d;Sat Feb 23 10:29:13 EST 2008;Committer;naruse;2;44;22;66;0
93efbc78bdc3d86088bcd7e7084d60591b95946b;Sat Feb 23 09:55:33 EST 2008;Committer;suke;2;5;1;6;0
23ac9d7035a62612c60f344d08cf74439029242c;Sat Feb 23 02:52:38 EST 2008;Committer;nobu;1;3;3;6;0
310735aa4ad3978557d64683989c1e51356390df;Fri Feb 22 16:12:32 EST 2008;Committer;akr;3;203;25;228;0
7b218308e0e4470abbd13aad4b116c5df2e3d306;Fri Feb 22 15:02:40 EST 2008;Committer;naruse;1;1;1;2;0
70eea8fd26c5df404a8cbe45846ad637cef9acaf;Fri Feb 22 12:56:21 EST 2008;Committer;naruse;1;2;1;3;0
bdb14b5bb6e5ed627dad1bb68c49f47f58d36c9b;Fri Feb 22 12:15:56 EST 2008;Committer;naruse;2;16;2;18;0
bc2fb51c5eb8c7010957cc8f3c8ed7e066c8ea51;Fri Feb 22 10:50:21 EST 2008;Committer;nobu;2;17;1;18;0
81fc1cf2017840d0786cf997b4d2a80f80060001;Fri Feb 22 06:52:54 EST 2008;Committer;akr;4;48;9;57;0
a532dcafe6f523b79024cb1ee7cff31cc1127ae3;Fri Feb 22 03:16:52 EST 2008;Committer;naruse;2;6;0;6;0
7a9cf391cd9f9fafaf66c7167c57a32a3efb0ab4;Fri Feb 22 02:18:23 EST 2008;Committer;naruse;2;8;1;9;0
492dde9c0963dff11217aa26f94148ec906067ae;Fri Feb 22 00:42:52 EST 2008;Committer;usa;1;3;3;6;0
ca3ce9bb9dfea896fcd6da109b1c31477d58c8af;Fri Feb 22 00:33:27 EST 2008;Committer;usa;1;1;1;2;0
b06fa3d168c3ab86a2ae26d1311572c7f92b494f;Fri Feb 22 00:17:42 EST 2008;Committer;usa;1;13;1;14;0
80e81d283d5bf1df5cc1a1df5bc7289525194ffc;Fri Feb 22 00:07:23 EST 2008;Committer;nobu;4;10;6;16;0
b62df564a6eff10ed741804c9a2415f6acac807f;Thu Feb 21 19:54:48 EST 2008;Committer;naruse;3;20;7;27;0
6d5ef97a32f74917efaa53049815873c4ae00aa1;Thu Feb 21 08:42:10 EST 2008;Committer;duerst;3;45;6;51;0
ca22f3e168dc16cda7b88cb257ce4298782e46b2;Thu Feb 21 07:47:12 EST 2008;Committer;matz;3;12;6;18;0
b356796f006af0c0836822e30e2c3b46dc8a8340;Thu Feb 21 07:35:29 EST 2008;Committer;nobu;2;8;4;12;0
ce0264b6f5dc41325abfd0b40abe6d8ad69976db;Thu Feb 21 05:49:42 EST 2008;Committer;nobu;2;4;4;8;0
7f2ca5ba7a5afd95354d7ea9a39741cebff38e70;Thu Feb 21 05:47:12 EST 2008;Committer;nobu;4;13;5;18;0
3ce61d2a639a47d505fa9179d6d41f774c85ad92;Thu Feb 21 02:42:51 EST 2008;Committer;naruse;2;34;21;55;0
4701476b97f0297751578062178f388c210947af;Thu Feb 21 01:36:50 EST 2008;Committer;naruse;2;6;1;7;0
e16fddf1a9b3ab01540fd0c3fae05d194c07fd11;Wed Feb 20 15:01:36 EST 2008;Committer;nobu;3;20;11;31;0
99b9eaaa68536d56ef4b63add25428c1e16cf0c4;Wed Feb 20 14:55:21 EST 2008;Committer;nobu;3;9;2;11;0
5a99317830b640fc76f9def256c3e5d97ee807d3;Wed Feb 20 14:43:39 EST 2008;Committer;usa;2;7;1;8;0
1e0958098f4ab4487041070c2d064c14c57406b9;Wed Feb 20 10:44:28 EST 2008;Committer;naruse;2;7;0;7;0
492f431a46b5742e0c741fb0345e3279661a5762;Wed Feb 20 10:20:43 EST 2008;Committer;naruse;2;32;4;36;0
96ada56fb9caf72b3ef451f251cf876c6bec3d7e;Wed Feb 20 04:08:54 EST 2008;Committer;nobu;2;83;34;117;0
f761aacdd8689f92e29fe9cb659060f4df198db9;Wed Feb 20 01:09:21 EST 2008;Committer;usa;5;20;12;32;0
f1c975b87aa1ac6b50e53424ba8ff4a0c73985e9;Tue Feb 19 12:18:03 EST 2008;Committer;naruse;2;65;2;67;0
e4021207fb0add1133b0c3e7f3b2acc2bc8d877c;Tue Feb 19 11:49:51 EST 2008;Committer;nobu;2;7;3;10;0
fec2c12c29df1fdc33a4d7fc110673adc35b7432;Tue Feb 19 09:37:10 EST 2008;Committer;akr;2;5;3;8;0
5f1284ca8dfbee247d534e6d8f0c22d1c0f36c72;Tue Feb 19 06:24:36 EST 2008;Committer;nobu;2;381;4;385;0
8a9bd6a5c610e96118815fd7c0fc9846e2903210;Tue Feb 19 05:27:35 EST 2008;Committer;nobu;2;19;2;21;0
b81a66d1ef2e578d9e248ea36d3cf4beb72bab53;Tue Feb 19 02:14:14 EST 2008;Committer;nobu;4;17;7;24;0
390adf6112228a4c32381a4882c8076ff6b44c84;Mon Feb 18 08:16:10 EST 2008;Committer;akr;1;6;0;6;0
1d2e4d830c23e3691de9560653c8b86a9d8f1d98;Mon Feb 18 08:09:05 EST 2008;Committer;akr;4;8;5;13;0
f0b758a1285f8e7a5ca2f4ddb2b268de0cb8ee44;Mon Feb 18 06:59:47 EST 2008;Committer;akr;3;6;3;9;0
8efc7ea9ad664b942f48e16bb325769b08844b9f;Mon Feb 18 06:18:31 EST 2008;Committer;akr;3;11;1;12;0
e61e1f6234fe994508506341932fa118abafb370;Mon Feb 18 06:18:14 EST 2008;Committer;akr;1;2;0;2;0
588d870234b9b7143fbb0b5927cc80bfdaca219b;Mon Feb 18 05:33:01 EST 2008;Committer;matz;5;11;6;17;0
b2b3f25c37f489a8ac2a639ac7362397fa309db4;Mon Feb 18 04:07:56 EST 2008;Committer;akr;2;5;1;6;0
d77ddf33aed2177ff0be4b4fc72aaee003865198;Mon Feb 18 03:51:34 EST 2008;Committer;akr;2;20;1;21;0
1783b7aaccf52291c5e7f84e349ad3c95a858269;Mon Feb 18 03:43:11 EST 2008;Committer;akr;1;1;1;2;0
b7cb4ddb216e047aefb8ec0843806bc578b9512c;Mon Feb 18 03:08:44 EST 2008;Committer;akr;1;11;10;21;0
a74c11cd4ae132d3019f684d1615c635587bfda7;Mon Feb 18 02:52:10 EST 2008;Committer;akr;2;10;0;10;0
879d41e22c7ef558aba93f93cf16632ba2e03a54;Mon Feb 18 01:17:44 EST 2008;Committer;nobu;2;6;1;7;0
bcf1e2ac129c7996a88a3129d3aa9a67010cbd84;Mon Feb 18 00:08:01 EST 2008;Committer;akr;1;6;0;6;0
57ae6ad003a00e614dde26fd5c17a9f4ce973d77;Sun Feb 17 17:00:09 EST 2008;Committer;usa;1;3;3;6;0
c2c32b50b18ff48882c51a6cbd2287646f27a267;Sun Feb 17 16:50:49 EST 2008;Committer;akr;1;20;0;20;0
583a4b1774a9458585fe896b7756e5e3e39beb32;Sun Feb 17 15:35:09 EST 2008;Committer;akr;3;7;1;8;0
adc639bb263ad411c0081b2d786865186c31ec2c;Sun Feb 17 14:08:27 EST 2008;Committer;kazu;2;11;1;12;0
8dd8dfce21d9ac6c7d791a9d95a11e6f7839d545;Sun Feb 17 13:01:52 EST 2008;Committer;naruse;3;16;8;24;0
b8fd2fabbef7696b42e2802caf1daf1368cc099e;Sun Feb 17 12:54:17 EST 2008;Committer;akr;3;13;4;17;0
a197a30a94938a54543c35a3f55fbcd542d402b8;Sun Feb 17 11:13:22 EST 2008;Committer;mame;2;500;0;500;0
2ea2063f5a81431c70dff8a1df7d73b33e3db27e;Sun Feb 17 09:52:50 EST 2008;Committer;akr;1;9;2;11;0
fbe308de9dece5d8640a3c417e295da5d006c780;Sun Feb 17 09:43:20 EST 2008;Committer;akr;1;7;0;7;0
8ccd884498fe944aba75c3ee91119823216460b3;Sun Feb 17 08:07:24 EST 2008;Committer;kazu;1;2;2;4;0
7a257b0110ec9f9dc1269b1b24975530787a135c;Sun Feb 17 06:49:11 EST 2008;Committer;naruse;4;19;3;22;0
a906fce838e51ddaa6c1b22162959968bc77a30c;Sun Feb 17 05:08:43 EST 2008;Committer;akr;2;6;8;14;0
bf2d82b280af0c2327a939013699a4616fa5c1c1;Sun Feb 17 04:04:14 EST 2008;Committer;akr;2;7;11;18;0
8984fa674290c17b62c7cf5cf0dd266d297fc14b;Sun Feb 17 03:21:20 EST 2008;Committer;naruse;14;345;4;349;0
0f4199fb56ec12dae32a6fa099f15aaa7e55d10f;Sun Feb 17 02:00:05 EST 2008;Committer;akr;3;17;12;29;0
35cb0f807b4689b0405dfbb2821e13f14c1fca45;Sun Feb 17 00:18:16 EST 2008;Committer;akr;3;23;5;28;0
71c5e485989cfead51f62f36d0d694cab65f855f;Sat Feb 16 20:08:35 EST 2008;Committer;akr;5;226;58;284;0
5b461c699623240b9b1305d567945ce7ffa297f4;Sat Feb 16 18:16:21 EST 2008;Committer;usa;5;22;17;39;0
66583d96634796a16e22ded9ba688026da54fb5b;Sat Feb 16 11:53:04 EST 2008;Committer;naruse;2;64;1;65;0
8bcfa698a040698247ca20006a4aa4b6c1978c4b;Sat Feb 16 11:43:12 EST 2008;Committer;akr;2;10;3;13;0
60fa63b819e12601eb4ad88faa52548ef389aabb;Sat Feb 16 11:13:47 EST 2008;Committer;akr;2;8;0;8;0
bb831578c5e52eaa6af149874fd1f95fec8ee59f;Sat Feb 16 10:06:15 EST 2008;Committer;naruse;2;4;3;7;0
0ad3d7ce2d679a92d2904430919c835639993a32;Sat Feb 16 09:30:03 EST 2008;Committer;naruse;2;16;9;25;0
7eeba5f440975912a63ee6e9da014c4a727cb565;Sat Feb 16 09:02:12 EST 2008;Committer;akr;4;62;3;65;0
de7c3793c0d0e842fff98bb64910be77fd4c7a22;Sat Feb 16 07:18:49 EST 2008;Committer;akr;1;1;1;2;0
a47e8e776c8e91cdf17f4cb79569c8b20c88b845;Sat Feb 16 07:16:36 EST 2008;Committer;akr;2;38;29;67;0
c2459f35acbef17644d706f8f6386e1368040f96;Sat Feb 16 05:48:42 EST 2008;Committer;akr;1;3;0;3;0
d3f565ef2cf5ba65bd9303c686ea07232dac121c;Sat Feb 16 04:38:06 EST 2008;Committer;suke;2;10;2;12;0
2df0301c72cfe9117d9fbdec0383a481dfe5e354;Sat Feb 16 04:21:46 EST 2008;Committer;akr;1;3;0;3;0
9b3ab49b5da2078af3917ab44db0ba92d4aa721e;Sat Feb 16 04:17:52 EST 2008;Committer;akr;2;25;14;39;0
327673a43b8aaf0df6ca2a494ab4aeadb49802fb;Sat Feb 16 04:05:58 EST 2008;Committer;naruse;2;34;0;34;0
af75cc01bc7ed39eafbc958936c51e0221313051;Sat Feb 16 02:55:08 EST 2008;Committer;akr;3;40;26;66;0
125c0a0d93f8562c1115290d10e110e20053eebb;Sat Feb 16 02:46:27 EST 2008;Committer;akr;2;11;2;13;0
9a431fd58c33900b6ced1d5ee18400276a32f2e5;Fri Feb 15 23:03:22 EST 2008;Committer;naruse;2;7;2;9;0
a2d85d61bdad79c89b0281dc3ad2e9afc3ae1c6b;Fri Feb 15 20:55:27 EST 2008;Committer;naruse;3;12;3;15;0
fc46d89b6d7a8e8859741a0120b9b4621dfb9de6;Fri Feb 15 20:42:34 EST 2008;Committer;naruse;1;5;0;5;0
132e3f54f2369575b27e315cb4f8ef3d82aaac27;Fri Feb 15 20:41:29 EST 2008;Committer;naruse;1;1;1;2;0
0831222a9135e0074b71d8f3890f94fdc78d61dc;Fri Feb 15 18:48:27 EST 2008;Committer;akr;3;55;30;85;0
0040ed402063ef2c846bae09027d7ca4ea2215db;Fri Feb 15 18:16:14 EST 2008;Committer;akr;1;4;0;4;0
9c0be2d5165286703e2627e80fdd216a63da9215;Fri Feb 15 15:21:51 EST 2008;Committer;nobu;3;12;11;23;0
41ca14e8ac90f64b05192020375dee852d0667eb;Fri Feb 15 11:36:24 EST 2008;Committer;suke;3;98;4;102;0
a05337f14d373d99da2b150b96a88800a0b7c018;Fri Feb 15 09:23:55 EST 2008;Committer;nobu;2;20;4;24;0
8b09f7015a6edf1aefecaed421c7fd4b750353bc;Fri Feb 15 08:14:40 EST 2008;Committer;matz;3;34;11;45;0
878bbd1199167d6beb0faa85a6d8fe5e8122ee49;Fri Feb 15 07:35:11 EST 2008;Committer;matz;2;11;5;16;0
12b1578cabdf06cc76f6debaf8a953a922b47154;Fri Feb 15 06:35:20 EST 2008;Committer;akr;2;50;0;50;0
b0333388ab089e70be9109434ba5a6961b08fa60;Fri Feb 15 06:29:32 EST 2008;Committer;akr;2;10;0;10;0
748beee825447256e1aa7dd1458ba317fabbd18f;Fri Feb 15 06:23:14 EST 2008;Committer;nobu;2;9;1;10;0
17fb1248afd41c0da5c421c34d029695bb690069;Fri Feb 15 01:35:56 EST 2008;Committer;nobu;2;6;1;7;0
5b7bdd56ad54624de87b107eebe417b755bfc25c;Fri Feb 15 01:27:48 EST 2008;Committer;nobu;3;7;0;7;0
04e7cc64115715f47d602114194c65d0e8471eee;Fri Feb 15 00:44:13 EST 2008;Committer;nobu;2;12;3;15;0
ab3e8e6143049662cf724c8574cd9fb8e248a4a0;Thu Feb 14 22:38:20 EST 2008;Committer;drbrain;2;6;1;7;0
48046586497d50c99c185a11b19cbe1d3a5d1a86;Thu Feb 14 17:42:27 EST 2008;Committer;nobu;3;9;3;12;0
82f631ac5740af938ccb3ee5f05f3463e0e44854;Thu Feb 14 17:40:56 EST 2008;Committer;nobu;4;26;12;38;0
67d0ce36f5c9405434a5a97230ca3593dbe86974;Thu Feb 14 14:56:40 EST 2008;Committer;nobu;2;15;3;18;0
5aa388c23c12747fd63827e93200fa0d90a7733c;Thu Feb 14 14:51:08 EST 2008;Committer;nobu;1;1;0;1;0
433fbebfbc49c330b66089f6d191558b967a84f5;Thu Feb 14 12:01:50 EST 2008;Committer;akr;3;26;9;35;0
a5c05a9ace5aad5fa9fc545be0be829cf61b16c4;Thu Feb 14 08:23:56 EST 2008;Committer;akr;1;4;0;4;0
c4b18d3cc59a849788c2c6d8fe9d096dd549d262;Thu Feb 14 07:09:36 EST 2008;Committer;matz;2;31;25;56;0
3a9bf2f1243eb0408963efbcd4df75a411eb6b4e;Thu Feb 14 07:02:54 EST 2008;Committer;nobu;2;5;0;5;0
23db145b072570f010e5f4409585cc6ebab09bea;Thu Feb 14 06:01:05 EST 2008;Committer;akr;1;5;0;5;0
bf8819235479e2772e317f5bc24ecad4046a56e7;Thu Feb 14 05:03:07 EST 2008;Committer;akr;1;36;0;36;0
ec4756f633d62223cb05b5f24aee0842a471fb9d;Thu Feb 14 03:34:12 EST 2008;Committer;akr;3;25;11;36;0
8435c6bb8cd2bedcd95cd5dcc4e5a75ded79735d;Wed Feb 13 16:43:18 EST 2008;Committer;nobu;2;25;3;28;0
c9c655bf2c758a3e9dc74b6ecebab6b109bf3ccb;Wed Feb 13 15:49:56 EST 2008;Committer;nobu;4;42;24;66;0
a707f6249f82cdd5183b18d115c25a765e6a82a8;Wed Feb 13 15:03:59 EST 2008;Committer;mame;4;256;1;257;0
70f25096c0c389888c06e0fea358c92153633b8e;Wed Feb 13 13:50:31 EST 2008;Committer;akr;3;27;1;28;0
800ff52c17e0036a91bfc074db51e4222d0c7b8f;Wed Feb 13 13:20:12 EST 2008;Committer;akr;1;4;1;5;0
cd6dcfb05b9d0fa429e943c6f8d656a77d145b82;Wed Feb 13 12:51:31 EST 2008;Committer;mame;3;172;2;174;0
8f842d71e98d7da744c4518afbdd49fe06b6a49a;Wed Feb 13 11:52:46 EST 2008;Committer;akr;4;56;26;82;0
f09eb27660e3fafe1aaa45c41b064cee010f4c88;Wed Feb 13 07:29:44 EST 2008;Committer;naruse;1;1;1;2;0
a8739621cf62695282ab971cac9c6ea48745b027;Wed Feb 13 07:26:52 EST 2008;Committer;naruse;6;14;6;20;0
f6628871b5d7d1b237dfebcee09b4c304ed6d1d9;Wed Feb 13 02:21:25 EST 2008;Committer;usa;3;14;7;21;0
bcd4deb6c5eb37e0389997ded4ed3e123cdefbc1;Tue Feb 12 23:59:03 EST 2008;Committer;drbrain;4;43;11;54;0
b797fdc7e88c5ad7552f1c95081ad3c60507e3ee;Tue Feb 12 22:23:00 EST 2008;Committer;drbrain;5;156;151;307;0
4660cc6fb9bba765ca259bc636d59e8c3c4620b7;Tue Feb 12 19:15:46 EST 2008;Committer;nobu;2;9;9;18;0
4aa1d12937f17b03a4644ea548bdcded2bdf5afb;Tue Feb 12 18:13:01 EST 2008;Committer;nobu;2;4;5;9;0
552fa153f0d370973580613cb9fddaec4af5966a;Tue Feb 12 16:27:22 EST 2008;Committer;nobu;2;9;9;18;0
813fcf768e6acbccd4d8afe941e6c35836ffbc2c;Tue Feb 12 16:26:47 EST 2008;Committer;nobu;2;22;4;26;0
8a876551627ade6e55a38abdba457f4dd17926c7;Tue Feb 12 16:23:02 EST 2008;Committer;nobu;3;8;20;28;0
55c4937048fe383432b23e9a36582c441bac5f12;Tue Feb 12 12:04:53 EST 2008;Committer;nobu;2;5;1;6;0
2b72892ac0de9ff1d05f2b21ed85ef09aa41c57e;Tue Feb 12 11:47:12 EST 2008;Committer;tadf;4;108;30;138;0
7d4defbe1b3b267695446adac950d726538ea621;Tue Feb 12 07:48:37 EST 2008;Committer;nobu;2;10;1;11;0
126297de1572ca791074a0437f63ab83c4c0a014;Tue Feb 12 07:18:49 EST 2008;Committer;nobu;2;61;22;83;0
a10ded3ba0f6da6b4f881cd23858aef3d9eb5f29;Tue Feb 12 06:28:23 EST 2008;Committer;naruse;11;27;17;44;0
40d8d38909fe15a96887f4097d95d7323fc93fb7;Tue Feb 12 06:18:06 EST 2008;Committer;naruse;25;71;58;129;0
38694016bc226abd074c239282dc047ad7c65c55;Tue Feb 12 03:17:43 EST 2008;Committer;matz;5;27;3;30;0
ff15c72d694a8bb9d5ad40d14dc5d8f1fee419e0;Tue Feb 12 03:16:07 EST 2008;Committer;matz;2;15;9;24;0
f3ac3dc79cdba4692b5b21695eef14d96b33400a;Tue Feb 12 02:46:21 EST 2008;Committer;matz;5;76;52;128;0
030a513a49f361f09f11a93d11c034ce07921873;Tue Feb 12 01:27:52 EST 2008;Committer;drbrain;2;11;1;12;0
dd738cd887a5a9a6358622aa88704073f0b0bbea;Tue Feb 12 01:20:43 EST 2008;Committer;naruse;2;6;0;6;0
0ecb56f170ab590d079659c82c7a4673d30cb51d;Tue Feb 12 01:17:39 EST 2008;Committer;drbrain;2;29;21;50;0
0472db84c5e2b3e4e8f253cb304d5360de2a6a4a;Mon Feb 11 17:46:52 EST 2008;Committer;matz;6;85;21;106;0
9d968bc2219318ea4f8bd2df877f026c9625a2df;Mon Feb 11 08:24:18 EST 2008;Committer;kou;12;91;34;125;0
bd5a15f76d87f1e095177f5c5db7b7518561ddcf;Mon Feb 11 01:47:26 EST 2008;Committer;naruse;2;6;1;7;0
65753a5838bf32db668ef29a52dc801c306384ee;Sun Feb 10 21:52:25 EST 2008;Committer;mame;9;63;26;89;0
a336e6ebd12cde09855b13fc8de1644de5bfc3ad;Sun Feb 10 15:29:00 EST 2008;Committer;naruse;2;5;1;6;0
e833cd9b3c0fd0e19a86b173c04afe4903596fb2;Sun Feb 10 13:13:30 EST 2008;Committer;naruse;2;6;2;8;0
5d613c83ccb6992c6b99e5a23512719604bbdae9;Sun Feb 10 08:00:19 EST 2008;Committer;drbrain;26;165;85;250;0
c12b28936266c205d174458f0bd21766154048f7;Sun Feb 10 06:07:31 EST 2008;Committer;nobu;5;12;6;18;0
455b051a008aa859a7b0d6fca56de69a38cc1f8d;Sun Feb 10 03:59:08 EST 2008;Committer;drbrain;21;1805;1554;3359;0
d44f24c47cc0d03135fabb7c764ab23e9d5d1152;Sat Feb 09 14:45:43 EST 2008;Committer;akr;2;34;1;35;0
4d5f46dc088f30df7fc552878da88be552f81bcf;Sat Feb 09 14:22:54 EST 2008;Committer;nobu;2;5;3;8;0
7ced5439b4fea1ca080473c82320dc81d20d5cce;Sat Feb 09 12:21:30 EST 2008;Committer;mame;2;68;2;70;0
87ea50380d06e71889251a22e86731c7f1dfa6bb;Sat Feb 09 09:49:31 EST 2008;Committer;akr;1;2;2;4;0
b160d23c68e2e8fcd82b96fab0977be11c2b9ec6;Sat Feb 09 09:36:03 EST 2008;Committer;akr;4;34;1;35;0
a424741c8e73bbca5d893594abbdfda489794739;Sat Feb 09 08:51:26 EST 2008;Committer;nobu;3;51;27;78;0
0e66903fca6743ab09504a5b9bd711c6d99821fb;Sat Feb 09 03:07:34 EST 2008;Committer;akr;2;21;2;23;0
c8aa30a95806939cc1d65e74895f2b57e6419d6c;Sat Feb 09 02:47:50 EST 2008;Committer;akr;2;15;2;17;0
1c6e4ff1a011e3211723b1d668a536f3e8846702;Sat Feb 09 02:12:21 EST 2008;Committer;akr;1;1;1;2;0
4c351aea173995f6e65bb85af8511d8ee78ba839;Sat Feb 09 02:10:57 EST 2008;Committer;akr;2;10;4;14;0
8f9fb1a82077d89bd107d02b456e86ed991d4c6e;Sat Feb 09 01:04:29 EST 2008;Committer;akr;2;6;0;6;0
998113d62f43a7052028105a1bc301d0af513d87;Fri Feb 08 16:10:27 EST 2008;Committer;naruse;2;6;1;7;0
8bc75b5bb09ebaebaf8e7178e45c7bdaa17f7ad8;Fri Feb 08 15:44:54 EST 2008;Committer;nobu;3;19;10;29;0
185849a664dc26b365e761413c1cf48c8011471a;Fri Feb 08 14:53:09 EST 2008;Committer;akr;2;5;1;6;0
54b455190b9ed9200436d9bd4967dd272576d0b7;Fri Feb 08 13:11:46 EST 2008;Committer;akr;2;11;1;12;0
ef816db96f1ec52a537a7623b476639291483fc2;Fri Feb 08 10:22:15 EST 2008;Committer;nobu;2;5;2;7;0
0123f3a922c677c6117061aa06c9cd3bda55e9c1;Fri Feb 08 10:19:57 EST 2008;Committer;nobu;2;25;22;47;0
d55c77f565d4537c8edc5ea07020fd18e51ef59f;Fri Feb 08 10:18:56 EST 2008;Committer;akr;1;7;1;8;0
f3d18d8c4c6f7cd3c2065ca75a2553553e9ae31c;Fri Feb 08 06:09:23 EST 2008;Committer;nobu;2;10;0;10;0
52a757686ddb4f0d848f5b707a39f131fc73801d;Fri Feb 08 04:27:37 EST 2008;Committer;akr;1;8;0;8;0
baa14688953cb5ce9013dfc9a5437f0ce352fbde;Fri Feb 08 00:54:21 EST 2008;Committer;naruse;2;5;1;6;0
2bef7dece17c3ef98c1c0aca08d4028d6afc998a;Thu Feb 07 15:09:12 EST 2008;Committer;mame;5;250;4;254;0
1809782c3eaa24fc751ac2fd96fb204a51c15e68;Thu Feb 07 10:11:40 EST 2008;Committer;nobu;2;5;2;7;0
fb506c3000b133d9dd4d423bcdf1290885ea6e22;Thu Feb 07 09:57:06 EST 2008;Committer;nobu;2;7;1;8;0
82b088aa0c5a79fbb6b4ac5fd4cba31594ea6472;Thu Feb 07 07:40:25 EST 2008;Committer;akr;3;28;1;29;0
89941dffb5366aa461f4de5b87d284dc716ea9b9;Thu Feb 07 07:33:50 EST 2008;Committer;nobu;2;61;31;92;0
6c6ae9866342519b775b243535aa223fadc010e9;Thu Feb 07 06:42:44 EST 2008;Committer;nobu;2;5;1;6;0
e22ff0c9b6396c132ff812ae80bc91f0018653be;Thu Feb 07 06:05:32 EST 2008;Committer;naruse;3;34941;6858;41799;0
f6d8188c5435100ee4de01f7aca5394e618de7fc;Thu Feb 07 02:40:57 EST 2008;Committer;akr;1;1;1;2;0
4cd86dbe9f7701134781562689d1a30d735eb9f2;Thu Feb 07 02:14:54 EST 2008;Committer;usa;5;16;6;22;0
58f7adb50ec65e1c2d131526729a17e56ef7c076;Thu Feb 07 01:52:53 EST 2008;Committer;akr;1;4;4;8;0
14373fc4db7440d39db4fd39297f2ed44cc990f2;Thu Feb 07 01:43:43 EST 2008;Committer;akr;7;219;1;220;0
b88ecbcffc30fdf8b5743003563e10a347c05b03;Thu Feb 07 00:22:16 EST 2008;Committer;usa;1;1;1;2;0
5a8d5c873bc2616d1646d3708e6f5f0855129353;Thu Feb 07 00:06:55 EST 2008;Committer;matz;3;10;3;13;0
4f0083e45fe977d0c8e728ed39a746161bb3abba;Wed Feb 06 19:40:11 EST 2008;Committer;naruse;2;17943;0;17943;0
8c1887e3a4c25d2e5c4ad385bba163307567e9f5;Tue Feb 05 16:53:23 EST 2008;Committer;matz;2;3;3;6;0
acc1a537448074acf7b331549fb49d2fa001e659;Tue Feb 05 16:51:30 EST 2008;Committer;matz;2;10;0;10;0
fe923029dfa4e4ec2fbfc211c613598104693d47;Tue Feb 05 15:57:32 EST 2008;Committer;usa;1;0;1;1;0
ba6e0752b02b41b24e6bc76079c0e1589e63014b;Tue Feb 05 15:54:33 EST 2008;Committer;usa;2;22;16;38;0
39f0a1196b99d45cf8af930ba55714257156de81;Tue Feb 05 15:50:25 EST 2008;Committer;mame;3;459;4;463;0
a73ec67e8d016b16b670234d47b0b0fc7a9b1d6d;Tue Feb 05 15:25:35 EST 2008;Committer;mame;3;9;4;13;0
03a4a0f1d2d0bdc7ff2fdedce2f5e67ae5cefdc9;Tue Feb 05 12:58:50 EST 2008;Committer;mame;2;6;0;6;0
f0cc22e99024eefe2867fb47bea1ad6b9da36d6a;Tue Feb 05 02:14:17 EST 2008;Committer;nobu;3;26;5;31;0
23757bce574850ba88fd6a9d8e62fed3fe237da0;Mon Feb 04 12:52:08 EST 2008;Committer;nobu;2;20;17;37;0
b00bc5f2a83f55d1d480768b5c1fc7aa902531d4;Mon Feb 04 07:44:26 EST 2008;Committer;nobu;2;6;1;7;0
b6a9ab890de783aca0fffc1c8e854496bcc18cc2;Mon Feb 04 05:59:13 EST 2008;Committer;usa;1;8;8;16;0
d739fc5a77cc4e5837c181c4cbd875fc22ad000b;Mon Feb 04 05:51:21 EST 2008;Committer;nobu;2;14;1;15;0
00f34f92741b4092a5f53afff0b9f01679325247;Mon Feb 04 05:01:00 EST 2008;Committer;usa;2;10;3;13;0
50f6e01b4444aa1a1004278ff3d7b0c1d4978fa2;Mon Feb 04 00:02:53 EST 2008;Committer;matz;3;9;28;37;0
8f655cec3d985fad2a135233a772164f9876fb58;Sun Feb 03 12:14:30 EST 2008;Committer;mame;3;1140;0;1140;0
6445ddf14a5834c8b824776e61e9436b09c3b936;Sat Feb 02 11:09:24 EST 2008;Committer;matz;2;10;1;11;0
887485907ed1336761dd384eab81d20d4d3fa302;Sat Feb 02 08:46:05 EST 2008;Committer;naruse;2;6;4;10;0
3940857f2b19ce5be51bc40f7b112c17e741e5e2;Sat Feb 02 00:53:41 EST 2008;Committer;nobu;3;13;3;16;0
b5fdd1bd76873fb0dbda439fdbaec2589b3c5e19;Sat Feb 02 00:32:40 EST 2008;Committer;akr;2;15;6;21;0
cb355eebf06075f9f57ca8e8594355171cd17754;Fri Feb 01 12:42:40 EST 2008;Committer;nobu;2;7;2;9;0
3fb0815d8cb1b60390301fa6478456386650923c;Fri Feb 01 03:43:48 EST 2008;Committer;nobu;2;15;3;18;0
12f3bcfcab78fd9bc89bf66d0e863d2978082994;Fri Feb 01 02:48:33 EST 2008;Committer;usa;1;4;4;8;0
ab12f27fb5e8314ce616a6d19083a24d7601a109;Fri Feb 01 02:45:47 EST 2008;Committer;akr;2;7;2;9;0
9a5fd6098d6185b8f415be06cb3af11dd29c7363;Thu Jan 31 14:08:14 EST 2008;Committer;mame;7;788;0;788;0
aa7c6a538e299577f75fcd6697b6af23d4ea99d5;Thu Jan 31 08:34:34 EST 2008;Committer;usa;1;1;1;2;0
1e3aa62254cb21f9e00dafb2d30e1447b6991024;Thu Jan 31 08:31:20 EST 2008;Committer;usa;3;5;6;11;0
1672df18704da19c8abfa5c544de37790d1da19a;Thu Jan 31 06:48:35 EST 2008;Committer;usa;3;13;5;18;0
b0a18f4d9fb6125549776fe29a188e749a0a8073;Thu Jan 31 06:10:56 EST 2008;Committer;naruse;2;15;0;15;0
d2bb8975e18ca089819145bf4b3c1c228973ce0d;Thu Jan 31 05:10:58 EST 2008;Committer;usa;3;40;10;50;0
ae8095e44dae9b440f07780d230d816f684a8f8a;Thu Jan 31 00:38:38 EST 2008;Committer;matz;1;0;1;1;0
4873f59aef534f02d502fe38e706ebbdd5a1b3f5;Wed Jan 30 23:31:22 EST 2008;Committer;nobu;2;31;26;57;0
6f4d6b165042d6045f8de378bfd3d00d89f3f2ed;Wed Jan 30 21:24:24 EST 2008;Committer;nobu;2;28;5;33;0
d7f5b291bedccdc449f16f3a77e6a4c2fed226ca;Wed Jan 30 17:23:27 EST 2008;Committer;matz;2;6;1;7;0
dd7bcfc07259dcd4720e44dd8ebcf4910a1d9554;Wed Jan 30 17:20:48 EST 2008;Committer;matz;2;5;6;11;0
1df7138a0d8e6c0c86572cb8c03059138e33aa9f;Wed Jan 30 16:42:15 EST 2008;Committer;akr;1;6;0;6;0
a1c42c017a74685e4a14814b7a80e12557e5c5b7;Wed Jan 30 15:40:49 EST 2008;Committer;usa;1;3;3;6;0
dc36ca0ba52ec2707c91fd87ea55a423e97c5bd9;Wed Jan 30 15:21:40 EST 2008;Committer;akr;2;7;1;8;0
8429f2be9fd3ac4bcc97580fece853fed6fc09bc;Wed Jan 30 11:20:03 EST 2008;Committer;tadf;1;9;10;19;0
9ac5a0ca4ded8a8a933cc222b82b69d295b9b323;Wed Jan 30 08:35:03 EST 2008;Committer;naruse;6;11;0;11;0
087801b64b9a612daf77bf3a08847c1b0163c1a3;Wed Jan 30 05:33:49 EST 2008;Committer;usa;2;5;1;6;0
84fe38438311911211c2d415967ed7c07624175b;Wed Jan 30 05:29:37 EST 2008;Committer;akr;3;19;2;21;0
44cfd58dc5f3949ff5cbcf7350a3e76d6ff1c49c;Wed Jan 30 03:49:54 EST 2008;Committer;akr;4;108;9;117;0
8e36fa69fd901a012ecdb056d3aedd97f9124879;Wed Jan 30 03:09:17 EST 2008;Committer;tadf;1;3;0;3;0
fb997983a29d97dbac13354c8e87cdf2b1742c4d;Wed Jan 30 03:07:37 EST 2008;Committer;tadf;2;15;3;18;0
7b83d04514fc55c53dd78faad6b7856b8572109b;Wed Jan 30 02:59:59 EST 2008;Committer;naruse;2;6;1;7;0
3c5d20272f7d5dbd021ed0a4d646172ff06c850d;Tue Jan 29 16:26:07 EST 2008;Committer;mame;2;193;0;193;0
0ba09d829c0f1a6dfdfa7ebb9f67b0bc3b8d32cb;Tue Jan 29 15:35:37 EST 2008;Committer;akr;1;1;1;2;0
5a674ddca6e026c9fc9037fcbd393b894791e130;Tue Jan 29 15:19:31 EST 2008;Committer;usa;1;3;3;6;0
12e8b588ac6b51563b71b5200fd4842e76cfb279;Tue Jan 29 15:10:50 EST 2008;Committer;akr;2;101;2;103;0
4622664c43867b12ba08b3d298e253495c07db17;Tue Jan 29 14:36:14 EST 2008;Committer;usa;1;7;7;14;0
7390164a646c83b22b4f265f29968664b6cad059;Tue Jan 29 13:59:13 EST 2008;Committer;mame;3;315;0;315;0
c8048c5f070403cbed0674cbc243a10ea86568ea;Tue Jan 29 13:30:15 EST 2008;Committer;mame;2;5;1;6;0
45ef2e8ef26f6b49b82db14e1176466447542b01;Tue Jan 29 13:27:51 EST 2008;Committer;mame;2;5;2;7;0
e1b85cbf17f3da7078452890edfc9c6e8cd7c001;Tue Jan 29 13:07:25 EST 2008;Committer;akr;1;8;0;8;0
6e3391c8665d83824fce669069ca67b69b952e2d;Tue Jan 29 13:01:27 EST 2008;Committer;akr;2;5;1;6;0
67212c5ba4e7955f9def6213e00bddd91675ef19;Tue Jan 29 12:58:24 EST 2008;Committer;mame;2;69;58;127;0
b9821b02a0c5c48fbde23cea6576e0f9e044af78;Tue Jan 29 11:44:08 EST 2008;Committer;naruse;2;44;12;56;0
7a8c02cd47750decd6c7507d8c5f090a8d3b4605;Tue Jan 29 11:18:22 EST 2008;Committer;naruse;2;42;0;42;0
ea24d298cf7a6146b5f233292f992ae7ef61771f;Tue Jan 29 11:18:03 EST 2008;Committer;usa;3;6;2;8;0
1a65f34057398884e0f6d654965185ccadfeef03;Tue Jan 29 10:40:34 EST 2008;Committer;naruse;3;6;2;8;0
74b254e8335d3fe5570edc1284b63aa562d198d6;Tue Jan 29 10:05:39 EST 2008;Committer;naruse;4;24;31;55;0
f3ed7fa2335ae52b8c07ac4bd3e039628b6f1e8b;Tue Jan 29 09:05:50 EST 2008;Committer;nobu;2;18;3;21;0
19d9380b3d8e20723b230fa47dbdf2729fde8be2;Tue Jan 29 08:55:19 EST 2008;Committer;naruse;2;5;0;5;0
315196bc7af78c121df9a6a4a01c8ac2f354fc2a;Tue Jan 29 08:48:35 EST 2008;Committer;naruse;4;24;7;31;0
86a9215bbfa659c3f663c5a61f855567c15c5437;Tue Jan 29 08:38:21 EST 2008;Committer;akr;2;101;9;110;0
419f0da293f51ae96d54ca1ce26110c784b6fc27;Tue Jan 29 08:05:26 EST 2008;Committer;naruse;3;7;3;10;0
d5c8ad535961968b40823512ccdb12e38f1ed529;Tue Jan 29 08:03:51 EST 2008;Committer;akr;5;104;47;151;0
65615986ec0cfc5971c990abe46643b0edbcab8d;Tue Jan 29 07:27:09 EST 2008;Committer;naruse;3;12;3;15;0
00a3c40c377ddcc408dea1a367dbbc15de7c3150;Tue Jan 29 04:41:41 EST 2008;Committer;naruse;4;18;13;31;0
fe15b86b9d75a679f68042d1c432fcd64c47c73a;Tue Jan 29 04:26:30 EST 2008;Committer;naruse;2;2;3;5;0
a2b03f10dc1726c8109e4fc5a2fc45e0dcf3d368;Tue Jan 29 03:55:45 EST 2008;Committer;naruse;1;192;0;192;0
01b5cfcf44aed45bf67aacd59f351a5639d8e60f;Tue Jan 29 03:54:21 EST 2008;Committer;naruse;1;4;0;4;0
34387d1a0273329ec0c9cf02c098b12552f4302b;Mon Jan 28 18:04:39 EST 2008;Committer;usa;3;56;8;64;0
ff0147a92052fac2263c39092385014d241c6ca7;Mon Jan 28 16:39:01 EST 2008;Committer;usa;2;6;1;7;0
af9a5d5f30b2811c321ce1d56f591d28fbfeeade;Mon Jan 28 16:26:25 EST 2008;Committer;nobu;2;5;3;8;0
d41b36ae5d32b41c2604996f97f2717167bb972f;Mon Jan 28 16:06:14 EST 2008;Committer;nobu;1;1;1;2;0
d3560b76cf15aba9789a588617b533013a911ec2;Mon Jan 28 15:52:16 EST 2008;Committer;nobu;2;6;2;8;0
02b9407e93f9c23ff64febad8176e183c93cf8ba;Mon Jan 28 15:20:21 EST 2008;Committer;usa;1;28;18;46;0
a9e23128061268b7823eeb701be9bea959a3d527;Mon Jan 28 15:12:43 EST 2008;Committer;usa;2;5;1;6;0
f7ed47355e63926e212fe0a72e5d0b31873290d8;Mon Jan 28 15:10:02 EST 2008;Committer;nobu;3;29;12;41;0
4102378f791ca5549e97d0b2ce1db6854e5a4b65;Mon Jan 28 15:02:53 EST 2008;Committer;naruse;1;1;1;2;0
4d961eb8a603bf3020836d6be661bc17c0b79321;Mon Jan 28 14:51:23 EST 2008;Committer;naruse;2;8;3;11;0
1e8e70a311bca1533a5196f4a3f685cf1b7a34bf;Mon Jan 28 10:42:53 EST 2008;Committer;usa;2;83;12;95;0
de3538b05165a24c96d56e361409637afc754d05;Mon Jan 28 09:29:05 EST 2008;Committer;usa;1;1;1;2;0
3c6969ec114d544d4e84c242171c30c346ccf23a;Mon Jan 28 09:03:09 EST 2008;Committer;naruse;4;12;8;20;0
2f961c1f371e6dd0517a1ca4b9f245e2c2f1a90d;Mon Jan 28 08:57:40 EST 2008;Committer;naruse;2;9;0;9;0
fee57bb8c8cae56287b57876fe3a41cf2b983eb7;Mon Jan 28 08:41:49 EST 2008;Committer;usa;2;5;0;5;0
ffbf8ab36777f3f7c148bc687491823bc82d7fec;Mon Jan 28 06:33:57 EST 2008;Committer;akr;2;59;2;61;0
5f9bc1779e7fb7011fe53746a0fe077e5b511088;Mon Jan 28 04:02:39 EST 2008;Committer;akr;2;59;2;61;0
06cd63ce9337e71c3f3c8c8b22d0626be58b2768;Mon Jan 28 03:32:27 EST 2008;Committer;matz;2;26;15;41;0
4a948632442b735d306c9583f20f734b0bf7577c;Mon Jan 28 02:26:23 EST 2008;Committer;usa;3;7;1;8;0
c7c263eefc2509df20206763f05383009961d68c;Mon Jan 28 01:26:37 EST 2008;Committer;usa;2;11;0;11;0
73e3ea958d625379b8df8af2c6efb4e903338470;Mon Jan 28 00:35:48 EST 2008;Committer;usa;2;15;11;26;0
7c69f166bd05703ecf8ed07fac0927f5fc9b22fa;Sun Jan 27 15:39:14 EST 2008;Committer;nobu;3;14;4;18;0
b980803a6e89c8e8b951fe6090fca8f083ef4687;Sun Jan 27 14:33:37 EST 2008;Committer;nobu;2;13;3;16;0
fc208c1bd56a4e3fc03cb2f54616b4479f4b0e41;Sun Jan 27 14:27:07 EST 2008;Committer;akr;9;90;48;138;0
526ab1f0d15247da489cb2fc8af8d4c3f1a71cc2;Sun Jan 27 13:55:29 EST 2008;Committer;nobu;3;10;3;13;0
7889fdd1e6c7a30963b7dd9e181c74cf4423095d;Sun Jan 27 13:33:41 EST 2008;Committer;nobu;2;22;8;30;0
ce26086b012328e6352059e1a962082b0f6dec04;Sun Jan 27 13:31:47 EST 2008;Committer;nobu;2;5;1;6;0
587167a8cbaab0727a80028062058a7a223cea1f;Sun Jan 27 12:55:18 EST 2008;Committer;naruse;1;2;1;3;0
02ca8ffbdcdd3bbc203d853897addc45552f402a;Sun Jan 27 12:50:44 EST 2008;Committer;nobu;1;174;174;348;0
c9ca560ce802dc5111fe001b2ed063a017cf5fb6;Sun Jan 27 12:49:01 EST 2008;Committer;nobu;2;35;10;45;0
2ae9745aedafff9c0ed7dd756158c365ec877610;Sun Jan 27 12:37:58 EST 2008;Committer;naruse;1;1;0;1;0
b8b0f6fd46840d90a22d2c75bf823d31aa62cc18;Sun Jan 27 11:09:41 EST 2008;Committer;akr;2;10;3;13;0
36b4d1a1dc0a160a08994fd6f165b46863ecc65b;Sun Jan 27 10:08:58 EST 2008;Committer;akr;2;23;35;58;0
ce7cdcdd95085545189419a3131625679fcf3b28;Sun Jan 27 09:19:00 EST 2008;Committer;naruse;2;15;0;15;0
4aa64b35fa75eb7fb2c953b557d950766386f17b;Sun Jan 27 08:55:31 EST 2008;Committer;naruse;4;31;14;45;0
b1e6c052cdbac72b3aeab3d6d06dc035d4a26985;Sun Jan 27 08:21:24 EST 2008;Committer;akr;3;171;93;264;0
4a9d407e35d9ccfe31d1fa1913fb71fe22c5f0b7;Sun Jan 27 07:43:31 EST 2008;Committer;naruse;3;6;1;7;0
086e5b1a63d77bf5a4ebe10396a430d544fbe505;Sun Jan 27 07:28:26 EST 2008;Committer;naruse;6;5249;5150;10399;0
f3fe101d5564fd674a4e475f4600e6962aaf1c75;Sun Jan 27 07:26:51 EST 2008;Committer;naruse;2;5;1;6;0
3f68c10536ac028efa9e673ea0317623b72d676e;Sun Jan 27 02:38:10 EST 2008;Committer;akr;1;30;16;46;0
4ccb16010378760bebf292a38b6bf69a54098d7b;Sat Jan 26 22:50:56 EST 2008;Committer;akr;1;3;0;3;0
0dfda18777f55d5faf12ecbf17bf6db624e1a390;Sat Jan 26 22:48:12 EST 2008;Committer;akr;1;139;9;148;0
3970d67185c90e3c017f205ef3c73e192015bab0;Sat Jan 26 21:23:59 EST 2008;Committer;akr;1;13;0;13;0
b9c18bdcddcc1ab6dc08988436d99d61eb8f3d7f;Sat Jan 26 21:01:52 EST 2008;Committer;akr;3;18;1;19;0
e7bf1bd4d4a3296d7ce7ed92d7258129a1fffb91;Sat Jan 26 20:30:32 EST 2008;Committer;akr;1;19;19;38;0
7560adca78aa58c46a6007a16d6413f3f075489b;Sat Jan 26 19:49:37 EST 2008;Committer;akr;1;11;8;19;0
f356662f6bb7ff8ae407aecd2441a235a2306f91;Sat Jan 26 14:46:36 EST 2008;Committer;nobu;2;14;6;20;0
259526006e4407c1ab40e2d8ad67ea6ad27f0c0c;Sat Jan 26 14:42:17 EST 2008;Committer;nobu;2;8;0;8;0
4e6bba219ec6fc9806a499d6c97cf62a20916564;Sat Jan 26 11:19:06 EST 2008;Committer;akr;1;7;0;7;0
8c02164fb53451dc7430b5948ef84e7722d490ee;Sat Jan 26 11:15:24 EST 2008;Committer;akr;1;4;0;4;0
26b86d8a721551216a8f22dd36569e2ef94759a6;Sat Jan 26 10:31:11 EST 2008;Committer;akr;3;17;1;18;0
51ea2cf4e431d2265a255cb3bfedc91461acf8d4;Sat Jan 26 08:44:43 EST 2008;Committer;ko1;3;16;0;16;0
3b1c663ed942c3125c8ff93243b3af77da7cdac4;Sat Jan 26 08:27:00 EST 2008;Committer;ko1;3;103;56;159;0
1e039d96f3c391cea3138c8c2c01d4f4757b0433;Sat Jan 26 05:05:07 EST 2008;Committer;akr;1;2;1;3;0
7c884e9012cbba4c7636fb7850cd7090eeab2fa6;Sat Jan 26 00:42:08 EST 2008;Committer;naruse;5;12;2;14;0
1f7db0db759dc285134cea0639d505a56699bb69;Sat Jan 26 00:30:28 EST 2008;Committer;nobu;3;10;0;10;0
df17bd4313558b5ff79c48969dec2d30584f3091;Sat Jan 26 00:18:50 EST 2008;Committer;naruse;2;6;1;7;0
2160c40fb2ef40e8a7ad593239fac3558e2639f1;Fri Jan 25 18:49:28 EST 2008;Committer;usa;3;20;25;45;0
13b5b22ae63cb35adc7e73f8f3d248a6ffd46ad1;Fri Jan 25 18:02:01 EST 2008;Committer;ko1;7;143;107;250;0
42dcda08aef365e166b8784e0349a28896a871e6;Fri Jan 25 16:40:02 EST 2008;Committer;naruse;10;145;33;178;0
f923cc360ae0e496da656a4253bc38fba12eed5d;Fri Jan 25 16:37:53 EST 2008;Committer;akr;2;10;4;14;0
ea345bccfa31b9518bdaba53d649dcf89727c408;Fri Jan 25 16:24:56 EST 2008;Committer;akr;1;23;23;46;0
f4d73e05d449eec5223f5186a881814c2f4deafc;Fri Jan 25 15:57:32 EST 2008;Committer;akr;2;44;33;77;0
665e571839c79095720871e46731e25b1b6a439c;Fri Jan 25 15:34:25 EST 2008;Committer;usa;1;3;3;6;0
9a2d2fae46223a00cf3bab059400759bdf2fafbe;Fri Jan 25 15:22:52 EST 2008;Committer;akr;1;9;0;9;0
3a783ba707eadf0ddad102e348e43968d434486c;Fri Jan 25 12:50:12 EST 2008;Committer;akr;2;28;20;48;0
dc059544721929209e1e02f018c88ee1d95588b5;Fri Jan 25 10:38:46 EST 2008;Committer;nobu;2;4;2;6;0
8af627ba4a248c64a1f2517b3d939dcb7443469d;Fri Jan 25 10:22:32 EST 2008;Committer;nobu;1;16;0;16;0
6d91bf3b0c423f647094846b8c9ec2c8d9829f9e;Fri Jan 25 09:27:30 EST 2008;Committer;nobu;6;65;20;85;0
a984e00b80d78fdb9f6d2e0ec3bdfb0a80a06105;Fri Jan 25 08:12:15 EST 2008;Committer;nobu;2;7;4;11;0
1e41069754ef69b02a9e0ed16a7a668cfab01dd0;Fri Jan 25 07:35:27 EST 2008;Committer;akr;4;34;1;35;0
8020c2e6761ce25021f15d0c22eca10f8b90079a;Fri Jan 25 07:11:18 EST 2008;Committer;nobu;2;11;1;12;0
5776f23d692fc92fc81696d1e49767ed1ef88508;Fri Jan 25 06:56:50 EST 2008;Committer;nobu;2;4;1;5;0
c30d2489dda69650d084e9e16bfdd94653d763d9;Fri Jan 25 06:41:22 EST 2008;Committer;nobu;2;18;9;27;0
95e59bd9e073edfe57b9c773ca414e6bb5ef5d83;Fri Jan 25 06:12:44 EST 2008;Committer;nobu;2;23;2;25;0
a470a2f1e184bf46642e54df093e32896dcf6e4e;Fri Jan 25 04:42:36 EST 2008;Committer;akr;1;300;0;300;0
2fc0fe5332c45f7c0eea5ba4581a00dce10311fc;Fri Jan 25 04:18:14 EST 2008;Committer;usa;2;44;17;61;0
b45fa58f6d01cd6ea437d59825b912780474d5fa;Fri Jan 25 03:58:32 EST 2008;Committer;akr;1;4;0;4;0
89fe999a7fa03d216aef0f8b9dee40163bc7ee51;Fri Jan 25 03:03:31 EST 2008;Committer;nobu;1;1;1;2;0
5f010f7299266f986041e6386e599712129cb222;Fri Jan 25 01:32:00 EST 2008;Committer;nobu;2;7;3;10;0
0dba38026aec845db9868a114c48819bc7254fea;Thu Jan 24 14:23:51 EST 2008;Committer;mame;2;10;5;15;0
14b9d47ae07e3c1aa5dd88d4dc24639c9d99240e;Thu Jan 24 13:11:00 EST 2008;Committer;akr;2;18;4;22;0
e27f4ef689bf15d47b7d5a56fbc11f39e5b377a0;Thu Jan 24 11:51:52 EST 2008;Committer;usa;1;2;0;2;0
120bb4a9d55a6e2b8c44b6223e7b5a2905a4abe4;Thu Jan 24 11:47:37 EST 2008;Committer;usa;2;12;10;22;0
439fab84598b2be5ad7f75016d08687429c664a9;Thu Jan 24 11:43:40 EST 2008;Committer;usa;2;30;7;37;0
8e7dd55a6e907c2232a66f2d48261cfde42b03dd;Thu Jan 24 10:36:24 EST 2008;Committer;nobu;2;7;1;8;0
0c390860cbc408a46d00808523e4f3ff4c8b1814;Thu Jan 24 10:29:22 EST 2008;Committer;nobu;3;36;33;69;0
5e7d638a4cb2f4b7145ad5b06f7b6d141ea8a67e;Thu Jan 24 09:19:44 EST 2008;Committer;nobu;2;5;1;6;0
b1257d4d209ea46b249e6e714f64b47dd912c968;Thu Jan 24 09:15:03 EST 2008;Committer;usa;2;5;1;6;0
fbe52683e60616f83bc5eec97ea078268b4c558b;Thu Jan 24 07:56:12 EST 2008;Committer;usa;2;6;1;7;0
ce3f8275659d95445b4b9baf32f2255779e11f44;Thu Jan 24 07:35:49 EST 2008;Committer;akr;1;1;1;2;0
4bcfd50ee7d33d23dcccfbbaf197051ebb4e34a6;Thu Jan 24 07:34:07 EST 2008;Committer;matz;2;8;1;9;0
e36dd522913f79973f0493cc885ce066920ed6e2;Thu Jan 24 07:25:46 EST 2008;Committer;usa;2;9;0;9;0
9b43eaf115172fdb942c8394ef6f7a4dbaac1737;Thu Jan 24 07:16:41 EST 2008;Committer;akr;1;1;0;1;0
2a02fe749776b8ea9e267951944a833f14c98c83;Thu Jan 24 06:59:03 EST 2008;Committer;akr;1;8;0;8;0
ffe425ecaaa2a3f813e1d540e20e2179bce44302;Thu Jan 24 06:50:22 EST 2008;Committer;matz;2;18;44;62;0
1ca6577e0cb2dad56d7c43e3eeb79b15171fed42;Thu Jan 24 06:38:57 EST 2008;Committer;akr;1;10;0;10;0
28d5ab7816620d922ce7781cad7016515661181c;Thu Jan 24 06:18:18 EST 2008;Committer;matz;2;58;129;187;0
4eca4cadff0ff6ee1931ab8d7653cdad65e2cac6;Thu Jan 24 06:10:49 EST 2008;Committer;akr;2;20;13;33;0
968e404220762d5adfc04b8c030c6f186cb47c0e;Thu Jan 24 02:17:26 EST 2008;Committer;akr;3;20;1;21;0
e336136d8a4943b4778ce93df7c3d944614416d4;Wed Jan 23 22:35:27 EST 2008;Committer;naruse;2;8;4;12;0
b97ec5d0c017c2d0342514f1075754bbb2419710;Wed Jan 23 18:53:52 EST 2008;Committer;naruse;6;12;6;18;0
9580a9ca91a84e410e643398130897b38e02a0a0;Wed Jan 23 18:43:51 EST 2008;Committer;matz;4;85;46;131;0
fe068da87997d1d412758c4aefa12a8a6621d005;Wed Jan 23 18:14:28 EST 2008;Committer;akr;1;4;0;4;0
ea5aa335047238ac7dce2d72caf828f3e5359477;Wed Jan 23 17:17:23 EST 2008;Committer;mame;4;13;9;22;0
ac7794478c1a79cc56a302b9a4a9bf120ae0c815;Wed Jan 23 16:08:04 EST 2008;Committer;naruse;2;3;1;4;0
5e3bb6c3aef7826fd9de646e16af53a2fde6c877;Wed Jan 23 16:05:57 EST 2008;Committer;naruse;2;6;3;9;0
1ccb0642edb91dfab77861bab700d07329e361ed;Wed Jan 23 16:03:29 EST 2008;Committer;naruse;3;14;0;14;0
3ef86ffdfe48ca12110bf1d393d7c725e3444e58;Wed Jan 23 15:46:17 EST 2008;Committer;usa;1;3;3;6;0
25fc9d25f72d2773cae49b23fe4db65cd9c567f9;Wed Jan 23 15:34:31 EST 2008;Committer;akr;1;3;2;5;0
d4f83d22618c5e140bc71e88928f7ad37784f08a;Wed Jan 23 14:55:39 EST 2008;Committer;mame;3;8;8;16;0
da8e083ba6d1095b536c5f618b381a984508b3e4;Wed Jan 23 14:37:20 EST 2008;Committer;akr;1;2;2;4;0
e405a1b93c77c785efbd88fd410bbffd07bba63e;Wed Jan 23 13:49:06 EST 2008;Committer;mame;4;410;6;416;0
b2c5814afc8fbfe73c0b150fa67e1ac5a2261799;Wed Jan 23 13:14:31 EST 2008;Committer;nobu;2;17;0;17;0
bbb7151467c4845f511cf87bb5be4cda1cc3b9d3;Wed Jan 23 09:25:17 EST 2008;Committer;akr;2;109;35;144;0
e3604a9e46d66af354fc6c26bcba054eb27ac161;Wed Jan 23 08:14:30 EST 2008;Committer;akr;1;7;0;7;0
562d6e8cd56abc2f0f37fccb7f51c9d476a8c3af;Wed Jan 23 07:59:56 EST 2008;Committer;akr;1;1;1;2;0
f2d84ac87b6f45d16b9c4ed3247aaf8822690769;Wed Jan 23 07:58:48 EST 2008;Committer;akr;2;68;42;110;0
5628d949f99a4b5debd91341b8c27ff14d4076b0;Wed Jan 23 07:48:27 EST 2008;Committer;akr;1;3;0;3;0
9430d7d8031fd7405420614ce1364fae80cc549f;Wed Jan 23 06:25:06 EST 2008;Committer;nobu;2;6;0;6;0
e94ece76d8d73b5e8a61531fe68f5e08ee78f8dc;Wed Jan 23 06:04:13 EST 2008;Committer;nobu;3;34;2;36;0
ce49faf5465abede7b0687b1b6f05658d4c7f802;Wed Jan 23 05:54:16 EST 2008;Committer;akr;1;3;0;3;0
3766eac339c6faf2514b380d7d9e0415a47f2c6a;Wed Jan 23 04:40:43 EST 2008;Committer;akr;2;10;1;11;0
0c8106ded6cae22cc54ec07c469b6b15eac4ea32;Wed Jan 23 02:53:28 EST 2008;Committer;nobu;2;19;14;33;0
3b6f862b3af128f1a17a88837b64390cb7a9be7a;Wed Jan 23 02:23:21 EST 2008;Committer;usa;2;16;8;24;0
105a66963140e7b3e8056c67c4e4e61b1d5a60d0;Wed Jan 23 01:20:51 EST 2008;Committer;matz;3;12;3;15;0
008d77d27cf2e468ca5e1d8a7d0c5f8cc102fd89;Tue Jan 22 13:28:04 EST 2008;Committer;mame;2;17;3;20;0
5b3b96bb1913f57301b86845c641412c137cc29f;Tue Jan 22 12:00:15 EST 2008;Committer;usa;1;1;1;2;0
8e2f164bd978602f8abfdaedf73adad777fdd80d;Tue Jan 22 11:59:47 EST 2008;Committer;usa;1;1;1;2;0
977eac0fe892b9c7e18c0f914cfad52cfd60dea5;Tue Jan 22 11:58:42 EST 2008;Committer;usa;2;5;1;6;0
385c5ffacc7521a81dbe102c07048e6ebd66b1b0;Tue Jan 22 10:40:23 EST 2008;Committer;usa;2;11;3;14;0
ef3fdbca15c0883d9ed1987b153a32c5ffeaf8ff;Tue Jan 22 08:52:02 EST 2008;Committer;duerst;2;29;24;53;0
707f2fd26e3c0696a3904365329b479e4965a4c1;Tue Jan 22 06:56:44 EST 2008;Committer;matz;2;4;0;4;0
65a8185eb212639875ae8db14dfffb1fa06b71e9;Tue Jan 22 03:59:53 EST 2008;Committer;matz;6;137;221;358;0
157664b9f3cfeb485abe1cf8298e82accef23acf;Tue Jan 22 00:26:49 EST 2008;Committer;nobu;2;9;9;18;0
02f4dcca2cbe9b82987deeaa68d6e54c063128ba;Tue Jan 22 00:01:59 EST 2008;Committer;drbrain;4;327;60;387;0
56be84e29300af86f31c7e5a025df81b2794811f;Mon Jan 21 19:47:26 EST 2008;Committer;matz;4;37;3;40;0
7760f3c462d6016cc220498c346db901e3ffcac1;Mon Jan 21 16:18:27 EST 2008;Committer;kazu;1;6;1;7;0
b3ee6f9718c8e0794e4bb83894ade34d66747b84;Mon Jan 21 15:46:48 EST 2008;Committer;mame;3;259;3;262;0
c06bb92b866e18ec71761a493fd7f8773e308f80;Mon Jan 21 15:33:32 EST 2008;Committer;mame;2;6;1;7;0
1363591ac2237f7823b0a81dc9f046e3eda9f02f;Mon Jan 21 11:12:43 EST 2008;Committer;tadf;1;1;1;2;0
3487136f706d51946394d18fb5d27f8aede19a1c;Mon Jan 21 11:10:53 EST 2008;Committer;tadf;2;8;1;9;0
38321fc0ebe2c434be24f67703f5b9f4096ee4b7;Mon Jan 21 10:41:59 EST 2008;Committer;duerst;4;450;60;510;0
282e828c59b85f9deeafe81277c76480476d9b96;Mon Jan 21 05:36:16 EST 2008;Committer;nobu;2;3;3;6;0
f5eb90f3c27a42ff61815e31ed4328f2450ba0b2;Mon Jan 21 05:32:12 EST 2008;Committer;nobu;3;10;1;11;0
91625011c2b7b8fd568ba8ac7d621f5527a6b24d;Mon Jan 21 03:50:14 EST 2008;Committer;nobu;3;6;2;8;0
463af63468620614074f024fb4310dc1cd332495;Mon Jan 21 03:35:05 EST 2008;Committer;nobu;5;68;57;125;0
76e19bc534c36daf2d093ff3eb434737756a86ef;Mon Jan 21 02:59:02 EST 2008;Committer;nobu;2;6;2;8;0
a8969e999a788c880dbd72d4622ab5c8bdf738a6;Sun Jan 20 21:40:08 EST 2008;Committer;nobu;5;69;57;126;0
ea64014c56374043926e95906fff06b4dfcd051b;Sun Jan 20 18:45:51 EST 2008;Committer;nobu;3;10;4;14;0
9007ae26a90c23cbaf984142b93e0ed23cd4c49f;Sun Jan 20 17:12:58 EST 2008;Committer;akr;1;9;0;9;0
e7902525448f5e00fcc8138ca6c820641841e7ea;Sun Jan 20 13:51:32 EST 2008;Committer;akr;1;6;0;6;0
a9b15a4e0cf2f26e05cf0c6761daf7f04f2cf196;Sun Jan 20 11:00:24 EST 2008;Committer;duerst;4;200;47;247;0
1e75c881da205e185b2bbadf35a68d509414654e;Sun Jan 20 08:54:28 EST 2008;Committer;duerst;1;15;0;15;0
3d0c7bea4d2ad108889d0c4d81d41c4ff03f2a77;Sun Jan 20 06:12:48 EST 2008;Committer;duerst;4;404;4;408;0
66aeb2f7080dea92703f10546fb3cbcc946f6fa3;Sun Jan 20 04:31:57 EST 2008;Committer;ser;8;163;51;214;0
00190701e0b8cc9ce5dbe9c836e9584d1c1caeb8;Sun Jan 20 04:06:03 EST 2008;Committer;nobu;2;19;3;22;0
3106b96ac8b5484e3501ad3575ecb649baef00ce;Sun Jan 20 02:06:50 EST 2008;Committer;akr;1;4;0;4;0
f909b891ba459ccecd2c6934154e605a115cefdc;Sun Jan 20 01:30:32 EST 2008;Committer;akr;1;3;1;4;0
e49820a827a6c495fcaf19fc7398316409fd1953;Sun Jan 20 00:51:52 EST 2008;Committer;akr;1;16;5;21;0
54a230bf7a7d70e51bff33316971b5b3e2e05cc2;Sun Jan 20 00:15:20 EST 2008;Committer;naruse;3;8;2;10;0
9a1d7e4d01ca2f3a1a9d92e1539eca37d75aacb8;Sat Jan 19 20:15:13 EST 2008;Committer;naruse;2;15;10;25;0
7b3781c60cbec2f98f4088b9e6c57c3ce7020540;Sat Jan 19 20:04:35 EST 2008;Committer;naruse;2;5;2;7;0
d0ce29fbee96a7a0b55f9c8f5e7e4b1b617a631b;Sat Jan 19 18:56:50 EST 2008;Committer;akr;1;8;2;10;0
55723ea86d46c567a5b9547aa943d4dd3c21af65;Sat Jan 19 18:36:31 EST 2008;Committer;akr;1;1;1;2;0
23346c20d78508878ac3468b69e80cf8b93ba864;Sat Jan 19 17:44:23 EST 2008;Committer;akr;1;4;0;4;0
6e1c3a0f54d7c68e6ea80853283e6383401266f9;Sat Jan 19 15:37:06 EST 2008;Committer;naruse;6;260;31;291;0
35a4fb5ef627e7105f796eacde5dd67ce0024b96;Sat Jan 19 13:42:50 EST 2008;Committer;akr;2;73;16;89;0
133a6011f7eb773050cf0fb435ad953fab10f6cf;Sat Jan 19 12:04:21 EST 2008;Committer;akr;2;7;0;7;0
bbeefa53caa359264c404dce14221b68807d66e1;Sat Jan 19 11:43:24 EST 2008;Committer;akr;2;7;2;9;0
3449e0710cb104d8621f9bc6b66b0e9d0321dc4e;Sat Jan 19 09:42:44 EST 2008;Committer;tadf;2;12;4;16;0
bf031c96998f1b98c91722f22249a32ffa2aadf0;Sat Jan 19 08:23:33 EST 2008;Committer;tadf;3;60;196;256;0
df28713ee338a4de5f6e67896dee3a2944d14102;Sat Jan 19 02:21:55 EST 2008;Committer;nobu;4;9;3;12;0
4239bc050137f615d709fe931473c2073624f4db;Sat Jan 19 02:10:14 EST 2008;Committer;nobu;2;6;6;12;0
1b8aac32698f2148fdf7b4ee45b33749e4fafc25;Sat Jan 19 00:29:31 EST 2008;Committer;suke;3;29;15;44;0
8d37cefaf8795fe80d457f101fb9678fc7f6adf6;Sat Jan 19 00:06:19 EST 2008;Committer;drbrain;18;1294;1112;2406;0
9872d4d60048cc16cf78d2e8a260b78468e87fc9;Fri Jan 18 23:35:38 EST 2008;Committer;nobu;3;17;6;23;0
4920980d17f0dce5e338513d1ae75fa2c4bf9c83;Fri Jan 18 18:48:12 EST 2008;Committer;matz;3;47;1;48;0
2a11c7f62a021a3fd6f991182e2ed30642a5c854;Fri Jan 18 15:37:22 EST 2008;Committer;nobu;3;37;0;37;0
caa539f2a358ed0ccac6e4bdcccc2bb4b59e307f;Fri Jan 18 15:15:40 EST 2008;Committer;usa;3;9;4;13;0
3882b07c3a8694e07b30b56e5c2c26c1695122f2;Fri Jan 18 14:49:43 EST 2008;Committer;nobu;3;13;1;14;0
956666cf5ae92d1046106c24e298469d127e3a6e;Fri Jan 18 11:20:30 EST 2008;Committer;usa;2;7;1;8;0
5e0824bcd846a77520c6c1d6ff76dff23c7f52e6;Fri Jan 18 11:06:12 EST 2008;Committer;usa;2;17;9;26;0
8a9993dfee20296431ac49ec48860c89160835c1;Fri Jan 18 08:56:11 EST 2008;Committer;nobu;10;38;26;64;0
3a4bfbad0976c60dd557dcdb64b390d055e6446b;Fri Jan 18 06:57:08 EST 2008;Committer;nobu;4;9;2;11;0
b66eb536507d4837948d615ef61b25c01a2e07ff;Fri Jan 18 06:56:06 EST 2008;Committer;nobu;2;14;5;19;0
4d1ee83e3c1e87597e0abb15dffd15d4b450d9be;Fri Jan 18 05:43:03 EST 2008;Committer;kazu;2;43;0;43;0
c58736dbdc74400d7ce58804e46b10c406b91c20;Fri Jan 18 04:49:14 EST 2008;Committer;matz;2;17;1;18;0
845ae33b17dc93b2ac3a1be0885b0fb9ae623225;Fri Jan 18 03:25:15 EST 2008;Committer;nobu;2;14;12;26;0
3798f9ec04f996ec769beb627eee93e5941f4dcc;Fri Jan 18 02:45:36 EST 2008;Committer;kazu;1;1;1;2;0
9f9ac3999676b258ea1b213b6f5d215fc12728bf;Fri Jan 18 02:39:12 EST 2008;Committer;nobu;2;8;1;9;0
f28118eb693d721046ed8ef692724f915f3162e7;Fri Jan 18 01:37:27 EST 2008;Committer;matz;2;4;1;5;0
d8644f632b5678ca28d1b681e0e2f1109cad185e;Fri Jan 18 01:30:41 EST 2008;Committer;matz;2;11;4;15;0
a7e37747011a3eecaf2a29c3ec26ddf17967d47c;Fri Jan 18 00:54:38 EST 2008;Committer;usa;1;12;12;24;0
61fd7dbf6d0cf3641d41cda3a3c2f6f3e4532865;Fri Jan 18 00:44:15 EST 2008;Committer;usa;2;6;1;7;0
15baeee701da0560d968e5f2f76365c6eea0caf6;Fri Jan 18 00:38:44 EST 2008;Committer;matz;2;3;0;3;0
231ab57f6f4cae9b81ce9eaf15f670479413ecf2;Fri Jan 18 00:23:18 EST 2008;Committer;matz;3;19;2;21;0
f7929ed206a0c2a7296ce415b259f29837e639e5;Thu Jan 17 22:21:40 EST 2008;Committer;matz;2;4;1;5;0
d765a38bf5cc8101bd4a337860367a2981cb7683;Thu Jan 17 22:20:20 EST 2008;Committer;matz;2;6;1;7;0
6d59907c0f34cae8ce23be7c64f094dfddfed2b5;Thu Jan 17 19:29:16 EST 2008;Committer;drbrain;3;32;25;57;0
b6dff84accf80618b16ff36cca5a7eae9fc5d600;Thu Jan 17 17:06:51 EST 2008;Committer;nobu;1;2;0;2;0
c8272db1795a7d63a2857b1fdbba4fa8775a6aee;Thu Jan 17 17:02:30 EST 2008;Committer;nobu;3;18;4;22;0
23980c8ba0a7e332204da31ba2b8ad5ae134c9c6;Thu Jan 17 16:59:23 EST 2008;Committer;nobu;2;26;23;49;0
ad82a53e5df909c10eb631b791dcc2af3d72972c;Thu Jan 17 16:53:48 EST 2008;Committer;nobu;1;10;0;10;0
08c319ee2a95312859d57156709a5effeb7dac5c;Thu Jan 17 16:48:18 EST 2008;Committer;nobu;2;36;27;63;0
64239e22918a43ca23bdc477a373644ca5b200ac;Thu Jan 17 15:49:33 EST 2008;Committer;nobu;2;12;0;12;0
a3776588ef0314ae6aaf68cab1ae4bf144b35883;Thu Jan 17 15:23:33 EST 2008;Committer;nobu;2;6;12;18;0
8b112c580c854a5fb84b129aafff0e91022fcf6a;Thu Jan 17 15:17:21 EST 2008;Committer;nobu;3;15;2;17;0
fe3987ae9605772f20b40bcce1b3ca644f048221;Thu Jan 17 15:03:56 EST 2008;Committer;nobu;3;10;4;14;0
0052259d5e9934de20411943ce2077909e82d1d3;Thu Jan 17 14:56:22 EST 2008;Committer;nobu;6;305;175;480;0
a0029e3adc2760bf9e617f6cc1e3ecc88c13779c;Thu Jan 17 12:48:23 EST 2008;Committer;nobu;2;5;1;6;0
49622de368339b214b3267045f68c3f4bae7e4f8;Thu Jan 17 12:05:43 EST 2008;Committer;tadf;3;16;7;23;0
85e6dff16563ae2233c8d1c162a441dc386a56c4;Thu Jan 17 08:08:08 EST 2008;Committer;nobu;1;1;1;2;0
d969620ea8892b580cf7d14a0f3c26c4fea1275f;Wed Jan 16 13:45:29 EST 2008;Committer;nobu;2;5;0;5;0
9c1bf098e0c7cc9c0d4761ca951d57c4a1766c40;Wed Jan 16 09:38:01 EST 2008;Committer;nobu;1;1;1;2;0
e477c919db3a070ab4eab882b0fb92b7968ad3ab;Wed Jan 16 09:03:12 EST 2008;Committer;nobu;2;7;0;7;0
50bcd83621bd313873141e3304c81273371afd6e;Wed Jan 16 08:56:45 EST 2008;Committer;usa;2;6;1;7;0
3009bcb67967ebeb3450e771746336512eb03206;Wed Jan 16 08:36:56 EST 2008;Committer;usa;2;19;0;19;0
fe5b495f883bbd5e34b15130f551e14600835465;Wed Jan 16 07:15:09 EST 2008;Committer;knu;2;6;2;8;0
5124dacaf6c0ba38d0030345ab575e0167078c43;Wed Jan 16 06:27:37 EST 2008;Committer;nobu;1;0;6;6;0
db26a9b105f0e2b4850c45554c1e77aa35973ef4;Wed Jan 16 06:26:33 EST 2008;Committer;nobu;4;29;10;39;0
2402ecabb064525651667374a0f758321bbc7f65;Wed Jan 16 05:55:22 EST 2008;Committer;nobu;4;59;19;78;0
ce2652c9d46acd102d80fe645000ad31dc45ebbb;Wed Jan 16 03:51:32 EST 2008;Committer;nobu;5;10;7;17;0
c3e2bdcc2039fdcc8bbac08016a8ac09826fdc76;Wed Jan 16 01:36:19 EST 2008;Committer;drbrain;1;9;41;50;0
0a640a93860ecd948431e5c29fc6f6ab8853c4b5;Tue Jan 15 14:54:40 EST 2008;Committer;naruse;24;101;90;191;0
904572d2e5a35c6fde655aeb24b11fcb9f7b5ba3;Tue Jan 15 14:02:32 EST 2008;Committer;naruse;5;37;32;69;0
edc61cf4c19c089d210c7774994ee6d57bff65ad;Tue Jan 15 13:36:18 EST 2008;Committer;naruse;14;58;67;125;0
d2a377d747c707bed4c2fb880fe4147807801e08;Tue Jan 15 09:47:58 EST 2008;Committer;matz;2;8;41;49;0
648c0f7c80df58bdbcb5ce89c361219e4adf83fb;Tue Jan 15 09:06:03 EST 2008;Committer;usa;2;4;4;8;0
a894055204f29bde302dbf42f846d14e49b186eb;Tue Jan 15 09:05:23 EST 2008;Committer;usa;2;6;1;7;0
a34288d9471e0f7db237d653452b618276813d41;Tue Jan 15 09:00:48 EST 2008;Committer;matz;2;6;1;7;0
68adb6193a39476cd91d5d9da8ca6aaf63e5ca1b;Tue Jan 15 08:53:07 EST 2008;Committer;nobu;2;5;3;8;0
ad73c8b34828469b242de6c9afe1e72993af695b;Tue Jan 15 08:26:54 EST 2008;Committer;nobu;5;493;485;978;0
9eab65b3f088d8109cdc27888afcb763e5d5181c;Tue Jan 15 07:59:33 EST 2008;Committer;nobu;2;12;8;20;0
9615084012e52961ce7648b7736f86f4eb8ebe48;Tue Jan 15 06:09:30 EST 2008;Committer;nobu;2;8;2;10;0
de556e6281860dd350f458e653052f8addf9ec6d;Tue Jan 15 05:57:40 EST 2008;Committer;nobu;4;22;4;26;0
3c3b2fe143943f0a8a11767637088b3ca82c2d53;Tue Jan 15 05:44:55 EST 2008;Committer;nobu;2;5;1;6;0
4f703c7dad3e8f765192bbe3d990f9df3afa3ff6;Tue Jan 15 04:55:28 EST 2008;Committer;usa;3;7;2;9;0
21365c4476eb32462b03527cb34ec4212e9c683a;Tue Jan 15 04:45:02 EST 2008;Committer;usa;2;6;0;6;0
1c5640855fe8527e22572319fcdcc5aa0d89cc2d;Mon Jan 14 18:41:44 EST 2008;Committer;nobu;2;9;4;13;0
45a5455d7af00aa649333071a8f1b3098ce7fa2e;Mon Jan 14 16:28:49 EST 2008;Committer;nobu;2;6;7;13;0
2e8965863d7edde804760f37ee82784c0a613a3b;Mon Jan 14 16:19:02 EST 2008;Committer;nobu;7;24;5;29;0
fa246559d2c1206e3f3d4b409c2e161671821905;Mon Jan 14 15:07:49 EST 2008;Committer;matz;3;20;3;23;0
dfca247f666821d41176737a89186cecf4a7a1fa;Mon Jan 14 14:37:29 EST 2008;Committer;naruse;2;5;1;6;0
7d8c42297e38a2e8a719c4775e491de0d49054f1;Mon Jan 14 14:32:46 EST 2008;Committer;matz;3;8;1;9;0
b9bac78cce93beb9dcde4653af39312ebb29845f;Mon Jan 14 14:29:26 EST 2008;Committer;usa;2;5;1;6;0
d9ff499bf3b4772b2657c8182f33180e9f70db49;Mon Jan 14 13:49:29 EST 2008;Committer;matz;5;16;11;27;0
45432a6d2b22bbc7318819e251127021810a728d;Mon Jan 14 13:35:51 EST 2008;Committer;eban;2;78;8;86;0
4d034f3477d698e3f1c760af1dd8ae8f75144b3b;Mon Jan 14 12:11:06 EST 2008;Committer;matz;3;9;3;12;0
5360e77db8aa0e40c7c79cee74f91634eefa8576;Mon Jan 14 10:02:51 EST 2008;Committer;ko1;3;28;1;29;0
4b8de30bc5c69b636851559689922aa522e0f472;Mon Jan 14 09:59:58 EST 2008;Committer;akr;1;1;1;2;0
0c801d657a963290c0cd269166bdbf79586b47ec;Mon Jan 14 09:45:46 EST 2008;Committer;ko1;3;16;5;21;0
7d7125e7b473beadce9767339603cac0a03ada07;Mon Jan 14 09:35:18 EST 2008;Committer;akr;1;1;0;1;0
2004a2b536bde0bff385821c1b570dc9d1f52a5d;Mon Jan 14 09:16:57 EST 2008;Committer;ko1;2;4;1;5;0
0605d15f6aeb776a0699a49fdb761ae1e9a40d6e;Mon Jan 14 09:08:45 EST 2008;Committer;naruse;4;12;4;16;0
d407e2fac82c643654f2d647243ae9a1e538505a;Mon Jan 14 07:14:14 EST 2008;Committer;matz;2;7;1;8;0
c884219d9668b3696028588569d3fafdb6ed78a0;Mon Jan 14 07:10:22 EST 2008;Committer;matz;4;47;3;50;0
a31e2da12c8e03517515c940c90f4e4c67da3b0b;Mon Jan 14 04:51:10 EST 2008;Committer;akr;2;20;9;29;0
fcb0b1f503b392e446e8ee4b1033e1e7c0e7d0fe;Mon Jan 14 03:34:05 EST 2008;Committer;drbrain;35;3499;3789;7288;0
cbd4604c530bd798db321a78d2f7bca4f568ba45;Mon Jan 14 01:59:03 EST 2008;Committer;nobu;2;1;29;30;0
5f31c7b54819917b41bcb06ac7761caf2c94da81;Mon Jan 14 01:45:52 EST 2008;Committer;duerst;2;5;1;6;0
669e94a31422283dac62c514cb2e65f4f79cbed6;Mon Jan 14 00:27:35 EST 2008;Committer;tadf;2;14;9;23;0
5b46f99ce1111eec5fc45ea0b9d9631b09aa02d9;Sun Jan 13 20:46:00 EST 2008;Committer;naruse;7;84;10;94;0
50bbc4e6ae9229907ad08730ab7330024361918a;Sun Jan 13 17:21:47 EST 2008;Committer;naruse;1;1;0;1;0
8f15b8128cf47ff679d4f0d3767605d0d0afcc3c;Sun Jan 13 17:16:09 EST 2008;Committer;naruse;14;1383;74;1457;0
21671b558cfd8d90647f40a8594fd9e6db038768;Sun Jan 13 14:29:12 EST 2008;Committer;naruse;20;52;7;59;0
62c596cb36af5471e65a4774dfe70047055f58b7;Sun Jan 13 11:24:44 EST 2008;Committer;naruse;2;34;4;38;0
bb8ddbe8471d4d1a66b79956b7697f947fb0a61d;Sun Jan 13 09:41:50 EST 2008;Committer;nobu;3;23;16;39;0
e26e05c4abf76d751bd17704b55ab550a9fe024e;Sun Jan 13 04:53:02 EST 2008;Committer;nobu;2;5;3;8;0
60e38b6efb7582f3c419ec7b06ed9579e4310b43;Sun Jan 13 04:50:48 EST 2008;Committer;nobu;2;11;2;13;0
a7b36aebe8d99906a37a87747d94e81b5909cac9;Sun Jan 13 04:37:17 EST 2008;Committer;nobu;1;1;1;2;0
0feac89d2dd6ff66914bb4d5d9e7306082abbd53;Sun Jan 13 03:35:34 EST 2008;Committer;drbrain;8;201;211;412;0
ec519b9b43db7756fcc2c19020ece2d7e2263fe4;Sun Jan 13 03:13:37 EST 2008;Committer;drbrain;27;4003;4004;8007;0
937b7ab8b59346f02da81ef324b8955b01d7cc25;Sun Jan 13 03:02:49 EST 2008;Committer;drbrain;26;4005;3998;8003;0
513d0ca7f6c7c27c8f875a84d5b9a8f3692dbe8f;Sun Jan 13 02:51:15 EST 2008;Committer;naruse;7;29;23;52;0
00fb802284de17da913506377f4a346210baa4a6;Sun Jan 13 01:21:42 EST 2008;Committer;nobu;3;64;60;124;0
80a569906d1fcbede2278193226fef84cdaa96f4;Sun Jan 13 01:15:32 EST 2008;Committer;naruse;6;411;391;802;0
55fc5598453ed67a86692e3540fca34ce27d2f13;Sun Jan 13 00:22:35 EST 2008;Committer;nobu;2;5;1;6;0
1637dbeca7f6dcd98224a6e992258abffd46c512;Sun Jan 13 00:17:31 EST 2008;Committer;nobu;3;6;2;8;0
9bded8aae94aacf03b308798bed7ee6a752ba099;Sun Jan 13 00:10:00 EST 2008;Committer;nobu;1;64;64;128;0
e699dda5042b65e9e4c8ce29fa6575e3684b9100;Sat Jan 12 16:55:33 EST 2008;Committer;matz;4;16;11;27;0
b866ecbc42f5cb4d2f6138a9038d0443dc9f6cc6;Sat Jan 12 16:42:43 EST 2008;Committer;akr;1;9;0;9;0
4261dd6ab742eea969df5da3e2ce94a75759efe2;Sat Jan 12 16:34:08 EST 2008;Committer;naruse;1;2;2;4;0
5b9739a832c884f450e04d90edb026a09da5e6de;Sat Jan 12 16:03:51 EST 2008;Committer;naruse;9;154;21;175;0
2cfd4473d6970dc9b82dd9326a22550dd46855c7;Sat Jan 12 12:18:37 EST 2008;Committer;tadf;1;0;1;1;0
aad2c434a781161513f30eebcde0a2c6c49b3cdd;Sat Jan 12 09:27:43 EST 2008;Committer;nobu;2;10;3;13;0
86da4be0284149bf0c6d56ca14b2ee86ab21910b;Sat Jan 12 03:46:13 EST 2008;Committer;naruse;2;5;6;11;0
ea78055b081804bc3c3e1053bfcdffe02f1d2ba9;Sat Jan 12 03:03:31 EST 2008;Committer;tadf;3;26;13;39;0
a615bbf40b96ee1b664d726daf11748d57842b66;Sat Jan 12 02:29:47 EST 2008;Committer;nobu;2;8;3;11;0
603f9304b285e31b39b705584b72218e80db8648;Fri Jan 11 22:28:37 EST 2008;Committer;usa;1;3;3;6;0
7f9c3b1c973a1785cd1471d86d8875caf17f0a7e;Fri Jan 11 19:41:22 EST 2008;Committer;naruse;2;13;8;21;0
353a69229dcedd1991b710085a37d6c331816a92;Fri Jan 11 19:33:37 EST 2008;Committer;naruse;2;6;0;6;0
e350fe247af325d9c148b27617dce77750e989a4;Fri Jan 11 14:26:26 EST 2008;Committer;akr;2;20;19;39;0
857b3018dd7b76828b0d61921cb24de59778765f;Fri Jan 11 11:20:18 EST 2008;Committer;nobu;3;14;0;14;0
7e6cf122efcea0aceda17feff2614fe6cda491c5;Fri Jan 11 09:31:15 EST 2008;Committer;drbrain;3;20;230;250;0
b5417ef56d8706cd340f7c6c97a73dfbae3b3833;Fri Jan 11 09:18:53 EST 2008;Committer;drbrain;2;8;3;11;0
1267156698d08d9467ea2daadd1b7810b97e59c5;Fri Jan 11 07:55:23 EST 2008;Committer;nobu;2;11;7;18;0
0ada40e2b1d85580ec14c96d18321d1a245d328f;Fri Jan 11 06:03:51 EST 2008;Committer;akr;1;0;2;2;0
825bfef2eab4f7e07da0f4baa7a086972c1459d4;Fri Jan 11 03:35:59 EST 2008;Committer;nobu;2;2;2;4;0
1af31107c9da12a5cc7e5c6691ac606fd57f5119;Fri Jan 11 03:27:46 EST 2008;Committer;nobu;3;18;7;25;0
5a1b5f8fe2eea72eeb3fcdd54d1ab8b954828bbd;Fri Jan 11 03:11:42 EST 2008;Committer;akr;1;10;0;10;0
82bf2c1ac7e4398e57a102119fdf16beb02a6e24;Fri Jan 11 02:57:38 EST 2008;Committer;nobu;2;14;8;22;0
0521c0e36e68920349a268a04e3690a62d70b59e;Fri Jan 11 02:17:25 EST 2008;Committer;nobu;1;2;1;3;0
8b39fb10455c4fa137d32730279e41d3e8377d01;Fri Jan 11 01:24:05 EST 2008;Committer;nobu;2;5;1;6;0
249c08716da39c4f51c295948125436640a60487;Fri Jan 11 01:03:23 EST 2008;Committer;naruse;4;22;21;43;0
9e35ba455d6b87b79ca872e9fa71d3f95c78286d;Fri Jan 11 00:39:44 EST 2008;Committer;naruse;2;5;1;6;0
78900b98b31d4ac8b789315623d51313573e7b54;Thu Jan 10 21:13:21 EST 2008;Committer;nobu;2;5;2;7;0
d17bcfc802cfc84212f10eaba5e80640e4b108c6;Thu Jan 10 16:12:32 EST 2008;Committer;matz;3;27;13;40;0
7a360de149dc00dcbed0a19d97c0882423a9b913;Thu Jan 10 14:26:08 EST 2008;Committer;akr;1;4;0;4;0
f478e73f0474a0ec77e2657c6d3b626a8e5b4b35;Thu Jan 10 10:35:52 EST 2008;Committer;akr;1;1;1;2;0
6871c342747a7df80450bde2aeabf4629648f9c6;Thu Jan 10 09:01:30 EST 2008;Committer;matz;2;6;1;7;0
f3098471770a3b813a4b5a6680af1374e908798f;Thu Jan 10 06:44:30 EST 2008;Committer;matz;1;1;1;2;0
a4c82312c356b2bfa33d2c11c7badc0b72de3b39;Thu Jan 10 06:42:49 EST 2008;Committer;matz;2;11;4;15;0
76b247202a19a56a0ba24639912ef2a0744371b3;Thu Jan 10 01:54:43 EST 2008;Committer;matz;2;6;0;6;0
81064a76880286242804119c8feb88c92fb48fd5;Wed Jan 09 17:44:13 EST 2008;Committer;matz;4;13;13;26;0
b3f93b1f43069c65766b965ec0864bc4cb3285cc;Wed Jan 09 14:23:34 EST 2008;Committer;matz;2;6;0;6;0
cbf7c9adde39ac857511fc85c1521205bd017328;Wed Jan 09 13:10:31 EST 2008;Committer;kazu;2;6;0;6;0
ad4fb57a3aea3bf5c1ca2a1fa937e549321e021a;Wed Jan 09 13:06:00 EST 2008;Committer;naruse;2;5;0;5;0
b04f5e661f98474b4779cb627a956a0ec02b2e9b;Wed Jan 09 11:37:03 EST 2008;Committer;gotoyuzo;3;126;2;128;0
53ac21c325ca360b1f61a21ea6e6660776092b15;Wed Jan 09 09:28:19 EST 2008;Committer;eban;2;16;4;20;0
8786b8a2823d146fbb382305707a24fc09f25618;Wed Jan 09 08:00:26 EST 2008;Committer;akr;2;7;3;10;0
d036633dcbfc7c4f7f28feab753694df1265f27d;Wed Jan 09 06:54:26 EST 2008;Committer;nobu;2;33;8;41;0
ff1cd79d0869c48a61bb002b5a9e9c52b74dcd06;Wed Jan 09 05:57:29 EST 2008;Committer;usa;2;5;1;6;0
9874fdbc866f8b504296cdfa75177f01b077f079;Wed Jan 09 05:52:20 EST 2008;Committer;nobu;2;12;5;17;0
3f2d1892dfe608722870cec8ee9ef0fda1f315ce;Wed Jan 09 05:46:35 EST 2008;Committer;usa;2;5;0;5;0
a5505ab8334fc6948b5745d3fc21011b67f844eb;Wed Jan 09 04:46:55 EST 2008;Committer;gotoyuzo;2;6;0;6;0
251dec5cf13b5ac9e1d2c115958be0ad23e799c5;Wed Jan 09 04:07:11 EST 2008;Committer;matz;3;12;5;17;0
8ed70a5186f23ec9c3efe0dc91bda8dc4466b28c;Tue Jan 08 23:42:38 EST 2008;Committer;jeg2;2;12;6;18;0
fdeb4b13846fdd72a89737ff813f2f8455da5327;Tue Jan 08 16:58:31 EST 2008;Committer;naruse;2;5;2;7;0
5cd70fa5e9b12e50177829217753cf2d2712381a;Tue Jan 08 14:56:50 EST 2008;Committer;naruse;2;4;8;12;0
ed540e8bdfca1e93e1285add58b1206408e19441;Tue Jan 08 13:35:24 EST 2008;Committer;naruse;5;25;11;36;0
1889c00e0710c43a64c1706ecabdc26d91890daa;Tue Jan 08 11:02:10 EST 2008;Committer;nobu;3;172;541;713;0
edeeefb7a544aadf2f788c8c6f88cb77bd941ac0;Tue Jan 08 10:49:19 EST 2008;Committer;drbrain;2;13;3;16;0
3e39ade457b432a57d63e00d5a9898ca202d26f1;Tue Jan 08 10:18:41 EST 2008;Committer;drbrain;23;2031;2071;4102;0
929faf7906a2f2ca7dbf5eda5670e666edddfa88;Tue Jan 08 09:50:01 EST 2008;Committer;matz;4;128;16;144;0
e539dc6080b4b1338968650c2b8ff645b72b11bf;Tue Jan 08 09:07:31 EST 2008;Committer;drbrain;11;531;579;1110;0
cc22700b900d37ffd452b0139749c3f024b9c380;Tue Jan 08 07:27:53 EST 2008;Committer;nobu;4;0;869;869;0
aab064f0dc660250eb4ad53bb352802a518128ea;Tue Jan 08 07:27:43 EST 2008;Committer;nobu;4;869;0;869;0
ecf8b1c807e5d52cdd70fedefc51b4e537f5f6bf;Tue Jan 08 06:48:49 EST 2008;Committer;usa;5;24;11;35;0
dca4de683847593efef8434192086bb98b79e946;Tue Jan 08 06:40:33 EST 2008;Committer;nobu;8;18;9;27;0
4cc42da33ffba12b14498499e3fbc13fb4b43c4b;Tue Jan 08 06:27:22 EST 2008;Committer;nobu;5;865;0;865;0
389abf1b3b9e65b5944fa3616bea93259b137a92;Tue Jan 08 06:04:26 EST 2008;Committer;akr;2;7;1;8;0
893ee3097885c83df17273d7de5ed54438de5d20;Tue Jan 08 04:05:59 EST 2008;Committer;nobu;3;25;20;45;0
6a1a57d13b4358f718a3b5037cefd2d00bbb48d2;Tue Jan 08 00:06:38 EST 2008;Committer;usa;1;3;3;6;0
fc5a26c2d41fade0771217e5b8ba257249db5251;Mon Jan 07 22:57:00 EST 2008;Committer;akr;3;17;1;18;0
3938f9db4614be6cebeff715653f4f1c76aa0484;Mon Jan 07 21:28:43 EST 2008;Committer;drbrain;1;38;36;74;0
7425f59f10b12ff57952b08100d5fe018b28b910;Mon Jan 07 16:28:43 EST 2008;Committer;akr;2;93;102;195;0
05e52bf46bfcbfb288ef841008358e04e58ceab4;Mon Jan 07 15:32:07 EST 2008;Committer;akr;2;27;0;27;0
cc3350f118d60fe5ccd254cbe3e6b5e6e0ee3916;Mon Jan 07 11:40:41 EST 2008;Committer;gotoyuzo;2;7;0;7;0
466d40ed15bc057ff786e73fde58a1ee48effabe;Mon Jan 07 10:40:50 EST 2008;Committer;drbrain;11;688;1573;2261;0
f2707db2dc05fb726f044e6dd0f9c11bef4d20d0;Mon Jan 07 10:12:45 EST 2008;Committer;matz;3;7;2;9;0
4d6c03475207b12bb64f3ce30169531d78abba11;Mon Jan 07 10:01:34 EST 2008;Committer;matz;1;23;0;23;0
3e2fe4a1eb301b6a3e089209389e8994fde7443b;Mon Jan 07 09:11:28 EST 2008;Committer;akr;2;10;4;14;0
4e4d4331cad48bddb91568daf2f325f08033f9b4;Mon Jan 07 07:48:24 EST 2008;Committer;akr;4;15;16;31;0
ead85d123f37be2f166acf9a2c0fb5e08368813e;Mon Jan 07 07:11:15 EST 2008;Committer;drbrain;2;21;9;30;0
48db39e35586b9339995978ccb3eef6d3cb7c703;Mon Jan 07 07:07:44 EST 2008;Committer;matz;1;25;0;25;0
9ad5f854e745043e144408b6408f38dff7bcf880;Mon Jan 07 07:06:59 EST 2008;Committer;drbrain;3;83;74;157;0
4b93d732e406957e094e848093517359b9ffecf4;Mon Jan 07 06:56:46 EST 2008;Committer;drbrain;13;635;594;1229;0
b9127221e5c28ab677c56fc5885259e90647e2a8;Mon Jan 07 06:53:39 EST 2008;Committer;usa;6;10;1;11;0
238c59842c6f9ab72ace7076a8850b5cc55c421c;Mon Jan 07 04:55:26 EST 2008;Committer;akr;2;5;1;6;0
d9d3e87a522ce180768aef2fcb32c236c68b07f2;Mon Jan 07 02:52:15 EST 2008;Committer;drbrain;3;27;10;37;0
063beac3436cb94bf51cb9fec08b34e977563faa;Mon Jan 07 02:49:01 EST 2008;Committer;akr;8;88;24;112;0
fa21f1b7510dba084b907a6189a67f36d36a5008;Mon Jan 07 01:56:16 EST 2008;Committer;matz;1;25;0;25;0
b543ed3ac8089e439e57ad5f667e35871882bd07;Mon Jan 07 01:36:33 EST 2008;Committer;drbrain;6;352;366;718;0
b0f13cfebec316491909e312608834c87792ca9f;Mon Jan 07 00:42:03 EST 2008;Committer;drbrain;4;248;262;510;0
ee6abe32523845d5c63f1c3bd23ecf555f4d0827;Mon Jan 07 00:16:09 EST 2008;Committer;usa;1;3;3;6;0
d16ae8706b344c11a5d1a9d9298c2e9b39de62df;Sun Jan 06 17:39:59 EST 2008;Committer;akr;1;1;1;2;0
9f808343c8e72675ea5765c65470b8205bc6be9c;Sun Jan 06 17:37:54 EST 2008;Committer;akr;2;13;6;19;0
b2168c5a2a37be1e9937659c499bb30be1db286e;Sun Jan 06 16:38:04 EST 2008;Committer;akr;2;31;5;36;0
35f28e6b81497a843d661e2d9751d3b8837fe8bb;Sun Jan 06 16:07:04 EST 2008;Committer;akr;2;6;1;7;0
c5e0963a5e86b4d3329cdd0bc0a9689926b1168a;Sun Jan 06 15:51:57 EST 2008;Committer;akr;1;1;1;2;0
6cdef2dc7e8a4098727de5befff8b2496fa71430;Sun Jan 06 15:49:38 EST 2008;Committer;akr;174;5;173;178;0
f38cc001a7ca64f7f613b5021b1714a2ee3318cb;Sun Jan 06 12:15:48 EST 2008;Committer;akr;3;17;2;19;0
8987b97ca9d3eca076a489fbf6eb9c1dfbf72df2;Sun Jan 06 09:25:09 EST 2008;Committer;akr;5;189;100;289;0
4ca078239309907130b6cb187d8d44ebaf220bae;Sun Jan 06 09:11:34 EST 2008;Committer;technorama;2;51;2;53;0
ebe7d94ca685ce8998ccc14bf59d3219bb9920d0;Sun Jan 06 02:17:18 EST 2008;Committer;akr;1;7;0;7;0
84a92191e3eb797aab7d625a8ad481277d9a16d8;Sun Jan 06 01:57:17 EST 2008;Committer;usa;1;3;3;6;0
352d72719b2918cca32eb07d086b90fd3f5dad32;Sun Jan 06 00:38:22 EST 2008;Committer;tadf;4;94;62;156;0
dbc78facbc7a0f3c8241a97c17a5c74ba149a1d2;Sat Jan 05 19:22:44 EST 2008;Committer;akr;1;0;1;1;0
b3b0fa3e85afd845ea85f420398b41c739300486;Sat Jan 05 19:14:24 EST 2008;Committer;akr;2;1434;1281;2715;0
1347a9a7e03fded7881a4c4fa40fe843edfaf5f1;Sat Jan 05 18:36:56 EST 2008;Committer;akr;1;4;0;4;0
da42c102c18156c2192df203cb2f79b88aa8092f;Sat Jan 05 16:39:38 EST 2008;Committer;akr;3;15;2;17;0
2435067f6ca2486570d3b90102b1a0ebe13cb1ea;Sat Jan 05 15:53:35 EST 2008;Committer;naruse;2;7;10;17;0
7967e3e2f445444a08f99fbe6d53858dad2c9ae3;Sat Jan 05 15:40:17 EST 2008;Committer;akr;1;3;0;3;0
730374e56e60f9e9d6b7aafd9f80902fd7fcd30b;Sat Jan 05 12:49:01 EST 2008;Committer;akr;2;6;1;7;0
ea394a402bc3312b250d6ecd415a490c9af68584;Sat Jan 05 12:17:53 EST 2008;Committer;suke;1;22;11;33;0
0d315337046760c7e1d4c3f6cac130a02e4a6f19;Sat Jan 05 10:42:36 EST 2008;Committer;suke;1;3;0;3;0
76c2550b5b39f96875205b4dc7fe226c0905c3d4;Sat Jan 05 07:50:50 EST 2008;Committer;nobu;2;3;3;6;0
80de7a2fe197408285c7a1a7ac5e466451a05b87;Sat Jan 05 05:45:40 EST 2008;Committer;nobu;2;6;1;7;0
4be0eb95cf92f40d68918b8f7f50e7367bff4aec;Sat Jan 05 04:04:26 EST 2008;Committer;nobu;2;5;1;6;0
8702c4d0d73a050e0d2181e16bf1e0688d6322f0;Sat Jan 05 03:35:13 EST 2008;Committer;akr;4;43;33;76;0
9c2204972b94c4fde59378739651736e4213bef4;Sat Jan 05 02:51:24 EST 2008;Committer;akr;2;6;0;6;0
9eab58ee0381ac804aa1b761a088424bbfc248ad;Fri Jan 04 17:21:53 EST 2008;Committer;akr;3;20;0;20;0
f3fa37e8e5743913e377ebd489cc9862f77770da;Fri Jan 04 17:15:22 EST 2008;Committer;matz;2;7;0;7;0
373d43f61e0a51938a578f2f20372427ce0f08a4;Fri Jan 04 16:51:16 EST 2008;Committer;matz;3;13;4;17;0
b65d6208fea61d75777622b60d0739695eccf503;Fri Jan 04 16:47:41 EST 2008;Committer;matz;2;5;1;6;0
8638ee26e704cb9b2e40bcbced713d459a374b1f;Fri Jan 04 16:30:33 EST 2008;Committer;nobu;7;62;13;75;0
91f9acdfeee3cf4340988193bd1fa6ad1834789f;Fri Jan 04 14:08:50 EST 2008;Committer;nobu;2;5;1;6;0
e395327e8e1d3250fbd222f72573a948b301f331;Fri Jan 04 09:41:44 EST 2008;Committer;akr;1;11;11;22;0
386e2d94d86428560b85a01ae9bd128f12cef229;Fri Jan 04 07:26:14 EST 2008;Committer;akr;2;6;1;7;0
f780cdec75b5f09a7afbd9b45fad1f0d709fe946;Fri Jan 04 05:01:58 EST 2008;Committer;akr;3;32;2;34;0
7d98c90ef2f7def3938a8eec825e314ab178e762;Fri Jan 04 03:13:53 EST 2008;Committer;akr;1;0;1;1;0
22e7258275966b89b0bf2462179f99c7a8feb34a;Fri Jan 04 01:24:12 EST 2008;Committer;matz;3;17;28;45;0
ed74723af4d28193f72242d4e6bc51a542aad118;Thu Jan 03 17:57:48 EST 2008;Committer;akr;19;201;162;363;0
52f9c1d2e173f07302ec263bf0026ded739a2d7f;Thu Jan 03 17:48:06 EST 2008;Committer;akr;2;27;8;35;0
97751bbd5a3a6b66f91932ff3292f5b113ee964f;Thu Jan 03 16:20:29 EST 2008;Committer;nobu;2;10;8;18;0
52ed8c4edd880e9b9482748e9692b1e22917bf92;Thu Jan 03 15:55:04 EST 2008;Committer;matz;23;872;652;1524;0
1aaf8b171373f6862fa8c523923b98ef6feb1c65;Thu Jan 03 15:40:45 EST 2008;Committer;akr;2;12;1;13;0
f905704727b20865f71a10fbc34ed032346a7f93;Thu Jan 03 14:49:38 EST 2008;Committer;akr;1;11;0;11;0
b661bfe319cb9aa324ee976ae5a96dd083a25137;Thu Jan 03 12:57:26 EST 2008;Committer;akr;2;14;7;21;0
a0350e5964c1edba90bf6cf4bd7e2d5b64eaa386;Thu Jan 03 11:26:48 EST 2008;Committer;ko1;2;6;0;6;0
37d1059f49bb817234dcab8ddba69f7ebe5ba2cb;Thu Jan 03 11:26:10 EST 2008;Committer;ryan;1;9;0;9;0
1421b85ea242c64272a3bed9974d834d305926b6;Thu Jan 03 10:48:35 EST 2008;Committer;ko1;3;14;9;23;0
059fe7997e0c9bf0861f8e6ff9a00277cb5846f6;Thu Jan 03 09:40:00 EST 2008;Committer;akr;2;6;2;8;0
b1d373308f7a3790eae21a6b79a17df539012190;Thu Jan 03 08:56:08 EST 2008;Committer;akr;3;5;2;7;0
5f237d79033b2109afb768bc889611fa9630e00b;Thu Jan 03 08:44:01 EST 2008;Committer;akr;5;189;121;310;0
155fda385e6657f270b8e30c1bc0ad99b2733236;Thu Jan 03 06:13:31 EST 2008;Committer;akr;5;35;14;49;0
df4f37bca3c46c9072aa6bf982cd9f7e9d8efa27;Thu Jan 03 05:37:47 EST 2008;Committer;akr;2;7;2;9;0
97653890177fa9fc102ba0b20f76836640834303;Thu Jan 03 04:31:37 EST 2008;Committer;akr;1;2;2;4;0
506ea448b31d4bac6f6ce378e348c7fea1d5e9fb;Thu Jan 03 03:24:21 EST 2008;Committer;akr;1;4;3;7;0
1144b9540e396686afe56b619bad08aaec8eb501;Thu Jan 03 03:11:45 EST 2008;Committer;akr;1;10;3;13;0
4666b9da3db0c2da51b36ca4f2e4148b08708d8c;Thu Jan 03 02:46:08 EST 2008;Committer;akr;2;5;1;6;0
2000bde8e7aa2f12dc3b437b5c6a6beb0edc96ec;Thu Jan 03 02:29:04 EST 2008;Committer;nobu;2;5;0;5;0
499bc93a42acddfd66c029343fe0836d9f3893a2;Thu Jan 03 01:47:18 EST 2008;Committer;usa;1;3;3;6;0
a13c1148a94d504a7b3d0db55c3b75cba733475e;Wed Jan 02 20:06:58 EST 2008;Committer;akr;11;119;96;215;0
9d52fda376509f22bee858b0190eb0b289734b90;Wed Jan 02 17:48:20 EST 2008;Committer;akr;2;7;3;10;0
1db957718408370ce6b23435ef642e6fad130ef0;Wed Jan 02 14:53:16 EST 2008;Committer;akr;2;13;2;15;0
99fc557fa5f15b82019c866b3f55bfd8106b04af;Wed Jan 02 07:09:14 EST 2008;Committer;akr;1;0;1;1;0
e7fb2586eff0f9479ae73abb112f37a3a3866ff4;Wed Jan 02 06:53:41 EST 2008;Committer;akr;1;2;1;3;0
1642877c69c07f87d7d3291b5a61ea6c8c169338;Wed Jan 02 06:29:08 EST 2008;Committer;akr;1;1;1;2;0
0352d32f05b42bb31fe98e0fa3582ef4e4689e79;Wed Jan 02 06:24:27 EST 2008;Committer;akr;11;142;211;353;0
aac5220c666dcb84db1c39247aaf0fd394869b89;Wed Jan 02 05:41:47 EST 2008;Committer;akr;2;4;9;13;0
8bebb44d0b0bc2e2f84e6d23247e291f5848752a;Wed Jan 02 05:02:42 EST 2008;Committer;akr;2;5;2;7;0
7e2fdd4cc84a3c2d35b19c46c63a261bd6afd03b;Wed Jan 02 02:36:58 EST 2008;Committer;akr;5;12;37;49;0
8676df80edb0439a1c368271e43583109195fa75;Wed Jan 02 01:58:33 EST 2008;Committer;usa;1;3;3;6;0
3236366b90a4860e48aa094d6bc7b952085334b0;Wed Jan 02 01:46:26 EST 2008;Committer;tadf;2;2;2;4;0
1f838ea1c10790349ce809cd1a71c29c68e5be2b;Wed Jan 02 01:15:30 EST 2008;Committer;tadf;2;14;6;20;0
dec7f6903b616a38d428b2c6537780463c211e5c;Wed Jan 02 00:15:17 EST 2008;Committer;tadf;1;0;1;1;0
af06cf81f15958f658faf192cae7e6ebf442b7a8;Wed Jan 02 00:12:05 EST 2008;Committer;tadf;2;4;48;52;0
5b0ab11b0a8a16a6f8777cb3bda6c4270a7652a4;Wed Jan 02 00:04:08 EST 2008;Committer;tadf;2;28;24;52;0
27bcfc3dc8b422a2d54d9b1e72448e4a12e1b3d6;Tue Jan 01 17:31:28 EST 2008;Committer;akr;1;52;91;143;0
40871d401fb1b7a60685d9a9767394e1925278ad;Tue Jan 01 16:20:56 EST 2008;Committer;akr;2;5;1;6;0
7d847f7c377b6dbf85371c3e03599881b76f1954;Tue Jan 01 15:22:25 EST 2008;Committer;naruse;6;801;867;1668;0
5f41f87d2ba568cb0ad1fdb523a4c60b15a40613;Tue Jan 01 14:55:35 EST 2008;Committer;akr;1;18;18;36;0
bda6512f3e9afaddca3dc31dac7ed20a3ebb6318;Tue Jan 01 14:17:37 EST 2008;Committer;akr;2;278;169;447;0
e3e49960e0aa9753b8a9c9e5eae8212faf72bdc8;Tue Jan 01 13:19:21 EST 2008;Committer;akr;1;10;15;25;0
041e8291271557ca0b18f283411b013888c55955;Tue Jan 01 12:24:04 EST 2008;Committer;akr;14;152;39;191;0
46933426b0a013efe1c978bbd200ea63c9ec644d;Tue Jan 01 08:50:49 EST 2008;Committer;nobu;2;8;0;8;0
4f6c04dc52ba78458bf1263b8ea75dc1440a2fad;Tue Jan 01 07:04:28 EST 2008;Committer;akr;1;1;0;1;0
1448668244c81cfc720bcdfa93af352a17cc230f;Tue Jan 01 05:43:50 EST 2008;Committer;matz;16;91;67;158;0
96e7713754c477fe98806b905301356371accb68;Tue Jan 01 05:16:49 EST 2008;Committer;matz;2;8;2;10;0
5e22f599825af9fa2134c91932a16815fc1e09e7;Mon Dec 31 16:34:30 EST 2007;Committer;matz;1;1;1;2;0
e460d4f75782a4785c3f47d778a1c9b8ccd25659;Mon Dec 31 16:32:24 EST 2007;Committer;matz;1;1;0;1;0
1701a536d10d6ac87ff93b7c67f5052a4e9a2b12;Mon Dec 31 16:29:06 EST 2007;Committer;nobu;2;5;3;8;0
d64a9753968e793e23f03c6b5de31d300e4bd438;Mon Dec 31 16:04:11 EST 2007;Committer;nobu;3;12;5;17;0
6cb161a66c014db83c62ebf8a0d6beff60f44382;Mon Dec 31 14:57:46 EST 2007;Committer;nobu;1;9;6;15;0
b4f09d76d3795650ed1f9109bcc9919e919c312b;Mon Dec 31 14:53:58 EST 2007;Committer;nobu;1;5;0;5;0
de3f2adb53561c99630478e8372326c0d0a63153;Mon Dec 31 14:27:20 EST 2007;Committer;nobu;4;23;9;32;0
aaf78dec43d85058d56dda5518fc757398ccf781;Mon Dec 31 14:17:41 EST 2007;Committer;gotoyuzo;4;434;105;539;0
d4c2cca3cbc8bc9268eac16ca1a071b6c0c920b4;Mon Dec 31 13:56:42 EST 2007;Committer;matz;2;7;1;8;0
58d8e1450f5656a41a8e37df76d13d8ab6d251b2;Mon Dec 31 12:55:50 EST 2007;Committer;akr;1;2;2;4;0
ca122fa53bdfe48378949b23701c19e37cc158f8;Mon Dec 31 10:39:20 EST 2007;Committer;akr;2;50;19;69;0
1137af8a03b92b51ccc22b26dddd61586c4f08a0;Mon Dec 31 09:06:45 EST 2007;Committer;akr;1;1;1;2;0
5088b14db79eb112f55ea983c45e3724ab9251d4;Mon Dec 31 06:43:32 EST 2007;Committer;akr;7;12;12;24;0
e21907e0f89e9d4870d1b533364cbc79dd9b6d89;Mon Dec 31 05:52:59 EST 2007;Committer;akr;3;6;6;12;0
84e02c87184ba5e7adff6e53645e4414bdc57703;Mon Dec 31 00:33:40 EST 2007;Committer;nobu;1;4;1;5;0
f610abc0a6e2ac60f6bcb7756a42e755db48a260;Sun Dec 30 22:39:34 EST 2007;Committer;nobu;3;29;4;33;0
74dd31fadfdc3b0b399d6bf0350a34e381e3de9c;Sun Dec 30 21:50:40 EST 2007;Committer;nobu;5;17;9;26;0
3d0260cc9445139eb51e4ff66858ebea336a108b;Sun Dec 30 21:08:36 EST 2007;Committer;nobu;3;38;8;46;0
f7b12afff5f7779ab0f6542abe41a356a32cc142;Sun Dec 30 20:58:31 EST 2007;Committer;usa;2;37;27;64;0
6ceb07bcdfb2e41c7d412c2d73821e7f75155db1;Sun Dec 30 17:30:54 EST 2007;Committer;akr;1;102;0;102;0
4edb5d229a7b76ce4ada9399d3d2050d343245d9;Sun Dec 30 14:57:07 EST 2007;Committer;akr;1;43;43;86;0
21789d53316b3894cbe81382ea45841728579225;Sun Dec 30 14:49:22 EST 2007;Committer;usa;2;9;0;9;0
75ee1d525277c0e07fce061af0ad73cda00250ae;Sun Dec 30 14:20:37 EST 2007;Committer;eban;2;6;2;8;0
ce1834d6587bcf71dc534fd351e9ffcbc69f264b;Sun Dec 30 13:48:03 EST 2007;Committer;tadf;2;9;4;13;0
b75c2a939d7c79c0e81e311e13beabc52c6402ca;Sun Dec 30 12:54:29 EST 2007;Committer;nobu;2;7;2;9;0
e282fc4c06cf5ddf8b14e365b2ba7446dee31c14;Sun Dec 30 12:42:20 EST 2007;Committer;akr;1;10;10;20;0
735f064df372186ea5724c6042176895b40eaf96;Sun Dec 30 10:23:53 EST 2007;Committer;usa;2;6;1;7;0
486dd97e74eb69334a737ab3ce168f4b74815373;Sun Dec 30 09:19:09 EST 2007;Committer;akr;1;2;0;2;0
1ed2aad9581f5bdf9eeaa82d405c37b855d2784d;Sun Dec 30 08:43:56 EST 2007;Committer;nobu;2;6;1;7;0
7494e2ef3273905e435b31c6f82a665c4c2b54a5;Sun Dec 30 04:56:17 EST 2007;Committer;nobu;2;16;6;22;0
e73a962a658029f40e51afa307204792af83692f;Sun Dec 30 02:06:48 EST 2007;Committer;naruse;1;1;1;2;0
6c2849dd46f77c6bf898e071ba635de1b48652e2;Sun Dec 30 02:00:59 EST 2007;Committer;naruse;5;21;11;32;0
7c1cab2a4f0322cfe37983ffb9ec620ad0b3002f;Sat Dec 29 21:34:15 EST 2007;Committer;usa;3;12;1;13;0
99a24e9e156c533f8b80353e9eaaf520baacf30b;Sat Dec 29 21:28:53 EST 2007;Committer;usa;2;9;0;9;0
f80bb164ce5ad1f4344e1d9c96a82466e13facca;Sat Dec 29 19:22:14 EST 2007;Committer;akr;1;6;6;12;0
7c8e5e2f655f7185e4480ce12f3f21a537b4fe8b;Sat Dec 29 18:50:49 EST 2007;Committer;usa;1;3;3;6;0
77dece6e63bd8a572c828dbd12d20530d75ff5d6;Sat Dec 29 18:39:43 EST 2007;Committer;akr;1;4;1;5;0
1644d3f073ab1c2709d7379a1833ef90328430ba;Sat Dec 29 16:43:59 EST 2007;Committer;nobu;2;9;3;12;0
32fe1ecdbc263d04cf6fff9edb99a6f9b7616d89;Sat Dec 29 14:52:32 EST 2007;Committer;akr;1;1;1;2;0
fffd379d4459a2022eb4a208e46a034d4620dea3;Sat Dec 29 14:49:11 EST 2007;Committer;akr;2;6;8;14;0
5ee7f4b0b5a015ae31bffe1b11723c9fce272866;Sat Dec 29 13:44:32 EST 2007;Committer;nobu;3;23;6;29;0
1b0ba5931ded52e16b24ea9ca8e466cd0aaed0fc;Sat Dec 29 12:54:40 EST 2007;Committer;nobu;2;8;3;11;0
26910f44bda52a57bf972113545f15320f9c3b7b;Sat Dec 29 04:31:50 EST 2007;Committer;akr;1;9;0;9;0
439e3880895826d18915ba77ca100ea696d708d6;Sat Dec 29 04:27:39 EST 2007;Committer;akr;2;21;0;21;0
5179e8a765768dedd49a5a4fa25c9433aa383370;Fri Dec 28 19:55:04 EST 2007;Committer;gotoyuzo;1;5;5;10;0
d356ccc9870a00b25fc44ff5815650578a4bcb68;Fri Dec 28 19:47:55 EST 2007;Committer;gotoyuzo;3;36;11;47;0
b3c2e224d35a09dc95451d2010b00ef3a6547189;Fri Dec 28 18:10:31 EST 2007;Committer;usa;2;5;2;7;0
57bb055c9334b2778b7a1b7469ce9be70f50bd4b;Fri Dec 28 17:20:24 EST 2007;Committer;usa;3;20;3;23;0
574b3297480dac8256ff3faaf02bdf61ab5e4623;Fri Dec 28 16:34:11 EST 2007;Committer;akr;1;0;1;1;0
b8a9eb304dccf584b003764a7f10f53893c33011;Fri Dec 28 16:13:43 EST 2007;Committer;akr;1;7;0;7;0
1c0416e6eed8fa11e02c406fca40c9c1f6f87450;Fri Dec 28 14:55:43 EST 2007;Committer;akr;4;31;9;40;0
f413b838141884fef9cff48891b9a494d2d8f3aa;Fri Dec 28 11:20:59 EST 2007;Committer;eban;2;6;0;6;0
eb1014e4aeb30b9ba18686d4c955cad7e0372108;Fri Dec 28 10:41:52 EST 2007;Committer;usa;4;20;35;55;0
b1b238da2c20e2312e1e802960feeda6b94b1ca5;Fri Dec 28 10:29:55 EST 2007;Committer;usa;2;8;3;11;0
371977ff3d76dda913442de13e7b71ab22c3ad4d;Fri Dec 28 10:12:13 EST 2007;Committer;akr;3;19;0;19;0
6b54d4fd0b582d6fb002f5f373b30f044de7cd53;Fri Dec 28 09:46:44 EST 2007;Committer;usa;2;25;1;26;0
793e9423cd4c4c679959b7dd011040b5aba2d169;Fri Dec 28 09:26:55 EST 2007;Committer;duerst;5;154;53;207;0
48af602e38293f53e7c9afa7b41ba778714220f4;Fri Dec 28 08:35:52 EST 2007;Committer;akr;2;17;16;33;0
727d85c0e359657ea0538c9d81de2f870d007120;Fri Dec 28 07:38:56 EST 2007;Committer;naruse;2;14;3;17;0
c43f86785288df9e39ebbe66235bea9824226e4a;Fri Dec 28 07:11:30 EST 2007;Committer;drbrain;4;272;274;546;0
ecb7eb6ba4a6f10ac9ff2e7531c9b12ac81646c5;Fri Dec 28 06:39:15 EST 2007;Committer;drbrain;5;60;58;118;0
cc54d01f8bcbffb2a66db767bbe3f367b86a78c5;Fri Dec 28 06:31:47 EST 2007;Committer;drbrain;1;0;2;2;0
4ddbd24eb3ef1ff78f082e4671279f7cfb069b5b;Fri Dec 28 06:30:37 EST 2007;Committer;drbrain;1;22;22;44;0
16ecc7c796026daaa29c507fbed25832e2268a6c;Fri Dec 28 06:20:07 EST 2007;Committer;knu;2;4;2;6;0
2a812650a8f315130224a27d6a0605962b75323f;Fri Dec 28 06:13:06 EST 2007;Committer;drbrain;6;659;658;1317;0
c3c58513d7ebb2c8396cf195b804bfc3e16e4871;Fri Dec 28 06:10:49 EST 2007;Committer;nobu;2;14;9;23;0
c48c31a528df1c9e2bf7e7b639a55b0836b4b322;Fri Dec 28 04:59:00 EST 2007;Committer;usa;2;5;4;9;0
7ad2d4cc9a4ef56aadc3823f938e7f77ced55765;Fri Dec 28 04:46:56 EST 2007;Committer;knu;2;7;2;9;0
9343a2deb3c72047d0aee1449d185d066ca89b44;Fri Dec 28 04:20:47 EST 2007;Committer;kou;5;37;16;53;0
0d7405b69fe5f39108ed665429737b3438f979c8;Fri Dec 28 04:07:33 EST 2007;Committer;nobu;2;7;1;8;0
76e845505a7a4e57152475097a521acda36fdcf0;Fri Dec 28 02:46:06 EST 2007;Committer;nobu;2;6;1;7;0
18ef0fef154fa8dd31f21a7f9693e455c5b2e704;Fri Dec 28 02:39:51 EST 2007;Committer;usa;2;6;1;7;0
ec12be85744493b78b6fc6ca299b10350a2592a1;Fri Dec 28 02:18:05 EST 2007;Committer;usa;2;10;0;10;0
f1ddd69d7bb8fa6af0f4306edea238fa97a2e941;Fri Dec 28 01:07:21 EST 2007;Committer;knu;2;10;0;10;0
3b83e10790dac26481242077ee51fc2187b8eefb;Thu Dec 27 16:55:06 EST 2007;Committer;nobu;2;32;11;43;0
b8f8c75579c31ef11697ff52dfe72a35d8bb5e9b;Thu Dec 27 16:47:58 EST 2007;Committer;usa;2;12;0;12;0
7ee205d1d1b273fa660ff35ce08544d5c3a3b9df;Thu Dec 27 16:28:45 EST 2007;Committer;akr;2;6;1;7;0
07c730fcbc3fa1e4cbb7ee0a78ed28d3204026dd;Thu Dec 27 15:30:30 EST 2007;Committer;nobu;1;1;1;2;0
3bcd7c418bdaf6132dffbef378490cefe97ca3a9;Thu Dec 27 15:03:14 EST 2007;Committer;usa;3;9;4;13;0
0e7eb0f84245c9a831bcbc4760e76d8916c71289;Thu Dec 27 14:56:04 EST 2007;Committer;nobu;2;7;1;8;0
7e4c66342d53841c11400fd7cb35898d6583a361;Thu Dec 27 14:43:39 EST 2007;Committer;nobu;1;5;0;5;0
992cc9469bbe92f97a95a32e09d5916428ebe980;Thu Dec 27 13:33:04 EST 2007;Committer;usa;2;10;5;15;0
f548ed48ebc85cc1b95d4b26ebc7c44c5138c8e9;Thu Dec 27 12:50:44 EST 2007;Committer;usa;1;2;1;3;0
e02f14addf1aea0928250e8660ca41389e4e5729;Thu Dec 27 12:48:34 EST 2007;Committer;usa;2;5;1;6;0
173f1e1563f5861de78b2bc4e43cd30ea19400c7;Thu Dec 27 08:58:03 EST 2007;Committer;akr;5;10;8;18;0
efd7504d44078af85a2ca6c632c18569bc562928;Thu Dec 27 08:27:19 EST 2007;Committer;akr;4;15;10;25;0
fd640aec82f65134d589d9603d0ed669e90ebb60;Thu Dec 27 07:38:23 EST 2007;Committer;akr;2;21;6;27;0
ce2b982cd2c839fa736375e7906057785f4f3738;Thu Dec 27 06:27:39 EST 2007;Committer;akr;4;11;5;16;0
cd2fd33edf4df972ea90b9e94a24866028247683;Thu Dec 27 06:19:09 EST 2007;Committer;akr;2;5;1;6;0
8bb84c92d4d78d72f9b7faab4fbd6e20f0cef2c1;Thu Dec 27 06:12:19 EST 2007;Committer;akr;2;7;1;8;0
6aef04f33827f18bf3e65eeae8bb2527ef0f4360;Thu Dec 27 06:02:55 EST 2007;Committer;nobu;2;6;1;7;0
fc9cc7440a44cfbb188f875e71095d7e49c22f51;Thu Dec 27 05:36:02 EST 2007;Committer;akr;2;19;8;27;0
5458a384eaa22b3427dc81a2c8e4c4599123e805;Thu Dec 27 01:47:11 EST 2007;Committer;matz;3;10;1;11;0
fc9a7983cfee35543b31d36f698d3b10ac9273ac;Wed Dec 26 17:32:22 EST 2007;Committer;usa;3;21;7;28;0
7ae8e804eda74c742fa2c7c8e7c5da5087d7b3be;Wed Dec 26 13:50:31 EST 2007;Committer;naruse;2;14;3;17;0
343a414ab0f946be19a4bd4935732b7164a4f94e;Wed Dec 26 12:29:20 EST 2007;Committer;tadf;2;65;28;93;0
b3e3c8a578bed04bb6ff3185fe9fb8971e8ee43d;Wed Dec 26 08:33:38 EST 2007;Committer;akr;2;7;1;8;0
c2d54ce2a035435683c9cfbbbba3a5a3fd148ed6;Wed Dec 26 07:10:20 EST 2007;Committer;nobu;2;5;0;5;0
7a0d1903d32d57543885929a22f5ead38feb00a8;Wed Dec 26 06:28:42 EST 2007;Committer;akr;1;1;1;2;0
af96c97cb19daf141ce674e454cd8e95c744d4b9;Wed Dec 26 05:39:03 EST 2007;Committer;usa;2;8;0;8;0
d8ad1e28e9401abec56288c4573dad01963bd2f3;Wed Dec 26 04:56:03 EST 2007;Committer;jeg2;2;10;10;20;0
0c48720b466b00e7187af8b2293e6576ec4d960f;Wed Dec 26 04:29:37 EST 2007;Committer;nobu;2;6;8;14;0
a3f722abef303678ec1926ba835fdefb6bd98b33;Wed Dec 26 03:49:10 EST 2007;Committer;akr;1;76;7;83;0
8ffd1eb2a4f725b0d785c0edaa7c06a8d77e0390;Wed Dec 26 03:07:08 EST 2007;Committer;akr;1;12;0;12;0
db5a25f3f37afeeaa9c3c1f793ea0c26b26cef82;Tue Dec 25 15:57:55 EST 2007;Committer;nobu;3;10;3;13;0
ce9df5d01e39cff95710974223232c67b4cb2bc1;Tue Dec 25 14:34:58 EST 2007;Committer;matz;1;4;0;4;0
23a8a5e78fa5e9a959155d1f0ab25695e0515cf9;Tue Dec 25 14:30:02 EST 2007;Committer;matz;2;7;1;8;0
1ffc06198e778d20fa8d9aefee43827c5c91865d;Tue Dec 25 14:19:55 EST 2007;Committer;matz;1;207;837;1044;0
14ab3bd2ac7a3dda443342354847b99d1967e73a;Tue Dec 25 14:16:03 EST 2007;Committer;nobu;2;12;8;20;0
70e01d72d875c5d68d3752622ac26e7e8cf150e3;Tue Dec 25 13:57:19 EST 2007;Committer;usa;2;5;1;6;0
d70a20a510b55074d16117479c3f448c0659b729;Tue Dec 25 13:55:45 EST 2007;Committer;nobu;2;5;1;6;0
dccf2b925597832f3534f3fdea707c7faf4d2bb9;Tue Dec 25 13:46:55 EST 2007;Committer;ko1;2;5;1;6;0
96b9744b3dab5bb9bbe5f53e2cb861a984b3e50e;Tue Dec 25 13:15:53 EST 2007;Committer;ko1;2;23;0;23;0
e037d72514d18deb383dffc8fc45e2fc681cfa75;Tue Dec 25 13:14:23 EST 2007;Committer;ko1;2;6;15;21;0
f64fc63cec6a9b9d55faa1fa2bef60efccc3a0dd;Tue Dec 25 12:44:52 EST 2007;Committer;nobu;2;10;4;14;0
633df8de16203da72dff1a010740fdf92f9f7f5c;Tue Dec 25 12:37:16 EST 2007;Committer;ko1;4;64;28;92;0
904b278f94d9d18fef50adce79aec0756496a773;Tue Dec 25 12:34:21 EST 2007;Committer;akr;2;30;9;39;0
d050e46b8ca92b26587f847b3950dd642d6ba666;Tue Dec 25 12:26:11 EST 2007;Committer;nobu;3;28;2;30;0
42643e482e1c58cd353d88d0c317d091df80cd3d;Tue Dec 25 11:31:51 EST 2007;Committer;technorama;3;30;1;31;0
a99c3a6e9d0ff69e08602061d7a24b3a2ffbe424;Tue Dec 25 11:24:50 EST 2007;Committer;nobu;2;9;0;9;0
7847c1b860cd634aa88e15ee5b7a81e3a8eb182c;Tue Dec 25 11:14:38 EST 2007;Committer;eban;2;5;1;6;0
b2258b6482dda5d30d85d49900cc7612f6ca2f73;Tue Dec 25 11:03:28 EST 2007;Committer;nobu;1;1;1;2;0
0ee5a49dd4ffbbb285c25fa6cba88370ce96ed3e;Tue Dec 25 10:01:06 EST 2007;Committer;nobu;4;21;8;29;0
3878b30881f46dab1458e70eaa6272dcff636518;Tue Dec 25 09:52:52 EST 2007;Committer;matz;4;31;38;69;0
36df55c6e4dff444d92eb5c44d2ecb65567427e6;Tue Dec 25 09:43:23 EST 2007;Committer;ko1;3;18;2;20;0
305c42739f9896602400bca08b48ae1de978d99e;Tue Dec 25 09:39:10 EST 2007;Committer;akr;1;24;0;24;0
0eb5c917e06561a0ce8957702d21c93ec803216f;Tue Dec 25 09:28:31 EST 2007;Committer;akr;2;6;1;7;0
ead329fd8ea6f0ecf11c6ec98e073eed6fe2810c;Tue Dec 25 09:07:32 EST 2007;Committer;akr;3;13;2;15;0
8e4c6d848216495cf4ddde1aae52f9ac3c0c0801;Tue Dec 25 08:49:09 EST 2007;Committer;shugo;3;12;0;12;0
c40d4252ce6b7332f270d21c562e5fef181de79f;Tue Dec 25 08:37:13 EST 2007;Committer;knu;2;7;1;8;0
7489c4d93e48a22b7af3599165d09125868e368a;Tue Dec 25 07:51:10 EST 2007;Committer;nobu;2;9;4;13;0
eadfbddd93caa870c062de5527b4789907d323f7;Tue Dec 25 07:42:53 EST 2007;Committer;usa;2;8;0;8;0
c90dbedbb1dab110596bad9d255bc61a86b89eb0;Tue Dec 25 07:37:15 EST 2007;Committer;nobu;2;5;1;6;0
47aa40cd55fa484b643559a25c27e77e209b5a6c;Tue Dec 25 07:35:47 EST 2007;Committer;usa;2;8;4;12;0
b79c8682960eef9d78a9c6e9c34dc966951bf45e;Tue Dec 25 07:28:51 EST 2007;Committer;ko1;4;17;10;27;0
ed7b25a85436cff446779f580e859da94cd4d9d8;Tue Dec 25 07:27:15 EST 2007;Committer;akr;1;10;0;10;0
9b0bba0e37483df6a4efe04e0681da189e6784fa;Tue Dec 25 07:18:44 EST 2007;Committer;nobu;1;1;1;2;0
84d6f71195f3974778ab9bba2de4ef1a07b19185;Tue Dec 25 07:15:18 EST 2007;Committer;nobu;2;12;1;13;0
4496da18a81b828fed293b1ab6645b6fac9be67d;Tue Dec 25 07:04:30 EST 2007;Committer;nobu;6;40;3;43;0
319bcad626335292723e1b1d668c56e1fa5d8fb8;Tue Dec 25 07:01:35 EST 2007;Committer;matz;1;4;4;8;0
75e4572768e5ae53f935d2899c08c8db9fc1bb36;Tue Dec 25 06:59:53 EST 2007;Committer;nobu;2;6;2;8;0
f1fc4bbecbc0a40d27a817187ea435b64160c507;Tue Dec 25 06:55:16 EST 2007;Committer;nobu;2;5;4;9;0
72bf77fb30fbc97e9dcbfe50d0f62f2f40c93ae3;Tue Dec 25 06:44:58 EST 2007;Committer;matz;2;11;0;11;0
9f98c9a9c2e6d25787e3d935f3724a31e2ea429a;Tue Dec 25 06:38:00 EST 2007;Committer;akr;2;10;0;10;0
f46baadb5698d650565a2f0828c8aa922da1e453;Tue Dec 25 06:22:27 EST 2007;Committer;matz;2;4;2;6;0
3e65d11090c5f4f3b87701ed39c8e3cc63e627d0;Tue Dec 25 06:21:35 EST 2007;Committer;nobu;2;8;2;10;0
ec579454bb3a9b4461021949ad2e621ec9e2a75b;Tue Dec 25 06:09:05 EST 2007;Committer;usa;2;5;1;6;0
54cf2fca17f6252b7144ed9ed0118fae95d8bafa;Tue Dec 25 06:01:22 EST 2007;Committer;matz;3;66;44;110;0
b7db9036beece0e278aae5fd48f689ebca86e9ca;Tue Dec 25 05:57:04 EST 2007;Committer;nobu;8;27025;26841;53866;0
df914b2fefa13400926c262408502923b90b249d;Tue Dec 25 05:37:25 EST 2007;Committer;matz;1;1;1;2;0
73b8faf7b93b72e3651152c46f7d42e33fc74fe2;Tue Dec 25 05:21:39 EST 2007;Committer;matz;2;5;1;6;0
a2443bdcf9f0c57c6623524fa5f85cd0d3a8ed29;Tue Dec 25 05:14:04 EST 2007;Committer;jeg2;5;21;10;31;0
33a071016b312561e74470441bc512a13a9bf1d1;Tue Dec 25 05:11:59 EST 2007;Committer;nobu;2;7;1;8;0
34c6bca38177e32f24c97e85494162b6d782401a;Tue Dec 25 05:08:04 EST 2007;Committer;naruse;2;9;3;12;0
ba852066351c147cf1010607b1f8195dda825b08;Tue Dec 25 04:54:49 EST 2007;Committer;akr;2;6;1;7;0
884f1eed2c4cebe4c0658b71ecef7a3ce3ae60d1;Tue Dec 25 04:47:47 EST 2007;Committer;ko1;2;5;1;6;0
42f0b52f771570adebbea518fa2464bd227bca99;Tue Dec 25 04:35:17 EST 2007;Committer;ko1;5;51;44;95;0
f3945617bd2ed8f4282bc21023f0aea1aa166654;Tue Dec 25 04:24:21 EST 2007;Committer;akr;2;7;2;9;0
3410fd681259e17432ec632327a85fc8eaaca8d8;Tue Dec 25 04:17:06 EST 2007;Committer;matz;10;52;47;99;0
5f0b8afb97d7830de8f04a7d6a39cde660020c69;Tue Dec 25 04:16:06 EST 2007;Committer;ko1;7;50;15;65;0
94c942ed34e328f23c3d3316b4bf66ecfda8bf8a;Tue Dec 25 03:45:29 EST 2007;Committer;ko1;1;1;0;1;0
b90e7414ceb911bc714389294164418528ab90b9;Tue Dec 25 03:44:53 EST 2007;Committer;ko1;2;4;2;6;0
e7ac333ba841e774911eac23ffb680ab3de7a993;Tue Dec 25 03:33:23 EST 2007;Committer;duerst;2;26;20;46;0
520d763d777721fd82bac7cea574e3f136efe91f;Tue Dec 25 03:24:50 EST 2007;Committer;matz;2;5;1;6;0
f2c33914aadc40094be33ea40bdfb369a6d92f8b;Tue Dec 25 03:23:15 EST 2007;Committer;naruse;2;92;73;165;0
d7f9d3bfa66fe56d525fe4f9583af99b33f882cf;Tue Dec 25 03:07:55 EST 2007;Committer;nobu;2;5;1;6;0
3a067a52788c18be1c74649ba3b2010b3ef19fdc;Tue Dec 25 02:57:15 EST 2007;Committer;matz;6;5;90;95;0
29ba327bd16fd7eb7114050724e4784bdcaac83a;Tue Dec 25 02:46:26 EST 2007;Committer;jeg2;13;3946;0;3946;0
0d570142ba2b7488804729b3cc1a9b4d87db1014;Tue Dec 25 02:37:40 EST 2007;Committer;nobu;1;1;1;2;0
81a68908cdefd6b399e9cb012c58fcf71c3f700d;Tue Dec 25 02:33:54 EST 2007;Committer;nobu;2;7;4;11;0
1af43d329fe797e4ac74feeff95c742eb7953338;Tue Dec 25 02:24:12 EST 2007;Committer;ko1;3;31;1;32;0
bfc19ade2e824dd549868d601b2c688f6ad928c5;Tue Dec 25 02:17:16 EST 2007;Committer;ko1;3;18;9;27;0
b40dbc304efe8297d7dbe10d6781c7608a651934;Tue Dec 25 02:14:36 EST 2007;Committer;ko1;3;53;1;54;0
29962f8fb6687010e005cbf311a791e4eafb2eae;Tue Dec 25 00:13:12 EST 2007;Committer;drbrain;5;32;28;60;0
951200ac639980c1d1d8d836c4badfa889f0ccbb;Mon Dec 24 23:41:06 EST 2007;Committer;jeg2;3;7;2727;2734;0
9ca563978e31b308f0e19fea597188a6495e2a7c;Mon Dec 24 23:28:35 EST 2007;Committer;drbrain;3;17;3;20;0
7ad94af99b237460eb86e0de5828ed9f45f561b2;Mon Dec 24 21:26:02 EST 2007;Committer;ko1;3;12;6;18;0
a560576158af1f502083a5f6e7bc496f336ce275;Mon Dec 24 21:21:16 EST 2007;Committer;gotoyuzo;2;44;75;119;0
a79ce52e085e3c61250ee817ba8b2d1df81e779b;Mon Dec 24 21:18:47 EST 2007;Committer;ko1;2;17;20;37;0
2b402d824344b011fe95783000465098104cc2ab;Mon Dec 24 20:47:11 EST 2007;Committer;drbrain;3;9;15;24;0
479568e5c14c6e62e09286fdd7e10f54f9bdbd14;Mon Dec 24 20:28:31 EST 2007;Committer;ko1;1;1;1;2;0
95ca3f72a8a72126ab412f5c58fd2c8f6e03bbed;Mon Dec 24 20:27:10 EST 2007;Committer;ko1;3;18;3;21;0
c94a89a739f32e9fcf64e2170b973717242090e3;Mon Dec 24 19:25:45 EST 2007;Committer;akr;2;19;4;23;0
edb8eee2365b8a1bdbaf72a50cdc4d8adf24c495;Mon Dec 24 19:03:09 EST 2007;Committer;akr;1;6;0;6;0
e885517639c2bc1eacedfffe68679c4882b2fa5f;Mon Dec 24 18:54:52 EST 2007;Committer;ko1;3;15;1;16;0
cf41125e3ab4a26292b718192ea717e873dbe684;Mon Dec 24 18:36:30 EST 2007;Committer;akr;1;5;0;5;0
efd4bbde49ff239681b174a0ec68d393bb992676;Mon Dec 24 18:24:15 EST 2007;Committer;eban;2;5;1;6;0
29595e23d711f5b96350759a6b474233b5ee00df;Mon Dec 24 18:17:35 EST 2007;Committer;matz;2;92;22;114;0
e3215a73423bdfca2ee2a2cae45a616296f0f605;Mon Dec 24 18:12:24 EST 2007;Committer;usa;4;17;8;25;0
8f5b0a4cd4decba7a56d1acb9601db47d2935ec0;Mon Dec 24 17:59:31 EST 2007;Committer;gotoyuzo;2;7;2;9;0
105e00bdd797fa6699919e3d34edf57428be3c6e;Mon Dec 24 17:41:29 EST 2007;Committer;ko1;4;29;9;38;0
fda0ef6f04fb7cb164bb4409734a1506fd257d78;Mon Dec 24 17:05:38 EST 2007;Committer;matz;5;8;11;19;0
8db7c837f9bf69ca0264190f36e78cd5d6b12f84;Mon Dec 24 16:44:39 EST 2007;Committer;akr;2;9;0;9;0
6ca558d6ab8e2553b32a415537c484bffd9b189c;Mon Dec 24 16:38:44 EST 2007;Committer;matz;8;17;13;30;0
a04a812ed0aa7424ea1f40756402d1f199a43308;Mon Dec 24 16:36:14 EST 2007;Committer;matz;6;80;35;115;0
13e239a0120deefd6f2e60345796e282a78ace29;Mon Dec 24 16:12:05 EST 2007;Committer;akr;1;2;1;3;0
027c45a1c7f272234962b3591902d6f0c5766ce1;Mon Dec 24 16:09:31 EST 2007;Committer;akr;2;10;5;15;0
6c9d911423caeb6823dd46ba56072db81beab02b;Mon Dec 24 15:30:02 EST 2007;Committer;gotoyuzo;2;6;1;7;0
71787f8ec2704a0559a8de8e91054f31e8444b3b;Mon Dec 24 15:19:44 EST 2007;Committer;akr;1;9;0;9;0
78fd550840f539125f8b304b97631a690c554173;Mon Dec 24 14:59:34 EST 2007;Committer;akr;2;19;10;29;0
f9b894273fe203f0ee262932c7307a7da1b67272;Mon Dec 24 14:35:41 EST 2007;Committer;gotoyuzo;1;1;1;2;0
0f064d27b3ab4e4bee96c19313c6fe1480972f24;Mon Dec 24 14:34:51 EST 2007;Committer;usa;2;5;1;6;0
0c395fbd904ccc5cb100e6654af7c771f1123e41;Mon Dec 24 14:15:45 EST 2007;Committer;gotoyuzo;2;6;1;7;0
101929732344e023cebbe3e6edf3d08276bdac5b;Mon Dec 24 14:09:57 EST 2007;Committer;nahi;10;20;352;372;0
ce0aa0af9107018bd5d7fcfe4fc5b27da1896342;Mon Dec 24 14:04:16 EST 2007;Committer;akr;2;6;2;8;0
c5f5173d1744d5bfbf6a917f005944290dbc75e7;Mon Dec 24 14:02:09 EST 2007;Committer;nahi;1;1;1;2;0
be86e3de339e31d532bd40233458c4ca30e0a418;Mon Dec 24 13:51:19 EST 2007;Committer;naruse;4;322;19;341;0
f23bc6b2b5228f39a55d798079fe0db514695ba6;Mon Dec 24 11:36:48 EST 2007;Committer;akr;1;37;0;37;0
9c09689301fd6bddbb5a9397a6854fef35a224ae;Mon Dec 24 11:30:29 EST 2007;Committer;ko1;2;5;2;7;0
7d6d35394bfb06309e2f58c2e73df38021ddd61e;Mon Dec 24 11:25:32 EST 2007;Committer;ko1;2;14;0;14;0
0bdcb32cd3c75a01f40d46ccca3f665d47c09172;Mon Dec 24 11:19:46 EST 2007;Committer;ko1;2;4;9;13;0
d12d33f0e50673b21b0c87dd05ed91b85458d3d0;Mon Dec 24 11:18:16 EST 2007;Committer;ko1;2;5;1;6;0
d0e61300311c03c849be3566fd799af383ab6bfd;Mon Dec 24 11:06:49 EST 2007;Committer;akr;1;15;0;15;0
23f0e341af6bca062b95fa9bc69b2fa59f903e05;Mon Dec 24 10:27:53 EST 2007;Committer;akr;1;20;1;21;0
b132f72b3f457fae0507996879f00764c0965d4d;Mon Dec 24 10:22:34 EST 2007;Committer;akr;1;81;0;81;0
dc980095ec093004dc6102252f1d255f64bbd7c6;Mon Dec 24 09:53:08 EST 2007;Committer;akr;1;7;0;7;0
b910bb7761373464a884e9c21c2897247aeffa78;Mon Dec 24 09:38:20 EST 2007;Committer;akr;2;8;1;9;0
96438d2bd8e209d176b42caecbc951766496a42d;Mon Dec 24 09:25:27 EST 2007;Committer;akr;3;16;11;27;0
e2e23e688fd655c55112872b10a7bd6840314653;Mon Dec 24 09:09:21 EST 2007;Committer;ko1;3;47;6;53;0
c332266ee0d026340e369c9b67d01837ba2ed2e4;Mon Dec 24 09:07:20 EST 2007;Committer;akr;3;17;3;20;0
97cdb5ac25ddcf0e7664867f39ccaccc4d139c0e;Mon Dec 24 08:59:31 EST 2007;Committer;nobu;3;10;2;12;0
162cc94d15683be9b45bb70b40cfdb3f040b74e2;Mon Dec 24 08:57:09 EST 2007;Committer;akr;1;14;5;19;0
dc18845c23d74519d69257dfd695bb7eb5197250;Mon Dec 24 08:51:38 EST 2007;Committer;akr;2;6;3;9;0
0beb35a75c84c3667494219a5a0091516adaf2d4;Mon Dec 24 08:40:59 EST 2007;Committer;nobu;2;8;3;11;0
bca0b4075d53194b09ed5edef95d9ba9c3f6e62a;Mon Dec 24 08:23:09 EST 2007;Committer;nahi;4;5;276;281;0
30f1eb1856eae8b310fe6440dfcab95b6fe76046;Mon Dec 24 08:19:28 EST 2007;Committer;akr;4;26;6;32;0
889c7de09d40ebdd3620cf9c0ad74d750b512221;Mon Dec 24 08:14:57 EST 2007;Committer;nahi;236;5;30253;30258;0
efed292c4311c8c182a32ac2afe70c6969815b2d;Mon Dec 24 08:06:16 EST 2007;Committer;nobu;4;69;22;91;0
68a66351a73b8801968262bdfa96a447ee4d1503;Mon Dec 24 07:53:50 EST 2007;Committer;nobu;3;22;16;38;0
e01c045a8b97de161ca74ddf417a58bb5b1e9424;Mon Dec 24 07:52:39 EST 2007;Committer;akr;5;20;24;44;0
a3bfedac36e946790c966c0319765479df770e4b;Mon Dec 24 07:31:23 EST 2007;Committer;gotoyuzo;8;53;947;1000;0
8fd40444465a6165f08490269f8e0b142edc2824;Mon Dec 24 07:20:56 EST 2007;Committer;ko1;2;5;1;6;0
835c8d9d48683192784a00a811fdb8fd39bce02d;Mon Dec 24 07:06:03 EST 2007;Committer;ko1;4;4;84;88;0
e5988f74040f8b073a1e315053801023cb957774;Mon Dec 24 06:56:06 EST 2007;Committer;akr;1;6;2;8;0
1c3c98821b6e0e7ba216b5e0f89256af84449fe5;Mon Dec 24 06:42:06 EST 2007;Committer;nobu;7;46;38;84;0
29cbf75cd0391fc9f4f466cea7bc592fe3434d0a;Mon Dec 24 06:29:43 EST 2007;Committer;akr;2;4;17;21;0
4542f21a429f05b7c290896248fed9b714f9f9f8;Mon Dec 24 04:55:37 EST 2007;Committer;nobu;4;14;10;24;0
75212993250d84b04bae19689ddeb5c12e4e23b8;Mon Dec 24 04:43:38 EST 2007;Committer;nobu;2;7;3;10;0
8d292a08dfb79ec9a55673eb570f1c5128cc47ec;Mon Dec 24 03:49:56 EST 2007;Committer;nobu;11;126;82;208;0
7c45c615819e9d8bb8fb947ec972e48cd45d561d;Mon Dec 24 03:35:06 EST 2007;Committer;nobu;3;6;2;8;0
82a73f0aa0611c37a16b8bb6f20399e9d0d5642c;Mon Dec 24 03:11:30 EST 2007;Committer;drbrain;1;5;0;5;0
67d3013c5a40362a1fdf4b33489ce3247d11e835;Mon Dec 24 02:56:33 EST 2007;Committer;nobu;5;23;8;31;0
836a01c51069ab741e304dadcb0f233f763a59bd;Mon Dec 24 02:44:13 EST 2007;Committer;drbrain;1;3;3;6;0
37855698ffd3ae3080304f08b0ec75df68ba0c8b;Mon Dec 24 02:40:55 EST 2007;Committer;matz;3;20;6;26;0
7c92ab16a9d911e61cccb8c030956bd3354238e4;Mon Dec 24 02:25:39 EST 2007;Committer;drbrain;3;50;20;70;0
a350a39c979930cedaa165749e12abf12e98e689;Mon Dec 24 01:51:49 EST 2007;Committer;drbrain;3;23;19;42;0
d0c819cf94451d6df95de6c2ace76d2cac41b7ba;Mon Dec 24 01:38:43 EST 2007;Committer;drbrain;2;11;2;13;0
e2630984e947f89a7ce198c60256fffc3b64cabd;Mon Dec 24 01:09:37 EST 2007;Committer;akr;1;11;0;11;0
c806d3f53f65b9dc43bfc4636f047b7a86757246;Mon Dec 24 00:55:36 EST 2007;Committer;akr;1;8;0;8;0
9c7718ac6b7b91d2613a02b8630b2916abf67f2f;Mon Dec 24 00:47:21 EST 2007;Committer;duerst;4;105;100;205;0
888a89153a11913e26774d7b9293512a4706629e;Sun Dec 23 23:57:14 EST 2007;Committer;akr;1;34;0;34;0
0fbe6b5da14ebc86846eae596ef0271ff777c2d7;Sun Dec 23 21:37:28 EST 2007;Committer;matz;2;7;4;11;0
161ed7c0dcc5afbd10a3bffb49f20ae294e35d31;Sun Dec 23 21:33:45 EST 2007;Committer;matz;1;2;2;4;0
983f40b9d2872d116e9b0a1c27b0080e71f3dfec;Sun Dec 23 21:01:25 EST 2007;Committer;matz;2;39;37;76;0
9bfdc4e736d60e98e2974bc25919fe56301459ac;Sun Dec 23 20:35:12 EST 2007;Committer;matz;2;8;3;11;0
19cf57f21ca8e838c78caa2d19d9da36569cc929;Sun Dec 23 20:13:55 EST 2007;Committer;matz;3;11;13;24;0
c749064f9f250d79db6ada0fe7f1f0784c183baa;Sun Dec 23 19:55:18 EST 2007;Committer;matz;3;23;11;34;0
b4f2e2ba074fb8eb689769ca4623eedcc265092c;Sun Dec 23 19:29:01 EST 2007;Committer;matz;2;4;2;6;0
b487d9459d6a7c2d64f496b3fc808fab571db2ab;Sun Dec 23 19:15:48 EST 2007;Committer;akr;1;11;0;11;0
e963ff1e987430e4979c9a62ccb639cc977e0689;Sun Dec 23 19:05:39 EST 2007;Committer;gotoyuzo;2;7;3;10;0
9f34b73009e9454e885378483d503b9466bac231;Sun Dec 23 19:03:23 EST 2007;Committer;ko1;3;9;6;15;0
3f623cfba1efdd0fdd4c11cf16734fd00c1a6579;Sun Dec 23 19:00:03 EST 2007;Committer;akr;1;1;1;2;0
65a0050268aadcfb4edd936ec3bac21e6944e95e;Sun Dec 23 18:58:09 EST 2007;Committer;matz;2;4;1;5;0
924f5f0f10b21970c154729b91354d965ff4b953;Sun Dec 23 18:54:22 EST 2007;Committer;akr;1;214;172;386;0
f03abbce93f27abc129b20a8fce015f6880e3985;Sun Dec 23 18:41:17 EST 2007;Committer;ko1;2;6;2;8;0
6604434cd6456cd8958c66ca03929f94d1fd2ffb;Sun Dec 23 18:22:59 EST 2007;Committer;akr;1;42;0;42;0
459ca7f3f01c72f001e9da484e8883ded0beeacc;Sun Dec 23 18:12:44 EST 2007;Committer;matz;2;13;4;17;0
7ea8ec5483f4a79e411b9813fc6347040bb4c55d;Sun Dec 23 18:01:16 EST 2007;Committer;matz;2;26;10;36;0
5f9748deb7b934d3ba150ea3184cb1006a7dc9fd;Sun Dec 23 17:38:32 EST 2007;Committer;matz;2;10;1;11;0
7e237b9813192265ee25bc43406c772ce65ff5ad;Sun Dec 23 17:31:32 EST 2007;Committer;akr;1;2;0;2;0
648cd42f776c349a26200c916bac2ae83ab7a5d6;Sun Dec 23 17:13:07 EST 2007;Committer;matz;2;35;6;41;0
df1312e2dbf6a1edb28195b307e5937eba0b20ab;Sun Dec 23 17:12:57 EST 2007;Committer;akr;1;3;2;5;0
751bb53a4b5c3ca524b8203951e2332f0a38c838;Sun Dec 23 17:05:40 EST 2007;Committer;akr;1;37;29;66;0
93444eea15d4bc3d7c09ceb87a663dca8718f51c;Sun Dec 23 16:48:28 EST 2007;Committer;matz;2;39;20;59;0
f5512ba7a3432aec693326ac0d49a07009c8cdd1;Sun Dec 23 16:35:43 EST 2007;Committer;akr;1;47;9;56;0
4b45ef7ba32455b4d61dbc1777ef79637c88380b;Sun Dec 23 16:25:49 EST 2007;Committer;akr;1;7;5;12;0
8fb23913ad3f9fadafcf42b719d4b6afef0ef880;Sun Dec 23 16:10:36 EST 2007;Committer;akr;1;122;4;126;0
fa1e530063ca4a825fc1a0e75151bac57ea2e5ae;Sun Dec 23 16:07:09 EST 2007;Committer;matz;2;13;6;19;0
61ea3fd50d50f2d7bc5f124cda2b6bd8239fcfc1;Sun Dec 23 16:02:46 EST 2007;Committer;matz;2;101;18;119;0
2e791ace7fae64683088e1e1e1905cdab974bf54;Sun Dec 23 15:56:41 EST 2007;Committer;matz;3;82;54;136;0
53e0672c4e95399bde7c42bfd79ed6bda628cc0b;Sun Dec 23 15:48:39 EST 2007;Committer;matz;4;20;14;34;0
e8b7ad0f5c93edb90f3eed38ce3ec91d3d34df84;Sun Dec 23 15:43:00 EST 2007;Committer;akr;1;4;4;8;0
cd047935e48ec48503e7e24001630cb5536578fb;Sun Dec 23 15:39:09 EST 2007;Committer;akr;1;5;4;9;0
e615f0ec428777b29846da515763fe6ccbac9f13;Sun Dec 23 15:36:00 EST 2007;Committer;akr;1;24;0;24;0
80e38ad66bfe60cece2e274410c6d03d35911965;Sun Dec 23 15:19:23 EST 2007;Committer;akr;1;4;4;8;0
c534670da1fc7d6ba66fb74b41caebd90ac188c6;Sun Dec 23 15:06:14 EST 2007;Committer;akr;2;22;8;30;0
cf36df97fb74f60b321fe5617b3805078393c028;Sun Dec 23 14:06:00 EST 2007;Committer;akr;4;173;66;239;0
40a6b594100fb75a2dbd3d2e205142779e1283ce;Sun Dec 23 11:16:34 EST 2007;Committer;akr;1;38;21;59;0
6b5a2b2f06a72bf67081040c263dadf485601ee8;Sun Dec 23 10:48:54 EST 2007;Committer;akr;2;15;1;16;0
5d592124f5700a762fc9a153031c786bb739f58d;Sun Dec 23 10:35:58 EST 2007;Committer;drbrain;2;7;0;7;0
03a1e25542345e6e4b40864a27d62d11df700047;Sun Dec 23 09:37:51 EST 2007;Committer;naruse;5;107;85;192;0
6c6f996d71d45a16adc50e768034dbb3971a2586;Sun Dec 23 09:07:17 EST 2007;Committer;drbrain;2;7;3;10;0
057d7369f97d3e0cd31c996ccb9cf18ef941f3ff;Sun Dec 23 08:55:30 EST 2007;Committer;akr;1;1;1;2;0
090b9a4f7deaa0918cfe9b3e5e8dba71c9294a4c;Sun Dec 23 08:40:37 EST 2007;Committer;akr;2;5;0;5;0
4dd61ce6c7231bc7aa77b51b129f48dbf06862cc;Sun Dec 23 08:03:52 EST 2007;Committer;akr;2;6;1;7;0
edfcee2bd203195d08f476f3d3274941c5c2f318;Sun Dec 23 07:13:09 EST 2007;Committer;drbrain;6;15;11;26;0
0ef8ed93bcd7d0e073e0e2f28ada279471155100;Sun Dec 23 06:57:52 EST 2007;Committer;akr;1;16;0;16;0
ed9690bba519982b694d03cdce536a3c5bcaf774;Sun Dec 23 06:34:28 EST 2007;Committer;drbrain;7;24;17;41;0
1777eaa523e48fa8023b0ab23e83f2c3187e62c5;Sun Dec 23 05:45:11 EST 2007;Committer;drbrain;2;18;5;23;0
e3897c538c27cf6c302972ee47f034ce909f0f45;Sun Dec 23 02:26:45 EST 2007;Committer;nobu;4;19;13;32;0
64bc558cc5fe5f19ff47ce0715e3ddd557206eac;Sun Dec 23 02:22:27 EST 2007;Committer;akr;1;7;1;8;0
a3c87a785996e6c735522cb750d805be887cba98;Sun Dec 23 02:01:34 EST 2007;Committer;nobu;2;8;2;10;0
a072f94fbe5e0a5635cd7f82ca0d39e1abf7bacd;Sun Dec 23 01:36:54 EST 2007;Committer;akr;1;9;1;10;0
4ef8764fef56fbe6a1a0e6da0ac62889f8893186;Sun Dec 23 01:23:39 EST 2007;Committer;duerst;3;1373;5218;6591;0
a84103ce6028448295d2f0dd9e0f0c3ca976ee1a;Sun Dec 23 00:15:23 EST 2007;Committer;akr;1;6;0;6;0
38c303bb5257a0ff811a2d9256f9ed32b8a30b06;Sun Dec 23 00:07:24 EST 2007;Committer;akr;2;4;4;8;0
5b809a28f825015661e7f51f0ecb5ecdfa7b77bd;Sat Dec 22 23:47:18 EST 2007;Committer;akr;9;21;14;35;0
cd42707d86eca75e22d7ac8053a0981ed8b1a90f;Sat Dec 22 18:35:53 EST 2007;Committer;nobu;3;43;40;83;0
872899fa5833fbe193e533c496672ef836095bc7;Sat Dec 22 18:26:50 EST 2007;Committer;nobu;5;9;2;11;0
c892851a25b58b10f71edf8abdfda4be6ef37012;Sat Dec 22 18:22:43 EST 2007;Committer;nobu;2;13;6;19;0
c4bdd0f1ef95a14cb89fee15a5cd3c4ac7e49047;Sat Dec 22 18:19:14 EST 2007;Committer;nobu;2;6;2;8;0
e8a71bc8539a71a836036ba9df195b06638c196f;Sat Dec 22 17:28:20 EST 2007;Committer;matz;3;31;26;57;0
b83cbb0c7c873fc3c09a77019ff72f1a9a8d5837;Sat Dec 22 16:21:09 EST 2007;Committer;davidflanagan;3;72;8;80;0
018bdcadac41c61445255025f1d0f7bf6afc60b0;Sat Dec 22 15:50:43 EST 2007;Committer;shugo;5;220;0;220;0
5b1d121bfaa8657054fc61b48ca2065c925ad927;Sat Dec 22 15:24:23 EST 2007;Committer;akr;1;10;4;14;0
444a19fe440abdf6d012acf548c2ee60878fed2e;Sat Dec 22 14:48:39 EST 2007;Committer;akr;1;33;37;70;0
9a602ab932e02af41bb5688a379e20b819078ddf;Sat Dec 22 12:28:22 EST 2007;Committer;matz;1;38;0;38;0
2329ba0d93c0393eb44ca00ed23f4f1d588a199b;Sat Dec 22 12:14:37 EST 2007;Committer;matz;3;8;40;48;0
020fd204f8063816301f31260dc00d8e91103d97;Sat Dec 22 10:54:02 EST 2007;Committer;ko1;2;5;1;6;0
fc5c62bef79c1d09606ba0e012d7a66e64d14270;Sat Dec 22 10:19:27 EST 2007;Committer;ko1;5;4;86;90;0
de1dbf48294c9d83049e8a398375001fd512bf81;Sat Dec 22 10:16:39 EST 2007;Committer;ko1;2;5;1;6;0
a95ae9619f4e3e831d50de1c545bc226f70c4ef0;Sat Dec 22 09:52:00 EST 2007;Committer;duerst;2;51;32;83;0
d9c407981cd76f93840bd42e391135b4fbb4ae96;Sat Dec 22 09:21:38 EST 2007;Committer;usa;2;5;1;6;0
a745e619d2c1f0b6dc5fe708dd8f7f95a7e98315;Sat Dec 22 08:49:28 EST 2007;Committer;naruse;2;7;1;8;0
bc0963a204493687243d24737215ad8819d2212b;Sat Dec 22 08:39:26 EST 2007;Committer;usa;2;5;5;10;0
b2a1dc616c9af33fc81b02dca617c4ce7c48b923;Sat Dec 22 08:38:53 EST 2007;Committer;akr;1;22;2;24;0
573bd7500b2e845949ccffa2ae7d2077ddfa489f;Sat Dec 22 08:36:30 EST 2007;Committer;naruse;4;149;165;314;0
eff45d2cc8a7a2fe51b04bd1c05496dbdb499a9a;Sat Dec 22 08:32:53 EST 2007;Committer;usa;2;5;1;6;0
40aa32a0d7ce7a651a610cc69cced23319a11cd5;Sat Dec 22 08:31:53 EST 2007;Committer;gotoyuzo;7;52;35;87;0
0fc7dfedd3101125d2ad823f76454b48e48a0e05;Sat Dec 22 08:11:47 EST 2007;Committer;akr;1;101;0;101;0
e875cfa1fedca6826c55b4d62f6860c933427cf7;Sat Dec 22 08:00:04 EST 2007;Committer;shugo;3;14;6;20;0
3ee72c86efef9d63f49c7513cf8b11c87be5b0eb;Sat Dec 22 07:29:01 EST 2007;Committer;shugo;1;8;8;16;0
fa3d06c738ba0665e8e3cd472a42552fdd999720;Sat Dec 22 07:14:07 EST 2007;Committer;akr;1;1;1;2;0
05ac036933db57f08e04bf617e4c2adf13876371;Sat Dec 22 06:57:26 EST 2007;Committer;usa;2;5;1;6;0
54f273406969c3a47671bac197945d839492a3e0;Sat Dec 22 06:54:26 EST 2007;Committer;duerst;1;14;0;14;0
5ad8c5566d77be1d7ad37be2a9a2ce43671c5577;Sat Dec 22 06:45:55 EST 2007;Committer;duerst;4;27475;73;27548;0
c9bf41968448b09f7b33f3cf1c21090d23cdde50;Sat Dec 22 06:30:40 EST 2007;Committer;usa;4;16;0;16;0
366b82dde8c9e48affb774840ae6f89d6e2a60c4;Sat Dec 22 06:19:11 EST 2007;Committer;usa;2;6;1;7;0
aefc34a041240889948f5af09c1526077c4fc0ca;Sat Dec 22 06:14:50 EST 2007;Committer;nobu;7;147;12;159;0
482690cdf88158e62efb9ea3f5bea5f1a7bf7346;Sat Dec 22 06:05:14 EST 2007;Committer;shugo;2;11;11;22;0
a7ef0c7303ed6faa4ca5eac73077d6ec5e2ee285;Sat Dec 22 06:03:20 EST 2007;Committer;shugo;2;61;50;111;0
da8b4a5e41760c86cf2a28fa4069184479cb9773;Sat Dec 22 06:00:56 EST 2007;Committer;akr;1;24;14;38;0
0067dc24d808710ec99308972bd29745d7d0630a;Sat Dec 22 05:48:30 EST 2007;Committer;tadf;2;6;2;8;0
bcb064eb0f639493f42284570377c521c371c6c2;Sat Dec 22 05:38:33 EST 2007;Committer;akr;6;50;11;61;0
e11ed98f8856c50b7c65aebbccabb4813eda6cfd;Sat Dec 22 05:30:37 EST 2007;Committer;nobu;2;7;2;9;0
34ff55e82a5b8cca1ecf43118926fc66c7223e9d;Sat Dec 22 05:19:38 EST 2007;Committer;ko1;3;9;2;11;0
e6f67598e9466a5cb95fc0a8ed487b04c764f361;Sat Dec 22 05:18:52 EST 2007;Committer;ko1;2;5;1;6;0
dd6ab4f3d5ba92c57d999f0ab4cbcb8c401af3d6;Sat Dec 22 05:05:30 EST 2007;Committer;ko1;2;6;2;8;0
3ce6e61a7bbe346e9cec0e88fb1a871000984cc9;Sat Dec 22 03:15:36 EST 2007;Committer;usa;1;2;0;2;0
85143195da6d07b7a50ae4ab73e461414293d47c;Sat Dec 22 02:52:27 EST 2007;Committer;ko1;3;8;2;10;0
b507930297de6991910ee086ca06af1fac5b5363;Sat Dec 22 02:37:40 EST 2007;Committer;usa;2;6;0;6;0
ccc842878dd4a41efd960e37822f354b881f13d6;Sat Dec 22 02:32:18 EST 2007;Committer;drbrain;2;6;2;8;0
a07e0b139cf1a72b96f849fb4f77d475cc3d2247;Sat Dec 22 02:10:44 EST 2007;Committer;jim;1;5;0;5;0
1d420d7c380a0ef4c57b4df8c9e400e2e8bd352d;Sat Dec 22 01:36:35 EST 2007;Committer;matz;2;3;2;5;0
c375b2f4206906618e437aa645523b8f5dca0983;Sat Dec 22 01:34:09 EST 2007;Committer;ko1;4;1386;1382;2768;0
c6b8f89c2e0e95d7e5a7ebcf88565478475f8ed7;Sat Dec 22 01:32:21 EST 2007;Committer;matz;2;8;1;9;0
0fe66f38cc04ea3d5e813ababe93123f7a32faa6;Sat Dec 22 01:26:30 EST 2007;Committer;nobu;0;0;0;0;0
d65ae590d05c46b28ed327f51eb34f0a9c0010f4;Sat Dec 22 01:20:57 EST 2007;Committer;matz;2;7;30;37;0
7f59e105d1dfb85cd6d0fb1d163b904b3d444f6f;Fri Dec 21 23:29:56 EST 2007;Committer;nobu;2;17;0;17;0
5a1cf1c5cb2dd1007389a5c3f2ef5bcecc74a6ac;Fri Dec 21 21:35:08 EST 2007;Committer;ko1;3;30;17;47;0
ac42f7adf953fb6af1ac72cd07438b3ecefbea1c;Fri Dec 21 21:10:55 EST 2007;Committer;davidflanagan;2;5;1;6;0
b211ed6460916ff9db3f000113fcf2261f953f29;Fri Dec 21 20:11:17 EST 2007;Committer;usa;3;10;4;14;0
d7cc14d4363cca3d0f9b0cf5ab81900e6ec17989;Fri Dec 21 18:55:30 EST 2007;Committer;matz;8;18;13;31;0
b36c642a8571399bb2f38a5381e922d25ef07093;Fri Dec 21 18:21:41 EST 2007;Committer;matz;2;5;1;6;0
1d41fe84f9c1402290d5d566b735975b8dbe2722;Fri Dec 21 18:02:19 EST 2007;Committer;matz;2;11;3;14;0
2c40f3a7a93bdbc9dcb1c7e9a3711ed17c77e547;Fri Dec 21 17:22:34 EST 2007;Committer;matz;1;7;12;19;0
2bed2cdc7fc3c1c2705b5de739db6dd125bf0d03;Fri Dec 21 16:54:25 EST 2007;Committer;matz;2;6;10;16;0
b82a05989e388a5d9500051ce91fd47f02aacbf9;Fri Dec 21 16:39:36 EST 2007;Committer;akr;3;32;6;38;0
47daa2f218bbaf8bedf9cc5144ee01428647f872;Fri Dec 21 16:25:53 EST 2007;Committer;shugo;2;6;1;7;0
3486311d540ba65e591a0fb54fc2acfb02c7f8dd;Fri Dec 21 16:11:39 EST 2007;Committer;usa;4;19;14;33;0
3edf43c4cfe9df91ba30888fb631eec036595f88;Fri Dec 21 15:59:24 EST 2007;Committer;matz;1;0;1;1;0
389278af977066c5c8b077432920db6df89fcd6a;Fri Dec 21 15:57:26 EST 2007;Committer;matz;3;8;3;11;0
fede8b213b8b06537c160f911698c12793920d24;Fri Dec 21 14:49:56 EST 2007;Committer;usa;2;8;4;12;0
256ddf48c2e143de22079faa7872cc8b486c6de0;Fri Dec 21 11:22:08 EST 2007;Committer;matz;2;6;2;8;0
7c2ae80d703edaff7f5727c5c78bbe02904e215c;Fri Dec 21 11:13:53 EST 2007;Committer;nobu;3;9;0;9;0
977eea57a3e9a3513c60a9dae48092db4c1a6f2e;Fri Dec 21 11:09:19 EST 2007;Committer;nobu;2;7;3;10;0
5f2e5c07a7d03641c038a484c7913d7ae4d66e6c;Fri Dec 21 11:00:04 EST 2007;Committer;nobu;3;81;20;101;0
91c6c2c170698577b4618139181f57f3874f5a9c;Fri Dec 21 09:43:49 EST 2007;Committer;ko1;4;69;45;114;0
59a07a0690ea964aa1f6d2f250a9ef176cac49ab;Fri Dec 21 08:57:35 EST 2007;Committer;nagai;46;1220;325;1545;0
d66a188c4a1aa269be94c5707df3aeff185dd076;Fri Dec 21 08:49:08 EST 2007;Committer;nobu;2;6;1;7;0
b42179135dfb005e7e2c14c2390ec19c93e986ec;Fri Dec 21 08:45:07 EST 2007;Committer;drbrain;6;11;4;15;0
f12cc82e0fced3708807df2db748fa86483a21ac;Fri Dec 21 08:38:16 EST 2007;Committer;ko1;4;18;12;30;0
131d0efb5fc34c2e7bb3b72d4404a3155c33e182;Fri Dec 21 08:31:24 EST 2007;Committer;nobu;3;19;5;24;0
f40a94a9cd2807296c89eff3240436b3065b4827;Fri Dec 21 08:29:33 EST 2007;Committer;ko1;3;12;7;19;0
6cbc9ac208b5bbaf5d43cdd47268f41d6a98970b;Fri Dec 21 08:27:14 EST 2007;Committer;ko1;4;15;8;23;0
5c00dd28c5e16c85ed2ada37cae3b8be3a08ef3e;Fri Dec 21 08:13:39 EST 2007;Committer;ko1;3;8;2;10;0
5bb7c8612fc0904070aa9cfad096e3c462877903;Fri Dec 21 07:52:49 EST 2007;Committer;akr;2;9;4;13;0
72d638fb2feab7a68f2caf2d4c58b4009cfd7a40;Fri Dec 21 07:50:31 EST 2007;Committer;naruse;3;61;47;108;0
e791259e005e35069af7d701366f11c320eb31f2;Fri Dec 21 07:33:31 EST 2007;Committer;nobu;3;13;9;22;0
968eb8beac192fcbfad25151879d505911716e99;Fri Dec 21 07:24:39 EST 2007;Committer;duerst;4;2942;2935;5877;0
f1a81f92cabff73ea06dd2bc8c8efbbc47d924fc;Fri Dec 21 07:14:42 EST 2007;Committer;matz;2;14;2;16;0
5c71aadbed1ce4fcfe337911c5bcc5c4740b6b89;Fri Dec 21 07:08:52 EST 2007;Committer;akr;1;2;0;2;0
e667720bd44123f5400d5696613312fa910b799a;Fri Dec 21 07:07:21 EST 2007;Committer;akr;2;7;2;9;0
e48ea0a5f330ce694e5d6e28a3b4825be13910df;Fri Dec 21 07:02:55 EST 2007;Committer;matz;4;43;9;52;0
12df6cf7cece79a1d5d99037b35b6a28c3c3296c;Fri Dec 21 06:59:48 EST 2007;Committer;nobu;4;35;6;41;0
328e6a02bf19c4b0397a6a2e066b273e7dd339de;Fri Dec 21 06:38:12 EST 2007;Committer;akr;1;15;0;15;0
ad89f7e6d2abe4fb96e713cf94b90c9781afc31d;Fri Dec 21 06:34:03 EST 2007;Committer;shugo;2;12;9;21;0
1ee46d76c49c2ddb72f1bb0539decc165b48feb7;Fri Dec 21 06:18:25 EST 2007;Committer;matz;2;3;1;4;0
0972cbc28422b89ad9eb5e051d88ba83e1fd3078;Fri Dec 21 06:16:56 EST 2007;Committer;akr;2;10;0;10;0
4baea7dd8ee879dfff74df824c7e5963ff954625;Fri Dec 21 06:16:02 EST 2007;Committer;nobu;2;8;0;8;0
8fa21bc05fc892d9c8569f5f3974e993621d9785;Fri Dec 21 05:59:20 EST 2007;Committer;matz;2;14;3;17;0
0d49e43be2440a7b2828d7568abbda9e321b486a;Fri Dec 21 05:47:15 EST 2007;Committer;akr;2;6;0;6;0
668bd7d992e3157e616ac7a0b0154d8accb17288;Fri Dec 21 05:03:14 EST 2007;Committer;matz;3;9;1;10;0
59dca1991089e87b21cc9edeadfb33033ffc1e3f;Fri Dec 21 04:54:54 EST 2007;Committer;akr;2;9;5;14;0
e15390d08d10b3b1183f9954a4bb2f801b04f368;Fri Dec 21 04:47:00 EST 2007;Committer;nobu;2;5;1;6;0
ef0706a5bf4dd888363f017c2408899009c24c4a;Fri Dec 21 04:40:13 EST 2007;Committer;nobu;3;32;7;39;0
ad47716266cc8048b6ec1c8d73490cfe06a05657;Fri Dec 21 04:32:53 EST 2007;Committer;matz;2;6;0;6;0
1b27cfcd6ca0bcf7b75be27de4746cd030b7c1d4;Fri Dec 21 04:26:38 EST 2007;Committer;matz;3;28;1;29;0
65a953c7c9527e32aa3024322bde24864a3a66cb;Fri Dec 21 04:22:59 EST 2007;Committer;akr;1;1;0;1;0
bef85feb24107599fb207153f4ad1c34faf7b8ec;Fri Dec 21 04:17:17 EST 2007;Committer;akr;1;2;2;4;0
8c68d9a15286e6bc0e76e1da1de433a4962b1cba;Fri Dec 21 04:09:45 EST 2007;Committer;akr;3;9;2;11;0
5a717c35eac92094910985699ba11ff126983782;Fri Dec 21 04:05:08 EST 2007;Committer;matz;1;1;1;2;0
3ec3412d83d750a986fbadb35faca031023deb41;Fri Dec 21 04:03:19 EST 2007;Committer;matz;2;7;6;13;0
923d3ea159d59bc355b19a74ba01723a0d16cd36;Fri Dec 21 03:56:45 EST 2007;Committer;akr;13;4;951;955;0
bda85cb021407ecf437891cd194e00e70669ca45;Fri Dec 21 03:34:26 EST 2007;Committer;matz;3;10;1;11;0
74a0c0cc7e7664402ae08fb6ae47e8b8db78b5be;Fri Dec 21 03:29:54 EST 2007;Committer;matz;2;10;2;12;0
e613c7cf5fed9bca9ccf98b045c45596508bd4e0;Fri Dec 21 03:27:31 EST 2007;Committer;ko1;2;10;6;16;0
df08853630b3bc270250bf734957e6bb95a4b52e;Fri Dec 21 03:25:02 EST 2007;Committer;akr;1;1;1;2;0
79f9b6c2cbfbd1231815e7323cedfd769f99c64b;Fri Dec 21 03:22:43 EST 2007;Committer;jim;13;3017;0;3017;0
9fbc6596ccf089a26ec7c38e2837b667790edbf6;Fri Dec 21 03:22:22 EST 2007;Committer;nobu;5;65;53;118;0
2b627148661701da59abf66ccd4b7125386a3b30;Fri Dec 21 03:18:37 EST 2007;Committer;akr;2;13;0;13;0
f2515d9938213ec99362c9f0e7d7fa6e6afc04dc;Fri Dec 21 03:03:29 EST 2007;Committer;akr;4;19;1;20;0
7a34e08d847ab72508c8714bfc76687e00a750f6;Fri Dec 21 02:56:17 EST 2007;Committer;matz;2;3;1;4;0
0530cf9ff88c13a69c95519139f75b87d097707c;Fri Dec 21 02:52:23 EST 2007;Committer;akr;5;33;26;59;0
685cc0f7c4c85877ccbb2804bdbb15280b049445;Fri Dec 21 02:49:14 EST 2007;Committer;ko1;1;1;1;2;0
2a564dfb94eaa293461a0439cbe714f923a6993d;Fri Dec 21 02:48:14 EST 2007;Committer;ko1;3;12;8;20;0
4cf437519f1cbefed5ad7ee2bf0e68857105823f;Fri Dec 21 02:31:11 EST 2007;Committer;akr;18;35;26;61;0
817a4e3c83fd830b93c286159e97a18654db1c35;Fri Dec 21 02:23:26 EST 2007;Committer;nobu;25;43;32;75;0
d45cfa45ab62ac9e31c20d5bdf4926bf7748df8f;Fri Dec 21 00:27:40 EST 2007;Committer;akr;3;22;19;41;0
bb1719875c357f8e1d58c430727973de810cb66c;Thu Dec 20 23:33:32 EST 2007;Committer;matz;2;6;1;7;0
ec0340b4b62693c53da1c262eabb3d130c086e01;Thu Dec 20 16:27:14 EST 2007;Committer;gotoyuzo;2;8;0;8;0
c6920177f3e561f779f54534e511f0c9f0de6edd;Thu Dec 20 16:21:22 EST 2007;Committer;gotoyuzo;5;139;51;190;0
d86caf318820ebcebf981b822a65d5a4cfab6364;Thu Dec 20 16:12:38 EST 2007;Committer;gotoyuzo;2;14;7;21;0
cfb91bc2f57050e853b330b5bf497fea4c19e0f4;Thu Dec 20 15:27:35 EST 2007;Committer;matz;4;20;9;29;0
5c04ed459bde261deff75a9d6f4fffee7d12dd58;Thu Dec 20 10:41:50 EST 2007;Committer;ko1;2;79;21;100;0
cb7e82a94aa8405ac650e12abdf52b8560e559bf;Thu Dec 20 10:14:16 EST 2007;Committer;ko1;2;9;0;9;0
b28155a02faccaffc35fb04ec1e80ae1239d06cf;Thu Dec 20 10:09:32 EST 2007;Committer;akr;1;50;4;54;0
ff3e1957465fa7c790077d93e250a8c9545e6af2;Thu Dec 20 09:35:28 EST 2007;Committer;ko1;2;5;1;6;0
c334a09f7ad58c692ec86e1d55c561e86806260b;Thu Dec 20 09:29:46 EST 2007;Committer;ko1;23;4723;4718;9441;0
c9923aeb6931f68ce600bbeb0f3c89aebf328a5b;Thu Dec 20 09:09:07 EST 2007;Committer;akr;1;1;1;2;0
36354bf53c886b29120d49ee4d6151780850d369;Thu Dec 20 08:55:35 EST 2007;Committer;akr;1;129;18;147;0
8289771e326006cc4e15a667e3eff3a72cfb3327;Thu Dec 20 08:39:12 EST 2007;Committer;drbrain;47;1153;993;2146;0
40d8543fbdec5485a638a2cb1008089d106b978d;Thu Dec 20 08:20:02 EST 2007;Committer;ko1;3;51;0;51;0
1b79b5be82ac6baa5be2c4483ab44143493069d5;Thu Dec 20 08:16:43 EST 2007;Committer;duerst;2;9;4;13;0
dc4d4b3923cbb832f69abdc0df6d9ee0ea38cae1;Thu Dec 20 08:07:56 EST 2007;Committer;nobu;25;87;27;114;0
be137f3601610491d4265a4f9c87bf52fef28d66;Thu Dec 20 07:44:03 EST 2007;Committer;ko1;2;7;0;7;0
314bef7ef149d7ce87c57fa0c95e30fc8fb9b27f;Thu Dec 20 07:07:35 EST 2007;Committer;ko1;12;82;89;171;0
e42fac7c061283180cbc630bd930ef16f5074d33;Thu Dec 20 06:47:14 EST 2007;Committer;nobu;31;3176;3172;6348;0
27fbeb3c4e8803d89fa1d765d7b1fdb49dddece2;Thu Dec 20 04:51:36 EST 2007;Committer;akr;1;141;4;145;0
e0dcf23cd5973c9f1fdb7218cf3eac7774f1f0c2;Thu Dec 20 01:03:15 EST 2007;Committer;ko1;4;27;3;30;0
bc162c69ea86378d6c0f649f2fecbf1a38bdddfb;Thu Dec 20 00:50:13 EST 2007;Committer;ko1;2;20;0;20;0
f5e7602c330110f28163708afac91f6de69999a7;Thu Dec 20 00:46:12 EST 2007;Committer;ko1;2;7;2;9;0
9a82a62937ab8978766b5f88208e8c44d9f6941a;Thu Dec 20 00:43:39 EST 2007;Committer;matz;2;8;2;10;0
1c32ff927f02f17a0e6cfe6edb375bbd3d309d09;Thu Dec 20 00:08:23 EST 2007;Committer;matz;2;5;0;5;0
5485df3e105aadfd6b61854180a8c4a803fe993f;Wed Dec 19 21:39:08 EST 2007;Committer;ko1;6;43;19;62;0
10b933295ac8fed13ecf87fee1e304f426d78db9;Wed Dec 19 19:58:58 EST 2007;Committer;ko1;2;4;1;5;0
1541ad6e8cd25b129b2f40f8738e7319cbfbfe37;Wed Dec 19 19:16:32 EST 2007;Committer;usa;4;21;2;23;0
8e8c1d02e0cae701e0b6a26c1ae3226654a038a9;Wed Dec 19 18:00:41 EST 2007;Committer;matz;2;5;0;5;0
c6779772678a03b1075ac0a21ea289d8977a3f1b;Wed Dec 19 17:50:30 EST 2007;Committer;nobu;16;102;52;154;0
d874dde2827e96dbbb09f89f4d9e671c43725eef;Wed Dec 19 17:46:17 EST 2007;Committer;matz;3;22;2;24;0
42244c17f648823f1aa0d645f37980cf28c2a779;Wed Dec 19 17:28:32 EST 2007;Committer;nobu;16;3130;0;3130;0
359115948aa43af6a69b03ec1ddf6d3afac733e9;Wed Dec 19 17:23:24 EST 2007;Committer;nobu;3;20;1;21;0
77629d2cbe4931e3033ae73cef2e9adf6c1c0373;Wed Dec 19 17:02:29 EST 2007;Committer;matz;4;23;3;26;0
a927483326e54e6a4e9387009af0b57f38636497;Wed Dec 19 16:10:54 EST 2007;Committer;nobu;4;29;9;38;0
5e8e08d74e9ed8f6805e0f86c643900770b1564d;Wed Dec 19 15:11:37 EST 2007;Committer;seki;2;7;2;9;0
94e82d6c651837247d2bb5a5ded8c7b7cb301441;Wed Dec 19 14:57:39 EST 2007;Committer;nobu;2;11;6;17;0
a329b7734874989596f506542f055ec19b5b47df;Wed Dec 19 14:43:37 EST 2007;Committer;matz;2;4;0;4;0
3e212b0484bb1f7106b4466209a8f507e718a96b;Wed Dec 19 14:38:46 EST 2007;Committer;matz;2;5;3;8;0
1c7f24d5b16ee21867b628535bd30556608086be;Wed Dec 19 14:15:05 EST 2007;Committer;matz;2;27;6;33;0
474a88f041f936c22327bf33156eeb115c85d3d8;Wed Dec 19 12:42:19 EST 2007;Committer;nobu;4;13;4;17;0
64a912155d70a97e37c01f6e132d1ccaf5cc142f;Wed Dec 19 12:03:46 EST 2007;Committer;nobu;1;200;200;400;0
4b8ebed41c106ea2909ae965f99a3f2b77fea533;Wed Dec 19 11:40:52 EST 2007;Committer;usa;2;11;3;14;0
dec6ba8a22aa5a20538f4f7d0bd37a384db0ad73;Wed Dec 19 10:19:38 EST 2007;Committer;naruse;4;57;85;142;0
8acb0fbd4d1d182a68a842ed472ee8646d17712a;Wed Dec 19 10:13:03 EST 2007;Committer;matz;2;88;19;107;0
e7e4d03a6eec1d25ccbfb5a72cc5e4049f89961d;Wed Dec 19 09:56:14 EST 2007;Committer;akr;1;62;1;63;0
4aa72e7fe370d1832c52b43d56e147b3e9f64b99;Wed Dec 19 09:30:45 EST 2007;Committer;akr;1;79;0;79;0
860b40fd631f280fbc9164abdc36409dcfac7e27;Wed Dec 19 08:46:49 EST 2007;Committer;ko1;8;45;62;107;0
def4a99af2081b428b91e8d00c74dd36caa230ca;Wed Dec 19 08:14:21 EST 2007;Committer;ko1;4;224;221;445;0
315faf62ffeeb9dc54bc3b697ff5788d652da665;Wed Dec 19 08:09:00 EST 2007;Committer;akr;1;150;0;150;0
9bd91ea3b00d896c65b94c44e4ed523353a81000;Wed Dec 19 08:02:03 EST 2007;Committer;ko1;4;25;18;43;0
66417115a2596a8e43d18b2945a629353756a8f7;Wed Dec 19 07:32:00 EST 2007;Committer;nobu;2;21;6;27;0
26538a20912fd5fbbf022b7fe594bf38822b537d;Wed Dec 19 07:26:37 EST 2007;Committer;nobu;2;6;1;7;0
d935298862c835e9ebe430a6b1c411a5ae2f144f;Wed Dec 19 06:39:00 EST 2007;Committer;matz;1;2;1;3;0
f00338f430481f4167ec8e4945c85acce8089c20;Wed Dec 19 06:37:41 EST 2007;Committer;matz;3;14;17;31;0
1de2b1259729e6f62854f231b0ef6d660d25de14;Wed Dec 19 06:36:15 EST 2007;Committer;akr;1;38;4;42;0
ac5250098da52e75f376ada50e738aae4330b2d9;Wed Dec 19 06:15:35 EST 2007;Committer;matz;2;6;1;7;0
c3f8c067954023ca268a9c8d83b379f267c4f19d;Wed Dec 19 04:57:46 EST 2007;Committer;nobu;2;16;0;16;0
0cf4378f14318890b8694665e4a37b511d0ac566;Wed Dec 19 04:29:22 EST 2007;Committer;naruse;3;1243;1040;2283;0
b9ca01063ef999af00f17e993d74cf6d0218b4ab;Wed Dec 19 04:13:17 EST 2007;Committer;akr;1;73;0;73;0
8c457ad4b8d2f6041002d04503fc793e4b424065;Wed Dec 19 02:08:59 EST 2007;Committer;nobu;1;1;0;1;0
198c0920045418b8c530b35dfab228cfeee0a4d1;Wed Dec 19 01:52:31 EST 2007;Committer;nobu;3;9;1;10;0
eddc9b7fd4a222534faa9aa5d2454d218d0dfa34;Tue Dec 18 16:01:09 EST 2007;Committer;akr;1;264;120;384;0
ba15fda3593b4ba8c7c64c0cf9c9e59223997611;Tue Dec 18 15:10:37 EST 2007;Committer;matz;3;12;5;17;0
63fabd365a5ca9fb1ff303bd58e3135cfacc9c71;Tue Dec 18 14:53:55 EST 2007;Committer;nobu;4;10;5;15;0
f2266fe471e77fb972fa0668b6345fc4940904e2;Tue Dec 18 14:46:52 EST 2007;Committer;gotoyuzo;3;88;84;172;0
a04281ff0e3f1dc0f6584102b94f88403ff35520;Tue Dec 18 14:43:03 EST 2007;Committer;gotoyuzo;3;19;4;23;0
d99a343dfd9f8b060a51b29ce89137e31786222f;Tue Dec 18 14:03:42 EST 2007;Committer;gotoyuzo;1;1;1;2;0
bd679566908f639d2a0163f13e8817ff607a05c6;Tue Dec 18 13:57:48 EST 2007;Committer;gotoyuzo;2;9;0;9;0
06591ad6b1aa55a9a05a17c1194a52999782fe3f;Tue Dec 18 13:37:10 EST 2007;Committer;gotoyuzo;7;15;9;24;0
192ec21adf718e324fbe499b38997fa5bea98375;Tue Dec 18 13:14:32 EST 2007;Committer;ko1;3;25;22;47;0
2364c5e6e768531586bff33653206ce18a26d3ca;Tue Dec 18 13:12:56 EST 2007;Committer;usa;2;8;4;12;0
8394de7bfcb053019f96f7171c4f2f4ebbdfbe50;Tue Dec 18 12:11:38 EST 2007;Committer;ko1;2;5;2;7;0
cd843108646b999e13cfbf04e51eca30b68850b3;Tue Dec 18 12:07:51 EST 2007;Committer;ko1;9;175;64;239;0
1f75a4e700883da8d15048fc3da6528ba53ec1e4;Tue Dec 18 11:58:28 EST 2007;Committer;ko1;2;21;0;21;0
2d01290cfd1a34b1ab7cde84612c2e9408ed2be6;Tue Dec 18 11:26:24 EST 2007;Committer;akr;4;130;0;130;0
400009cac20e271f458ef14cf05565841a994df1;Tue Dec 18 10:17:25 EST 2007;Committer;akr;1;11;4;15;0
ec69dddc0d7b0dbaf92ef70bc7b50c7003db0a8e;Tue Dec 18 09:14:46 EST 2007;Committer;matz;2;10;1;11;0
2521b33ed74822cb6e81a180bfbcfff3e1683815;Tue Dec 18 08:28:39 EST 2007;Committer;matz;4;24;2;26;0
98da73bc963e17b25c9df961f407c91cffbfc2f4;Tue Dec 18 08:04:26 EST 2007;Committer;nobu;2;33;17;50;0
60abbb7ad77bd723afef16439e6fbf9f9967c947;Tue Dec 18 06:46:52 EST 2007;Committer;akr;1;103;0;103;0
168b9e13ff4192d850bc2f46cf6debd6849a96a8;Tue Dec 18 06:44:25 EST 2007;Committer;nobu;2;7;2;9;0
cbc4bb6b924e7b538b2e51e41938114586be4e8b;Tue Dec 18 06:20:24 EST 2007;Committer;drbrain;2;8;4;12;0
346e9e78f0e4c122561d12422d368097c14ae644;Tue Dec 18 06:17:33 EST 2007;Committer;nobu;2;6;2;8;0
2e0e02d358de4689bfaa5431507479df7ecbfd26;Tue Dec 18 05:50:37 EST 2007;Committer;matz;3;5;7;12;0
a3a6ba958429dd6baa7916a0dbcbd0865376d07a;Tue Dec 18 05:44:30 EST 2007;Committer;matz;3;17;13;30;0
874b367bdc09664e209fb163c354bb62168c9317;Tue Dec 18 05:05:25 EST 2007;Committer;nobu;2;9;5;14;0
0c19240983832840de397dbda8875a2b112ab1db;Tue Dec 18 05:02:24 EST 2007;Committer;akr;2;126;71;197;0
1281cb00e53d2a4425fc28c3f75dee48e8e7a2d3;Mon Dec 17 23:01:50 EST 2007;Committer;matz;5;51;11;62;0
97591e82d9ba3b7204110302b52540007ff081a5;Mon Dec 17 21:05:25 EST 2007;Committer;matz;4;2;108;110;0
51b031093069dd4a89e25b6057f1eca8c0c7e24e;Mon Dec 17 20:58:34 EST 2007;Committer;matz;6;4;228;232;0
c611b6d0cc50af72847ddb7c1d0f31aa3b18da25;Mon Dec 17 17:30:57 EST 2007;Committer;nobu;5;20;6;26;0
c9fe9f5850358765dbcd414943fd43443a56f094;Mon Dec 17 16:53:12 EST 2007;Committer;matz;1;1;1;2;0
1ec5dcdd3120eb532ff9bf53d88f5316741f2b69;Mon Dec 17 16:50:17 EST 2007;Committer;matz;2;6;1;7;0
acaa4a431ec4ac17c8db3295705f38d51de05f72;Mon Dec 17 16:40:22 EST 2007;Committer;nobu;2;5;1;6;0
bf04c0946f8892e4d54553f0b06b8cc586c93281;Mon Dec 17 16:21:21 EST 2007;Committer;nobu;2;36;4;40;0
6ed9bdd463cd5365fdf91b94a8b9d83e7765ef8b;Mon Dec 17 16:15:46 EST 2007;Committer;nobu;7;82;70;152;0
ebfcc5d9337ec64e2ddb9c4125b7768df1b1995a;Mon Dec 17 16:06:21 EST 2007;Committer;matz;4;14;6;20;0
50a0a8647125ec8be499675a4e6c479d2146cc2a;Mon Dec 17 14:59:11 EST 2007;Committer;akr;2;190;4;194;0
a0fc8b5564ade5a595ee5eb28a9aad3aea279036;Mon Dec 17 13:11:13 EST 2007;Committer;akr;1;10;3;13;0
bd79a2eb2d62c9c79a27fa87470aecee17bca6ec;Mon Dec 17 12:41:27 EST 2007;Committer;nobu;3;12;0;12;0
2a0aa84713216aebab93034fbf29be902880f1dd;Mon Dec 17 12:25:26 EST 2007;Committer;gotoyuzo;2;23;1;24;0
2c038353963843b8dfa7850b0b34023437b2174d;Mon Dec 17 12:18:28 EST 2007;Committer;gotoyuzo;3;189;65;254;0
d6a70c4bb71ff6d29231878be398c7775a90007c;Mon Dec 17 09:44:06 EST 2007;Committer;matz;3;10;5;15;0
ea1b9d58b995f9ced8a4e92c7e5b459569ec921f;Mon Dec 17 09:08:27 EST 2007;Committer;matz;4;22;6;28;0
b2d9f1e9d0da3a0b63e231d5692824368efd80cd;Mon Dec 17 08:47:28 EST 2007;Committer;nobu;8;147;82;229;0
5043ab95ed0fdbdc20a918d8b7b809dbc41bcba1;Mon Dec 17 08:32:57 EST 2007;Committer;nobu;2;4;2;6;0
5f431c49a4e41dd14d051a9f4a2fece740be280a;Mon Dec 17 08:19:29 EST 2007;Committer;nobu;1;3;0;3;0
4cf13ffaef0a53311254fb74b2688c675969fc4e;Mon Dec 17 08:17:50 EST 2007;Committer;nobu;6;31;33;64;0
33ecb05d5118ec54f4b6efdd53d8f5b2f666ead8;Mon Dec 17 08:08:23 EST 2007;Committer;akr;2;7;10;17;0
0d0a8a55fc6650a9b1dee937f66f9dc1690a2579;Mon Dec 17 07:41:21 EST 2007;Committer;akr;2;27;32;59;0
d4f5b77d3ab62c0b05feb2897bf93b2b3032dfeb;Mon Dec 17 07:06:16 EST 2007;Committer;gotoyuzo;3;14;1;15;0
1e8c6e2ba4eb4305a756f650248283ecad4f36cb;Mon Dec 17 07:03:57 EST 2007;Committer;gotoyuzo;4;29;11;40;0
3f07e548fc8b1247824a008c970fcbcf10116a93;Mon Dec 17 05:07:37 EST 2007;Committer;akr;3;10;3;13;0
5a41626dea072a4493984f05ba3aa032919da70d;Mon Dec 17 05:01:47 EST 2007;Committer;matz;3;18;5;23;0
17f4486abc48c427a0cf2f5cd984df1ca541bc33;Mon Dec 17 03:24:51 EST 2007;Committer;akr;1;2;0;2;0
9cbc37f505994abe7e956c5a8e2dcc1c58d9d150;Mon Dec 17 03:21:27 EST 2007;Committer;nobu;3;6;2;8;0
c392e6e66603853e4b0880d9b86c559e0e9f0e0f;Mon Dec 17 02:40:26 EST 2007;Committer;akr;2;6;1;7;0
5c4cf9bfdfa8afe48c096830787d4e7e6ae7bb23;Mon Dec 17 01:28:26 EST 2007;Committer;matz;5;1667;1981;3648;0
b7beb63b0b55819a68eb93a96b86ceda9bd8c5a4;Sun Dec 16 05:52:01 EST 2007;Committer;nobu;2;4;2;6;0
22456e709d024202bc5b3201d9e62c0923ab9ef2;Sun Dec 16 02:17:42 EST 2007;Committer;akr;1;61;0;61;0
bcf4a9947daab5750fde75a0d7c97cb27accc45d;Sat Dec 15 16:29:26 EST 2007;Committer;akr;1;17;0;17;0
6ac2742afacf9fd7c9a378d1bbadcf9b730bfbef;Sat Dec 15 15:36:44 EST 2007;Committer;nobu;3;9;4;13;0
c8c709ddfa6c8369346688193cb908d1e05c0902;Sat Dec 15 15:00:52 EST 2007;Committer;akr;2;10;0;10;0
ba3bb2895f6f8bc95cf2c12d157fcac0779c7f05;Sat Dec 15 14:51:48 EST 2007;Committer;akr;2;6;1;7;0
0481de5db50d8078dc9a5995530815a72024e43a;Sat Dec 15 13:27:41 EST 2007;Committer;nobu;2;8;1;9;0
5fcbf61023c607f8c155e623c902f6562093c6b8;Sat Dec 15 12:39:25 EST 2007;Committer;akr;2;8;1;9;0
bdce0db7b5ed04abe4fa5a76f98b37712ff47e2e;Sat Dec 15 11:20:50 EST 2007;Committer;nobu;2;4;2;6;0
2f9ecb628b3bf29c3c1ae74701ba267a8e6036be;Sat Dec 15 11:20:45 EST 2007;Committer;akr;1;1;1;2;0
0884b1d8b1e333a88a4ec4bff073e1e8c387203a;Sat Dec 15 11:12:20 EST 2007;Committer;akr;1;5;7;12;0
49f00d5d2dcc70fffa2501f639a8ef3ce1763d81;Sat Dec 15 11:04:30 EST 2007;Committer;akr;1;7;1;8;0
f2bd108d8df6def3ff39674337eb4d40cfb25e3b;Sat Dec 15 09:56:59 EST 2007;Committer;nobu;6;103;10;113;0
c5851d1d6906e130bbb156d9ace962c59c8b0086;Sat Dec 15 06:03:22 EST 2007;Committer;matz;2;9;25;34;0
f2b0dba1cfff30d94d21d224a2c240752fda8edb;Sat Dec 15 05:42:25 EST 2007;Committer;matz;5;1448;1373;2821;0
4f131139456edc120612b7264619042fc698f08c;Sat Dec 15 04:09:24 EST 2007;Committer;akr;6;58;24;82;0
8063edd4c941dd32e8760307c0d56493015dfae8;Sat Dec 15 03:58:02 EST 2007;Committer;nobu;2;53;10;63;0
e34b2c31dff29678032d0cfb56281caca813cd9c;Sat Dec 15 02:39:34 EST 2007;Committer;akr;1;2;3;5;0
8523343780f3544bdef9fa68936f670c794999b6;Sat Dec 15 01:14:25 EST 2007;Committer;nahi;1;1;1;2;0
b4268bf067e8472fa723e083119bdd8e8335cf9b;Fri Dec 14 21:27:16 EST 2007;Committer;akr;1;8;0;8;0
0f0f79d34bed4ef5f2b1055aca6eedfacde60470;Fri Dec 14 17:05:15 EST 2007;Committer;matz;5;15;23;38;0
6deeaf6226cc7c4e4e72a7b6d2f38e44da7576f6;Fri Dec 14 09:20:35 EST 2007;Committer;akr;2;7;1;8;0
11f3462fb7e66d366224984bc38a0e6a5e7a50d6;Fri Dec 14 08:38:18 EST 2007;Committer;matz;3;9;2;11;0
269bd16b28e86d1333969389b7b402f2915e336f;Fri Dec 14 08:37:39 EST 2007;Committer;matz;2;41;13;54;0
8b6cb6994c2d2e5a9be49f8a4c78542e86abddda;Fri Dec 14 04:47:57 EST 2007;Committer;nobu;5;18;10;28;0
e9ac3573f0025893957d785aa6f0ce361411c8e0;Fri Dec 14 03:36:37 EST 2007;Committer;nobu;2;7;5;12;0
3cce5965da45677a6f219ebea422425ade2d9d3b;Fri Dec 14 02:54:08 EST 2007;Committer;nobu;3;8;5;13;0
a2ccbc14d9b56f44707fdcfb7aa928330ac5fdd7;Fri Dec 14 01:01:42 EST 2007;Committer;nobu;3;61;32;93;0
30c5d612c221ce69fb7bf92255db64d79bca35bd;Thu Dec 13 23:19:14 EST 2007;Committer;akr;2;8;3;11;0
c958d9a9c6955e70297d93e8f9f86cf1b3196107;Thu Dec 13 18:00:50 EST 2007;Committer;matz;2;29;12;41;0
e0334fb250d6d2cd34de379743551864ace9c496;Thu Dec 13 17:30:54 EST 2007;Committer;matz;2;6;1;7;0
c3b5279d4953de9bf046920abe45bf83097b3299;Thu Dec 13 17:06:41 EST 2007;Committer;matz;2;6;0;6;0
7bb3ea6afa643948db2ad445f8f05e4113677e10;Thu Dec 13 16:09:53 EST 2007;Committer;matz;3;24;11;35;0
a648fc802bd626dc29ec690f29c6a69f2510b0cb;Thu Dec 13 13:44:02 EST 2007;Committer;matz;4;18;9;27;0
968918da16ea89434798d29247e247601a046a9d;Thu Dec 13 12:32:06 EST 2007;Committer;akr;1;7;6;13;0
9595af4ad59f9a8f98941d22619b61206be1a4c2;Thu Dec 13 11:52:15 EST 2007;Committer;akr;4;21;2;23;0
719841ca3779e22bb8ad3d2f4d3fc93d0db62030;Thu Dec 13 11:10:46 EST 2007;Committer;akr;2;9;0;9;0
7987f38467442964e6f33b913c1aa392769f844b;Thu Dec 13 09:20:13 EST 2007;Committer;matz;3;12;4;16;0
66bae8ad6df90c83b34908057afd991ffc9492c7;Thu Dec 13 09:05:49 EST 2007;Committer;matz;4;12;5;17;0
fb14b7eb05f9a2e378ebb69d2cbf001c3f4edbc3;Thu Dec 13 08:28:40 EST 2007;Committer;matz;2;16;6;22;0
e18e89384675fb9e0923bbea6c8923d99b8abdbf;Thu Dec 13 08:05:00 EST 2007;Committer;nobu;1;0;10;10;0
af69c730879ecd0ae4e63732d46522659c053b70;Thu Dec 13 08:03:31 EST 2007;Committer;nobu;2;7;0;7;0
02501dbe9157f7d8d233157c494b7dfa01d93726;Thu Dec 13 07:44:52 EST 2007;Committer;matz;2;5;6;11;0
266d186bcf06aab76ed14afd97199d9699c7295e;Thu Dec 13 04:10:24 EST 2007;Committer;matz;2;6;0;6;0
b21aa43b4c1e8f450040fac2125f73c96f35303e;Thu Dec 13 02:37:27 EST 2007;Committer;akr;1;10;0;10;0
cf8c1e49dd059a7549865e967a17777a3bfb99a3;Thu Dec 13 00:21:18 EST 2007;Committer;akr;1;25;25;50;0
b754d62f725210fc9bfdcd564e9fc96a20d965a6;Wed Dec 12 23:58:58 EST 2007;Committer;matz;4;14;4;18;0
0ca7036682dad1caea4e7a4fe8fd908d94c878e8;Wed Dec 12 23:46:58 EST 2007;Committer;matz;3;22;17;39;0
b92cee1ddbd8c0025ce2e11e3e02d160294556f9;Wed Dec 12 14:30:54 EST 2007;Committer;akr;7;16;11;27;0
098ca001752dd6cfd6c044f06e9773fc39536c6e;Wed Dec 12 13:23:07 EST 2007;Committer;matz;2;40;7;47;0
c6fa37e2f0b6ca4926690861f3e16aa15f93ba51;Wed Dec 12 12:27:39 EST 2007;Committer;matz;2;5;2;7;0
6fd91d288c695b2011ab49259f8f3a6a8ce50fbd;Wed Dec 12 07:39:43 EST 2007;Committer;matz;2;32;24;56;0
91142c95bbd14165937dba21799212703ba2d115;Wed Dec 12 03:45:36 EST 2007;Committer;matz;2;8;3;11;0
ad72efa269af16d7c3f66015a46fbac1a7f2d7d8;Wed Dec 12 03:11:44 EST 2007;Committer;nobu;4;20;3;23;0
65a30eb3e75823eee745ba9709f99f548a4cc9ef;Tue Dec 11 14:05:34 EST 2007;Committer;matz;2;14;6;20;0
646f27b8220ead3cb68cfd8f6e9870d203c430e4;Tue Dec 11 07:39:16 EST 2007;Committer;akr;4;18;10;28;0
7554dd13468b105faec11f5d8ffef4499381c59d;Tue Dec 11 07:19:28 EST 2007;Committer;nobu;6;18;2;20;0
2db98d937aa31ae832896e55b3293eea2c9204f3;Tue Dec 11 06:23:21 EST 2007;Committer;matz;3;14;5;19;0
3609358aacdf2fe551f584ff9d685e5c24b8fa98;Tue Dec 11 05:27:52 EST 2007;Committer;nobu;2;63;29;92;0
a153fdb6ed9d9596a64eb9f7b477f31e3aca5be5;Tue Dec 11 04:57:51 EST 2007;Committer;nobu;2;24;15;39;0
5802768b40e50cabfbfe0a198a44e01cbad9faae;Tue Dec 11 03:08:50 EST 2007;Committer;akr;4;90;69;159;0
9ee1ab0e28c3e9538941a55f1703a1a1ffd5cddf;Tue Dec 11 00:41:56 EST 2007;Committer;akr;2;6;1;7;0
0dd39db036cbbfcbf7176eab11d9190415229060;Mon Dec 10 17:24:52 EST 2007;Committer;matz;2;8;0;8;0
ff7f462bf49a1199b1657de6a73a0dc91deae1fa;Mon Dec 10 16:53:52 EST 2007;Committer;matz;2;57;3;60;0
6bd65de203c7aaffc8d4241a771491356002ed75;Mon Dec 10 16:22:52 EST 2007;Committer;matz;3;25;17;42;0
d2e596ad04050ebfe575106ea815849aefb689b2;Mon Dec 10 13:25:39 EST 2007;Committer;knu;3;33;2;35;0
6d7999c13285a7a2bec9073504703226e1a2b2f2;Mon Dec 10 12:47:55 EST 2007;Committer;nobu;3;34;7;41;0
d04f1089528f395caf7398a94af947f7e32128e2;Mon Dec 10 12:01:45 EST 2007;Committer;matz;2;7;0;7;0
f6a9c859bec2801a99c26a09c8845c54401a62be;Mon Dec 10 10:03:48 EST 2007;Committer;matz;2;11;4;15;0
32bfc874fa5325d34a5e51c91667360a125339b2;Mon Dec 10 09:49:37 EST 2007;Committer;akr;1;2;0;2;0
9ab6f563a2a5959c9ccf04ff44c4798a7b3037ce;Mon Dec 10 09:31:28 EST 2007;Committer;matz;2;7;1;8;0
3a3bda73dd0e5d6803f2aecfe7415804268d9251;Mon Dec 10 08:46:06 EST 2007;Committer;nobu;5;229;292;521;0
38b92f838f0c387807e5f430277af5cd7196cd71;Mon Dec 10 08:25:01 EST 2007;Committer;nobu;2;46;46;92;0
c26e32ec168040c5778dfdd6a435d53ab283a181;Mon Dec 10 07:52:19 EST 2007;Committer;nobu;2;8;3;11;0
5ee029f62cbb728453f6db3ae54127a376696447;Mon Dec 10 05:34:50 EST 2007;Committer;matz;4;17;20;37;0
7ded13f54b4963f9e535d4909c9957d33f68f1ed;Mon Dec 10 05:01:47 EST 2007;Committer;matz;8;3797;3;3800;0
38a24d73c80acf6b7eba4e7ad6c958fd95de2f86;Mon Dec 10 04:50:35 EST 2007;Committer;nobu;3;54;29;83;0
eaba0fc94ad627d8ffac30b3f0317a2b8f758504;Mon Dec 10 03:16:02 EST 2007;Committer;akr;1;8;0;8;0
b7090e3673897708b50ee82d4247ca3f5f3dce20;Mon Dec 10 00:59:04 EST 2007;Committer;ko1;2;15;15;30;0
3db5e76e50f1acd979c0f40cd139e224f0ac6af3;Mon Dec 10 00:57:10 EST 2007;Committer;ko1;3;19;0;19;0
126e7ed66febc5f20bf8d2e259b24c8f37b78621;Sun Dec 09 23:25:20 EST 2007;Committer;matz;2;6;2;8;0
862b6b68a4ca21026e925b6fba0a81ebe0e70f84;Sun Dec 09 23:18:25 EST 2007;Committer;akr;1;27;27;54;0
6e12ae857e9f0ac087efb44cf0de3d6aef72e727;Sun Dec 09 23:16:54 EST 2007;Committer;matz;3;9;5;14;0
f4592d7bb0c88ab22e15e632afb70279f119af4e;Sun Dec 09 21:48:05 EST 2007;Committer;akr;9;28;11;39;0
08eb58d3dd6543a44c798aacc4385bf9f8bc005d;Sun Dec 09 21:44:19 EST 2007;Committer;akr;4;171;6;177;0
9d8075b99cf131e0b2522bcf82a5b47e82d3882e;Sun Dec 09 16:39:49 EST 2007;Committer;matz;7;87;95;182;0
e56e8c758d8effb54144df0b61ca9d5f6b98a0cd;Sun Dec 09 13:35:38 EST 2007;Committer;akr;3;93;44;137;0
2d101f0a87ed256fda0b85a93ad89997ff0f2f13;Sun Dec 09 11:57:06 EST 2007;Committer;akr;1;25;0;25;0
7a7c26be7328099b4b2ba57ba9547e20080e071f;Sun Dec 09 07:35:54 EST 2007;Committer;akr;2;20;4;24;0
18d8fbac5484411bc7194c408edf0a3e17ea640d;Sun Dec 09 07:12:44 EST 2007;Committer;akr;3;110;6;116;0
a44f38ff52e3d828173e0719bc27ef7a5f381cf4;Sun Dec 09 06:00:56 EST 2007;Committer;ko1;2;7;2;9;0
3923d7f420d1cbcad2b7fd781ffeb389d3151d07;Sun Dec 09 05:56:00 EST 2007;Committer;ko1;3;19;7;26;0
3a8f7f1d7f3f1b66f47c37b230bc9c53cbdae250;Sun Dec 09 05:12:31 EST 2007;Committer;akr;5;68;8;76;0
5a1c2b2677129ffadde65633577f7e0a739a1745;Sun Dec 09 03:50:11 EST 2007;Committer;akr;3;27;4;31;0
78cc1c45ee1dac3f32fccb6f0cd8739403d7568c;Sun Dec 09 03:39:04 EST 2007;Committer;nobu;2;10;5;15;0
54f236542d7a1cb28e7902a987ca583b5eefe874;Sun Dec 09 03:18:21 EST 2007;Committer;nobu;3;13;1;14;0
45fa4a4b634515ff9c7f1e8008990f0e7e8c46dc;Sun Dec 09 03:12:25 EST 2007;Committer;nobu;4;13;8;21;0
0076f3b3f825b39e4629b29c6525864f68d9a855;Sun Dec 09 03:03:18 EST 2007;Committer;nobu;2;5;1;6;0
4892115adae731491f02bbcbf721334fd2cfc4a1;Sun Dec 09 02:30:22 EST 2007;Committer;nobu;1;3;3;6;0
54c146d2c3d8a9a5e3d4bbd8b5fd61e17ad45819;Sun Dec 09 02:29:24 EST 2007;Committer;nobu;4;13;10;23;0
221e6de720042585265cb38c05701663829ac40d;Sun Dec 09 01:25:32 EST 2007;Committer;akr;1;1;1;2;0
be98b422b086ecd51da282e29f7f002970f767a4;Sun Dec 09 00:56:10 EST 2007;Committer;akr;1;49;0;49;0
56f8092459c4c5b6c5f263552bbd8db352eb72e9;Sun Dec 09 00:31:02 EST 2007;Committer;akr;1;58;0;58;0
78eae5da628492d64f582b577d401b3864b04f16;Sat Dec 08 19:10:58 EST 2007;Committer;akr;2;8;2;10;0
4db4d80357a40690531cd393a79ec6f8f8484cd8;Sat Dec 08 18:47:42 EST 2007;Committer;akr;1;1;1;2;0
cbff149e47a370762f6e0de6bb00d995c06c5909;Sat Dec 08 18:45:20 EST 2007;Committer;akr;1;7;0;7;0
cde5b2a9cf6934bd5fe006be31d6a09901609c13;Sat Dec 08 18:41:47 EST 2007;Committer;akr;2;7;1;8;0
6c6cf008cd8df085b9402439c3c14963d8cc422a;Sat Dec 08 17:41:47 EST 2007;Committer;akr;1;9;0;9;0
0bb9c3e6d9dfaf11b66ed78493e0fca48212b4c9;Sat Dec 08 09:24:52 EST 2007;Committer;akr;1;0;3;3;0
1dd06c4301cd759d22917503e6c341b291146f2f;Sat Dec 08 09:01:43 EST 2007;Committer;akr;2;5;1;6;0
d4463c42c025eaa06fe5a71e5255031353996c0b;Sat Dec 08 08:53:20 EST 2007;Committer;akr;1;3;1;4;0
cf95a55cc9015fbb6b906d37d68589d4362edff4;Sat Dec 08 08:23:07 EST 2007;Committer;gotoyuzo;2;9;5;14;0
5b57724691aac5ef0cab09cbaf18874d3ffd4209;Sat Dec 08 08:11:52 EST 2007;Committer;akr;2;11;6;17;0
b12bb501496a3ad2822db14d13629629fad8fefb;Sat Dec 08 07:21:05 EST 2007;Committer;akr;4;75;12;87;0
9667f7953e1ca78e5acfa40e9573d1fcdbd3d1ea;Sat Dec 08 04:31:26 EST 2007;Committer;akr;1;59;0;59;0
f1b7e60cb90a7e1a392d4ffccd07dd06eeff5345;Sat Dec 08 02:50:43 EST 2007;Committer;akr;10;119;53;172;0
990bec97020bfabd09ebfd92581f505b4f09a78a;Fri Dec 07 11:35:13 EST 2007;Committer;gotoyuzo;3;5;304;309;0
9bc20bef7a8ff177a385e9437c9005a895f93caa;Fri Dec 07 06:45:28 EST 2007;Committer;akr;2;10;6;16;0
62c94002ef73f284830fdda64c39b8acd87b6118;Fri Dec 07 06:04:03 EST 2007;Committer;nobu;2;9;6;15;0
2257138aa5951bfd4e500e99437451ca0d8eb0d7;Fri Dec 07 03:27:20 EST 2007;Committer;nobu;2;64;49;113;0
ff2ec563b2de24bf4025f1114c35052c900b765f;Fri Dec 07 03:22:28 EST 2007;Committer;nobu;2;24;18;42;0
0f8e9a24c1172ebbc37985173ea124892e255df3;Fri Dec 07 02:52:37 EST 2007;Committer;matz;2;5;1;6;0
aff0d98a5bb4e8b6d808fa1a461991f3158690d4;Fri Dec 07 02:51:31 EST 2007;Committer;matz;3;9;9;18;0
a42bb2a45697ec1f988b367ebbab22f62501c520;Fri Dec 07 01:42:16 EST 2007;Committer;akr;1;13;0;13;0
92af9c0d5417f663be10b5ab49c0223bb018e333;Thu Dec 06 10:09:44 EST 2007;Committer;akr;1;1;1;2;0
b791feb69486468741b10e3737381b3919c603c3;Thu Dec 06 10:06:41 EST 2007;Committer;akr;1;1;1;2;0
948d1a6821dc3388ef8ce5e0a755e58d38e520ea;Thu Dec 06 09:37:40 EST 2007;Committer;akr;1;2;0;2;0
69406aad505414de34dc8b560ac1eadf147b0dbc;Thu Dec 06 09:28:26 EST 2007;Committer;akr;10;588;143;731;0
de4ec689910c07a48b81083adc3130b6b6023be3;Thu Dec 06 02:04:19 EST 2007;Committer;nobu;2;19;8;27;0
95cf86dd269c1b468ab55007616ef2854a13cdad;Thu Dec 06 00:27:35 EST 2007;Committer;nobu;1;9;0;9;0
a5c6b705dbe19ac4123f7f5773c4a86cf74bec61;Wed Dec 05 16:37:25 EST 2007;Committer;nobu;3;10;8;18;0
46d6af3a9ca883ac2b68f11f8e2ad23e494510be;Wed Dec 05 16:04:12 EST 2007;Committer;naruse;3;23;0;23;0
360a674fe5ae9f03a8ef4c1a425808069b8a9510;Wed Dec 05 07:43:08 EST 2007;Committer;nobu;1;1;1;2;0
430f5a1d61a1dae175f1e29840f7e7a91c1eaf1c;Wed Dec 05 07:18:52 EST 2007;Committer;nobu;4;100;15;115;0
0af432ce08b33428b9dc6c5c60ffccee3f60fd77;Wed Dec 05 06:25:56 EST 2007;Committer;nobu;2;11;18;29;0
e8ffe28214c8908a2fec5d7869d89db9e41eeb4e;Wed Dec 05 06:15:23 EST 2007;Committer;nobu;2;31;16;47;0
9c1e3d00d51e28fa8ffedd56dc326fdc0ffbc6db;Wed Dec 05 05:25:58 EST 2007;Committer;ko1;2;5;1;6;0
45b05313ec0db9c6940ce6c144e8a87a2a240c60;Wed Dec 05 04:53:51 EST 2007;Committer;nobu;1;1;1;2;0
8ea5018d20c3deed76c3347c61f11fc480ebe712;Wed Dec 05 04:41:27 EST 2007;Committer;nobu;4;39;24;63;0
398cdd3825d793f5ed7f7e7e34fc84768cd2af20;Tue Dec 04 10:56:44 EST 2007;Committer;nobu;2;12;4;16;0
01b097e475a4cba774d2ba14db9b9d275b9561bb;Tue Dec 04 09:06:41 EST 2007;Committer;naruse;2;9;4;13;0
825ce503c0e52edb944def195be0d3d55e3e71b3;Tue Dec 04 08:09:44 EST 2007;Committer;naruse;40;4688;4681;9369;0
86f1cff0eb8fa3c4d5925fb8fe5eac31a323bb84;Tue Dec 04 07:35:07 EST 2007;Committer;nobu;1;10;0;10;0
bea3572740606bca4e09dd5c46d61b23c89ab183;Tue Dec 04 07:34:49 EST 2007;Committer;nobu;2;44;26;70;0
ac9c68fbe105cd55f5e6dae076911f16236d9a93;Tue Dec 04 06:31:42 EST 2007;Committer;akr;1;4;0;4;0
6658e98c2d3f2ba3f59cb883dd784ad07a502edd;Tue Dec 04 05:34:37 EST 2007;Committer;nobu;2;9;0;9;0
80644b31d5fa315bfe2ef73456557a9c985f88bd;Tue Dec 04 02:23:52 EST 2007;Committer;nobu;4;12;4;16;0
97a9e9da8504718660d03253a528161da7cfdb8f;Mon Dec 03 02:53:13 EST 2007;Committer;usa;16;1568;1779;3347;0
6af5227ec0a2d77edb5156d1c1b7e598d006bef8;Sun Dec 02 15:46:21 EST 2007;Committer;akr;1;2;2;4;0
7f65110b53b2ee66a06d6aae3259e3c78db253cc;Sun Dec 02 14:42:05 EST 2007;Committer;akr;1;13;0;13;0
1524572ce96fcef2871b2dcda3eaf3161b2b8469;Sun Dec 02 13:08:03 EST 2007;Committer;nobu;2;17;5;22;0
c650096adf12f6a51604d455a6aae7314ab3d1e1;Sun Dec 02 11:45:02 EST 2007;Committer;akr;2;6;2;8;0
040e3e7bddb7269e25b2e88f8135d7fc9bbe1afd;Sun Dec 02 06:47:59 EST 2007;Committer;nobu;2;19;11;30;0
4fab2c7526c160bef4db28871864c53c60a6c587;Sun Dec 02 06:45:53 EST 2007;Committer;kou;7;22;9;31;0
f3e3ce4c8241e1c6aa2afca5468d7fb69b93c47b;Sun Dec 02 06:20:23 EST 2007;Committer;ko1;3;10;4;14;0
f8e92ad562b10547c2fdcfe028e2616da3f6f579;Sun Dec 02 04:13:17 EST 2007;Committer;akr;1;1;1;2;0
9bd11f24b3d37c689519696db2851402a77270d0;Sun Dec 02 02:53:46 EST 2007;Committer;akr;2;81;13;94;0
0893957bc6c5c1b0a6fc145ed6b53a2e475007e8;Sun Dec 02 02:04:34 EST 2007;Committer;akr;1;1;1;2;0
850cd3a536e491bba93c9a09670d680b9294fb4d;Sun Dec 02 01:43:29 EST 2007;Committer;akr;1;5;0;5;0
21729a1c7796cb152f9dc13b56ca2d761e511a96;Sun Dec 02 00:16:24 EST 2007;Committer;akr;3;32;3;35;0
5a930580c9ec152ac3940b3b5ecfe2a86813835c;Sat Dec 01 17:29:43 EST 2007;Committer;akr;1;6;0;6;0
bd741ee16a414d15cc7be250c70f0cb01e742805;Sat Dec 01 17:24:13 EST 2007;Committer;akr;1;1;8;9;0
7ff702406a324ed12c69bc23a7cfaf066e401547;Sat Dec 01 16:56:19 EST 2007;Committer;akr;7;635;174;809;0
d92b461dd9f5ff0eae7d15435aab1507dfb53496;Sat Dec 01 16:01:49 EST 2007;Committer;jeg2;2;9;3;12;0
d5bd9d159369ea12070497878e40ae6f829f5e70;Sat Dec 01 14:05:53 EST 2007;Committer;matz;5;23;19;42;0
ec27275122985aa832d084062652ca8461a037df;Sat Dec 01 13:26:01 EST 2007;Committer;matz;1;0;1;1;0
b587334b08d74596c430e23948e9d6dd6acb4b2b;Sat Dec 01 11:13:32 EST 2007;Committer;tadf;2;12;4;16;0
0d4761fb1a122e012a355107b6cb2fbedaa7a124;Sat Dec 01 05:43:06 EST 2007;Committer;ko1;4;25;14;39;0
70e28cf1ebb0edc674aa60556ed125f7f32e1984;Sat Dec 01 05:22:15 EST 2007;Committer;matz;2;22;9;31;0
2bbffcd6a401f047beda6ec4aadacc2c899afec6;Sat Dec 01 05:20:06 EST 2007;Committer;matz;8;14;48;62;0
6fafbfd63e9f56350e06910bbac70bf7ff0d5df0;Sat Dec 01 04:30:19 EST 2007;Committer;ko1;7;50;18;68;0
4afa82056c42f9f2010fbc9d17c5aa3887610e2b;Fri Nov 30 18:34:34 EST 2007;Committer;nobu;3;11;6;17;0
da42035b09065c3efdb0115e6d30fde08ea5c82c;Fri Nov 30 14:49:45 EST 2007;Committer;matz;4;18;3;21;0
29c7c72e09b28e2dd35ac73805b33604c6e4ae09;Fri Nov 30 14:08:58 EST 2007;Committer;matz;4;22;7;29;0
897b452f8d83c28f8b9aedf513fb02dea025f6ea;Fri Nov 30 13:39:28 EST 2007;Committer;matz;1;0;231;231;0
16296af65d702580d97c40adc7aeb5d9bdde0be0;Fri Nov 30 12:47:49 EST 2007;Committer;matz;1;0;1;1;0
c861f13f0641c1c86d1c7b1fc7940927597456aa;Fri Nov 30 12:11:36 EST 2007;Committer;naruse;1;6;0;6;0
a049c43c65822b8736791d71c3d51dcca0f75cfa;Fri Nov 30 12:08:46 EST 2007;Committer;naruse;4;305;12;317;0
e46a61775933d1ce9207fde4422ad536fed4846a;Fri Nov 30 10:42:40 EST 2007;Committer;matz;3;12;2;14;0
9497f7996a67fd4ef1a89292d84a9b89e86a829b;Fri Nov 30 10:08:03 EST 2007;Committer;matz;2;13;2;15;0
092ec0146dbf4489e4754a6287ddc81feb055c83;Fri Nov 30 08:47:22 EST 2007;Committer;akr;1;1;1;2;0
58c070aa9bcfb391e86f271c6e7dee4757c73670;Fri Nov 30 08:15:12 EST 2007;Committer;matz;2;8;0;8;0
efedaa432b4c6847df4667598d31a60aae7b4615;Fri Nov 30 05:26:59 EST 2007;Committer;matz;3;9;4;13;0
058ec52c0db102a44de7fe09564c1ef0c5a0e1b5;Thu Nov 29 07:59:12 EST 2007;Committer;nobu;3;15;10;25;0
0cf0b824182fc643c4e295b7178b84e71fdded54;Wed Nov 28 09:22:57 EST 2007;Committer;naruse;15;346;152;498;0
6272cf8ecd8f4cd35af10aecf505f22b8244c56d;Wed Nov 28 07:48:23 EST 2007;Committer;akr;1;10;1;11;0
c2aef47c846e1ff2ddcc2059c36b494859d740f6;Wed Nov 28 07:31:10 EST 2007;Committer;ko1;3;19;5;24;0
49b1513d1e7fe5e8ce440a19c77865b74ee6ed87;Wed Nov 28 05:43:17 EST 2007;Committer;nobu;3;19;4;23;0
c3c320c40a39af7befb8a2add54fe5f4ad2fde9a;Wed Nov 28 02:45:12 EST 2007;Committer;akr;1;41;29;70;0
f63918441e61c9191d1040b9a50c9ee6df0f7f53;Tue Nov 27 22:53:28 EST 2007;Committer;akr;1;1;1;2;0
22c18f1e1bef63072149536a7b3532f2373a0e93;Tue Nov 27 17:44:21 EST 2007;Committer;nobu;1;3;3;6;0
6eea7a7c718acdeb2c800d52c5e738ef22d4c467;Tue Nov 27 17:42:12 EST 2007;Committer;nobu;3;35;28;63;0
0cdd3bced5e42557ed4ee3c7f3cd35f7f56cbcf0;Tue Nov 27 06:54:58 EST 2007;Committer;ko1;3;31;6;37;0
1bed0ccca83a56dac3a30ecf25a0dd0b3fe66118;Tue Nov 27 06:45:01 EST 2007;Committer;ko1;3;109;79;188;0
b0986a8f827cc97d7cf19b15c38fbdab794e34b9;Tue Nov 27 04:43:54 EST 2007;Committer;ko1;5;46;10;56;0
8e09ab045ff2cb241365ff03e3c7f02960c4f2e9;Tue Nov 27 02:58:11 EST 2007;Committer;matz;1;0;193;193;0
1152eef81de3897b3ff823aa84d515058b796109;Tue Nov 27 02:56:15 EST 2007;Committer;ko1;2;5;1;6;0
db2b0037fd2e8eb61d59d4e9a2420cabbba4cd78;Tue Nov 27 02:28:28 EST 2007;Committer;ko1;2;9;2;11;0
f5ee0fd52135315aba8441420cd647a06b718c59;Tue Nov 27 02:21:17 EST 2007;Committer;akr;6;30;22;52;0
9c7aab17a54996b7320e7bc34230a1aab7f7a115;Tue Nov 27 01:47:34 EST 2007;Committer;ko1;5;27;17;44;0
329484693ae6d9dab6e01675faf7b535c2783a83;Tue Nov 27 01:02:30 EST 2007;Committer;ko1;5;63;39;102;0
724de18989353b277b175e56ef69b78ec339510a;Mon Nov 26 14:24:29 EST 2007;Committer;seki;3;21;7;28;0
bfc502fe517dee050085df406c72f61593a9d2fa;Mon Nov 26 13:05:08 EST 2007;Committer;akr;3;103;157;260;0
35adbb5f8890cfba80b35f3042f1fb45f91c8790;Mon Nov 26 09:38:49 EST 2007;Committer;matz;2;6;1;7;0
cbd72b86da4f6ed5828c83ec17d9febd8e304bf7;Mon Nov 26 08:33:11 EST 2007;Committer;akr;2;5;0;5;0
e6140f3e3c2a0b17ce4f254187978d2a5fea4118;Mon Nov 26 04:33:21 EST 2007;Committer;keiju;2;7;0;7;0
2ed20789094a372076ca59539d18bd2fd3062f60;Mon Nov 26 02:49:44 EST 2007;Committer;akr;1;1;1;2;0
0dc9be63a5f5a2835f5e3910e9c2f4d5067b37f8;Mon Nov 26 02:27:59 EST 2007;Committer;akr;2;54;63;117;0
cf74bde83c9197fec51836bba6d0e81f1ee10f19;Mon Nov 26 01:44:23 EST 2007;Committer;nobu;2;12;2;14;0
691df99d6acd07d1791b68b6b7208ec553dab33f;Mon Nov 26 01:31:20 EST 2007;Committer;matz;3;11;17;28;0
e42d6b886245deba61e179bc0f9fa589c26737c3;Mon Nov 26 01:20:48 EST 2007;Committer;nobu;2;14;14;28;0
f7bd951bead8460d422db320480062e911d18fc5;Mon Nov 26 01:17:17 EST 2007;Committer;matz;3;12;9;21;0
b2e60b2ce7a7cbcb8a67ac78606a18d3c2591d81;Sun Nov 25 13:25:34 EST 2007;Committer;akr;5;318;40;358;0
43090c9f504f117203085286710d92afc2429f34;Sun Nov 25 07:47:51 EST 2007;Committer;akr;1;1;1;2;0
369697bcebcfd05a2b7d541d59a85fa529cfe6c9;Sun Nov 25 03:26:36 EST 2007;Committer;drbrain;9;254;34;288;0
f90fdbfc73ff41570a068b410692acd4812ef9f5;Sun Nov 25 00:38:33 EST 2007;Committer;akr;1;44;0;44;0
07ba43734dad3b26d3e0ecb6d3c75a05efce7d7d;Sat Nov 24 16:32:10 EST 2007;Committer;akr;1;79;0;79;0
1d8519ad8640029724e1469b6906da2bc8ed98fb;Sat Nov 24 16:08:10 EST 2007;Committer;akr;1;3;0;3;0
c4c151bed8dc3ffacf28a7f58cb23bcd82bcc5ae;Fri Nov 23 08:35:29 EST 2007;Committer;ko1;2;33;11;44;0
2a2e4bbbc3d43ad37fdef17f3d6942eb10db96b7;Fri Nov 23 08:34:34 EST 2007;Committer;ko1;2;5;1;6;0
1e4278c98dbb8481d460483146cf18f0ff108c37;Fri Nov 23 08:33:32 EST 2007;Committer;ko1;7;55;46;101;0
e265a55740d7cec3e392d421e4e0f76c6fdb56f0;Fri Nov 23 07:15:17 EST 2007;Committer;akr;1;1;1;2;0
0d8956725284206788bae5fbd6ed032f186ad366;Fri Nov 23 07:00:50 EST 2007;Committer;akr;4;30;4;34;0
2109a52503eb61ef38b25aa2266f0313e7ad56ac;Fri Nov 23 06:30:26 EST 2007;Committer;akr;4;231;10;241;0
f1afb3959cb1746ea9f632cac069549ff289e84b;Fri Nov 23 04:51:02 EST 2007;Committer;akr;1;2;0;2;0
0dbdad759916fb214750882cf73f4d686b3f10aa;Fri Nov 23 04:35:53 EST 2007;Committer;akr;4;45;24;69;0
d73f08d56d92de1ad41abb877c2f9ed6c8c15d76;Fri Nov 23 02:10:44 EST 2007;Committer;matz;3;33;14;47;0
050a10c607e471bb2f387eb9644db5ee9e43c46b;Fri Nov 23 01:46:44 EST 2007;Committer;matz;4;21;10;31;0
cca64ecb9a5d228de0d8fb483785a9bd78c7905c;Thu Nov 22 01:36:13 EST 2007;Committer;akr;1;1;2;3;0
6ed29c55ef84a2dab81a2b7eb8c2a0516438f333;Thu Nov 22 01:32:32 EST 2007;Committer;akr;1;21;0;21;0
c227d3feb393c7aaa4e40612dc1ac39e598df3b4;Thu Nov 22 01:17:52 EST 2007;Committer;matz;10;76;67;143;0
c79ab68d378cd2ebde4013e2204e0d365fce0b3e;Wed Nov 21 09:06:06 EST 2007;Committer;ko1;4;65;6;71;0
58b1f91b469fddbe52e280bc044d7c0594bca6d0;Wed Nov 21 09:03:52 EST 2007;Committer;ko1;2;21;1;22;0
a5c44807324afc06cac9975bfccd6579a0c07271;Wed Nov 21 07:40:36 EST 2007;Committer;akr;2;24;1;25;0
53b3bf961cd4f4de0388d56c7d8b5059eba1c3c0;Wed Nov 21 06:06:10 EST 2007;Committer;ko1;2;8;2;10;0
d154b1c346448b432245d19147502bbffb796cb5;Tue Nov 20 18:21:39 EST 2007;Committer;matz;2;10;4;14;0
7da723cfbb81a7e40228db33b65fbf4eecd574ad;Tue Nov 20 16:16:53 EST 2007;Committer;matz;3;7;24;31;0
43e55c6bc4ef107d1be548ed24a2772f96d36987;Tue Nov 20 12:50:29 EST 2007;Committer;akr;2;14;6;20;0
01dacec2b4f7ec733ebea7b0427fc123542be21e;Tue Nov 20 11:35:12 EST 2007;Committer;ko1;4;10;4;14;0
9ea27a0b53b7b104c62b7c37119d176c7c103dfd;Tue Nov 20 10:55:22 EST 2007;Committer;akr;1;40;7;47;0
3453b2bd0e186788bb81deff5d723cf48e10881f;Tue Nov 20 10:47:53 EST 2007;Committer;ko1;11;86;40;126;0
d481323b9211cc0823fba407253d0432fa7f1734;Tue Nov 20 08:12:34 EST 2007;Committer;akr;2;101;0;101;0
60d0ddc942e1c5822bd7b88a4df61153891e82eb;Tue Nov 20 07:25:07 EST 2007;Committer;akr;2;6;1;7;0
64ba5303fd885833697f026cffbeb6f98bc8ed7b;Tue Nov 20 06:09:03 EST 2007;Committer;nobu;2;5;2;7;0
d7e4c1e66b65fdb70a71b9aaf687bf77055a4f15;Tue Nov 20 06:08:16 EST 2007;Committer;nobu;2;6;0;6;0
db74541efec489c62310ab85091b28bb360e79c8;Tue Nov 20 05:56:43 EST 2007;Committer;drbrain;19;275;95;370;0
cae4fb76dcc6810a38ad67301fb764b8b7e5c5ca;Tue Nov 20 04:04:51 EST 2007;Committer;usa;5;59;53;112;0
0d8ac93f58782d694f30daf7dbf2735b3ecb434c;Tue Nov 20 03:16:53 EST 2007;Committer;akr;5;165;25;190;0
ee1029cb7f040405c1e249bbbd5806f509ef39e1;Tue Nov 20 03:01:49 EST 2007;Committer;akr;2;8;2;10;0
6591e380169e85e7764150e3a93722ca990ee05d;Mon Nov 19 18:30:18 EST 2007;Committer;seki;12;95;85;180;0
44b6b031bac42734d567b3adfefcaa80011fb039;Mon Nov 19 16:19:12 EST 2007;Committer;akr;1;3;3;6;0
b4a002070779beaf267ae86bb9c54ba50e99d633;Mon Nov 19 15:57:52 EST 2007;Committer;akr;3;27;2;29;0
18b46e0c21738f128a21519fd87ff5d38800deeb;Mon Nov 19 14:40:15 EST 2007;Committer;akr;1;130;88;218;0
b5ccb6b34f05561b1dbf273f32c955ce65d9bf85;Mon Nov 19 10:55:39 EST 2007;Committer;akr;1;1;0;1;0
63a297994b9226276d36ecf986e301f3f83fccf0;Mon Nov 19 09:48:00 EST 2007;Committer;akr;2;22;10;32;0
81f0bb309e5448a1c62e1f54df0deb716869a794;Mon Nov 19 09:24:28 EST 2007;Committer;akr;1;6;1;7;0
a070c4fbe3cff184d224d1abb8a3101e3c11fc48;Mon Nov 19 09:09:38 EST 2007;Committer;akr;11;569;174;743;0
a2946d85ec24abd6693a366b78f19cb03acf81b2;Mon Nov 19 08:49:42 EST 2007;Committer;matz;2;6;0;6;0
7a978073c9160e6ed1c706aaf034b2c4c4d104e1;Mon Nov 19 07:10:09 EST 2007;Committer;matz;7;112;51;163;0
03c4e447fab16864abed71b174a0636d9524b5b9;Mon Nov 19 07:06:03 EST 2007;Committer;matz;2;17;5;22;0
126bd2014139a951e0c989243fe4b0de27c89978;Sun Nov 18 17:44:09 EST 2007;Committer;nobu;2;12;5;17;0
9cef6acdc7c377d30dbfa6fa9f56b1097b2ba998;Sun Nov 18 17:31:39 EST 2007;Committer;nobu;2;5;1;6;0
94175959938eff1977b6895e98c626bae31788ac;Sun Nov 18 16:53:12 EST 2007;Committer;nobu;3;10;5;15;0
30e97cbb8b4095250784cae859ba970413451f45;Sun Nov 18 11:50:25 EST 2007;Committer;akr;2;6;0;6;0
3184ac2dfed8366246df87af97eee548f4ab7248;Sun Nov 18 09:30:17 EST 2007;Committer;akr;3;18;2;20;0
1e3ca9807b94902e1a36ef9abacea4cb0116209b;Sun Nov 18 08:30:26 EST 2007;Committer;akr;2;8;3;11;0
68543f30921c52cb1bf5c041879a232b41ba6580;Sun Nov 18 07:18:56 EST 2007;Committer;akr;22;92;115;207;0
c719cd9b463049932ae1dc1af5a6a1b50609cbef;Sun Nov 18 05:03:46 EST 2007;Committer;nobu;2;7;0;7;0
16dc06014c00f3fcf6d1387740f016def024b08b;Sun Nov 18 00:09:50 EST 2007;Committer;nobu;3;17;10;27;0
5c19fbacec511e2dd62e7a76e3160f7b7b707358;Sat Nov 17 20:25:27 EST 2007;Committer;akr;1;56;4;60;0
aa7ce1ece14842c6e376107c339374e5bc6f4b6c;Sat Nov 17 20:20:44 EST 2007;Committer;akr;2;11;4;15;0
24dcd39f193332e85485fabec0b9e730957b0aca;Sat Nov 17 15:04:55 EST 2007;Committer;suke;3;9;5;14;0
4bd57e3311ef216016ba06560f2b531147678511;Fri Nov 16 14:41:11 EST 2007;Committer;matz;2;41;0;41;0
0d95854a52fb35f9d6827aef91fca50d6bcc600f;Fri Nov 16 08:41:37 EST 2007;Committer;nobu;2;5;2;7;0
85b72a85b50d9b03045478b28481ead2fbca205a;Fri Nov 16 08:03:36 EST 2007;Committer;nobu;2;16;8;24;0
731aa0d0a886bef3fc6a8591e706d7284a4f8cb8;Fri Nov 16 07:29:44 EST 2007;Committer;shugo;4;40;23;63;0
fd0ab684150cde7672d5e3d524c9c1813b05e76f;Fri Nov 16 02:16:43 EST 2007;Committer;nobu;3;8;4;12;0
75feee0968c9345e7ffd2bda9835fcd60b4c0880;Fri Nov 16 01:30:29 EST 2007;Committer;nobu;27;1744;1744;3488;0
c0978692df91f23d4dd32f3fe247763173ed61a5;Thu Nov 15 18:36:51 EST 2007;Committer;why;4;7;4;11;0
91e0600535329f9fda341ebc876b6ddef9c0ea8c;Thu Nov 15 18:03:26 EST 2007;Committer;why;2;7;3;10;0
2fb73a8b0a41460ab886989f4e2380b53ca0e016;Thu Nov 15 17:54:32 EST 2007;Committer;why;4;27;9;36;0
808becf9e0919d5e155be1574d364ada6046c111;Thu Nov 15 10:52:21 EST 2007;Committer;usa;1;1;0;1;0
0595aef18eaf442b91f013bbe8a289fca961f104;Thu Nov 15 10:50:34 EST 2007;Committer;usa;2;6;1;7;0
7d6eb8e68bb215a04ad7b5b28d31af6b3c177849;Thu Nov 15 09:07:45 EST 2007;Committer;akr;2;6;2;8;0
790f631301b8318df8b57ec8967fb2a56215cf76;Thu Nov 15 08:33:10 EST 2007;Committer;akr;1;1;1;2;0
479c06d19d415f19a97f296c27a8a021f0c131c6;Thu Nov 15 08:30:07 EST 2007;Committer;akr;2;8;2;10;0
f1bc46f06d56232b38d53e263efc631efe68eb9b;Thu Nov 15 08:08:40 EST 2007;Committer;akr;2;9;3;12;0
dc6e5706651f1a53c048c14db039091139bf79ba;Thu Nov 15 05:29:58 EST 2007;Committer;nobu;2;8;1;9;0
afb554d90a742933f7f45ecd4f443ba427508e92;Thu Nov 15 03:32:26 EST 2007;Committer;akr;2;10;3;13;0
3b37c7456406b7b9423c5fe0399f792be37e7d27;Thu Nov 15 03:26:20 EST 2007;Committer;akr;2;43;32;75;0
af2ab37334cdd70ad4d0a7e859ded4653dcc391c;Thu Nov 15 03:20:52 EST 2007;Committer;matz;2;18;4;22;0
4c56aaa162645ff29e5524271d38a6cf1113aa61;Thu Nov 15 03:15:37 EST 2007;Committer;matz;3;8;4;12;0
af6a9d70b27ba96366a2b7b37c0ed06d687d86bc;Thu Nov 15 02:54:55 EST 2007;Committer;akr;2;31;12;43;0
0529882de724854044ee499fbdcb7ffbcad6e06c;Thu Nov 15 02:27:08 EST 2007;Committer;akr;2;6;1;7;0
67172a240103ed20d297fffd113171da7b4f3e5b;Wed Nov 14 07:17:18 EST 2007;Committer;matz;2;9;0;9;0
326659c0bfdd9adc1f4a032ced0374dbb6a7bcc8;Wed Nov 14 07:03:39 EST 2007;Committer;matz;3;24;32;56;0
e81b38e3782d280c1577b78b35f8a1c5cd217a3f;Wed Nov 14 05:06:36 EST 2007;Committer;akr;5;17;8;25;0
d907cbc81d6aa67502695df21a6f31c55325db0c;Tue Nov 13 22:13:04 EST 2007;Committer;ko1;18;115;107;222;0
3688c7a1eeda83b3da39cf03bbd0b8ae09df94b9;Tue Nov 13 22:09:43 EST 2007;Committer;ko1;3;4;101;105;0
499fef3e53ed230ddf1126eb881f579f4e64014f;Tue Nov 13 17:50:33 EST 2007;Committer;nobu;2;11;4;15;0
1a6e152000eb036b28ebe26a4b89f03d9300d455;Tue Nov 13 17:18:34 EST 2007;Committer;akr;1;6;6;12;0
c87280a54ee7fa255102ff55ea042721943df1bc;Tue Nov 13 17:12:52 EST 2007;Committer;akr;2;4;6;10;0
093fe3b839b9d3c5890e0d31faaefcce5d8acf7c;Tue Nov 13 16:54:27 EST 2007;Committer;akr;2;11;0;11;0
fd3ef45a423675e71b22952b59963058039063a6;Tue Nov 13 16:34:45 EST 2007;Committer;nobu;2;26;6;32;0
25c0cb981af8fda9860ec6e365b9ea7a9e3f498f;Tue Nov 13 16:00:53 EST 2007;Committer;ko1;17;213;197;410;0
c4af7f51b7c703cfdf4a84f633af6b892b5d14a8;Tue Nov 13 15:15:39 EST 2007;Committer;nobu;3;9;4;13;0
19c0ede6fc6d148af85e2f5191a63da65b2e3feb;Tue Nov 13 14:59:02 EST 2007;Committer;akr;1;1;2;3;0
d5a3389886c9dc7f3492ef5369009c40d85b0f3c;Tue Nov 13 12:41:41 EST 2007;Committer;nobu;10;85;56;141;0
b7d363ead696a2f1143c547d71d0242b1402c9f6;Tue Nov 13 07:33:09 EST 2007;Committer;nobu;3;19;2;21;0
9829e14432c2d30371305120c58c406a9df69a68;Tue Nov 13 06:29:49 EST 2007;Committer;akr;8;293;218;511;0
65cb92fca34538ce3cb39ac91f9421674c57dfc5;Tue Nov 13 06:24:06 EST 2007;Committer;ko1;2;13;7;20;0
69c1181a9f4ff295b3bcdb465979323533b50f65;Tue Nov 13 05:45:52 EST 2007;Committer;why;2;18;13;31;0
8d464a9948f034160617b86aa5de43780e226f95;Mon Nov 12 18:41:31 EST 2007;Committer;shyouhei;3;9;4;13;0
862cd3cd3c1c78dae69500fdae2be6abb63b72db;Mon Nov 12 15:38:10 EST 2007;Committer;shugo;2;164;125;289;0
fef818ec822e978c73b68d3ecaa8e730316bd843;Mon Nov 12 10:47:46 EST 2007;Committer;usa;2;5;1;6;0
647cd75166d9d40b3fe8f0abd10adf1612375ad0;Mon Nov 12 10:46:02 EST 2007;Committer;usa;3;7;2;9;0
dc3ee49747027a6d2bd7c00e79d97d714d14ad39;Mon Nov 12 09:32:55 EST 2007;Committer;nobu;3;6;2;8;0
2c42aa4364f2be6cfc83183ad51cc771a6cfb065;Mon Nov 12 08:15:10 EST 2007;Committer;akr;3;8;4;12;0
bbad2d22eae6ce9a3fe9b7ad257ff1dadfdeb763;Mon Nov 12 07:52:31 EST 2007;Committer;nobu;2;36;0;36;0
c840239cc8b95f0810e5125599a469c15909ac07;Mon Nov 12 07:49:36 EST 2007;Committer;akr;3;20;15;35;0
a48fd5df213e076084757a5333d7b4767eff1cfc;Mon Nov 12 05:04:24 EST 2007;Committer;akr;3;13;10;23;0
8110d523333c48d8a2fd7018d98e193a4f00dbcc;Mon Nov 12 04:54:00 EST 2007;Committer;matz;3;11;5;16;0
2c645e7ab61bc7562a58c35f6bd12d335b7281e4;Mon Nov 12 03:59:52 EST 2007;Committer;akr;1;5;5;10;0
e8f7398ce95c1cb1b8ee1114a3df47530523d74d;Mon Nov 12 03:18:49 EST 2007;Committer;akr;2;5;5;10;0
6f9dbb1636e34dbf12e45b31bc1f54611d174280;Mon Nov 12 01:31:11 EST 2007;Committer;akr;3;14;1;15;0
457686dd11881afbaed38c03bc94dcc79dd9b908;Sun Nov 11 12:48:39 EST 2007;Committer;akr;1;1;1;2;0
900da8992d987efe55e788a15d21777dba7d48eb;Sun Nov 11 12:44:01 EST 2007;Committer;akr;1;5;3;8;0
24b62f0ee88d4ef3f2fc0ef09b0883454162483c;Sun Nov 11 12:15:50 EST 2007;Committer;akr;2;1;5;6;0
f13082c95d0d7b3bf738989e10b3cd7a867deca2;Sun Nov 11 11:55:09 EST 2007;Committer;akr;2;5;1;6;0
d705eabd777010b4306c996c9a8a3fc9a2795b7c;Sun Nov 11 11:35:49 EST 2007;Committer;akr;4;4;9;13;0
200c3aaa25c07fc40cb4bc9b38a51528e2117807;Sun Nov 11 10:41:35 EST 2007;Committer;akr;2;7;9;16;0
ae7a85f54961576ffa5273a6710a550e1473143a;Sun Nov 11 10:33:33 EST 2007;Committer;akr;1;5;1;6;0
7687666c4511af9ca98e1699a7b4a2e2798c82e7;Sun Nov 11 10:21:30 EST 2007;Committer;akr;1;3;3;6;0
efd8303bc39d07a2bb20c891bf1778077c437e7e;Sun Nov 11 09:32:30 EST 2007;Committer;akr;2;3;3;6;0
f0a827f087db47cb4555491511cebf46e1eeec6c;Sun Nov 11 09:27:05 EST 2007;Committer;akr;2;11;1;12;0
577eaa60a705efd018a94ec5e752fb77626dba72;Sun Nov 11 08:42:13 EST 2007;Committer;shugo;5;48;22;70;0
c5335ee110cfab1179018f6b0dbd504742017a4e;Sun Nov 11 07:56:30 EST 2007;Committer;akr;4;231;220;451;0
fc69e47713f248ca3c7429e532957032b4e09bf4;Sat Nov 10 20:44:57 EST 2007;Committer;drbrain;2;27;0;27;0
53d2cd2435f8caaa1a3dc762e3e089c302b60a44;Sat Nov 10 16:33:30 EST 2007;Committer;akr;1;6;0;6;0
098a5639355b11697159ab916f67b53b43088a8b;Sat Nov 10 14:53:26 EST 2007;Committer;akr;2;7;1;8;0
c585a9eba193379ca18f7e80f30af2a7552e97c1;Sat Nov 10 14:18:03 EST 2007;Committer;akr;4;9;15;24;0
7cb1a184c862beebca7cd47d7383bf89628d48fc;Sat Nov 10 11:22:28 EST 2007;Committer;akr;1;2;1;3;0
b3d64632eade955a4e6207ce422f84156caa9ceb;Sat Nov 10 10:51:42 EST 2007;Committer;akr;1;1;1;2;0
7315b449f3b184cc46568ad2e2e765d31510dab3;Sat Nov 10 10:50:58 EST 2007;Committer;akr;4;24;15;39;0
00e55418cedb52c5d10383359ccb4d6fb7aa2135;Sat Nov 10 10:22:38 EST 2007;Committer;akr;3;16;9;25;0
3480ff6ec1af70e16fb307bd17d9495c026c3f96;Sat Nov 10 09:24:54 EST 2007;Committer;akr;1;3;1;4;0
040ffb5d792d932215b7b6fbce9ee9752d76e285;Sat Nov 10 09:22:59 EST 2007;Committer;akr;7;103;14;117;0
66c127bc6f95761f967efc5109cd229973fbc50f;Sat Nov 10 08:33:28 EST 2007;Committer;shugo;2;16;1;17;0
f3a250758d9165385061504ba1bee6b33f8cb50d;Sat Nov 10 08:05:00 EST 2007;Committer;nobu;1;183;183;366;0
fbf59bdbea63efd34ccc144e648467d2f52e7345;Sat Nov 10 07:48:56 EST 2007;Committer;drbrain;144;21330;0;21330;0
7a4aad75356496559460041a6c063bdb736c7236;Sat Nov 10 07:35:37 EST 2007;Committer;drbrain;2;5;1;6;0
03919fd210e02b34e96190b122da0ef6ba61858f;Sat Nov 10 05:45:52 EST 2007;Committer;davidflanagan;2;19;0;19;0
16262b6972935aa773d5468b5528becff1d73032;Sat Nov 10 04:18:44 EST 2007;Committer;nobu;4;21;3;24;0
87f538563f39c379ffff373a48dcc2c5c8c5acf3;Fri Nov 09 14:33:18 EST 2007;Committer;nobu;2;26;15;41;0
6e572060eba0d526125bf3044104747062f6f79a;Fri Nov 09 13:04:22 EST 2007;Committer;nobu;3;10;3;13;0
28c0aec1d889cfb3447c708a790b0acb95607e2f;Fri Nov 09 12:49:03 EST 2007;Committer;ko1;2;5;1;6;0
94a6c1eef97a379d123fa1fe95612d2d4ad27e11;Fri Nov 09 08:48:13 EST 2007;Committer;nobu;2;42;4;46;0
70f70f7dfef89b145f74e44ad0777328caac3388;Fri Nov 09 08:14:42 EST 2007;Committer;matz;2;30;35;65;0
1c4e2b11a1f5fc00d727809225d089b7990ed979;Fri Nov 09 07:54:39 EST 2007;Committer;matz;2;7;2;9;0
7bfed9613cadef52574df8b3c7e1e6324d7230c4;Fri Nov 09 06:52:02 EST 2007;Committer;nobu;2;7;4;11;0
03d68e3ba44e457669b8115546355ef73b95f338;Fri Nov 09 06:20:15 EST 2007;Committer;nobu;2;7;1;8;0
c23d67293221c287f30320ff83ee957f6c63757a;Fri Nov 09 04:59:07 EST 2007;Committer;matz;2;7;1;8;0
364f0bfe9fa182a33a7b297546edf3b42052295a;Fri Nov 09 04:46:58 EST 2007;Committer;matz;2;11;6;17;0
4ab384be2d4a98868c8da9739609585efc15f920;Fri Nov 09 04:37:36 EST 2007;Committer;matz;4;30;14;44;0
a46c532ab83c1c080311e4c7948b6fc4e5d6df14;Fri Nov 09 03:56:38 EST 2007;Committer;nobu;2;28;8;36;0
4155206ebdc3aad0aafec2097c1cd42935397b82;Fri Nov 09 01:43:57 EST 2007;Committer;nobu;3;18;5;23;0
9a0e440b810a10efa5db716a5df36dd9d9229567;Fri Nov 09 01:39:56 EST 2007;Committer;ko1;2;6;1;7;0
4c040861c885b7446ae0a7ab786cc7994abf83e4;Fri Nov 09 01:29:24 EST 2007;Committer;nobu;4;40;7;47;0
9f6de20f5879ea8460e74e2b7bf1e989cc6573cb;Fri Nov 09 01:11:49 EST 2007;Committer;ko1;2;43;22;65;0
0303c1d42b0dc8c8dfe96b885adb7f7ab9098e85;Fri Nov 09 01:10:06 EST 2007;Committer;ko1;2;13;6;19;0
9099eab331f91a2c26c6722535193185e40e9296;Thu Nov 08 22:27:54 EST 2007;Committer;matz;3;9;6;15;0
68ddfec346331004e4b4a5374ee4e60c756d7d5c;Thu Nov 08 08:12:59 EST 2007;Committer;davidflanagan;2;21;9;30;0
453889cf0ccc2d5676f49893e670fc611e4ae08c;Thu Nov 08 06:14:45 EST 2007;Committer;davidflanagan;2;4;58;62;0
219d2315afc0fbb393ed759fd48005c92d32b32d;Thu Nov 08 03:14:16 EST 2007;Committer;usa;3;12;6;18;0
baae1c407513a625db5544eb8c8ee6458398c790;Wed Nov 07 22:55:27 EST 2007;Committer;davidflanagan;4;602;81;683;0
89397d2f6e158877ea72c3ceaeda59efad2c32e0;Wed Nov 07 22:17:58 EST 2007;Committer;davidflanagan;2;21;0;21;0
f6fb4b3e8ecede29d25e4b5577174ed6f98d88c8;Wed Nov 07 22:07:13 EST 2007;Committer;davidflanagan;2;25;19;44;0
ec0187ef156b26df99241db95e6487038771d29e;Wed Nov 07 06:07:52 EST 2007;Committer;nobu;2;11;13;24;0
ba80fd2bbfc034398e92295a776940db56f8fae6;Tue Nov 06 20:21:50 EST 2007;Committer;davidflanagan;2;5;1;6;0
53f22d3a0529ba95d41356f7e93396a42da25cf8;Tue Nov 06 18:54:02 EST 2007;Committer;matz;2;6;1;7;0
d9ebaef79b6137e75d0cc53dd4f8d7136ebea684;Tue Nov 06 18:36:49 EST 2007;Committer;matz;2;5;0;5;0
23176da722333963c8b6011a527bfc92fb7b6199;Tue Nov 06 18:35:33 EST 2007;Committer;matz;3;11;5;16;0
974cd1b3800519d356298b0f7526dd90938c31ed;Tue Nov 06 07:37:49 EST 2007;Committer;nobu;2;26;7;33;0
bb1f1c57823758d2450d184ce7c85beb0d538bf0;Tue Nov 06 06:52:01 EST 2007;Committer;nobu;4;103;34;137;0
6a24fdb09d8f92c8bebcebe13ca424bd64577a44;Mon Nov 05 03:21:54 EST 2007;Committer;matz;2;5;1;6;0
1eee78b8769f7f01cead3b0782e1ee4ed84e281b;Sun Nov 04 20:36:20 EST 2007;Committer;matz;28;90;99;189;0
ed823523e32e8e8a04123ee5b8ec9c0f3de63c02;Sun Nov 04 20:17:06 EST 2007;Committer;nobu;2;7;1;8;0
950c618335a3e74fd5907e7af2b8812c67d3ad33;Sun Nov 04 16:23:59 EST 2007;Committer;matz;3;14;8;22;0
fc8bd6d109ffe798003c0cdddc51af5f0dd69391;Sun Nov 04 16:03:30 EST 2007;Committer;aamine;2;7;0;7;0
fc3b17968b0ca073498e0ee7f3e1be84070d6b97;Sun Nov 04 15:26:21 EST 2007;Committer;usa;4;14;4;18;0
af9c868eae89487e8083a61837479efad69b5c19;Sun Nov 04 15:03:31 EST 2007;Committer;akr;2;9;1;10;0
794fc684e8441afb840137e16fb26eafe3245c05;Sun Nov 04 14:53:36 EST 2007;Committer;akr;2;6;1;7;0
06f2b5b1d890253cdc4de78a326369a10d22595b;Sun Nov 04 04:52:08 EST 2007;Committer;ser;4;18;6;24;0
b3ab1dbf34f9ab5b69462c1b7aa8575c27cf8f65;Sun Nov 04 01:53:29 EST 2007;Committer;akr;1;4;0;4;0
4cdcfbe2ba2a9b529c189dc5e17b386d425e1920;Sat Nov 03 23:13:57 EDT 2007;Committer;akr;2;9;1;10;0
19c4d26c5138830c4a7d2435ce1af7d7184913c3;Sat Nov 03 19:04:53 EDT 2007;Committer;matz;4;123;41;164;0
e920777bb5c9d8a9e0cdf38d72fc00bbb40e6e39;Sat Nov 03 15:50:35 EDT 2007;Committer;akr;1;1;0;1;0
16c8ac3921ace49eecc16b16aabc5d417fb3d4b8;Sat Nov 03 15:09:10 EDT 2007;Committer;akr;2;95;0;95;0
6e8eea7abe958e7323e0941687ca2e917426d681;Sat Nov 03 14:07:48 EDT 2007;Committer;matz;3;20;63;83;0
fbc00c877258057fe282659cf5e7d0a1c9dcc80e;Sat Nov 03 13:41:52 EDT 2007;Committer;akr;3;16;1;17;0
9435853daf0cdc9400cd1dceb8b38cd83a81efaa;Sat Nov 03 13:30:59 EDT 2007;Committer;akr;3;27;0;27;0
21eebfb086c3feb30bc59a11299da6d74ec92e81;Sat Nov 03 11:35:59 EDT 2007;Committer;akr;5;45;2;47;0
79041dfc8d68fa9009aab2dea6bf8c0c95cba0fe;Fri Nov 02 11:58:03 EDT 2007;Committer;kou;9;103;49;152;0
a7f1c72e9067e347613a4219767f1ea7c0824dd1;Fri Nov 02 11:49:20 EDT 2007;Committer;kou;3;6;2;8;0
7f018bde09070604ccd664819578d2842c161d6c;Fri Nov 02 06:28:52 EDT 2007;Committer;matz;4;20;12;32;0
d04b7871a12fa2ddbe518f53da9632d0bb37b906;Thu Nov 01 05:53:52 EDT 2007;Committer;davidflanagan;2;5;2;7;0
a95d19bf5988b60d3649f18d267e25a666955476;Wed Oct 31 17:16:00 EDT 2007;Committer;usa;2;9;2;11;0
4905959e348f3125e9d2c61543d524abbb06354f;Wed Oct 31 16:53:04 EDT 2007;Committer;usa;2;5;1;6;0
ac5a975aafcbe36f7342424d931fef57aedd3188;Wed Oct 31 16:52:10 EDT 2007;Committer;usa;2;5;1;6;0
2276493ee54ae673be131d2ff4b6188890e59bcc;Wed Oct 31 16:34:16 EDT 2007;Committer;usa;1;0;1;1;0
24ada5f55ef795b47b2d34c25450805ea4c2df14;Wed Oct 31 15:53:19 EDT 2007;Committer;usa;5;51;22;73;0
d2a1637d904768bf7833e211609421af9888ad78;Tue Oct 30 23:43:26 EDT 2007;Committer;matz;3;84;92;176;0
a68451d61015e094d804d286027ac22d443aab62;Tue Oct 30 01:06:10 EDT 2007;Committer;matz;4;50;7;57;0
f3cbb20b2272ea5b1c9cafb16e22221aa527f952;Mon Oct 29 09:42:18 EDT 2007;Committer;nobu;2;15;3;18;0
2ae60f16349a0fdbe1094ad2eb5283fb4e71970d;Mon Oct 29 08:58:17 EDT 2007;Committer;nobu;2;38;11;49;0
b088414390fb4094110661f4357de2e9f1221fcc;Mon Oct 29 08:20:13 EDT 2007;Committer;nobu;2;69;15;84;0
3dacfd3fe43e67eefc5f7eed63cd02d1c1b92612;Mon Oct 29 08:18:36 EDT 2007;Committer;nobu;3;13;3;16;0
2e064c694ce2e24030188da5f89ad66a59118350;Sun Oct 28 12:55:51 EDT 2007;Committer;akr;2;29;0;29;0
62354319cdd323bd915c8341fa49c939f65c7107;Fri Oct 26 08:38:14 EDT 2007;Committer;nobu;3;36;11;47;0
69c7312cb3337baa4a91817bdf73f2c9316d11c0;Fri Oct 26 08:14:14 EDT 2007;Committer;nobu;2;4;1;5;0
31667e5ffc1f99f745664ff7a80791ebb5875841;Fri Oct 26 08:01:41 EDT 2007;Committer;nobu;2;12;2;14;0
32865ef821a045b1bf14c4cfcfc52c70125b3794;Fri Oct 26 06:00:52 EDT 2007;Committer;nobu;3;27;18;45;0
27b35eddd6ee9f5844c636f8201f09281e32d9bb;Fri Oct 26 05:52:16 EDT 2007;Committer;davidflanagan;2;4;0;4;0
d520759f6507177cc2b5b74e026ba884b99ddded;Thu Oct 25 22:12:53 EDT 2007;Committer;jeg2;2;6;1;7;0
7c31f2a12039966f92a1d85493dcc1413ef23080;Thu Oct 25 21:35:19 EDT 2007;Committer;jeg2;2;6;1;7;0
7f31a0e7933885729eeb94629bb342b0949a1369;Thu Oct 25 19:22:27 EDT 2007;Committer;matz;2;6;1;7;0
bbe0af6be1f85ea93c3f5fe8ca1e100c784a01e9;Thu Oct 25 17:06:29 EDT 2007;Committer;matz;3;37;6;43;0
012b58b121ff499a6c811a3e7498e9a50145109b;Thu Oct 25 17:05:09 EDT 2007;Committer;matz;2;32;8;40;0
d9ff0a6c2279d7329438686a73b25b07d06067c4;Thu Oct 25 16:52:40 EDT 2007;Committer;matz;3;10;6;16;0
bb053cd8242aa3794ad24f9a2aab5d9fcd4907b0;Thu Oct 25 05:19:33 EDT 2007;Committer;nobu;3;11;5;16;0
966e15e655098152eb9b66d18bd43f7de9061550;Thu Oct 25 05:08:08 EDT 2007;Committer;davidflanagan;2;8;4;12;0
1c662c2b63a224539dfd9aaa57203d61d9b341f3;Thu Oct 25 00:53:34 EDT 2007;Committer;akira;3;18;0;18;0
6b63368278e32d3dc64468de30a7de8ab265599d;Wed Oct 24 21:24:09 EDT 2007;Committer;jeg2;2;8;2;10;0
7e2c0cbda2629f816e9be7ea4bc5b72462753f88;Wed Oct 24 20:00:10 EDT 2007;Committer;jeg2;2;8;0;8;0
6f8537cf7f1340d4c98c801c0aaa10c8b3814cc5;Wed Oct 24 19:48:06 EDT 2007;Committer;jeg2;2;7;2;9;0
3c15e9efe3d7951612f6915900b6870f1b4b50db;Wed Oct 24 18:46:08 EDT 2007;Committer;jeg2;2;6;1;7;0
2070362f3303df4c854ad141b41c4d7895049bac;Wed Oct 24 08:09:40 EDT 2007;Committer;nobu;3;32;10;42;0
7989a0868d6a5231bfbed846eb84d99c7514939a;Wed Oct 24 07:11:35 EDT 2007;Committer;akr;3;3;3;6;0
7eee7f1cde9012d4ad315fa4562eb63a8f7c7fb1;Wed Oct 24 06:29:59 EDT 2007;Committer;akr;2;22;26;48;0
462d4e12247f097123001227b1500a84519e41ed;Wed Oct 24 06:20:31 EDT 2007;Committer;akr;3;6;9;15;0
0945e23b078b07e18c6dcf690c33f45a180d3e9f;Wed Oct 24 06:03:48 EDT 2007;Committer;akr;1;1;1;2;0
5d2671d2bc4b0009d8d2b419369f80f9c2ada1e8;Wed Oct 24 05:55:26 EDT 2007;Committer;akr;3;23;27;50;0
124bdf881594b09dc5748d0dec4e27519aac5c68;Tue Oct 23 07:40:56 EDT 2007;Committer;akr;1;4;4;8;0
3980699f546be11dc2387cf347cd777a0cd45338;Tue Oct 23 04:44:15 EDT 2007;Committer;nobu;2;6;1;7;0
22179f812472a16792dce593c4e0baca30c3f6ff;Tue Oct 23 01:48:51 EDT 2007;Committer;nobu;1;4;4;8;0
4bc9096b23e29b02f46100462b3e38c9d5e73b4c;Tue Oct 23 01:42:53 EDT 2007;Committer;nobu;2;13;1;14;0
3493a66ec6d7e391f94a9ca819936a4342cc3427;Mon Oct 22 15:29:53 EDT 2007;Committer;matz;2;6;1;7;0
15112cf003008c44eab12e9054c5f4a907102a26;Mon Oct 22 15:29:17 EDT 2007;Committer;matz;3;15;7;22;0
ea0c6d3349046d6dc743bd73ca27c2ece8e91d7c;Mon Oct 22 03:40:41 EDT 2007;Committer;akr;1;4;0;4;0
d0cbfbd995cd601e626fa9796a37b7f4b9eb9e18;Mon Oct 22 02:06:50 EDT 2007;Committer;nobu;1;2;3;5;0
3cb10b32bbc49236b26b172336633bc26807ee92;Mon Oct 22 02:03:10 EDT 2007;Committer;nobu;2;18;13;31;0
00befb4b3f58f11343ec0e84b76ec7075a84a839;Mon Oct 22 01:57:08 EDT 2007;Committer;nobu;4;34;4;38;0
b2c81746ace2e7a2ab5433e59b585776d945499a;Sun Oct 21 09:29:19 EDT 2007;Committer;nobu;4;31;15;46;0
6c77d5835604b672601ba9ce3a1716440b02de2f;Sat Oct 20 02:49:22 EDT 2007;Committer;nobu;3;17;10;27;0
5d5d0b5c38e0d4259f9c775d88dc2177f5e943ba;Fri Oct 19 11:08:16 EDT 2007;Committer;nobu;3;68;21;89;0
c7697aba346c6928164ef53151f3e1090a1176e8;Fri Oct 19 07:41:03 EDT 2007;Committer;nobu;3;71;37;108;0
a4e493a98547f3511bb35d942bf84e585f4ae092;Fri Oct 19 02:09:57 EDT 2007;Committer;nobu;2;8;9;17;0
572513527403b9dcac46764fcc9eec3a8430ea44;Fri Oct 19 01:57:49 EDT 2007;Committer;nobu;1;1;4;5;0
c2aee4c87828d827c77f9157b4f246e297ab6531;Fri Oct 19 01:55:44 EDT 2007;Committer;nobu;2;7;3;10;0
53d8c99d8b63d452a05d0744c37e8a78a94aa401;Thu Oct 18 08:14:21 EDT 2007;Committer;matz;2;3;1;4;0
0c7d366e47dad8693dbfb0f7b88b4afe70e86b77;Thu Oct 18 08:12:27 EDT 2007;Committer;matz;2;29;15;44;0
b8c9921c02f843444a05796dfbf6ec9ff4fe50b6;Thu Oct 18 07:41:21 EDT 2007;Committer;matz;2;13;6;19;0
fada885be6a030cc91d297f83c7a2a35a6f5206a;Thu Oct 18 06:58:35 EDT 2007;Committer;matz;6;82;13;95;0
ae7ea35916567109103a7b585272f107e15ad8ad;Wed Oct 17 08:39:33 EDT 2007;Committer;nobu;2;5;1;6;0
05737c35002d482382b72910d9bd792b794c8121;Wed Oct 17 05:21:10 EDT 2007;Committer;matz;2;13;3;16;0
2d1d6c470563375ec4d71353fdf8de3aa4c40ef2;Wed Oct 17 02:30:57 EDT 2007;Committer;nobu;3;24;6;30;0
5daecbc0e14f840059db48f34f6b000df54c40cc;Tue Oct 16 21:18:09 EDT 2007;Committer;nobu;3;83;12;95;0
de46b903a9f202952d0b84b0642cf98cdd4f8fa9;Tue Oct 16 20:26:29 EDT 2007;Committer;nobu;1;0;1;1;0
3cd040b6ef9ddfd9373083498a7537436f7ed0bb;Tue Oct 16 20:07:20 EDT 2007;Committer;nobu;6;108;11;119;0
b06a606278f48ff10ef6dfecb2f819f7caac8c19;Tue Oct 16 18:37:09 EDT 2007;Committer;nobu;2;7;2;9;0
59609a4fba53c86b8e179dc1c000610e56ba135c;Tue Oct 16 18:06:31 EDT 2007;Committer;nobu;2;6;5;11;0
b1d53d10e2805932b094ed7316d5395435728dd6;Tue Oct 16 17:50:51 EDT 2007;Committer;nobu;2;5;1;6;0
81ed881511962bbd3d03f8c02c190ad247883aa5;Tue Oct 16 16:57:08 EDT 2007;Committer;nobu;3;19;4;23;0
24c863cf84f8c4573d2b8c30c88258c6b18e9f1a;Tue Oct 16 11:06:27 EDT 2007;Committer;akr;1;12;0;12;0
5d8ba5a43faac6b74ab838c8b3fa22f07c387a0e;Tue Oct 16 10:48:02 EDT 2007;Committer;nobu;2;9;3;12;0
55eed62a43273d2728800d0af0140414a4b2dbc2;Tue Oct 16 09:47:31 EDT 2007;Committer;akr;1;3;0;3;0
6ade565b634260c3fb7dd53d854803ddfebfe913;Tue Oct 16 09:39:04 EDT 2007;Committer;akr;1;1;1;2;0
dfcfa13872911e6806bb07ecee878a06987dd20d;Tue Oct 16 09:29:32 EDT 2007;Committer;akr;2;37;34;71;0
4b3a26c00e08ab835ed5e5e904f289980776c553;Tue Oct 16 09:21:11 EDT 2007;Committer;akr;3;51;46;97;0
b8dc3c1e2ae4ebf40485c3191995ca3a8d8624b3;Tue Oct 16 09:17:28 EDT 2007;Committer;akr;3;23;1;24;0
676dc908b6ae40413e552ae4edf047190cdb583d;Tue Oct 16 05:48:40 EDT 2007;Committer;nobu;4;112;399;511;0
9f00119776a1dec9f26203e0ce46e28d954102e4;Tue Oct 16 05:06:30 EDT 2007;Committer;matz;2;9;0;9;0
4ad19a7dee4fc9133c6fa9e00d74ee4b4b4adc64;Tue Oct 16 04:50:16 EDT 2007;Committer;matz;2;7;3;10;0
eb6e9c15bd5f4ea664bd1f7a336a0512b21f9a37;Tue Oct 16 04:25:47 EDT 2007;Committer;nobu;2;6;0;6;0
8cb190c41634fdc0079b24be76291c83fdd282ca;Mon Oct 15 16:41:30 EDT 2007;Committer;matz;2;43;55;98;0
ff3859899dbe25ccf42f8a1cc5400826d3c8bc4f;Mon Oct 15 16:28:18 EDT 2007;Committer;matz;3;9;3;12;0
118625a3b3e468d09748358989b9b4c603b784fe;Mon Oct 15 04:24:10 EDT 2007;Committer;nobu;2;6;1;7;0
16652ad4ce7617d004a475de2631d64ee219ed16;Mon Oct 15 02:45:14 EDT 2007;Committer;nobu;2;5;1;6;0
8c3658fd1b3d377158b53784652a72fc005321c2;Mon Oct 15 01:31:11 EDT 2007;Committer;akr;2;63;38;101;0
cb1d63724cf35b9f7af70a186ba4b4199c9f96e3;Mon Oct 15 01:11:52 EDT 2007;Committer;nobu;1;0;15;15;0
d420686fdc62e7b61f57b3299a831b0036f85e0c;Mon Oct 15 01:06:51 EDT 2007;Committer;nobu;1;1;1;2;0
14264f5f622f7a2b7688edfdcfad0aa6d8db155d;Mon Oct 15 00:58:09 EDT 2007;Committer;nobu;4;29;4;33;0
297d2e05cbb0ff8314cf9f595ba8916ef23b0ad3;Sun Oct 14 16:18:41 EDT 2007;Committer;akr;2;24;0;24;0
a0e3752870c2159c56c52ec971a5ed7f42649701;Sun Oct 14 15:36:24 EDT 2007;Committer;akr;1;15;0;15;0
b314d3e999b3ac3c99403c57a66a4c5bad32e654;Sun Oct 14 08:31:51 EDT 2007;Committer;nobu;3;65;4;69;0
9d326d261ef24dc4ba0b66be29f12fcacb9be52d;Sun Oct 14 02:14:16 EDT 2007;Committer;akr;2;14;12;26;0
b933a5348bcbbaebae8710286ae4727612a58e4e;Sat Oct 13 19:08:37 EDT 2007;Committer;nobu;4;16;2;18;0
5542fe44bd31d4e844c09a75256c64ec1a337831;Sat Oct 13 18:55:54 EDT 2007;Committer;nobu;3;9;4;13;0
c7f751025944e61118e49a51634ccc71d4e7bd43;Sat Oct 13 17:20:42 EDT 2007;Committer;nobu;2;5;1;6;0
9c24fed339c77552223d5da339a1e58419bd0b71;Sat Oct 13 16:32:40 EDT 2007;Committer;nobu;6;179;20;199;0
04c290820c99e5b0daefa4c55d1a80abcfd17aab;Sat Oct 13 16:04:31 EDT 2007;Committer;akr;2;4;1;5;0
31c764ff7fd0d0dbd5700d0850a2d6e8a3951f7e;Sat Oct 13 12:40:24 EDT 2007;Committer;suke;5;53;75;128;0
e0a6ff2aa6f4994b5cdebd98a6f588c0c44cd927;Sat Oct 13 00:12:00 EDT 2007;Committer;nobu;2;11;6;17;0
fc3e0bd5625c6869c9eae63179d37da207f8de30;Sat Oct 13 00:02:20 EDT 2007;Committer;nobu;3;9;4;13;0
9f99bc463176fa2b0244b20af5eeb82b50eb3405;Fri Oct 12 15:19:28 EDT 2007;Committer;matz;2;6;1;7;0
d962ef745445532eb267651b2a6e09722a732178;Fri Oct 12 15:04:46 EDT 2007;Committer;matz;3;10;10;20;0
ba9eb2c92930c85e4671fc6da71f88f5ffcb504c;Fri Oct 12 14:35:26 EDT 2007;Committer;matz;2;9;41;50;0
7927f32a19f501f7323dbd71066e7480ce104b8b;Fri Oct 12 14:34:37 EDT 2007;Committer;matz;2;10;2;12;0
b1e97c9070e61ce4e7f1be0a02cef9ef302bba8f;Fri Oct 12 06:04:57 EDT 2007;Committer;nobu;3;82;21;103;0
9bcbd08b0b6aef3fb9305860b5d86b132d85721d;Thu Oct 11 13:20:14 EDT 2007;Committer;matz;5;9;25;34;0
ba997e3529e3397dd64557891c06ccb350601d17;Thu Oct 11 05:31:48 EDT 2007;Committer;usa;2;2;2;4;0
46a30fd4a27df9ce2aa39c7835069262adec65da;Thu Oct 11 05:30:21 EDT 2007;Committer;usa;2;6;1;7;0
72483cdcca360eda40e9fcad298d090658f975b9;Wed Oct 10 21:35:45 EDT 2007;Committer;nobu;16;12383;12365;24748;0
5fc7312d1b6da1acccc8cf7dfff2bed79b48a33c;Wed Oct 10 15:05:32 EDT 2007;Committer;matz;10;109;88;197;0
79a202433ca81eda26450c19d5ffd5b638202c5f;Wed Oct 10 14:34:42 EDT 2007;Committer;matz;2;11;19;30;0
ee624f97ac3560abfe55e6d8ba88bb38a4016180;Wed Oct 10 06:50:33 EDT 2007;Committer;akr;3;11;5;16;0
8c19ecbeeb846e254df520b9e339c36a42277ceb;Wed Oct 10 05:31:08 EDT 2007;Committer;nobu;3;8;4;12;0
7550659a330c099b31c047293a8ab486b8638c8a;Tue Oct 09 12:35:31 EDT 2007;Committer;nobu;2;7;5;12;0
f6a26d06a26cdc094b2d675f29c096110fa14275;Tue Oct 09 12:29:21 EDT 2007;Committer;nobu;2;26;19;45;0
1c65de728414c0420ade1d0e3094401956859878;Tue Oct 09 09:11:36 EDT 2007;Committer;matz;2;23;19;42;0
44ee78db94567e6550fcc83bea5d4cac325cf3e0;Tue Oct 09 08:15:37 EDT 2007;Committer;akr;1;9;0;9;0
81b55c0ff3c5d84e0cbf6b630b5ccb38e7680729;Tue Oct 09 07:33:35 EDT 2007;Committer;nobu;2;16;1;17;0
51baef22a6269887023add80b25444f319fd5d69;Tue Oct 09 07:01:36 EDT 2007;Committer;usa;2;33;29;62;0
04da3111efd4804d098e96e03eb1b99a421c005e;Tue Oct 09 06:41:16 EDT 2007;Committer;akr;1;12;0;12;0
78c4cc29ae42c7cc5773ae5d3ffd89740b4a4665;Tue Oct 09 06:40:26 EDT 2007;Committer;nobu;3;8;4;12;0
cf9bdd01d896bcf013b38a97f7e40a253009179d;Mon Oct 08 16:03:53 EDT 2007;Committer;akr;1;17;17;34;0
3ecc791ddcc537e5eaa663254af6207e65da1a51;Mon Oct 08 11:14:41 EDT 2007;Committer;gotoyuzo;6;50;25;75;0
3465feb90b0d8401ad9b101929dbed11707a2eca;Sun Oct 07 13:42:22 EDT 2007;Committer;kou;5;50;11;61;0
b07ff6ba89e5183e433d1bfb12ef415298e5ae45;Sun Oct 07 13:26:41 EDT 2007;Committer;akr;1;31;31;62;0
a6e5b6d660869b0dd5fe1247eb5764b53fad8669;Sun Oct 07 13:03:05 EDT 2007;Committer;akr;4;22;18;40;0
9b2350e8360314ac6cffc2c332a186036b8e24b6;Sun Oct 07 12:34:37 EDT 2007;Committer;akr;1;1;1;2;0
775eece15a55815473f20229c23866b32439c907;Sun Oct 07 10:41:23 EDT 2007;Committer;akr;1;27;27;54;0
fe1ecef30270651277916c3d86fe6f498266307f;Sun Oct 07 10:18:09 EDT 2007;Committer;akr;1;3;5;8;0
c2115fe8f4c5f11f11a9b8312ffa1154c7dda440;Sun Oct 07 09:58:26 EDT 2007;Committer;akr;3;69;65;134;0
a1455c75e93c536e0e8e4076fe2fa091ecb1d4ab;Sun Oct 07 08:53:06 EDT 2007;Committer;gotoyuzo;3;7;14;21;0
3c78d621e60a2cae073b5e6ef7b7ac8b6d884a7e;Sun Oct 07 06:49:38 EDT 2007;Committer;ko1;3;8;18;26;0
026568c9156b1ba2a153b4a6d594ea590343c1bb;Sat Oct 06 14:17:35 EDT 2007;Committer;matz;2;6;1;7;0
68bcdf4c7ee41b73d165c78fe320c7a22d778a19;Sat Oct 06 07:30:02 EDT 2007;Committer;ko1;3;8;6;14;0
597974c21fed42a7e781718bcaa39315b041d800;Sat Oct 06 05:56:09 EDT 2007;Committer;nobu;3;47;11;58;0
d751dad12abeee9b257da2269e26a12e386b786f;Sat Oct 06 05:40:45 EDT 2007;Committer;akr;1;1;0;1;0
6845578c926de256ee158652a4563f185fa6fec9;Sat Oct 06 05:32:37 EDT 2007;Committer;nobu;5;25;19;44;0
bd00bb3ef75b469a83a8eac6995bb6800a22c15a;Fri Oct 05 17:39:59 EDT 2007;Committer;matz;5;9;35;44;0
b5b6d1f0ea914515adf9e11849bc365fd04f26b5;Fri Oct 05 13:25:50 EDT 2007;Committer;akr;1;1;1;2;0
dea669cf4e6c8c4a6fa8ebc3eeb0a315b3d07363;Fri Oct 05 12:26:35 EDT 2007;Committer;akr;2;27;8;35;0
ef1d280a4c93e4403ad8b2d0975950ab6e16c44b;Fri Oct 05 07:43:34 EDT 2007;Committer;akr;3;21;0;21;0
4005af452020c6b0061c67363076f156a145e747;Fri Oct 05 07:24:19 EDT 2007;Committer;knu;2;28;25;53;0
f3e7ae56969e1f46b5818c390b231a31cc1464b9;Fri Oct 05 07:12:54 EDT 2007;Committer;knu;2;11;4;15;0
ee6901b1992ca994ea76f9a815ea7c7c3129eee7;Thu Oct 04 19:56:35 EDT 2007;Committer;knu;1;3;3;6;0
228bb8ea4c882cda737ceceeec9eab207ee19a22;Thu Oct 04 19:03:56 EDT 2007;Committer;knu;2;11;14;25;0
2a3528a051347ef336e89576e945dc789aab3771;Thu Oct 04 18:56:32 EDT 2007;Committer;knu;2;43;0;43;0
7a796ddefc977dabe6f1415bcbe3e5310191b0c6;Thu Oct 04 18:23:22 EDT 2007;Committer;knu;2;65;34;99;0
57831cebe13ed93a09e3659ce7e8425506fcc0ba;Thu Oct 04 11:47:18 EDT 2007;Committer;usa;2;5;2;7;0
b618f011b7820d64c533c8d8e9fb99cc7bec121e;Thu Oct 04 11:18:14 EDT 2007;Committer;usa;2;9;3;12;0
1d758debe041555fe40bbda9e71c6591f14845fc;Thu Oct 04 09:59:56 EDT 2007;Committer;matz;1;1;1;2;0
c953283d7e40df3c75f32c1a4fb372b7e32b254c;Thu Oct 04 09:54:53 EDT 2007;Committer;matz;4;13;18;31;0
1677425e9dc9a0ae872a776803b93788b12715ba;Thu Oct 04 09:24:00 EDT 2007;Committer;matz;4;18;13;31;0
506cdbf64a7883b769725c20ced87c38d254f5b0;Thu Oct 04 08:34:06 EDT 2007;Committer;matz;2;5;2;7;0
dbcc539602450423ccbdabe350bb0636f8d12594;Thu Oct 04 08:09:06 EDT 2007;Committer;matz;3;10;5;15;0
7b28e82f6fe94a67c20d4f519f81c4c5341fd20f;Thu Oct 04 07:56:55 EDT 2007;Committer;matz;2;3;17;20;0
9a2a45cd69fe4ebf923c8d33c264ba1558cf6ae8;Thu Oct 04 07:54:53 EDT 2007;Committer;matz;2;3;2;5;0
150a8b4fe0c7ed520a1c73117291b1bbc6af54bb;Thu Oct 04 07:53:32 EDT 2007;Committer;matz;2;3;19;22;0
1c9a2e11545f91848fc5733005b0a4f6249290ff;Thu Oct 04 07:31:50 EDT 2007;Committer;matz;3;20;60;80;0
47732dbd2ba2430c22d10663399a42447e98b240;Thu Oct 04 07:28:35 EDT 2007;Committer;nobu;2;4;3;7;0
0f09f59ef7ae5179936c48311574f5607034ef43;Thu Oct 04 07:16:04 EDT 2007;Committer;nobu;2;4;1;5;0
19dee8af57634c5813286ffbb63cc82611748378;Thu Oct 04 06:57:19 EDT 2007;Committer;nobu;5;26;16;42;0
612b2ed6a751629b2809e58a8f42a56e8690e8c7;Thu Oct 04 06:51:17 EDT 2007;Committer;matz;3;18;8;26;0
137edebc4a25c1483ba38f905b2171c8612fe54b;Thu Oct 04 03:40:40 EDT 2007;Committer;akr;1;13;13;26;0
ebe0e986c4b2e5eed930ce48c2c7ff48a163774f;Wed Oct 03 14:42:35 EDT 2007;Committer;matz;1;1;0;1;0
f63aae063aa55991db755c2bd98f027b5e434939;Wed Oct 03 14:39:54 EDT 2007;Committer;matz;4;9;4;13;0
c5f2bbaf829d35c65ccab8ef8d209646b552c4da;Wed Oct 03 08:58:56 EDT 2007;Committer;ko1;2;13;2;15;0
5dd4990d0e3ff940fb4c21eda74659c044d53afb;Wed Oct 03 07:58:50 EDT 2007;Committer;nobu;2;74;19;93;0
8ba5375af142f26fcf02dbd3bb0b7fe956b7a226;Wed Oct 03 06:49:56 EDT 2007;Committer;matz;1;6;6;12;0
91a079cc86b01699d11481bdd8f9636df334a404;Wed Oct 03 06:48:06 EDT 2007;Committer;matz;3;77;16;93;0
ee2ac58e4de6a63cc83bbef13b6a25718f5b8f0f;Wed Oct 03 01:06:57 EDT 2007;Committer;nobu;4;33;17;50;0
50c7751b606ac0568e531301149db404717d4717;Tue Oct 02 11:17:23 EDT 2007;Committer;usa;2;14;13;27;0
77a6c82eabe113802a52bf77b8b8a0bcfe1f28f4;Tue Oct 02 03:33:53 EDT 2007;Committer;matz;3;70;14;84;0
437565235f3bae03cfed4afbf9902ca96adb3252;Tue Oct 02 01:47:08 EDT 2007;Committer;ser;1;1;1;2;0
9a39093337c6632d46874460bd097e2da942144a;Tue Oct 02 01:46:50 EDT 2007;Committer;ser;1;8;0;8;0
9acf1749fb72fead34f9d5a7bf07b77891199680;Tue Oct 02 01:46:32 EDT 2007;Committer;ser;4;56;17;73;0
c1b7ca8feccf9432d0c8de5f75b43ab889cc1292;Tue Oct 02 01:46:13 EDT 2007;Committer;ser;1;1;0;1;0
a6c2c86b24d53a02f4da229b8eab537ac57f06f5;Tue Oct 02 01:45:55 EDT 2007;Committer;ser;1;1;0;1;0
efe8edf32cff09aa59cd3d2a8338e3531c80caea;Tue Oct 02 01:45:19 EDT 2007;Committer;ser;5;39;68;107;0
209b950f3f92b8f7734a9b1456afedf7b5280b51;Mon Oct 01 23:37:02 EDT 2007;Committer;matz;2;8;2;10;0
04bc87e582ec83f56f3375724ef7370e53a914cd;Mon Oct 01 23:35:30 EDT 2007;Committer;matz;3;112;37;149;0
88f570d9ae5984decc313f10b54d259ff54fa525;Mon Oct 01 22:02:23 EDT 2007;Committer;ko1;5;27;20;47;0
25ff7ef4c68ef7b6f53a8eb61ef4ec57142852b9;Mon Oct 01 14:46:07 EDT 2007;Committer;matz;3;10;7;17;0
5838fff3341e6b4ebca956a6a96659eb5afb9859;Mon Oct 01 07:43:21 EDT 2007;Committer;akr;1;5;1;6;0
adcd9f7ea160d60a9433f012707f1fd62c6eb97e;Mon Oct 01 07:18:26 EDT 2007;Committer;akr;2;6;2;8;0
36585f17fb8deb2042c36842c68637b740565811;Mon Oct 01 06:57:56 EDT 2007;Committer;nobu;2;6;1;7;0
e5a15da7990e9bc98733b11cfae3180023e82ee3;Mon Oct 01 06:30:39 EDT 2007;Committer;akr;2;6;1;7;0
7d0787116d9aca851422acbc59c6488fff65850c;Mon Oct 01 06:17:50 EDT 2007;Committer;nobu;4;18;15;33;0
014d1ae20d939d2d522634ad54cc20036253314b;Mon Oct 01 01:58:44 EDT 2007;Committer;nobu;2;9;5;14;0
b9b34059a6f7eaa63aa0b7764db6eacb77531315;Mon Oct 01 01:52:32 EDT 2007;Committer;nobu;4;26;12;38;0
eb64f5de06ff378c3efe17504a1b57df9f4985f9;Sun Sep 30 08:13:28 EDT 2007;Committer;nobu;3;15;2;17;0
1a004904d1a9e61a404063538bb89c82530b814d;Sun Sep 30 06:52:45 EDT 2007;Committer;akr;1;5;0;5;0
adf5c69f295ff1eb8e6d698c77ef3e1a0e855109;Sun Sep 30 02:52:55 EDT 2007;Committer;akr;2;5;0;5;0
d1c7f6c9cd1b226be6754157b70b665aa32e079e;Sun Sep 30 02:33:18 EDT 2007;Committer;akr;2;6;2;8;0
11f6502652a1c618bbeb050a7f2f9ba1faa2a58e;Sun Sep 30 02:23:58 EDT 2007;Committer;akr;1;14;0;14;0
f2d609e0f6937d37a9671bae43038994d425c579;Sat Sep 29 20:40:20 EDT 2007;Committer;akr;1;7;7;14;0
c0d197423db523850799461fa32a2f523447d582;Sat Sep 29 19:33:03 EDT 2007;Committer;akr;2;9;4;13;0
910b0709ed68184c84e93e122d3c42a36843a5e9;Sat Sep 29 19:06:40 EDT 2007;Committer;akr;2;13;13;26;0
38694262ef41c6071ec58fee794212545700c752;Sat Sep 29 15:56:50 EDT 2007;Committer;usa;3;8;4;12;0
400202f6a5b5f833b13ecc1b9b9628de05ea27a8;Sat Sep 29 08:45:24 EDT 2007;Committer;nobu;7;65;25;90;0
43c4d8093074e4d7c2639a7fd81c889739599b4d;Sat Sep 29 08:43:59 EDT 2007;Committer;matz;4;175;1;176;0
0d077554723c88f06dd351d29edd2246693e0a42;Sat Sep 29 08:17:48 EDT 2007;Committer;matz;2;9;4;13;0
6108fcdc53fb5b44cc397cf622e9f07cb1cc82ca;Sat Sep 29 04:52:43 EDT 2007;Committer;akr;1;1;1;2;0
d537ca1f847efc8298ae4aa1d699c68b48302195;Sat Sep 29 03:32:57 EDT 2007;Committer;akr;3;36;0;36;0
2d6ad7e11875aca83123fb98aa82a3c4428ed941;Sat Sep 29 03:11:24 EDT 2007;Committer;akr;1;15;0;15;0
238ac9fcb2abd5cfea328eb108886e523c09189b;Sat Sep 29 01:21:15 EDT 2007;Committer;akr;3;9;0;9;0
5a3e59d284a20bf7bda78b828dfce522267acee8;Sat Sep 29 00:13:58 EDT 2007;Committer;akr;2;7;1;8;0
affcfc9e7a13674736103508a26f0c7624199b8f;Fri Sep 28 23:57:17 EDT 2007;Committer;nobu;2;7;3;10;0
8ef1027a094062b2921a6bed2e7b6e578aecd60a;Fri Sep 28 23:50:36 EDT 2007;Committer;nobu;1;1;1;2;0
310416744d1c00b9fc5ad0fcabe48a8ed2650f8d;Fri Sep 28 21:50:01 EDT 2007;Committer;nobu;1;1;1;2;0
4507782baa98291e552ce9a76fc5e0bf8795ca49;Fri Sep 28 21:47:31 EDT 2007;Committer;nobu;2;203;183;386;0
29621688c75a3124e538c8fae590f2c321d1c5e8;Fri Sep 28 20:29:32 EDT 2007;Committer;nobu;5;65;25;90;0
c351afc37276bb3d82eabe142a20be10127fed27;Fri Sep 28 19:27:10 EDT 2007;Committer;nobu;6;128;12;140;0
534d057e58e68c5a65509e718366f2dab5e69e84;Fri Sep 28 19:04:45 EDT 2007;Committer;ko1;5;44;31;75;0
4dc8ff965bea4226c36acae8880dc359e05414dd;Fri Sep 28 18:22:23 EDT 2007;Committer;akr;4;101;95;196;0
a9c2a18cc796fa59d5d696ef9d99d41b1149a242;Fri Sep 28 16:51:41 EDT 2007;Committer;akr;8;106;87;193;0
228728325ee08b31944cffb35126222d1671c01e;Fri Sep 28 15:58:34 EDT 2007;Committer;akr;1;0;1;1;0
ac835db6c8d5ed105ab3783c48a5b577fa0e05cf;Fri Sep 28 14:17:28 EDT 2007;Committer;matz;4;11;1;12;0
fbebfdf23db958e3bb06dc0d4ccadca48d748dff;Fri Sep 28 13:42:36 EDT 2007;Committer;ko1;7;196;0;196;0
d6c43c45eaf5a6813ba5c2b3a68df154a69bdf9b;Fri Sep 28 11:57:30 EDT 2007;Committer;akr;1;1;1;2;0
30b2cb380e0a8f777a2fc2d736c2ccddf3362fcd;Fri Sep 28 10:18:53 EDT 2007;Committer;ko1;16;1173;4;1177;0
335fe1ee7bf51534c5f2abd0f359e86721307335;Fri Sep 28 09:07:02 EDT 2007;Committer;matz;3;49;35;84;0
07d12a2a5f99ed6446f86aeb6e13e6c906a238be;Fri Sep 28 07:25:51 EDT 2007;Committer;matz;4;10;6;16;0
8aa618d8e27e9728b6d102bf69e3294d7e9283e6;Fri Sep 28 06:59:59 EDT 2007;Committer;ko1;4;71;37;108;0
37f9d089ed30477e1f7d8c54fde6047e7c1d3154;Fri Sep 28 06:34:13 EDT 2007;Committer;akr;1;4;1;5;0
5c0e68c39c3fc7717311826549a30d1615eb2007;Fri Sep 28 06:21:46 EDT 2007;Committer;akr;17;448;193;641;0
041fbcbf50993925b2d61fbfca4d16b766d8ea5d;Fri Sep 28 04:20:12 EDT 2007;Committer;nobu;2;15;5;20;0
225e95fe830494bf929a09f96ac518534e8b67fd;Fri Sep 28 03:53:34 EDT 2007;Committer;ko1;5;77;0;77;0
6698dd81e6d05b76baddf76703308c5d20f2a492;Fri Sep 28 03:51:41 EDT 2007;Committer;ko1;3;41;17;58;0
34d9c3d5c74aa12898f96008027e74eb52c8164d;Fri Sep 28 00:23:40 EDT 2007;Committer;akr;1;12;18;30;0
cc09ba4699b438773177639beac10b66bf2c98c1;Thu Sep 27 09:51:24 EDT 2007;Committer;akr;1;35;0;35;0
1ff31c2d2de0a863e638357e1673b1fbb559cecd;Thu Sep 27 08:38:46 EDT 2007;Committer;usa;2;22;7;29;0
2fe11b75d631ea10a3dd3acbdb25ce40cb40a411;Thu Sep 27 08:33:21 EDT 2007;Committer;ko1;3;26;9;35;0
87375866a629e64a646c1b32d0e50926a729ca11;Thu Sep 27 06:46:31 EDT 2007;Committer;ko1;6;216;17;233;0
29538dbb0ed5dda03ecd6348b33ab29d174fcb58;Thu Sep 27 06:45:03 EDT 2007;Committer;ko1;2;6;1;7;0
5829a95b47136c17b661e8b17567296b147dd7db;Thu Sep 27 00:42:51 EDT 2007;Committer;nobu;2;12;6;18;0
bb32165fe9934ee3fb2bb06cb47772b77af0ce19;Wed Sep 26 23:24:08 EDT 2007;Committer;akr;1;2;2;4;0
654cdfb90ba127bcf453d3d45dc7a3f4c99a8c05;Wed Sep 26 22:40:44 EDT 2007;Committer;akr;3;61;5;66;0
19d8793ef4df2183a1187eefae1c71009634e92b;Wed Sep 26 19:51:00 EDT 2007;Committer;nobu;1;0;16;16;0
e41b84895efbf8d8bd80b5e88f52a1baf46f5da7;Wed Sep 26 19:46:58 EDT 2007;Committer;nobu;5;120;20;140;0
b416cc6f3f843fd17cef94bdb10eb6af63fd5b18;Wed Sep 26 19:40:49 EDT 2007;Committer;nobu;4;38;9;47;0
71341b814a863ffd95f9fc640c1d62ae83b668f8;Wed Sep 26 19:12:04 EDT 2007;Committer;nobu;2;60;19;79;0
4d1450fc96fdf80ebac183ce920e61aa392e05e5;Wed Sep 26 18:17:43 EDT 2007;Committer;nobu;3;9;10;19;0
55f7f3dd3c9569a33589e481cae8d727cafa60e5;Wed Sep 26 11:12:55 EDT 2007;Committer;ko1;2;4;18;22;0
ff2af1ed9843ac3bb7cddc014b58b5dcde225ebd;Wed Sep 26 11:01:18 EDT 2007;Committer;ko1;4;35;27;62;0
f902e0946044222e4214ddde0e63ba64a435d7bb;Wed Sep 26 10:41:03 EDT 2007;Committer;ko1;1;1;0;1;0
67aa07f44d40e5e67081c6e8fef5af49caee1525;Wed Sep 26 10:39:49 EDT 2007;Committer;ko1;4;13;6;19;0
94331261e94b15fe06df26ec78668480c17537f5;Wed Sep 26 10:29:00 EDT 2007;Committer;ko1;2;6;1;7;0
e826eec433728676af1bde2f6dde74a6f7126693;Wed Sep 26 10:26:35 EDT 2007;Committer;ko1;3;11;5;16;0
94a0db11e7f286b9d8432814dcc8b857ce129481;Wed Sep 26 09:39:08 EDT 2007;Committer;nobu;8;122;53;175;0
62096ef6900717559f091e26b952be0e0c51bc5e;Wed Sep 26 06:01:43 EDT 2007;Committer;nobu;2;8;2;10;0
cecd39bee2dd6e442230f2784aa8f68f39ce5b6c;Wed Sep 26 00:41:08 EDT 2007;Committer;akr;1;8;0;8;0
d095fc2445431b0b7c3071301b19cf2c1acb55d4;Tue Sep 25 23:36:48 EDT 2007;Committer;nobu;2;6;1;7;0
52866db1fef59c3138300f00283bf9e8ef1bb3a8;Tue Sep 25 20:12:24 EDT 2007;Committer;nobu;3;24;5;29;0
2f6f2bfb0211a7f9a278a20bce69472fa78048f3;Tue Sep 25 12:45:03 EDT 2007;Committer;matz;3;15;9;24;0
a50ef07e16b8d09073c34ba3124868b22917972f;Tue Sep 25 12:41:48 EDT 2007;Committer;matz;2;13;2;15;0
72ea36112ced7623337aead592fe8dbd4d4d1998;Tue Sep 25 12:40:17 EDT 2007;Committer;matz;3;21;7;28;0
c1a432a7d9a9fee1b96c3af9889d86310e2d3ed7;Mon Sep 24 13:43:58 EDT 2007;Committer;matz;3;34;26;60;0
5f93fa308bd970eeab9a3028c44577f0af8c636c;Mon Sep 24 13:18:02 EDT 2007;Committer;matz;2;5;0;5;0
af4310be97ccebd6c06eec164a1b197a61085032;Mon Sep 24 13:15:34 EDT 2007;Committer;matz;3;7;5;12;0
7ab48f03e90ed3859ad4e49166bbfd31707e5c91;Mon Sep 24 08:56:24 EDT 2007;Committer;nobu;2;7;3;10;0
11dc2b9641888c2e045f6b86e8189edb905ff3f0;Mon Sep 24 07:55:41 EDT 2007;Committer;shyouhei;2;5;1;6;0
4f04f0372bf16f0d38f02bfb0a1cd162f2dd1766;Sun Sep 23 22:21:18 EDT 2007;Committer;gotoyuzo;4;32;11;43;0
c9faac88af5744e03ad2cdcb367d5ac00f5d9eee;Sun Sep 23 00:05:07 EDT 2007;Committer;nobu;2;10;37;47;0
0a274820bdcfd662f4381cef5915455789077ef6;Sat Sep 22 23:58:03 EDT 2007;Committer;nobu;3;11;7;18;0
4fb45dd5dca3f5973b16fd3c57c6ffe7a841e42a;Sat Sep 22 23:49:08 EDT 2007;Committer;akr;1;1;12;13;0
15838ab0053aa6319696f64fc3f85b291c5eb6d0;Sat Sep 22 23:26:31 EDT 2007;Committer;akr;1;22;1;23;0
bc5d30584353fc9770f6009cb8017260af5a98c6;Sat Sep 22 21:16:21 EDT 2007;Committer;nobu;3;20;10;30;0
c5e449d8660aeaba76c50eca95c8037b2d3ae7e7;Sat Sep 22 20:58:40 EDT 2007;Committer;shyouhei;2;7;2;9;0
9b268cdbca9147515fca783448e66bb1aaa96677;Sat Sep 22 15:56:01 EDT 2007;Committer;akr;1;8;0;8;0
f610ff5a397a8f980524ad082bef07e752595e1a;Sat Sep 22 15:29:32 EDT 2007;Committer;akr;1;9;0;9;0
5bc87779fd50ea0cea04c381943d01ab4af6ea31;Fri Sep 21 21:02:13 EDT 2007;Committer;nobu;2;8;1;9;0
2f4951f01e62f6c30cdeb31a60b6cafae326047d;Fri Sep 21 20:19:51 EDT 2007;Committer;nobu;3;21;7;28;0
80eba73d6a28901b6c198b3c59488ca4fdbc1d71;Fri Sep 21 05:51:43 EDT 2007;Committer;nobu;2;24;7;31;0
ac907e669a4cb0cbaf23651fec30008e7f294049;Thu Sep 20 19:58:41 EDT 2007;Committer;nobu;2;28;3;31;0
9c6ff18f6cfcec8185fa94afb4d34630463f9237;Thu Sep 20 18:48:19 EDT 2007;Committer;nobu;1;3;3;6;0
5376745fb65804a5dafe8f13a5bc9a4ced5c263b;Thu Sep 20 17:14:01 EDT 2007;Committer;matz;3;42;2;44;0
f4d9d3d39b2018ea5330c1b21db722cd29ca11b4;Thu Sep 20 17:03:41 EDT 2007;Committer;matz;3;11;4;15;0
bf6575ef62b4521d6c1d45371372dc1c1e74f18e;Thu Sep 20 08:28:03 EDT 2007;Committer;nobu;4;23;7;30;0
ee9e5a6ea87fb0365a939639d027ade3eee93cb1;Tue Sep 18 13:12:47 EDT 2007;Committer;keiju;2;5;1;6;0
7dc51206303e03e37ade64ee5e59cd35bed5b530;Mon Sep 17 12:07:07 EDT 2007;Committer;aamine;2;6;0;6;0
3f483f7082ebe5865817f6b12d238abdcfe6e40d;Mon Sep 17 12:02:35 EDT 2007;Committer;aamine;3;94;70;164;0
50f5de149110e9f86d7a1b8d13e2c57639763b0c;Sat Sep 15 14:36:33 EDT 2007;Committer;nobu;2;6;2;8;0
740e1b66c8e42ef63bbf5043e349f80855cbec14;Sat Sep 15 09:26:06 EDT 2007;Committer;kou;2;5;0;5;0
fd7e89ddc2e6f3a5857d483ff9884a9e09c46124;Sat Sep 15 08:32:12 EDT 2007;Committer;nobu;3;18;8;26;0
26adfc185fac192ba0d0f3f75e40159a972a9fe5;Sat Sep 15 08:04:10 EDT 2007;Committer;nobu;3;51;1;52;0
1b56bcce22a069eba6afb7e36f654783e5b4fbbc;Sat Sep 15 04:41:28 EDT 2007;Committer;kou;19;296;18;314;0
b528261ad821d84b6a392d9497cea6f199cba307;Fri Sep 14 13:25:44 EDT 2007;Committer;suke;2;8;5;13;0
64221159aa3e9aa183d6083b04cca50de8009f93;Fri Sep 14 08:31:24 EDT 2007;Committer;ko1;3;22;1;23;0
3e3953cd66b2204c12b779b73192d7f025019cb5;Fri Sep 14 07:26:07 EDT 2007;Committer;ko1;2;8;1;9;0
34530b1ad317cb522233c72cb4dc0895a0f9cf6f;Fri Sep 14 07:18:23 EDT 2007;Committer;ko1;2;8;0;8;0
d5e687b724f067fbd83652ed8f6aa037395861c0;Fri Sep 14 07:17:17 EDT 2007;Committer;ko1;5;20;19;39;0
8b92f5df326ed21d1afeb8e7a6f46587846c9a1f;Fri Sep 14 07:14:13 EDT 2007;Committer;ko1;3;8;3;11;0
73c8bfa6482b6ca63710c0d913d25e7dc8bba378;Thu Sep 13 06:42:05 EDT 2007;Committer;nobu;2;9;8;17;0
458c4e98aad847abdfaf9b5260b065ed161360bc;Thu Sep 13 05:00:23 EDT 2007;Committer;nobu;2;6;1;7;0
ffc1b8af9be70cb6d46706054f0509a564f9de88;Thu Sep 13 04:48:43 EDT 2007;Committer;nobu;1;1;1;2;0
f41c0a54e2434e5982722195bf0297ed217c94db;Thu Sep 13 04:47:10 EDT 2007;Committer;nobu;3;8;5;13;0
9019911a2f1f356ea5c40d0d39c23ac5ceb4d363;Wed Sep 12 14:14:32 EDT 2007;Committer;matz;2;6;1;7;0
9391daf9543835f2a5dd850cee422310d8e79449;Wed Sep 12 06:19:06 EDT 2007;Committer;nobu;5;24;19;43;0
35028627e581b0a77385e6d6f4fee799c4a6a2f2;Tue Sep 11 16:22:50 EDT 2007;Committer;akr;1;2;2;4;0
55717aa69b82231d4fcacf2197a63e00348b3b41;Tue Sep 11 08:28:29 EDT 2007;Committer;knu;2;27;4;31;0
d2a68669da4b31f70d99888ef87286c6cc901afb;Tue Sep 11 08:27:48 EDT 2007;Committer;knu;2;141;18;159;0
068d11ef96ba506e3606713d431ce053e5e8294b;Mon Sep 10 06:50:22 EDT 2007;Committer;akr;3;13;3;16;0
4261abb2305320ac2a335fed5460adafc265f0bd;Mon Sep 10 06:25:40 EDT 2007;Committer;akr;3;10;6;16;0
b3fc59837aa53c67e8167700b27ad79feaa30e33;Mon Sep 10 05:05:49 EDT 2007;Committer;matz;2;6;1;7;0
c19fafb0a45cc30b04fdeb9eb5b5fb8a6d80be79;Sun Sep 09 16:23:27 EDT 2007;Committer;matz;2;10;5;15;0
3ee33a6dbc636a16ff1aa89f070e428842ed1f32;Sun Sep 09 16:11:28 EDT 2007;Committer;matz;3;11;4;15;0
8dc6147e3efcea20343dc845fc9acfd0bf497812;Sun Sep 09 00:14:22 EDT 2007;Committer;tadf;2;12;2;14;0
507a5116c6aa164577a8b3c471489c9bd6bd62aa;Sat Sep 08 16:59:49 EDT 2007;Committer;akr;2;7;0;7;0
29dcf02239830f8749f55cdcf40421b45f6ffecc;Sat Sep 08 16:29:50 EDT 2007;Committer;akr;1;1;1;2;0
a8b4677b144e30ad764a108459c27102fa087826;Sat Sep 08 16:19:13 EDT 2007;Committer;akr;4;12;2;14;0
c19ebe04e6a7842b9e6986c3616be409c9491b35;Sat Sep 08 16:04:36 EDT 2007;Committer;akr;1;3;3;6;0
4fe6fa884957545c0cecaee8ac4ebaa636904a43;Sat Sep 08 15:59:05 EDT 2007;Committer;akr;1;18;0;18;0
2a37152f3fa3cd90f786c581dcc8d93b6279c288;Sat Sep 08 15:07:18 EDT 2007;Committer;akr;6;279;52;331;0
22bcf22ea4ed3a49c497679c5fa82b6542787a47;Sat Sep 08 01:24:00 EDT 2007;Committer;matz;1;5;8;13;0
2677f72e2e8088abd77db2bb8895a1bb94335a3e;Sat Sep 08 01:08:23 EDT 2007;Committer;matz;2;11;0;11;0
86ca9a693025411b874289a9de7509629bcb0674;Sat Sep 08 00:38:03 EDT 2007;Committer;tadf;3;56;44;100;0
89e1e1e78400a4bd8c9f701a197e6f30d2bee74e;Fri Sep 07 23:06:33 EDT 2007;Committer;akr;1;12;4;16;0
d790c7c802b9e571e147b6c75cbe78405f040d0f;Fri Sep 07 18:00:44 EDT 2007;Committer;matz;2;6;1;7;0
531eab2cdc11ee90f681cfa7d014fa156f41dace;Fri Sep 07 17:47:56 EDT 2007;Committer;matz;3;8;4;12;0
eda22a34116e7c889cc0f7f4a5aaa1f59dc5495b;Fri Sep 07 16:48:10 EDT 2007;Committer;usa;1;3;3;6;0
24eeec7a719e08b8c9d20d1ff63bd1fda1b5d663;Fri Sep 07 16:47:40 EDT 2007;Committer;usa;3;7;2;9;0
a22a489cdeafc3a92db2bd1dead932fac6cb3a4f;Thu Sep 06 15:59:29 EDT 2007;Committer;ko1;2;5;1;6;0
080605efb199588ef7f28733853256f5e362ae72;Thu Sep 06 15:42:53 EDT 2007;Committer;matz;3;8;3;11;0
ae11bc70f1f165b4bd6a4045aa3f5810c7928209;Thu Sep 06 15:30:49 EDT 2007;Committer;matz;3;8;4;12;0
9a46ab6b6264ea428e6424b6d6b898a0bbf73af4;Thu Sep 06 13:59:37 EDT 2007;Committer;matz;2;16;4;20;0
205d12524c163416207bc8d0be26b873383fff21;Thu Sep 06 12:39:58 EDT 2007;Committer;matz;1;10;0;10;0
edd7c787adc53f70a9d2790076e4c6d77a1f5324;Thu Sep 06 12:33:45 EDT 2007;Committer;matz;19;146;133;279;0
629b1e4324ecfbdb9e953f2a0da74a833786e1e9;Thu Sep 06 03:42:12 EDT 2007;Committer;nobu;4;109;30;139;0
9df2b5fd0cc6170bd25bf4dc4bf1775c105c29a2;Wed Sep 05 13:37:18 EDT 2007;Committer;matz;2;13;5;18;0
c349959778f17cb322b065a02da4183825f8e69e;Wed Sep 05 13:06:01 EDT 2007;Committer;matz;3;9;4;13;0
9ecd43fa98bb45b77a1c2334c6e9ba500d31962a;Tue Sep 04 11:48:53 EDT 2007;Committer;suke;4;90;9;99;0
1acdd51cf9da5ec8987af38007776d1c5cc94495;Mon Sep 03 06:37:11 EDT 2007;Committer;nobu;3;8;4;12;0
15c8e4618bb2d0f63b338f74e1525c815ac7175d;Sun Sep 02 14:40:47 EDT 2007;Committer;akr;2;7;2;9;0
96c859834e792cc0ad82868f602c363684857917;Sun Sep 02 06:39:58 EDT 2007;Committer;akr;1;8;0;8;0
e8959acc9f469e0d5e1c1b146e078fe02c12cb7a;Sat Sep 01 15:57:22 EDT 2007;Committer;matz;1;2;2;4;0
ec6cf1f454eedfa541b113212426f26fcdec5c0d;Sat Sep 01 15:47:52 EDT 2007;Committer;tadf;2;28;12;40;0
ebef450d28ec493b53487ead5c2cfdbc0234c17b;Sat Sep 01 14:56:59 EDT 2007;Committer;usa;2;11;11;22;0
87fe4d49139524fddd58c8119cf356308a081813;Sat Sep 01 14:46:00 EDT 2007;Committer;matz;2;7;2;9;0
6c7466e82a0e81db338f7a75fd584d80f9f82a56;Sat Sep 01 14:15:05 EDT 2007;Committer;usa;1;10;0;10;0
49be22d8dfaa82da0b5f0538096ec1338e3c9a61;Sat Sep 01 12:56:29 EDT 2007;Committer;matz;5;62;18;80;0
2c8e7a50c1db8fea3fb012052828ad1eea51883f;Sat Sep 01 12:02:36 EDT 2007;Committer;akr;12;332;203;535;0
0c5e6ab2bb6726b0d70e99db25d5369e196d8ddc;Sat Sep 01 11:11:51 EDT 2007;Committer;suke;2;40;27;67;0
1588a79069fdcd1dc6156e38ee54963fdc2b23a7;Sat Sep 01 07:27:26 EDT 2007;Committer;usa;2;5;1;6;0
ec2beed3b2f4670c31d931613d4c9b297343feda;Sat Sep 01 05:24:25 EDT 2007;Committer;nobu;2;7;8;15;0
d4cbf950029c99d37ad2f4369d1782f3a9a3dc98;Sat Sep 01 02:14:40 EDT 2007;Committer;nobu;4;49;26;75;0
b39e00d39d426ef8a08af0a3627ea7f5bf4cd973;Fri Aug 31 07:20:38 EDT 2007;Committer;akr;1;1;1;2;0
6cca1f4c6a0fe27930383350402a45013cf091c1;Thu Aug 30 22:15:07 EDT 2007;Committer;usa;2;6;1;7;0
6a9b9f488b04654728bd338d117bc3d68499a55a;Thu Aug 30 19:18:05 EDT 2007;Committer;nobu;2;6;3;9;0
7aaf7dac8d312b6b1a27ea8240d2818c5c77ee17;Thu Aug 30 18:49:00 EDT 2007;Committer;nobu;5;21;15;36;0
70f5d818f8f4956354221e7977bb1b8b40c00a5a;Thu Aug 30 10:42:09 EDT 2007;Committer;usa;3;18;8;26;0
7d4ee1d235a90d98e94b12a6a2070d5e8b0c404f;Thu Aug 30 05:06:52 EDT 2007;Committer;nobu;2;16;2;18;0
18c9e590c3303977a9b7960394e36e1d716722ae;Thu Aug 30 04:49:27 EDT 2007;Committer;nobu;2;4;1;5;0
10084a3e615ad9820b242348e210b6ed5a084c3b;Thu Aug 30 04:13:16 EDT 2007;Committer;nobu;2;43;0;43;0
b58f080349b1aae9d9102280423e21fc76b8c66d;Thu Aug 30 02:44:20 EDT 2007;Committer;nobu;1;3;2;5;0
c8b8b7438e469fc66d981507e8e2085e7ff0208f;Thu Aug 30 01:54:51 EDT 2007;Committer;akr;1;3;2;5;0
2b18d1ee8e0d2b715da4c5ac8e6043c6037e49c4;Thu Aug 30 00:41:24 EDT 2007;Committer;akr;2;4;12;16;0
1591776d465bb901d0be1f45d03a65e2691ede50;Wed Aug 29 23:38:38 EDT 2007;Committer;akr;3;13;9;22;0
eee95e67b9794c3c4d3a583b413377c12bcb565d;Wed Aug 29 23:16:55 EDT 2007;Committer;akr;1;2;2;4;0
2a4c4f7b0c147585119036c43c1d04f73621e510;Wed Aug 29 23:12:21 EDT 2007;Committer;akr;12;136;59;195;0
3d7f8c2320d13fcc0c12e8910d70a812dab2f681;Wed Aug 29 19:16:02 EDT 2007;Committer;matz;5;13;16;29;0
24385e708ec111dc199c27d937c04656d6f8e6d9;Wed Aug 29 09:38:36 EDT 2007;Committer;akr;2;15;1;16;0
089cfabaf00f1d208f1af15c64a5e7c8b7025dc4;Wed Aug 29 06:54:56 EDT 2007;Committer;akr;1;8;0;8;0
2656b0545eaa3a5d8d2b96788adc2c1f4e78a1e0;Wed Aug 29 03:48:19 EDT 2007;Committer;nobu;4;21;17;38;0
69099d3e69cda873114981b131bc45b1490bcbf7;Wed Aug 29 03:19:00 EDT 2007;Committer;nobu;1;1;1;2;0
167358d00091069aac5874b38d04ef9ae20e1828;Wed Aug 29 02:36:54 EDT 2007;Committer;akr;3;173;1;174;0
3783246a2ee835575a025c7225abadb756ad93f7;Wed Aug 29 02:15:03 EDT 2007;Committer;matz;3;10;7;17;0
41585e424be2bfc12526a3f00378745c5851ad59;Tue Aug 28 10:23:31 EDT 2007;Committer;suke;4;18;4;22;0
51b4cc11d179106d4b7b9e8baf84e8e55c7b49f7;Tue Aug 28 06:45:32 EDT 2007;Committer;matz;4;40;20;60;0
01c24a2f78cb65c813331a9d590304c4352a4b34;Tue Aug 28 06:19:11 EDT 2007;Committer;nobu;1;8;0;8;0
53635dea12e9459168b45647cf52e26e0f1d451b;Tue Aug 28 05:23:33 EDT 2007;Committer;nobu;2;5;0;5;0
38b1f98a72129983956d26162df6825046ccf5db;Tue Aug 28 05:21:48 EDT 2007;Committer;nobu;2;13;3;16;0
88f13dfc7276ac7fbc4f010de9848ed8652c369c;Mon Aug 27 16:52:23 EDT 2007;Committer;ko1;1;0;1;1;0
6244e502cc12a7b8c5698740d3b5b355c1695e37;Mon Aug 27 16:48:14 EDT 2007;Committer;ko1;19;363;95;458;0
51fb5511e0f4ac9eb96819648beaac173f054c0b;Mon Aug 27 14:32:15 EDT 2007;Committer;matz;2;10;1;11;0
9166bd2bc9fa21a6cfa3c6390a7d165c0068895c;Mon Aug 27 14:17:28 EDT 2007;Committer;matz;2;6;2;8;0
4461bd2f1f804b82ab4c77902eecaa28bc99be39;Mon Aug 27 13:48:09 EDT 2007;Committer;matz;3;31;2;33;0
a1a618ead1bf6559cffb903b1d34e05a442957b0;Mon Aug 27 11:38:29 EDT 2007;Committer;suke;3;10;6;16;0
fd618e22343d82f5ca5ec0d21a476c0a534220d9;Mon Aug 27 10:15:18 EDT 2007;Committer;matz;2;7;0;7;0
3ca07d8718a156d2dcc3691bfdd5a0fecfc276d7;Mon Aug 27 06:56:49 EDT 2007;Committer;nobu;2;11;1;12;0
d4b9e9815babe982cd66852945d72e96297cac1c;Mon Aug 27 06:33:12 EDT 2007;Committer;nobu;2;47;37;84;0
fa02a6ceddfee03f7e68ef217f32e72ce44f7a1c;Mon Aug 27 04:51:45 EDT 2007;Committer;matz;2;10;4;14;0
1a0b7d0fb6e05704c94d7916aebbaca7c288a86f;Sun Aug 26 17:22:26 EDT 2007;Committer;matz;4;22;8;30;0
98d6d636e33f2f5bf067df64ae617d86e1f610bc;Sun Aug 26 16:33:45 EDT 2007;Committer;matz;3;8;4;12;0
d55c0f53825546c309dc613e34a96b2b13d61170;Sun Aug 26 03:31:20 EDT 2007;Committer;ko1;3;23;11;34;0
71e6011d63fde90dc7f6dda1e93acfe0c6eae585;Sat Aug 25 21:57:46 EDT 2007;Committer;suke;2;10;3;13;0
2ca7ad139f651baa6b8093f0f51fc0358e47b2c9;Sat Aug 25 21:05:20 EDT 2007;Committer;ko1;2;19;15;34;0
343c363d5b1374f3aca6f9ba6d755a156d03f3f5;Sat Aug 25 20:56:51 EDT 2007;Committer;ko1;3;136;81;217;0
cf16f0de0f01cbabec98e6efe8bcaaef2edeefe1;Sat Aug 25 20:54:50 EDT 2007;Committer;ko1;2;5;0;5;0
1ba65ebfe9ad769dda3b8e1c584829702b0c53ce;Sat Aug 25 15:27:08 EDT 2007;Committer;matz;3;7;5;12;0
890eb07370e66409dba4fce63aca5d7a48b6aa5f;Sat Aug 25 14:01:08 EDT 2007;Committer;suke;2;15;31;46;0
5ba27573a0d179d0a39d9997cfde000b20cd0b87;Sat Aug 25 08:54:29 EDT 2007;Committer;ko1;4;12;5;17;0
c2a734ea9946f88109b5ffc4507af66eed7f8cc8;Sat Aug 25 08:51:59 EDT 2007;Committer;ko1;2;7;2;9;0
2d888a8f331411751a9394a99c52d9b6928fe25e;Sat Aug 25 08:05:08 EDT 2007;Committer;nobu;2;4;1;5;0
10f56f8fd026456f02f65f270461faeadadf5386;Sat Aug 25 07:14:01 EDT 2007;Committer;nobu;2;6;4;10;0
c456863bd648a67eb57579f4e20b790ed6f7e304;Sat Aug 25 07:06:47 EDT 2007;Committer;nobu;3;33;24;57;0
7eeabe2f589de5272acae6c37a07ab2d9fa1ff7e;Sat Aug 25 06:34:28 EDT 2007;Committer;nahi;1;2;2;4;0
8bbac3ba77bb8261563b62bc709fc05759eea20a;Sat Aug 25 06:20:48 EDT 2007;Committer;nobu;2;13;7;20;0
000b6e22f463c560f695b460272395a492eface5;Sat Aug 25 04:14:26 EDT 2007;Committer;matz;1;79;0;79;0
5678ab5182b27d684cf7a4e7c6c48f3657389d31;Sat Aug 25 04:07:20 EDT 2007;Committer;matz;1;229;0;229;0
6527bcfe30e84c0b3f28b039f251ced47218c32c;Sat Aug 25 03:53:30 EDT 2007;Committer;akr;1;8;1;9;0
a25fbe3b3e531bbe479f344af24eaf9d2eeae6ea;Sat Aug 25 03:29:39 EDT 2007;Committer;matz;113;1423;752;2175;0
0ada813abfe3a049da29bd423ba34606a00777bd;Sat Aug 25 03:03:29 EDT 2007;Committer;akr;1;11;2;13;0
977d66ec993b0f1892fb3e4cd8ac1c41716daf85;Sat Aug 25 02:03:44 EDT 2007;Committer;ko1;12;83;40;123;0
cfaf3d9a1aee75a51f63bda5ff447da2bfc4234f;Sat Aug 25 01:20:30 EDT 2007;Committer;nobu;3;23;8;31;0
c289cf3a1ffa71217e597df051d945ff24126379;Sat Aug 25 01:09:08 EDT 2007;Committer;ko1;2;17;0;17;0
bdf32ff14f062b1813ccbf71f47fb301a0f47513;Sat Aug 25 00:43:13 EDT 2007;Committer;matz;3;18;3;21;0
d866a4202518df17b0acd02a601a56a4b44e252e;Fri Aug 24 23:55:16 EDT 2007;Committer;ko1;4;13;6;19;0
2f17991bd12e45ba5e4ca4ae973ba0af3887b5d6;Fri Aug 24 23:49:19 EDT 2007;Committer;ko1;2;13;3;16;0
4c86818f47ddd7988545c41c94b26cf39a19cc98;Fri Aug 24 19:01:46 EDT 2007;Committer;akr;3;77;55;132;0
85e3b4703208af36a0b15ecaf12c17f658138d8c;Fri Aug 24 18:10:37 EDT 2007;Committer;ko1;2;9;7;16;0
5e1c401ff5f72bb5e2bc6eb844b65977881a71c9;Fri Aug 24 17:47:09 EDT 2007;Committer;matz;6;103;0;103;0
487a7da22df69432d471a80982c446ec2e7db649;Fri Aug 24 15:51:33 EDT 2007;Committer;ko1;2;18;0;18;0
6bf7d3d8c08dbd96ec485bb856cb739139e720bc;Fri Aug 24 15:26:28 EDT 2007;Committer;ko1;6;60;6;66;0
b285d26a16c90f8e2d491592e793c3b40545aaf1;Fri Aug 24 15:19:00 EDT 2007;Committer;ko1;4;18;6;24;0
901343a761e7868839e00c69ac142353db734d0e;Fri Aug 24 10:48:43 EDT 2007;Committer;matz;4;36;45;81;0
4e183b11acebdbce9fe843059ddb8e18e491cce1;Fri Aug 24 09:57:53 EDT 2007;Committer;matz;12;35;22;57;0
99ab1fed49ba6b441fa5a6ae3d6818fae09b760e;Fri Aug 24 08:15:37 EDT 2007;Committer;matz;8;35;30;65;0
ac150ad226ce961dd8b0563cb2cd52ca07beb71e;Thu Aug 23 11:32:21 EDT 2007;Committer;ko1;2;84;10;94;0
32716144fdb3f83aa90cb0e6ab9207d63688fc9e;Thu Aug 23 11:14:03 EDT 2007;Committer;suke;3;80;25;105;0
42850db14b21b4fa9e85f575fe3a2bce0ba1867e;Thu Aug 23 08:25:12 EDT 2007;Committer;nobu;4;16;4;20;0
7912fdf599869eb279f750266eadddc275207274;Thu Aug 23 07:59:42 EDT 2007;Committer;nobu;3;6;3;9;0
e1b18be0166ee3e815d2a3dd0351cae3df2985a5;Thu Aug 23 07:57:03 EDT 2007;Committer;nobu;2;19;9;28;0
4af553f1e7a3ba8d7b668abdcf47d4f117099a65;Thu Aug 23 07:55:37 EDT 2007;Committer;nobu;2;12;6;18;0
e39eb9dab50eaa681467e51145b37cdc11667830;Thu Aug 23 07:10:56 EDT 2007;Committer;ko1;7;122;163;285;0
ac41d2774982fcf6f297e71c3e1209a650e44ce7;Thu Aug 23 06:51:21 EDT 2007;Committer;nobu;2;10;1;11;0
aa071a3b26a2b7946ffee6e608f8f204562a79f4;Thu Aug 23 06:48:28 EDT 2007;Committer;nobu;5;73;54;127;0
fcab7ebb713da9c0bfdffeb016186db781b8bbba;Thu Aug 23 04:19:45 EDT 2007;Committer;nobu;2;5;1;6;0
fb56832daf90bb63e24316ae0bb3de086d0a84de;Wed Aug 22 15:08:09 EDT 2007;Committer;matz;2;36;169;205;0
3e687367919352940f7664bed8c562aaf025deb6;Wed Aug 22 15:05:56 EDT 2007;Committer;matz;4;24;291;315;0
29ce3fad8213ec9d6c5988227a6487b9af244ac0;Wed Aug 22 07:30:07 EDT 2007;Committer;akr;1;1;0;1;0
95f37b477e09e2cfd2b75640ec805e1e6b7dd853;Wed Aug 22 07:01:51 EDT 2007;Committer;ko1;3;14;9;23;0
e9a2d02fec6e3d662ed536f5b38bcbcedb549fa0;Wed Aug 22 05:09:45 EDT 2007;Committer;ko1;3;19;3;22;0
00e6d5da69fd986b100fd9da18f490d201bd5dd9;Wed Aug 22 04:21:37 EDT 2007;Committer;akr;2;5;1;6;0
d4486478d4a8c1aa624bad3316470765a490c381;Wed Aug 22 03:43:12 EDT 2007;Committer;akr;1;2;0;2;0
40b5c7b26c3bd800b7e38a47a301973e87e6ae77;Tue Aug 21 20:57:48 EDT 2007;Committer;matz;3;3295;253;3548;0
c5e4cd063838033dff617f360a5b670b9eedaece;Tue Aug 21 18:51:39 EDT 2007;Committer;ko1;6;163;75;238;0
c4d6f4c01e44aa48070d091649795c586f3583e6;Tue Aug 21 12:15:34 EDT 2007;Committer;akr;2;32;5;37;0
1ad3f7f582c0b52a2b4b104d469c589a524f2c88;Tue Aug 21 06:00:25 EDT 2007;Committer;nobu;2;5;0;5;0
2b1cbac0ed37ec5927b1f7d69855b480b87693f2;Tue Aug 21 04:57:06 EDT 2007;Committer;nobu;2;11;5;16;0
1be6cc2388e963b99d50d6fe725dceb6a1ba48c8;Tue Aug 21 04:51:54 EDT 2007;Committer;nobu;1;2;2;4;0
271aaf297ec02e60f1b5e98b737e58e7cdf12eb7;Tue Aug 21 04:47:01 EDT 2007;Committer;nobu;2;7;2;9;0
be4fc7941bff50f6c90210a1d9e9178ffc05adda;Tue Aug 21 04:43:51 EDT 2007;Committer;nobu;3;174;93;267;0
c629aecbc810e8014a88943a2b3ddcb716aa6ffb;Mon Aug 20 19:11:20 EDT 2007;Committer;ko1;2;21;0;21;0
3fffbe1e82d974a3bb6cdba58733086a369d4b06;Mon Aug 20 19:09:03 EDT 2007;Committer;ko1;2;8;4;12;0
2d3724e05833f79e19f729195fdf0f01f081c5a6;Mon Aug 20 19:00:27 EDT 2007;Committer;ko1;2;6;1;7;0
ad56f8c6110bd8233a4f2224ccdd1cc7ef645dc1;Mon Aug 20 18:58:32 EDT 2007;Committer;ko1;4;73;10;83;0
009debfd02f5024b85b5c325f42533b40f4028e9;Mon Aug 20 14:46:03 EDT 2007;Committer;matz;3;5;2;7;0
5d51ae926b39781fa99c9462d761e2dd5649f2da;Mon Aug 20 14:35:53 EDT 2007;Committer;matz;2;4;0;4;0
b6449f6080fffc6ecdb662d1ba353586c4edeae6;Mon Aug 20 14:30:12 EDT 2007;Committer;matz;2;5;19;24;0
f2f08335df6a84ad82bba9defe7e5f3e7cfd8d55;Mon Aug 20 14:17:16 EDT 2007;Committer;nobu;5;17;15;32;0
cf82149d213c7e140bd6c50072598a2fa19af45b;Sun Aug 19 15:43:04 EDT 2007;Committer;akr;1;61;42;103;0
1d23c250f07a3d977eb5b0c9dd4fac359dc112d2;Sun Aug 19 04:34:44 EDT 2007;Committer;akr;2;15;0;15;0
0a02ad5e2e2cdd7e3dcb33f40eae056a8dfdc639;Sun Aug 19 04:16:13 EDT 2007;Committer;ko1;3;26;13;39;0
cd30220afff0d5473022bfb5749716364ebc05a8;Sun Aug 19 04:02:21 EDT 2007;Committer;ko1;5;23;15;38;0
a854a4358f84a04cb79b8e0db3a08f63731fd526;Sun Aug 19 03:37:14 EDT 2007;Committer;akr;2;53;11;64;0
98e7aa679a65fc0ec8e476c52b7254d4d6d2350d;Sun Aug 19 03:35:39 EDT 2007;Committer;ko1;3;10;6;16;0
9e5d0d861f1f082c0c8632e62aa018972cc533bb;Sat Aug 18 17:04:06 EDT 2007;Committer;akr;3;281;15;296;0
7017b63b81dd2ab35c6f33d9dd01357480b77b9a;Sat Aug 18 10:04:24 EDT 2007;Committer;akr;2;13;7;20;0
0dec7d57886a067c66a08fa15265cd8bbd4b86fc;Sat Aug 18 08:44:44 EDT 2007;Committer;nobu;2;6;5;11;0
6fc746d7e32243b4c46ac5ef9fee4806664fd7e6;Sat Aug 18 08:40:13 EDT 2007;Committer;nobu;4;45;4;49;0
2c5ae0eebad1397653f5dac5982cd5eba14ff35d;Sat Aug 18 07:48:28 EDT 2007;Committer;ko1;4;23;4;27;0
115a3d21e49a887f615b2b85c3eb4dd11701ab51;Sat Aug 18 07:44:51 EDT 2007;Committer;nobu;4;159;149;308;0
6e0c6ac3be8069e939748b00febcf4411ce905cb;Sat Aug 18 06:59:54 EDT 2007;Committer;nobu;2;13;9;22;0
bade43f9d16d1a03c29077c0f1c8fbf07e19acd1;Sat Aug 18 06:52:51 EDT 2007;Committer;nobu;2;6;1;7;0
d23abfc546cf0b5f1b28588036af691938c484a0;Sat Aug 18 06:45:37 EDT 2007;Committer;nobu;2;6;2;8;0
88e1fec39389ab4ea4952db397e7ad1d1bab4a65;Sat Aug 18 06:31:04 EDT 2007;Committer;akr;1;11;7;18;0
65b0b08529bd33b6f1f9f6c0ac59a2e3035959d7;Sat Aug 18 06:12:48 EDT 2007;Committer;nobu;1;1;0;1;0
e765f48428280bf2c1b70853d5a47dad5c33092b;Sat Aug 18 06:03:45 EDT 2007;Committer;nobu;1;2;3;5;0
2d9512edd95722eff788d33c24d7c92d6e5a35de;Sat Aug 18 05:35:03 EDT 2007;Committer;nobu;2;15;18;33;0
c2a41b3a713052d4c970830d703ae3f71b33a931;Sat Aug 18 05:11:49 EDT 2007;Committer;nobu;2;40;40;80;0
0c031468fe31537bad55ce558e22a6c5da527d7d;Sat Aug 18 05:07:07 EDT 2007;Committer;ko1;3;18;0;18;0
3f025d2078157e895fdcf77e31bfe62351bf90b4;Sat Aug 18 05:05:36 EDT 2007;Committer;nobu;3;34;16;50;0
42cf6ee7530e312288ff78236f552e1b6d5ca341;Sat Aug 18 04:26:48 EDT 2007;Committer;ko1;2;49;12;61;0
2e83c555d83d379f65f8e6af79ce7bda36a7ba2c;Sat Aug 18 04:17:39 EDT 2007;Committer;ko1;2;13;2;15;0
f72409043cb0e9cdea665ee7248ec98a9e523016;Sat Aug 18 04:14:31 EDT 2007;Committer;ko1;2;6;1;7;0
4a6335717f11b799bcc7c12564b9c25da677656c;Sat Aug 18 03:47:03 EDT 2007;Committer;akr;1;9;0;9;0
f62fff5f413048d4cb19207212bb25fee84b9963;Sat Aug 18 03:44:28 EDT 2007;Committer;akr;3;55;20;75;0
6355e16257501fe882c4aeeb22b683ab0f279b23;Sat Aug 18 03:24:41 EDT 2007;Committer;akr;1;1;1;2;0
54a3576eaa58463089a34f1b9cb713b3b864738e;Sat Aug 18 03:24:32 EDT 2007;Committer;nobu;3;13;2;15;0
77cc5f203126933569bb28ec77f8d3fb9df78019;Sat Aug 18 02:50:37 EDT 2007;Committer;ko1;1;2;0;2;0
4d3a58bc693dc589293426c0115cbc6897e0a45e;Sat Aug 18 02:48:13 EDT 2007;Committer;ko1;4;23;4;27;0
69dd06ae685b41ed9a77c4b2bdfa5587c12c5019;Fri Aug 17 16:12:03 EDT 2007;Committer;nobu;4;28;8;36;0
2c5463fe99df8868e53817af834f1ecec9875515;Fri Aug 17 13:48:39 EDT 2007;Committer;ko1;2;18;9;27;0
ad272173cdeb8233757088d765ed16444dc7d17a;Fri Aug 17 13:11:39 EDT 2007;Committer;ko1;2;8;3;11;0
b982cff67c1e7e879b4532f496c40d9ebd3b1c0d;Fri Aug 17 12:25:47 EDT 2007;Committer;ko1;6;106;31;137;0
e5d5f5a61a484c5d3993cee2c02c4f501a6f74f8;Fri Aug 17 07:24:03 EDT 2007;Committer;ko1;2;25;9;34;0
82a9ca296b69144212c10b66eb932555310bd973;Fri Aug 17 05:41:10 EDT 2007;Committer;akr;2;49;6;55;0
4675be9a656d3bd447addd27620bb53521d02cca;Thu Aug 16 22:24:45 EDT 2007;Committer;matz;1;2;2;4;0
bef0b1fa361728e144ec97a2a7ab88feb6752c69;Thu Aug 16 22:22:24 EDT 2007;Committer;matz;4;14;1;15;0
04176dc21fb74c26a12895319a86eb2c3b138f90;Thu Aug 16 18:12:02 EDT 2007;Committer;ko1;2;8;3;11;0
fc466622fd220b1d907d86cdbc3f74acc11a58ca;Thu Aug 16 16:29:11 EDT 2007;Committer;ko1;4;24;7;31;0
4657257b75ff1d88e2653e4c408b0d98e7fbdc9a;Thu Aug 16 16:25:30 EDT 2007;Committer;ko1;2;6;2;8;0
e7c3478261c30c64092a0f9532cb8b714911e1e8;Thu Aug 16 16:24:18 EDT 2007;Committer;ko1;3;8;3;11;0
571f22f5fe3fd3e265512c0e9ee4720482443301;Thu Aug 16 13:12:24 EDT 2007;Committer;ko1;4;132;30;162;0
48442d46b39976ec9a3a17e357fd3be13cd8feaf;Thu Aug 16 12:16:14 EDT 2007;Committer;eban;2;5;0;5;0
c710449a85cb9a1556264ab1a5dfa1640e1f925a;Thu Aug 16 12:07:29 EDT 2007;Committer;akr;1;8;6;14;0
5fe865d0ac29601d8220e0055e46282cc25a472c;Thu Aug 16 10:21:49 EDT 2007;Committer;akr;1;7;0;7;0
9a26bd3f57fac024f0b6d6ad11882ced875a5007;Thu Aug 16 10:21:16 EDT 2007;Committer;akr;5;482;277;759;0
ff31ae014108aedc48223aafd0b941e735402fce;Thu Aug 16 07:48:49 EDT 2007;Committer;nobu;2;23;17;40;0
29ab4251f721c64324202357310cba16aa34a2c0;Thu Aug 16 07:46:11 EDT 2007;Committer;nobu;4;47;35;82;0
478e984e939cc79c7d23910ceda1482cbb0cbf14;Thu Aug 16 04:30:18 EDT 2007;Committer;akr;1;2;1;3;0
02c581be74aba5d5d509717c78e89b60b49421bf;Thu Aug 16 04:09:02 EDT 2007;Committer;akr;2;19;10;29;0
e7e1b3a2d69abe7a85ecd82491f271f5ddfe73f6;Wed Aug 15 21:29:10 EDT 2007;Committer;nobu;2;17;4;21;0
3efcb087a37b73f2c3095dcfbf44bfd7b43ae4d1;Wed Aug 15 17:56:22 EDT 2007;Committer;ko1;3;15;4;19;0
5aa850d260849a13f4b372476321e822e3f9601d;Wed Aug 15 16:03:16 EDT 2007;Committer;akr;1;0;128;128;0
bba925eae6f49931a46fd879425c1b0927e95aab;Wed Aug 15 15:38:18 EDT 2007;Committer;akr;2;65;0;65;0
f13e9b734cbdec6f93796aa68feb95f0b123a040;Wed Aug 15 09:58:59 EDT 2007;Committer;ko1;3;12;0;12;0
0aecfb04393982d79907539dcd202c71c28c7f53;Wed Aug 15 07:50:11 EDT 2007;Committer;ko1;2;6;1;7;0
758c51cafe539206b25364b6c84a70cccb8dd6ad;Wed Aug 15 07:47:03 EDT 2007;Committer;matz;2;10;5;15;0
ad1e42421cc06037f1c3f6622c6ce7775690941c;Wed Aug 15 05:59:24 EDT 2007;Committer;nobu;2;6;7;13;0
fc5885aa7a6be99bf19a827a42d1de157a1f4a94;Wed Aug 15 05:22:44 EDT 2007;Committer;ko1;2;6;2;8;0
aca2aa245774a4ec6861aa00c109d3cd76b40ba8;Wed Aug 15 05:17:06 EDT 2007;Committer;akr;1;1;1;2;0
fe898043ccc99f3e127c63e0c18f4d2233bfa555;Wed Aug 15 04:52:56 EDT 2007;Committer;ko1;4;34;15;49;0
4edc1d8c9c234303096e6e5a35e87944b50d247d;Wed Aug 15 04:50:12 EDT 2007;Committer;nobu;3;57;16;73;0
686535d403395587995082e5436f3131e80a04d7;Wed Aug 15 04:42:19 EDT 2007;Committer;ko1;2;5;1;6;0
c8c6ab229a1358174b90b027b65430674af7b656;Wed Aug 15 00:33:33 EDT 2007;Committer;matz;3;85;75;160;0
333454e4dd89fb6bd1c206cd79485b22ffb992b7;Tue Aug 14 16:06:44 EDT 2007;Committer;akr;2;8;1;9;0
b235e8f474b24b22162ed3feb8a0a3abec14f2e0;Tue Aug 14 12:48:12 EDT 2007;Committer;akr;3;41;15;56;0
7e8d337aa47a282f632b11d62503739251766463;Tue Aug 14 11:03:29 EDT 2007;Committer;matz;2;46;53;99;0
14c3aa52aeff4fed170b3dbe8666aaa851b654d2;Tue Aug 14 10:53:53 EDT 2007;Committer;ko1;8;44;8;52;0
9cdeae9dad9f8ac8fe50b6b6f01ecd76f21f5e6b;Tue Aug 14 10:53:06 EDT 2007;Committer;ko1;3;8;4;12;0
3349fd5826427a6dfe512202976ddd825ba550b9;Mon Aug 13 15:06:58 EDT 2007;Committer;kou;4;13;8;21;0
f5da26fc3419426c6619fc86308f966181762f07;Mon Aug 13 08:23:12 EDT 2007;Committer;nobu;2;26;12;38;0
8a25f09d6c9dfd55644d8b3afb750cdc76c5bc7e;Mon Aug 13 04:23:42 EDT 2007;Committer;akr;2;6;0;6;0
d7a19d03334075e29e14e0e2065d29b73e5d5350;Sun Aug 12 20:06:59 EDT 2007;Committer;ko1;3;27;2;29;0
161b2e264fcfc0ecb046b35245139e02847bbdb0;Sun Aug 12 19:37:16 EDT 2007;Committer;ko1;3;16;4;20;0
fc234a916a18f27b47005358c8ae3f7e4205415a;Sun Aug 12 19:12:55 EDT 2007;Committer;ko1;1;8;0;8;0
b1c5d848f89dc4bc7a25909fed26b4d8dcebb074;Sun Aug 12 19:09:15 EDT 2007;Committer;ko1;6;199;146;345;0
99b51f6020e847826d60a5bae0fca451cf2e7994;Sun Aug 12 19:02:30 EDT 2007;Committer;ko1;3;8;4;12;0
6a7dc2698560cb1c3a46a3f45d821aae5431bbca;Fri Aug 10 22:33:48 EDT 2007;Committer;tadf;2;15;10;25;0
1a7564a0ed8aa82eb3a7002906e34388b677dc58;Fri Aug 10 15:01:14 EDT 2007;Committer;nobu;3;15;5;20;0
9242da9e02fb7b37e20d6178ba6c9658d6bf8f31;Fri Aug 10 14:54:50 EDT 2007;Committer;nobu;3;6;4;10;0
3660ca5281a0dd77a01d75b7967387ae756aacde;Fri Aug 10 00:47:33 EDT 2007;Committer;nobu;2;6;0;6;0
2903ea4aeb7f9b73ec6d15819e811a4f0c715444;Thu Aug 09 20:12:21 EDT 2007;Committer;nobu;2;22;0;22;0
d3a1980b9632af97814240e21b29a3aeb3eb453a;Thu Aug 09 19:47:11 EDT 2007;Committer;nobu;3;9;3;12;0
ae709e831f6f1130c0a7e5b6e59e3f3c8a5f6f3f;Thu Aug 09 07:04:56 EDT 2007;Committer;nobu;2;68;50;118;0
fb20d67ff5b7966b5203d4ece1bc70a03ed51980;Thu Aug 09 06:15:44 EDT 2007;Committer;akr;1;9;9;18;0
fda5eeae72dc043d4359cf1c9a8e092008292f22;Thu Aug 09 05:01:37 EDT 2007;Committer;nobu;2;17;10;27;0
e2de7c70dc4979b545254f18e38868e8e1a68dcf;Wed Aug 08 17:03:33 EDT 2007;Committer;matz;3;9;4;13;0
7db17c6ad6ace607939ff9b817f15b1b77af4e63;Wed Aug 08 10:20:08 EDT 2007;Committer;matz;3;4;9;13;0
4b3644bef769719e2b90c05b719120f27a438c23;Wed Aug 08 10:00:06 EDT 2007;Committer;matz;2;6;1;7;0
c186fdb90bfecb9ecc9a001796a19efca401dc4c;Wed Aug 08 07:07:03 EDT 2007;Committer;matz;5;68;14;82;0
cc317d920817a169a8761c9e756082bcc126a1c1;Wed Aug 08 04:45:15 EDT 2007;Committer;akr;3;25;31;56;0
120a9d2f8336935d5f1b346c3df01c7ceb7505fd;Wed Aug 08 02:48:39 EDT 2007;Committer;nobu;2;10;6;16;0
b42698eaff77b1894176104bb32b5c7396eb3361;Wed Aug 08 02:26:40 EDT 2007;Committer;usa;2;8;4;12;0
9644a2c02cad092d15cd96d465d78f4c9ed626ea;Wed Aug 08 02:02:45 EDT 2007;Committer;nobu;3;14;5;19;0
785d6c77780d2d0b4b9684b9ca78a1e40bdf96b8;Tue Aug 07 11:01:06 EDT 2007;Committer;suke;1;0;1;1;0
27b103f37aa5dab4f0182cdc27b754af6a03d480;Tue Aug 07 05:58:41 EDT 2007;Committer;nobu;2;8;2;10;0
a37d419c5dfced39d99d26bd4012a9700eb7bda4;Tue Aug 07 05:56:52 EDT 2007;Committer;nobu;3;42;43;85;0
f800cdbabc950ff4d18f9183c75670cb2a937d84;Tue Aug 07 04:58:07 EDT 2007;Committer;nobu;3;39;13;52;0
8063c2b2e34222884237794d1cdc381765a35d8b;Tue Aug 07 04:28:34 EDT 2007;Committer;nobu;2;6;1;7;0
2effce2eb5b5c670aa807ba0e30be3668eac2fbf;Tue Aug 07 03:45:15 EDT 2007;Committer;nobu;2;8;3;11;0
819619495ae880d03deee55b39b7381a38fb2b03;Tue Aug 07 03:31:54 EDT 2007;Committer;nobu;2;8;5;13;0
81201b4007dfa68765d168321edbc3a163d9f2c8;Mon Aug 06 18:03:11 EDT 2007;Committer;matz;2;264;150;414;0
ecb93c3fdf347a3d14c13f8f9292bebf77ebfa07;Mon Aug 06 16:53:36 EDT 2007;Committer;matz;4;53;106;159;0
57b0b6c7b13d44bd7655eee7e315d09d72ada640;Mon Aug 06 16:41:17 EDT 2007;Committer;matz;5;145;24;169;0
b3e977a4c03e435a9a6edd305b03a2769c31df96;Mon Aug 06 16:26:17 EDT 2007;Committer;matz;4;72;3;75;0
5956c7ab3ec70bc798b6843e0fb17e22424d5083;Mon Aug 06 15:11:33 EDT 2007;Committer;keiju;2;10;0;10;0
f4a3bcbff05afe3062784af3de4005cd95aac0d8;Mon Aug 06 11:37:22 EDT 2007;Committer;suke;1;9;2;11;0
ae421c43dfda6e9a1e9af1edaa649a3de17ff07a;Mon Aug 06 11:36:30 EDT 2007;Committer;ko1;7;332;300;632;0
7e2b837a3939b0c7473728c12579dd8930c3cfaf;Mon Aug 06 09:43:31 EDT 2007;Committer;ko1;2;12;0;12;0
fe0f6734bf0ee31f17b29e2e1c90d2ce8fb58e3f;Mon Aug 06 09:38:51 EDT 2007;Committer;ko1;2;14;4;18;0
7bc137942d07349a5ab90e4f1e54ce17fd376fe5;Mon Aug 06 08:39:01 EDT 2007;Committer;akr;1;132;0;132;0
27e2b689f2e5a4db83e22912b688c8254997d4d5;Mon Aug 06 08:36:31 EDT 2007;Committer;nobu;3;84;80;164;0
d18fd7206d494cb1db54a018afa722f001be5e61;Mon Aug 06 08:27:04 EDT 2007;Committer;akr;1;7;1;8;0
18c81c3d3ef53c6548c5fa0cad90efe2b3ae93cf;Mon Aug 06 07:58:45 EDT 2007;Committer;ko1;2;7;1;8;0
1951ef76cec33f2e6abcdb1a017972d53c032cfb;Mon Aug 06 07:46:57 EDT 2007;Committer;ko1;3;11;6;17;0
1a300415363ed3b87a7210aaed79623510e1fc9e;Mon Aug 06 07:38:18 EDT 2007;Committer;ko1;2;5;1;6;0
2829c72cce152f5d0d198e47b9ea0c00ab44cc1e;Mon Aug 06 05:36:14 EDT 2007;Committer;ko1;2;10;5;15;0
ab664381aa170064d378e2c9912f043cc1c14b81;Mon Aug 06 04:34:11 EDT 2007;Committer;nobu;2;19;6;25;0
a9ba30ee8661fbbb01f79a923cef70e2aa050a06;Mon Aug 06 04:09:56 EDT 2007;Committer;nobu;4;18;233;251;0
ee8f40b5a62a15298c668b57b3504e177289972c;Mon Aug 06 04:00:09 EDT 2007;Committer;nobu;4;25;10;35;0
d690c9283c8af8c4714524b0a3e98cdcae36980f;Sun Aug 05 04:10:51 EDT 2007;Committer;tadf;1;2;2;4;0
cbc22bf9bd0a84d00c76da72052a42e99a3e5d6e;Sun Aug 05 04:06:08 EDT 2007;Committer;tadf;1;4;0;4;0
71976790ec02f88d9fb51fab151312124f6df223;Sun Aug 05 03:03:05 EDT 2007;Committer;kou;43;3053;1455;4508;0
43009063c70fe62028eb035e67a06863b98dc540;Sat Aug 04 19:56:27 EDT 2007;Committer;nobu;3;47;36;83;0
341ae6ac3ed239acf5322192c4c70c8fbac88bcd;Fri Aug 03 02:05:57 EDT 2007;Committer;nobu;2;53;16;69;0
f3a1a4a4ba1d36dcfa79bc7be8a4fd56ff5ab40d;Thu Aug 02 22:09:08 EDT 2007;Committer;nobu;2;38;13;51;0
332297419613bf3df97e77d4f21ee7be6b1da1aa;Thu Aug 02 21:40:06 EDT 2007;Committer;nobu;2;4;2;6;0
899742b26930aac433a64f00c960fa08250d062b;Thu Aug 02 21:17:37 EDT 2007;Committer;nobu;3;20;9;29;0
51732bc6d277aa695ffd266ea4394d03fd4029fb;Thu Aug 02 15:00:22 EDT 2007;Committer;nobu;2;11;5;16;0
230aa7715ae576db636c19469b204696ff331d48;Thu Aug 02 14:45:34 EDT 2007;Committer;matz;2;118;19;137;0
11e1e96f4b18330e4b8de1eadee505897bdb4e88;Thu Aug 02 14:42:59 EDT 2007;Committer;nobu;2;72;47;119;0
d9274e7d6bbffd15291ffc6bdd5fefbde79f5cb8;Thu Aug 02 14:36:25 EDT 2007;Committer;nobu;4;31;10;41;0
46e848a65a866663161edecc81d1b46aa3e36de3;Thu Aug 02 04:46:41 EDT 2007;Committer;nobu;4;13;4;17;0
12b1e59f2eacd346da550bbc30cc3644909cb314;Wed Aug 01 03:40:08 EDT 2007;Committer;nobu;4;122;70;192;0
a16bdfdfba95abeec8cff6ea6f8381292ade248a;Tue Jul 31 14:46:58 EDT 2007;Committer;tadf;2;6;1;7;0
8721f3983daf486a173b8ebc5d1ca7266c35014b;Mon Jul 30 03:45:05 EDT 2007;Committer;akr;1;3;1;4;0
148e522f6314b4c34a6d0eeb6b92553e7e962649;Mon Jul 30 03:42:55 EDT 2007;Committer;nobu;1;1;1;2;0
798b8d27916adcb3faa87e85e45211340b6bc3a4;Mon Jul 30 02:16:42 EDT 2007;Committer;nobu;4;37;15;52;0
7e168983ce133427289d53d159a1e354abb4e92e;Sat Jul 28 13:28:30 EDT 2007;Committer;ser;3;12;7;19;0
0e83f22cf5c79d73f8723e91c7e9460849b0f494;Sat Jul 28 00:44:08 EDT 2007;Committer;matz;3;12;5;17;0
6d9a4f510c6ad2eb5e9f50acfc600cfad7915586;Thu Jul 26 13:37:13 EDT 2007;Committer;matz;2;25;3;28;0
d13499173031809a316f1e5d25d9bb3e825e146c;Thu Jul 26 04:57:48 EDT 2007;Committer;nobu;3;9;5;14;0
ea7e249079c86e502d2af4c6c896952dd5cad150;Thu Jul 26 04:38:07 EDT 2007;Committer;nobu;4;124;121;245;0
e85e24aceabe1597b68b7ceb67a59c4e1dc17818;Wed Jul 25 13:03:38 EDT 2007;Committer;ser;1;1;0;1;0
1d8c98a486a81bc5cd6957b5eba4a118eda2a46f;Wed Jul 25 12:47:23 EDT 2007;Committer;ser;23;1775;1414;3189;0
fead3c93e744f45ff8e7d4bac550bbd0cd79994f;Tue Jul 24 01:37:07 EDT 2007;Committer;nobu;2;5;1;6;0
6afa428a342c1562756ffcb48b54b4b419147584;Mon Jul 23 16:11:37 EDT 2007;Committer;matz;3;9;4;13;0
e1def8a98713beef25e048c5333d418624f7d192;Mon Jul 23 09:39:30 EDT 2007;Committer;matz;14;1392;1411;2803;0
46eb6e9428918e78e852562a6926adc76f81ed97;Mon Jul 23 09:13:44 EDT 2007;Committer;matz;3;16;6;22;0
3c5510565b4070ced940a29b90c79a1abe36a792;Sun Jul 22 11:22:03 EDT 2007;Committer;tadf;3;67;22;89;0
fb00d61acf3e7f3c8c839f25c4a9c094349160f3;Sun Jul 22 07:07:12 EDT 2007;Committer;nobu;5;13;5;18;0
f1622c195da92aaaa0200d3afcf44f58c0cf29d9;Sun Jul 22 05:33:54 EDT 2007;Committer;nobu;8;33;19;52;0
4b40f2c51607e5a918699952605bbcfc5bff9f99;Sat Jul 21 14:54:51 EDT 2007;Committer;nobu;1;1;1;2;0
54057bbe33ef38bc62c092af9b4987565f5f2be0;Sat Jul 21 13:02:29 EDT 2007;Committer;tadf;3;318;24;342;0
2840fa6b6504de820c3ca40457306787545d27fe;Sat Jul 21 08:48:29 EDT 2007;Committer;nobu;4;50;15;65;0
92cad4305b1751fcea0bcfe1386e8f8cba265167;Sat Jul 21 08:32:34 EDT 2007;Committer;nobu;5;160;53;213;0
021660e4428f941553ae0cf893d756f270771471;Sat Jul 21 08:07:37 EDT 2007;Committer;nobu;2;6;2;8;0
985099b0e3c47b4ade1b36f8cae5712f5744c7e3;Sat Jul 21 07:11:39 EDT 2007;Committer;nobu;1;1;1;2;0
267241808bb5d603537794931ffe70c782940bd6;Sat Jul 21 06:39:26 EDT 2007;Committer;nobu;4;6;4;10;0
7dcc7aca28505460b64cd82a1416189e517c7f80;Sat Jul 21 06:32:40 EDT 2007;Committer;nobu;2;9;3;12;0
90ae4b364b91c505e708b468d22d1ee940640356;Sat Jul 21 03:06:50 EDT 2007;Committer;nobu;3;8;3;11;0
6683940715a917e79050e01e0f02c9642c8ffa00;Fri Jul 20 16:52:59 EDT 2007;Committer;tadf;2;30;17;47;0
644d3a650fc31c865bb87d53de6624f876bf68dd;Fri Jul 20 07:30:33 EDT 2007;Committer;nobu;2;23;8;31;0
39c56c33490275091939ba33ee18b03b140ea3b7;Fri Jul 20 07:11:35 EDT 2007;Committer;nobu;7;102;74;176;0
98a54d46f74bf3c7b60b83bcc73e0b312425a1bb;Fri Jul 20 06:22:54 EDT 2007;Committer;nobu;2;9;1;10;0
2c2adf8dc3fd0a36620b723778b1c1a86646940b;Fri Jul 20 01:43:50 EDT 2007;Committer;nobu;1;2;2;4;0
bf27f224f014fc549026b2ef837d65438662e81f;Fri Jul 20 01:39:30 EDT 2007;Committer;nobu;3;26;20;46;0
327be4636e4eca04ef34f4e59655dd9bdd1a0a00;Fri Jul 20 01:21:12 EDT 2007;Committer;nobu;1;20;0;20;0
4beb1193936ff7ea65fbe81d4a8b096cc3067c96;Fri Jul 20 00:50:42 EDT 2007;Committer;nobu;3;19;5;24;0
863e7e95f2a811530df1f5bc8400d098c35cce45;Thu Jul 19 17:04:53 EDT 2007;Committer;akr;2;56;7;63;0
a1c76bc3de808ab3c5b36725369e952210ef8b64;Thu Jul 19 10:24:17 EDT 2007;Committer;nobu;3;14;7;21;0
09ce106ab3341030cc1893ca308532d196658508;Thu Jul 19 05:38:48 EDT 2007;Committer;nobu;6;147;26;173;0
ec6e26742cd467b210c8d2935edb1a0dcb26e0dd;Wed Jul 18 07:57:45 EDT 2007;Committer;nobu;2;7;1;8;0
233221db60c32a626b7e7d06dae71a4c3f78d380;Wed Jul 18 00:19:10 EDT 2007;Committer;nobu;3;16;4;20;0
73c8156360db536af7e64b062bda1bdd4454719d;Tue Jul 17 23:55:17 EDT 2007;Committer;matz;3;14;4;18;0
4d16ce7da4b142d411513048895972d682a45d0f;Mon Jul 16 16:58:58 EDT 2007;Committer;matz;2;9;9;18;0
bc8724d05fcde5d703f622855844460f35fcfce7;Mon Jul 16 15:45:35 EDT 2007;Committer;matz;3;9;4;13;0
6c12b69fdac5b38410fb37e94f1546e3c119685e;Mon Jul 16 09:29:35 EDT 2007;Committer;nobu;2;50;39;89;0
c2b34e34cbca5d8c10f6ed9af96b9ff1d998e6a5;Sun Jul 15 22:17:31 EDT 2007;Committer;nobu;2;6;0;6;0
192c936e2317286fa428a76a4018c9082d11c828;Sun Jul 15 20:45:55 EDT 2007;Committer;nobu;3;74;26;100;0
66e1be60c39e3ab96fc7de01fb950cac9b5bc700;Sun Jul 15 15:26:12 EDT 2007;Committer;nobu;3;10;18;28;0
cba32dcaa6cd7369d0c0d130a15522048440c658;Sun Jul 15 13:24:39 EDT 2007;Committer;nobu;10;54;9;63;0
746a7ec4f676b84febc1c2199bbfba20b3c9050a;Sun Jul 15 12:15:42 EDT 2007;Committer;akr;1;16;6;22;0
959bd6cfdfdecaba2017932fe1178fae3c1a9f32;Sun Jul 15 12:09:42 EDT 2007;Committer;nobu;1;1;1;2;0
65055630acd67e9d85b30646c9311e7d214f8912;Sun Jul 15 12:07:46 EDT 2007;Committer;nobu;2;6;1;7;0
b64881077e272f421759149bff40e8d472621423;Sun Jul 15 10:05:37 EDT 2007;Committer;nobu;3;33;15;48;0
dd523215af505c1f80997fd71d3afdc2e62aac92;Sun Jul 15 01:41:40 EDT 2007;Committer;akr;1;4;0;4;0
3c883bdd1700f23da29fd8f534ee366855c0a6a5;Sun Jul 15 01:20:56 EDT 2007;Committer;akr;1;12;5;17;0
1edeb9a6d12ab2a74efcf7db4498a4603918d7ee;Sun Jul 15 01:20:19 EDT 2007;Committer;akr;1;1;1;2;0
146216ccb40e64d34f28d585b3b2f1328cc8a121;Sun Jul 15 01:18:55 EDT 2007;Committer;akr;1;5;0;5;0
2adf19d6c4febaa497c28dfc5fe0942e540dd883;Sat Jul 14 19:42:25 EDT 2007;Committer;nobu;3;8;3;11;0
7f0bb427e09ab985da52217f792c292ba9d0c556;Sat Jul 14 14:31:21 EDT 2007;Committer;matz;3;28;5;33;0
bb44ba9b72adf41dc17714351df724bc5c21bd7a;Sat Jul 14 09:47:05 EDT 2007;Committer;akr;2;4;4;8;0
4608b08d1f86a15674a403e8218fdbce6a18e4d4;Sat Jul 14 07:48:54 EDT 2007;Committer;akr;1;1;1;2;0
a8b39ddf5a3dfd8717e88e95f3aff71fd414aaf3;Sat Jul 14 07:27:32 EDT 2007;Committer;akr;2;4;4;8;0
0886a4d8a06a609445f04351dc1e899dd59a3678;Sat Jul 14 07:19:59 EDT 2007;Committer;akr;6;108;28;136;0
a5941516685eac751193ea88424be5588698b2c7;Sat Jul 14 05:04:09 EDT 2007;Committer;nobu;2;10;1;11;0
75d484a453ca5448d0b916f813b3c7782ffa4b65;Sat Jul 14 04:13:12 EDT 2007;Committer;akr;1;9;2;11;0
f3750dbf9957ce00c1cdf0a145f19505f3292199;Sat Jul 14 02:14:31 EDT 2007;Committer;matz;2;7;1;8;0
b13b3e624b62d321ab5fb84f1aa02e9672a7cc43;Fri Jul 13 17:29:24 EDT 2007;Committer;matz;2;11;6;17;0
2a5c48a54d3ffd25e584c9568761711cb1c4fd8c;Fri Jul 13 17:09:38 EDT 2007;Committer;matz;1;2;2;4;0
716ad250e96aa2d8cc6c2d523f98585089d7b8d2;Fri Jul 13 17:08:12 EDT 2007;Committer;matz;2;6;1;7;0
3a4e0f1f5ab181ddc42a4f5359a114737c5d218a;Fri Jul 13 16:34:19 EDT 2007;Committer;akr;1;21;16;37;0
3e6f0e6a20ee36c09e1078ef2e64d22c93a6393c;Fri Jul 13 15:38:48 EDT 2007;Committer;matz;3;9;4;13;0
4122a1356058bc4df1073713b8f43a75a8cca51a;Fri Jul 13 15:20:49 EDT 2007;Committer;akr;1;12;0;12;0
744701f40464355af08734482b7ec02f6447ca25;Fri Jul 13 14:50:06 EDT 2007;Committer;akr;1;30;0;30;0
3cf28c2caa1d0edbd78082bfe7b6c01172bb861f;Fri Jul 13 13:31:41 EDT 2007;Committer;akr;1;15;0;15;0
71467c78c2923115649ce93550352fd4f9d550e5;Fri Jul 13 12:51:27 EDT 2007;Committer;akr;1;302;0;302;0
d2113feba8807132bcb550e3131fed9f53c863b6;Fri Jul 13 10:21:50 EDT 2007;Committer;akr;1;52;0;52;0
b626539e9b5cead657348e93d9f36d95d533b1eb;Fri Jul 13 09:36:04 EDT 2007;Committer;ko1;3;6;16;22;0
c6818f4104448757677a6c5835c38a61475c78b9;Fri Jul 13 09:35:29 EDT 2007;Committer;akr;1;1;0;1;0
c393603f945d22fd6edd1b16ca367c41a5f6962c;Fri Jul 13 09:33:17 EDT 2007;Committer;akr;1;32;0;32;0
0b0b62e9a413020fb8383559bdd051d30d128de9;Fri Jul 13 08:42:27 EDT 2007;Committer;matz;2;3;1;4;0
a309f1047548bafcde65ef66143854f289926bab;Fri Jul 13 08:40:09 EDT 2007;Committer;akr;2;195;1;196;0
53d317b9acf2827c1cad06f64f27e406493d75d8;Fri Jul 13 08:37:37 EDT 2007;Committer;matz;2;6;0;6;0
d98a362c1a8925cf68a379e81b58be704bda19e3;Fri Jul 13 07:59:40 EDT 2007;Committer;akr;2;7;1;8;0
aebce0bb76fb68bb734ec4fc081ae0ece183990e;Fri Jul 13 06:21:26 EDT 2007;Committer;ko1;1;1;1;2;0
9dbaa0a9a9df1c1180a2e9bc5e94441aff1c888d;Fri Jul 13 06:02:18 EDT 2007;Committer;nobu;2;24;10;34;0
091fb1c2e49ab52b6433186a7bfca7f1a43a8376;Fri Jul 13 03:47:18 EDT 2007;Committer;akr;1;2;0;2;0
853999fb20f49b4f519d39e9ee4a29f2bbe554bf;Fri Jul 13 03:44:53 EDT 2007;Committer;akr;1;9;0;9;0
4bb5091496d4f06384fcfc775271247693f115ec;Fri Jul 13 03:35:04 EDT 2007;Committer;akr;1;8;0;8;0
113a709cce1baf1623ad8457a08585c5db49a5df;Fri Jul 13 02:33:11 EDT 2007;Committer;nobu;3;13;1;14;0
608545ced079d61569951461406eea45c64f6221;Fri Jul 13 02:31:56 EDT 2007;Committer;matz;2;6;1;7;0
e6dc7d3d6fc36846b6213c3ca9d87d250659c5bb;Fri Jul 13 02:25:29 EDT 2007;Committer;nobu;2;5;1;6;0
4a0ea31319df8b64a17766937349059877b7a9da;Fri Jul 13 02:17:58 EDT 2007;Committer;nobu;2;5;2;7;0
b1d5c752fbafe0433508e6719d576072fd938e01;Fri Jul 13 02:16:27 EDT 2007;Committer;nobu;2;7;7;14;0
6dcf9f16ccf2523e9473b10d8b8f308013913c57;Fri Jul 13 02:09:40 EDT 2007;Committer;nobu;2;8;12;20;0
f64a557efdbc191f54721ec0a56c8f6a46c618fd;Fri Jul 13 01:33:31 EDT 2007;Committer;nobu;2;6;2;8;0
b53224b4936c8d6a1230f71cdce2b5572c14333f;Fri Jul 13 01:10:48 EDT 2007;Committer;nobu;3;19;12;31;0
8f79c623f39756cce4c8a81dc77d24972629ae7d;Thu Jul 12 13:23:29 EDT 2007;Committer;akr;2;12;0;12;0
f603c4ae082cc7d5c5a6f11b2528240f31dafc88;Thu Jul 12 12:41:27 EDT 2007;Committer;usa;1;1;0;1;0
d504f64a3b7b76195e449fd886cfe7d2b37b412f;Thu Jul 12 12:40:49 EDT 2007;Committer;usa;2;5;2;7;0
c13cd729bfdb5f5eb44ec681db4fea85f029a31f;Thu Jul 12 09:52:48 EDT 2007;Committer;akr;3;19;6;25;0
4c289d8d104fc3cd73858b4dc2bdf13c62f50377;Thu Jul 12 08:03:18 EDT 2007;Committer;nobu;2;8;8;16;0
6b6bf4dd481f744faf54b5efcda5f32e4565bd7d;Thu Jul 12 04:25:46 EDT 2007;Committer;ko1;36;1468;1599;3067;0
2e601474e7dc483aca0e7c7b7ced750e869aab7f;Thu Jul 12 03:24:31 EDT 2007;Committer;nobu;2;6;2;8;0
1fe38a5caee8985c0e2d6eb05894fad3c9476d6d;Thu Jul 12 01:30:48 EDT 2007;Committer;nobu;3;15;9;24;0
0fcf8e17aaea1b5562a89c3aed24c2e722b38a66;Thu Jul 12 01:19:18 EDT 2007;Committer;nobu;4;14;20;34;0
2e4f2aaaf0e9e245db7f5d2596b4aef4ec0406f8;Wed Jul 11 20:35:10 EDT 2007;Committer;usa;3;8;4;12;0
302c311199c80ac9094dfa2b9781e6240f6a3092;Tue Jul 10 10:39:39 EDT 2007;Committer;ko1;4;23;1;24;0
bc1e2ab306ada94a7169d5812dd8252743553102;Tue Jul 10 10:22:30 EDT 2007;Committer;ko1;4;14;11;25;0
3ead5dcfb461a1ae8d7f48cbee408e1478783153;Tue Jul 10 09:52:21 EDT 2007;Committer;ko1;2;7;3;10;0
a6e3d19f3ac344613da68dff705fb411d9120d63;Tue Jul 10 08:04:52 EDT 2007;Committer;ko1;9;120;74;194;0
d4662d49d925484f673969693f47cd4ac4338206;Tue Jul 10 07:52:03 EDT 2007;Committer;nobu;2;24;16;40;0
c0258a9ea6f06988f03d06b19d2174890c34b809;Tue Jul 10 06:57:56 EDT 2007;Committer;nobu;2;5;0;5;0
c18e8ad7e9f152880de35f4e1904e46693dcba57;Tue Jul 10 05:50:10 EDT 2007;Committer;nobu;4;25;21;46;0
a87664923f2158245a7adf58d116921f44155f35;Sun Jul 08 19:16:33 EDT 2007;Committer;usa;1;3;3;6;0
a6ae274c3b06174401276fde2636f17720508532;Sun Jul 08 17:19:01 EDT 2007;Committer;usa;2;15;3;18;0
f880de86edc7eacd6b37c5d0b18956a7117d6564;Sat Jul 07 17:33:57 EDT 2007;Committer;akr;1;1;1;2;0
322003ef8f2c36d24f1d009eda5408102f5658ae;Sat Jul 07 17:15:30 EDT 2007;Committer;naruse;11;778;216;994;0
acbffce267b63bb06281f3ebe6a8bb0d897d4566;Sat Jul 07 13:02:35 EDT 2007;Committer;akr;2;10;4;14;0
079976cac25cdc31805479a66c21c7fec1f9c2d2;Sat Jul 07 08:14:00 EDT 2007;Committer;ko1;2;54;63;117;0
0ec2b20d2f1339ab1e4d41567f9b37d733802968;Sat Jul 07 07:16:05 EDT 2007;Committer;ko1;4;46;6;52;0
174b77b2805bca12afb67d24bfc4ce9182a8daac;Sat Jul 07 06:39:56 EDT 2007;Committer;akr;2;13;1;14;0
0afe6cb08f97a2fdbfb945f8b5685a5fe79fa184;Sat Jul 07 06:34:40 EDT 2007;Committer;ko1;6;41;22;63;0
7756f1df188b8a8ef7182d66d0a2f94df27fabe9;Fri Jul 06 11:09:38 EDT 2007;Committer;keiju;3;30;18;48;0
616f4d33856a539e89aadfbf75ebb17acc7781da;Fri Jul 06 09:23:53 EDT 2007;Committer;ko1;5;24;6;30;0
9aa9c07c077d918a2a70c7e60402d1e475c6686a;Fri Jul 06 06:55:19 EDT 2007;Committer;ko1;2;11;7;18;0
b2d827cc5ba954862ba618bbe7d2fe2d785b6e1c;Fri Jul 06 06:21:27 EDT 2007;Committer;nobu;2;7;2;9;0
e8fc29990fa4042dc38757e3e10013aba2c4f388;Fri Jul 06 05:57:14 EDT 2007;Committer;nobu;3;10;4;14;0
7990a473eb5e50304a276d4fce920d0da1f994d9;Fri Jul 06 05:50:42 EDT 2007;Committer;nobu;2;17;5;22;0
c512a69a2df121215d20edf4e8b646c929d62987;Fri Jul 06 05:35:28 EDT 2007;Committer;nobu;2;6;1;7;0
56fe47de3a8e9ef2dff934dbdfc695d9817a102c;Fri Jul 06 03:16:46 EDT 2007;Committer;akr;3;246;0;246;0
976bfae03be67236543367aef7b8a22df02cd37b;Thu Jul 05 18:16:54 EDT 2007;Committer;ko1;4;39;41;80;0
b9171a73c4f0d212b723e0160859ab69b89b3339;Thu Jul 05 17:11:45 EDT 2007;Committer;ko1;4;22;19;41;0
0d0ef6eccc50ed95d8babcf5381426c70c4d4b30;Thu Jul 05 10:49:45 EDT 2007;Committer;ko1;10;54;46;100;0
6a858e554c646c52f05f38b876e97322302c5c3d;Thu Jul 05 10:18:53 EDT 2007;Committer;ko1;3;9;2;11;0
92818d7eb647116ca51fde4018f58fc0ba1c2e78;Thu Jul 05 10:12:52 EDT 2007;Committer;usa;2;5;1;6;0
0bb4c2b3db16c7e1c23877f1f1efc216c601f3d0;Thu Jul 05 10:04:56 EDT 2007;Committer;ko1;4;123;49;172;0
a74dbca6863a41bd948961944d1c6b19e01070c7;Thu Jul 05 09:45:27 EDT 2007;Committer;akr;2;6;1;7;0
c5077a2c72a75d7e8f3486be7a81f52de90db6f0;Thu Jul 05 09:28:00 EDT 2007;Committer;nobu;2;13;10;23;0
46603a78afde1386f92b38f9b16ca86daa93ad88;Thu Jul 05 08:12:18 EDT 2007;Committer;nobu;16;497;472;969;0
a0d50fa3c494ea5afb98c05be049a0cde6fde28d;Thu Jul 05 07:38:41 EDT 2007;Committer;usa;3;39;4;43;0
b553a34c63da315637afeced46afd05d33f7c623;Thu Jul 05 06:56:10 EDT 2007;Committer;nobu;2;5;1;6;0
a670571ad3ceab1ac1f1266f2b263640f2b11cc6;Thu Jul 05 02:02:30 EDT 2007;Committer;nobu;1;10;10;20;0
e8b0aa4ca047b06d657735e2cdf10c3f58f2d9bb;Thu Jul 05 01:42:09 EDT 2007;Committer;nobu;5;608;101;709;0
6bbcf6f43d55e3b617f780f6c2812195622b15fe;Thu Jul 05 01:13:10 EDT 2007;Committer;nobu;2;9;7;16;0
ba563e4a410eb8f01709cc2f37a42361f5998311;Thu Jul 05 01:06:49 EDT 2007;Committer;nobu;8;23;18;41;0
151d11b5b12b0dc9222e93c8e1c668ccd15d931d;Wed Jul 04 14:51:22 EDT 2007;Committer;nahi;2;7;1;8;0
c1596a80afc2841e9368c950c82ffbf44c6987e1;Wed Jul 04 09:32:45 EDT 2007;Committer;akr;2;18;3;21;0
50e22262fd0819b3138b75571f7b1107672cf5e3;Wed Jul 04 06:56:16 EDT 2007;Committer;akr;1;2;2;4;0
e96cd603e5f5da7a887cff4feded62ff05d02d0d;Tue Jul 03 20:12:55 EDT 2007;Committer;ko1;2;48;34;82;0
21b644e8123d357df653b65689273be51617bae3;Tue Jul 03 19:59:59 EDT 2007;Committer;ko1;2;8;2;10;0
04e9a81b8e969dd4827219572880c05e5fbac2f8;Tue Jul 03 19:35:09 EDT 2007;Committer;ko1;3;36;19;55;0
43bbe2841daf838111aa3f2687c23506191e76e7;Tue Jul 03 19:11:49 EDT 2007;Committer;ko1;3;34;10;44;0
590609f255378694c085b5ee20a6a083d4eab0c3;Tue Jul 03 19:04:39 EDT 2007;Committer;ko1;2;5;1;6;0
1d8ce92a37df9e8c1f9a68de82fee8c9b3e66af6;Tue Jul 03 18:58:42 EDT 2007;Committer;ko1;3;34;0;34;0
d82f3e7d5cf98f484cd1b3ed397e45d2fd7cf806;Tue Jul 03 18:50:28 EDT 2007;Committer;ko1;4;25;5;30;0
49b0a4d5edf3a86b2854bdf3d6d705d199f0aa90;Tue Jul 03 14:14:08 EDT 2007;Committer;usa;4;14;1;15;0
0e5360b2e406fd0f182e62bc5cb38be4d43a9afc;Tue Jul 03 04:53:05 EDT 2007;Committer;ko1;3;19;10;29;0
ee457d92c2d99d85f61346ccd7dd3a6c21b294b6;Mon Jul 02 12:49:35 EDT 2007;Committer;ko1;8;71;49;120;0
0a75feb94adbce32b35e23e11b58ace9a2a3e924;Mon Jul 02 02:59:37 EDT 2007;Committer;nobu;2;27;20;47;0
9c708baa2de1db5eb3541459385967c9b6a8dbd4;Sun Jul 01 23:57:04 EDT 2007;Committer;ko1;6;39;28;67;0
1ccf555a707324facc28f8a8f075c5e23a0a359d;Sun Jul 01 21:43:30 EDT 2007;Committer;ko1;3;78;53;131;0
27013e71e4ca0417ad8a694bb743de5457ed3ff7;Sun Jul 01 18:16:02 EDT 2007;Committer;ko1;10;102;56;158;0
061cce6d6f98021d5c5d1b7912d4fcf1955f5240;Sat Jun 30 18:27:20 EDT 2007;Committer;ko1;3;25;32;57;0
6a69ad4df1719516a2da8b95872d3a44deae026c;Sat Jun 30 18:04:35 EDT 2007;Committer;ko1;6;71;60;131;0
eb9aaa4c4fdaee9225e1843a71b5cdefaf179db6;Sat Jun 30 18:02:24 EDT 2007;Committer;ko1;5;32;23;55;0
fd3f9eee0e9a37218edf21e1726ff1b5d90792ba;Fri Jun 29 15:17:02 EDT 2007;Committer;nobu;3;10;3;13;0
9c69eff7b362f99c0efab3781a4169bfe16eb3d4;Fri Jun 29 14:38:10 EDT 2007;Committer;nobu;2;7;5;12;0
0d7e74a6bebf02a289f77c13c34dc5c8d4934478;Fri Jun 29 13:00:27 EDT 2007;Committer;ko1;2;8;0;8;0
c43511cd89c822789763dc2a439b0915de12c79c;Fri Jun 29 11:52:17 EDT 2007;Committer;akr;2;6;1;7;0
78ce3ea1edb66003bdc8c92ca699e2e08434ae76;Fri Jun 29 08:10:16 EDT 2007;Committer;nobu;2;9;7;16;0
eae8a9143f04d6598b564787a45f03b27111cf9d;Fri Jun 29 07:57:24 EDT 2007;Committer;nobu;5;54;29;83;0
e648fc492344f07744ad3c32d9fbe405c9dd8a43;Fri Jun 29 07:55:57 EDT 2007;Committer;ko1;1;1;0;1;0
6c635566c08f8c44ff98dbcd8f19f518109d549f;Fri Jun 29 07:46:44 EDT 2007;Committer;ko1;1;1;1;2;0
6aacb0ede41385bf1bb6328931a5c071de7345d3;Fri Jun 29 07:42:16 EDT 2007;Committer;ko1;2;9;0;9;0
3b5eac1a0844ecd4ab5bd937f2ca9bd7b984441e;Fri Jun 29 06:44:01 EDT 2007;Committer;nobu;2;24;3;27;0
f35974066131e8c5517abc1cad366780bd90cf43;Fri Jun 29 06:43:24 EDT 2007;Committer;nobu;1;29;29;58;0
3d04e2e40f1bbcf2ad56e4a19f72178d33dbf596;Fri Jun 29 06:33:51 EDT 2007;Committer;ko1;2;5;0;5;0
71f8ca8bc4131a1c3e638a3af7842f4176f1adc2;Fri Jun 29 06:27:49 EDT 2007;Committer;matz;4;55;60;115;0
453f64fa477686e6a1accade80d27480a372d948;Fri Jun 29 06:02:00 EDT 2007;Committer;nobu;1;1331;1331;2662;0
ca9b486294fa860c5fbe9a3b29e1cde7b4935b7c;Fri Jun 29 05:52:18 EDT 2007;Committer;ko1;4;1346;1296;2642;0
32421ba3e1858c4e766aba7fdc445afe2961018a;Fri Jun 29 05:15:46 EDT 2007;Committer;nobu;1;112;112;224;0
9f46c2ba2e36f241d854012ca30104c018e2dfd7;Fri Jun 29 03:08:19 EDT 2007;Committer;akr;1;2;3;5;0
cf46a2fce6758d7ba2b9a5615249fde9af6015ea;Fri Jun 29 02:23:13 EDT 2007;Committer;nobu;3;9;3;12;0
baaa30ec03195e4d6fc6c2d144f8224f250d58f2;Thu Jun 28 14:33:45 EDT 2007;Committer;matz;2;6;1;7;0
dea470cca449120adc70592d2e934afd79c89c06;Thu Jun 28 14:22:30 EDT 2007;Committer;akr;2;24;2;26;0
480c602bdc9ad15c40e093bd1acf9776e3ade5de;Thu Jun 28 13:31:08 EDT 2007;Committer;ko1;3;12;16;28;0
c4a0a17df12c2bcc3777a846765982e94c2cc3bd;Thu Jun 28 11:41:25 EDT 2007;Committer;akr;1;1;1;2;0
b73d7a44aa97a422f9a6781b87fb9a0f12b9b56b;Thu Jun 28 10:41:39 EDT 2007;Committer;ko1;2;21;20;41;0
8253094f39f3daf6745bb6271816039b93a2afd1;Thu Jun 28 09:59:47 EDT 2007;Committer;akr;2;5;1;6;0
a0aa5f977e6644f1cb9803a8c08b866623ed8227;Thu Jun 28 06:00:09 EDT 2007;Committer;nobu;2;6;3;9;0
14010ce4a390e470e29959fbfef253b15ed3847f;Thu Jun 28 02:32:25 EDT 2007;Committer;usa;2;8;4;12;0
fd58a0836f2c4d0cf1c03be97011691a29a035ba;Wed Jun 27 20:03:53 EDT 2007;Committer;ko1;4;27;9;36;0
c1849cf09476181825ab5f59f819245d3559bfa2;Wed Jun 27 17:14:10 EDT 2007;Committer;ko1;2;4;1;5;0
c1ac175af5d819d319e4410602be9a9e64e37566;Wed Jun 27 17:13:13 EDT 2007;Committer;ko1;2;12;8;20;0
8e11ff411a97198cedb510ebeecde56e67ed3cd2;Wed Jun 27 17:05:03 EDT 2007;Committer;usa;2;5;1;6;0
d9987aa704e5b94983aac43804269b52902e7fc4;Wed Jun 27 16:45:56 EDT 2007;Committer;akr;2;15;3;18;0
caa535286d7442ddcbc1caf9fb2778efd435c56d;Wed Jun 27 16:26:31 EDT 2007;Committer;ko1;10;2579;0;2579;0
fd78c2193e7032389a2a3ff9154654fa231ac8f0;Wed Jun 27 16:23:49 EDT 2007;Committer;ko1;5;4;6;10;0
4a7d47e41a771bda537ce92139500fb441ad6fd3;Wed Jun 27 16:21:57 EDT 2007;Committer;ko1;3;22;80;102;0
cd72ed32cc9b3b9a1fcb314d9d9c91edd11d0bfb;Wed Jun 27 14:52:00 EDT 2007;Committer;usa;2;4;54;58;0
1aa54c6db6a10bf671a80eddf93630fbbea4f810;Wed Jun 27 11:47:53 EDT 2007;Committer;usa;7;83;28;111;0
41e9245e853c6d1f02a60f431afa87aeb7749787;Wed Jun 27 11:33:01 EDT 2007;Committer;ko1;3;9;2;11;0
c44e2cdd58efbe13ed3b57cd56f98fc81ea64c2e;Wed Jun 27 08:21:21 EDT 2007;Committer;ko1;5;48;13;61;0
35ecb83d413f5d7143dd269b2d591cb742526a90;Tue Jun 26 19:24:40 EDT 2007;Committer;ko1;2;6;2;8;0
30ab3f75f9a8399c300359ea84e25f9a93df73ae;Tue Jun 26 18:56:15 EDT 2007;Committer;ko1;5;262;91;353;0
99c58e9ebcb90a81c2b6201d1d11ac1d5bd84604;Tue Jun 26 15:19:39 EDT 2007;Committer;matz;3;10;4;14;0
883fadf9affab1ab72233d23ecdbb8894a3ca1e5;Tue Jun 26 07:39:04 EDT 2007;Committer;nobu;2;5;1;6;0
ab7c645fee1f3776951da9928c57f774c80e55ce;Tue Jun 26 07:30:01 EDT 2007;Committer;ko1;2;6;0;6;0
9b9cc53e236ebae47b2f96d5ab7c3f9e3c158702;Tue Jun 26 07:28:42 EDT 2007;Committer;usa;2;9;0;9;0
02ae0a3e76dab85cfe7a363bf23d00d3af9e2455;Tue Jun 26 07:26:58 EDT 2007;Committer;ko1;2;22;2;24;0
c179584ba4949a6f569e2c0734a6f01dbdae3f60;Tue Jun 26 06:23:34 EDT 2007;Committer;usa;4;34;14;48;0
931574010102b4bd9db6cfb17b840e28b26030e6;Tue Jun 26 06:14:44 EDT 2007;Committer;ko1;8;29;33;62;0
8bfcdf323f1843237140e9f119496b93557eaefd;Mon Jun 25 19:06:00 EDT 2007;Committer;ko1;3;38;20;58;0
1a49d91fddf47bd791836a20505558c724fa491b;Mon Jun 25 18:47:03 EDT 2007;Committer;ko1;2;5;2;7;0
702e431f1b3741ac3e88d05e450f32b745207f5c;Mon Jun 25 18:39:23 EDT 2007;Committer;ko1;3;10;2;12;0
0043929b5f564ef6c9377d8321a4e4a4b7ec6e14;Mon Jun 25 18:23:35 EDT 2007;Committer;ko1;2;13;40;53;0
762a7ec12e1cd6cd59129eeb1ed42035157ded2a;Mon Jun 25 17:52:33 EDT 2007;Committer;ko1;2;6;0;6;0
ed4e57690c9cc782ab8675c4bf48153ce0a36896;Mon Jun 25 16:05:17 EDT 2007;Committer;ko1;7;152;79;231;0
588e79f7688c9b7f085cb8d46b9289e4769f4135;Mon Jun 25 11:20:45 EDT 2007;Committer;usa;2;5;1;6;0
6792979e981b6378db325a24800500c549f78bb8;Mon Jun 25 11:19:11 EDT 2007;Committer;akr;1;4;4;8;0
d81af2f7b255a67a48bd6279394a0bbdde462634;Mon Jun 25 09:03:43 EDT 2007;Committer;usa;2;5;1;6;0
a00c1ed6723e9c92d6c09716169cc0210c331fb2;Mon Jun 25 09:01:27 EDT 2007;Committer;usa;2;7;2;9;0
4bdb5ced9a06532d33e6aa0dd6be49e863b31d22;Mon Jun 25 02:44:20 EDT 2007;Committer;ko1;14;379;360;739;0
ace2b68ac4215b46f5de94bad68f3fef91df4245;Mon Jun 25 00:45:48 EDT 2007;Committer;nobu;5;8;0;8;0
f58eb1e276a2db3ff2062c80a7acf97860aca8ca;Sun Jun 24 20:33:04 EDT 2007;Committer;ko1;13;69;82;151;0
6bd0345627f383f1d1b041edba2a255ea4cdfb9b;Sun Jun 24 19:23:24 EDT 2007;Committer;ko1;14;1401;1422;2823;0
144ff322c7adcc600139da1cfacf0e98010c1bce;Sun Jun 24 18:40:13 EDT 2007;Committer;ko1;4;50;30;80;0
7980e653e57ae5b539533dee1d0b1a00fc16ea5d;Sun Jun 24 17:19:22 EDT 2007;Committer;ko1;15;932;962;1894;0
61fa3576222f7bee1ecc8486075baee62936c840;Sun Jun 24 15:46:22 EDT 2007;Committer;ko1;2;5;1;6;0
97ba019c9410ccb5ec76f6b54fd2e140b7583038;Sun Jun 24 15:42:41 EDT 2007;Committer;ko1;22;263;312;575;0
a5c2d584284e2b137b1d4d06574470a971c9087e;Sun Jun 24 13:32:57 EDT 2007;Committer;ko1;2;5;1;6;0
62deb7dbbda5104c352abd723053bd1b18e50dbf;Sun Jun 24 13:05:51 EDT 2007;Committer;ko1;8;300;384;684;0
904b9e5d547f4f9a9f3236d2633f0cb6d7aae14c;Sun Jun 24 11:02:40 EDT 2007;Committer;ko1;7;242;252;494;0
59202b7ab8147f3947900a919fcf82bc5f3e74e7;Sun Jun 24 10:33:00 EDT 2007;Committer;ko1;4;73;61;134;0
1757fc9927fe25b761fca9f2391d1982e7a781c3;Sun Jun 24 10:06:23 EDT 2007;Committer;ko1;3;34;27;61;0
f2074245b4c4d712cb74716c680d876eda9b8789;Sun Jun 24 08:55:17 EDT 2007;Committer;ko1;3;9;3;12;0
adc677eb5cd3aed1986c3316d5b98ed942f544d5;Sun Jun 24 08:40:45 EDT 2007;Committer;ko1;6;110;79;189;0
d1bd418715091794dc207198a0fe4152b5f40cb1;Sun Jun 24 07:35:49 EDT 2007;Committer;nobu;2;14;10;24;0
68e02f2c2cc98e6ab736b3122aafe7a2398642f6;Sun Jun 24 07:29:21 EDT 2007;Committer;ko1;7;691;210;901;0
a5c9bf7d63bff7772d7a3b392e9d5ebe6a0bf479;Sun Jun 24 07:10:46 EDT 2007;Committer;nobu;2;8;4;12;0
3aa45744ab0d100934dcefcc90fdf157f259c7f4;Sun Jun 24 06:52:59 EDT 2007;Committer;ko1;3;24;3;27;0
1fb587ddec95d23675a2ff919d5f4f11339ae247;Sat Jun 23 18:10:59 EDT 2007;Committer;akr;2;9;2;11;0
3f2fe372005b0bd1f6535ffaaf23ff8ea4f8271f;Sat Jun 23 15:05:05 EDT 2007;Committer;matz;3;149;5;154;0
fe377d3b8e554856b27e00b4c4e1ccce0cb1ee5e;Sat Jun 23 08:34:21 EDT 2007;Committer;akr;2;2;2;4;0
18ee9451746f5a60817e944209caeda9dacc3776;Sat Jun 23 08:26:08 EDT 2007;Committer;akr;2;29;1;30;0
fdf213b71a4a9d1a48708516c6cfc6cc85da7c74;Fri Jun 22 16:26:07 EDT 2007;Committer;matz;3;154;5;159;0
115410ecde172034fdbfdea703252dcfc6ea0468;Fri Jun 22 16:23:16 EDT 2007;Committer;matz;5;51;57;108;0
f11a6f2d65e01b966e5053ea8438d5e6c590c423;Fri Jun 22 10:56:43 EDT 2007;Committer;akr;2;6;1;7;0
e2bc064096cf85f3bf4dcdbb17a4f1f5a4de09ea;Fri Jun 22 10:34:19 EDT 2007;Committer;akr;2;9;3;12;0
0bc84af1f97e2ecf9a32042b4ef974935c3bd9c1;Thu Jun 21 14:50:14 EDT 2007;Committer;matz;2;27;42;69;0
967cca2f8d13c113461f26879d501b03cfeec6c0;Thu Jun 21 14:16:00 EDT 2007;Committer;matz;2;6;2;8;0
5a164c1891600cd20fadbda4f173b8a578f95126;Thu Jun 21 10:40:50 EDT 2007;Committer;nobu;2;10;10;20;0
3fc180ebeb7db9d2b0193c846b780bc1967026f3;Thu Jun 21 08:12:14 EDT 2007;Committer;nobu;3;8;4;12;0
f8e1e5389faea41cde412cf91543cabba7bd0902;Tue Jun 19 23:27:47 EDT 2007;Committer;akr;2;7;1;8;0
9a7a11564c9e36819fbb54034e3b17391b912d30;Tue Jun 19 19:43:59 EDT 2007;Committer;nobu;3;17;14;31;0
f91ec98d430491a88b8a8aa10f21d79e936c526a;Tue Jun 19 01:53:31 EDT 2007;Committer;nobu;3;24;18;42;0
9fa80b19a61adf70ec785d96ebffc2a9327b7b5c;Mon Jun 18 08:56:21 EDT 2007;Committer;technorama;6;317;25;342;0
1c03862049be55c911c1dfb2621c3be42d7c0d09;Mon Jun 18 08:02:30 EDT 2007;Committer;nobu;4;42;7;49;0
942a54302de5bfa4665960947c403e1c0b6831ad;Mon Jun 18 07:55:45 EDT 2007;Committer;nobu;5;107;98;205;0
31345380ac41f8b830104ea41b4b52e1e2b094a8;Mon Jun 18 04:52:59 EDT 2007;Committer;nobu;2;19;0;19;0
8adc4541ff4fa7caa2fbd3c006465305e21e336a;Sun Jun 17 17:50:56 EDT 2007;Committer;ko1;2;14;6;20;0
d220634bb7d1e3b13e12fe444de709c4ab9df458;Sun Jun 17 17:47:35 EDT 2007;Committer;ko1;2;6;0;6;0
4471bf2356b86683c8490de12d2d199eea461e3a;Sun Jun 17 17:46:25 EDT 2007;Committer;ko1;2;6;0;6;0
c72ecb25ad372ed4d0a0c571f7ce4e5191fdf3d6;Sun Jun 17 16:12:32 EDT 2007;Committer;nobu;2;51;34;85;0
3dc070e90e53dfd281acdbaada2871d5eeac4a1a;Sun Jun 17 15:56:36 EDT 2007;Committer;nobu;3;9;7;16;0
7e48040b3aede45041670ba07ec6e9c5eac6ab06;Sun Jun 17 02:30:13 EDT 2007;Committer;akr;1;13;13;26;0
a03d4a0635bdd594da4f494e66cc16cce25b81e7;Sun Jun 17 02:12:14 EDT 2007;Committer;akr;2;6;1;7;0
ccbdd90865c3576fb0cac306e08a2a7c5aa95089;Sat Jun 16 13:45:30 EDT 2007;Committer;akr;2;7;0;7;0
38f9878b592f073da3fb258309d6d98470866472;Sat Jun 16 13:30:58 EDT 2007;Committer;akr;1;1;1;2;0
c4d2965fb614480d477a4be52f80ec6d0eb20f3a;Sat Jun 16 12:39:35 EDT 2007;Committer;akr;2;17;2;19;0
8092d0bd873e9d3a5e12abbf778d9705d26b130a;Fri Jun 15 14:33:59 EDT 2007;Committer;akr;1;8;7;15;0
afa74d6cae93b86919eef752ec34fdcfb084a439;Fri Jun 15 13:59:45 EDT 2007;Committer;akr;2;146;0;146;0
787f96eb9793fbcd33fc1e866753c1ad7ba55325;Fri Jun 15 13:38:32 EDT 2007;Committer;akr;2;78;59;137;0
a96b6f060406c15d56f3cc6a493a8b3d59c3fed9;Fri Jun 15 13:31:54 EDT 2007;Committer;nobu;3;21;4;25;0
868e180cefabbbf2ec8cf53ea9f58559468418d7;Fri Jun 15 12:14:21 EDT 2007;Committer;akr;1;6;2;8;0
a30fe695e64783e834945f08fc77282b3f3cc2fb;Fri Jun 15 11:50:45 EDT 2007;Committer;akr;3;52;42;94;0
cebc9bb19d219aaf5d035ff2d0e5fb69636bd2c1;Fri Jun 15 09:58:10 EDT 2007;Committer;akr;2;13;7;20;0
e3dd9a78db1f918bd4e621492975b741269b5cb4;Fri Jun 15 08:38:58 EDT 2007;Committer;akr;1;4;0;4;0
5cbefb96b998480208b26ea260658c985bf7b861;Fri Jun 15 06:55:36 EDT 2007;Committer;ko1;2;9;2;11;0
afb1901848f9b6998f320423474e830a1e95d780;Fri Jun 15 04:25:07 EDT 2007;Committer;ko1;4;25;7;32;0
7307d38c4fb5c6943bab8859e178d2d28769a64c;Fri Jun 15 03:37:49 EDT 2007;Committer;ko1;2;4;1;5;0
7567fbf080552e04df4b5d2af9d601cf1d345b11;Fri Jun 15 03:27:33 EDT 2007;Committer;ko1;8;75;34;109;0
70df6311af85b7f53b5c730502d4b9a94fa23cc9;Fri Jun 15 03:22:51 EDT 2007;Committer;ko1;2;9;1;10;0
31ac946975a8e20157e1f47d23546ae237484024;Fri Jun 15 03:20:13 EDT 2007;Committer;ko1;3;17;25;42;0
f84c8cb19079cbfe2b5433a7b3e1eca4eae3ef22;Fri Jun 15 03:18:12 EDT 2007;Committer;ko1;3;9;5;14;0
d3be3d71022f091958b339e15d790e2d760ee576;Thu Jun 14 08:37:13 EDT 2007;Committer;akr;1;5;1;6;0
3cd5af52e9b321be3d3e4071359c637f0eb3bf34;Thu Jun 14 08:35:20 EDT 2007;Committer;akr;9;166;9;175;0
0dc3a071d3dc02dc40965abae4c5bd6512cb251a;Thu Jun 14 08:08:13 EDT 2007;Committer;nobu;2;6;1;7;0
e948c70e061bea575ac5746a5adc9343a77d20f0;Thu Jun 14 06:38:07 EDT 2007;Committer;eban;1;3;3;6;0
4ba1c80b9a931ce948f5ea427e198f65dae1e2f9;Thu Jun 14 05:40:16 EDT 2007;Committer;akr;2;7;2;9;0
68c6bb997dab1f5bd29ace69806d5b55d8ec71c1;Wed Jun 13 13:42:02 EDT 2007;Committer;matz;2;7;22;29;0
89c2418467dfec3e8732bb0a8ca5d587d97b3f5a;Wed Jun 13 13:25:39 EDT 2007;Committer;matz;2;7;60;67;0
0e6287543373a023f97a6362f5415ca85b2381c9;Tue Jun 12 21:04:07 EDT 2007;Committer;nobu;3;11;5;16;0
1cc502b9f4d15ecf0686719a83ed18a687ca9fe2;Tue Jun 12 07:55:25 EDT 2007;Committer;shyouhei;1;5;0;5;0
13349fd176f80c21b95c05f35d127f63760da561;Tue Jun 12 05:52:19 EDT 2007;Committer;nobu;2;10;2;12;0
8cc8c9f9a19a18463cf10c05368dc5e42bd2e45e;Tue Jun 12 05:43:06 EDT 2007;Committer;nobu;2;6;1;7;0
3cf184ce6ffec4b2f0815d1d5a7826e86033f7be;Tue Jun 12 04:09:12 EDT 2007;Committer;usa;1;3;3;6;0
8964a01bae1a4b3c99cfed61ce22278acbafde4f;Tue Jun 12 02:32:28 EDT 2007;Committer;ryan;1;2;2;4;0
73d64b981146768035e02062805046794ef3f2d8;Tue Jun 12 00:38:57 EDT 2007;Committer;ryan;1;1;1;2;0
54a816cfdfcb2c2b7ece54d5537a7c39432419d5;Mon Jun 11 13:02:30 EDT 2007;Committer;akr;1;1;1;2;0
0c57bf4b612e741de3ec05988f6b4432530688bb;Sun Jun 10 09:35:42 EDT 2007;Committer;nobu;2;11;9;20;0
2cb9ebd55d355263a8679539fc11ec9ba0b3df1d;Sun Jun 10 09:30:55 EDT 2007;Committer;nobu;6;10;5;15;0
79a74f5ec19b67798e2b8a5860ed6eb6d9828d31;Sun Jun 10 08:47:49 EDT 2007;Committer;nobu;2;6;0;6;0
30dbd2a6baedd027a8db5f9825d9614d79c3b9d1;Sun Jun 10 07:58:09 EDT 2007;Committer;nobu;2;11;7;18;0
5dc9bf105a5cc1935c03334e6e05f6a254bb7b46;Sun Jun 10 07:55:49 EDT 2007;Committer;nobu;2;8;5;13;0
4d2421d58b1da845f9dbf09ce78555398106756f;Sun Jun 10 07:34:51 EDT 2007;Committer;nobu;2;12;6;18;0
8e8a3a07b149e25aa743b68f180338fb10b32997;Sun Jun 10 07:10:56 EDT 2007;Committer;usa;2;6;2;8;0
cfb6b44bde0371e4cdcfeba19287205d90b4b595;Sun Jun 10 07:05:39 EDT 2007;Committer;nobu;2;8;1;9;0
8782d3d977e4f357825a977112001765bd49fad8;Sun Jun 10 06:43:12 EDT 2007;Committer;nobu;2;6;0;6;0
cd67b62289db0b99e6e788c18086b28b144f7960;Sun Jun 10 06:26:24 EDT 2007;Committer;akr;2;5;1;6;0
6b95829d71c0a3bb88b3263c6a7a8ef2ba059567;Sun Jun 10 06:09:40 EDT 2007;Committer;nobu;2;4;3;7;0
c389b3bb637a32a12d2445bfcd958d1b3c033c19;Sun Jun 10 05:47:12 EDT 2007;Committer;nobu;4;9;3;12;0
7d8743d5c50bb95d6f3296d125f921445eb07513;Sun Jun 10 04:46:17 EDT 2007;Committer;nobu;2;14;10;24;0
d4d7164a9bda880ea998a382b20f9f7e4218d2c8;Sun Jun 10 03:55:15 EDT 2007;Committer;nobu;2;7;4;11;0
2b592580bf65040373b55ff2ccc3b59a0a231a18;Sun Jun 10 03:06:15 EDT 2007;Committer;nobu;137;4597;4359;8956;0
1b8a677b235066d91994e3490e0bce5a098196a2;Sun Jun 10 02:47:41 EDT 2007;Committer;akr;1;9;0;9;0
52ec7cc543605ccb43e883c2a89f4a90e8cb67c9;Sun Jun 10 01:42:51 EDT 2007;Committer;akr;3;136;3;139;0
e3dbf4cebdb44778d454750a98155002b7142b3a;Sat Jun 09 15:01:27 EDT 2007;Committer;akr;1;1;0;1;0
7d061438f1c0dcde95c5e798176e454217eca902;Fri Jun 08 21:40:05 EDT 2007;Committer;akr;2;34;27;61;0
3a868301ea9997fd3eca20eb62f2d5a8c74be3de;Fri Jun 08 07:33:59 EDT 2007;Committer;akr;2;6;1;7;0
3a6860058ef4990c519dd21ba67e422010cbcbe1;Fri Jun 08 07:10:50 EDT 2007;Committer;ko1;2;5;1;6;0
bfe90639909626c30a81e8fcee209e341b57d3e2;Fri Jun 08 06:12:49 EDT 2007;Committer;akr;1;60;1;61;0
4d436328524b23cfd446191cb391f17450a872a0;Fri Jun 08 05:58:06 EDT 2007;Committer;matz;3;75;4;79;0
b1cd416c1a446f2e47e964ee6e9d77461a16427d;Fri Jun 08 05:39:13 EDT 2007;Committer;akr;2;17;9;26;0
94fdd87fddb977ba4a9075a05476bc6fc294b746;Fri Jun 08 05:26:20 EDT 2007;Committer;akr;2;70;0;70;0
250a29cc6be6a40b828b399d230748d02572efda;Fri Jun 08 03:49:07 EDT 2007;Committer;usa;3;10;0;10;0
1a8d5ed8cbeb491285290944aec2f138f9f3b511;Fri Jun 08 03:47:16 EDT 2007;Committer;akr;1;1;1;2;0
c571d4702ec568a16f1b3ee912a8cf996b480f8d;Fri Jun 08 02:56:12 EDT 2007;Committer;akr;4;223;214;437;0
72734ac15451af26a7eac789cfaa3ed61bd002f8;Thu Jun 07 12:41:30 EDT 2007;Committer;ko1;2;6;10;16;0
6f9ded1fb0cba5c14f83f0610c864e7f59d0c827;Thu Jun 07 10:02:58 EDT 2007;Committer;akr;2;14;3;17;0
d7d85f9ecdfb34b80a9d44f24462e0bdc1542b7a;Thu Jun 07 08:21:01 EDT 2007;Committer;ko1;3;16;3;19;0
8620de6b042f2c069a25d7fdbf5b1d5a3ffd87a9;Thu Jun 07 03:48:13 EDT 2007;Committer;ko1;3;20;3;23;0
b60d64b001c8819e6626b00efbeae96560368a08;Wed Jun 06 22:38:42 EDT 2007;Committer;naruse;7;51;22;73;0
6d2dee14f3d5d4224effd0ec2d8fbc07dc54cbac;Wed Jun 06 18:30:14 EDT 2007;Committer;ko1;2;20;0;20;0
d80e7373cfb0ca1558bdeb79643c53db5f9ce4d8;Wed Jun 06 18:19:42 EDT 2007;Committer;ko1;4;48;3;51;0
ed8897523701745467cf831ff19ec3268856cf6e;Wed Jun 06 16:04:02 EDT 2007;Committer;ko1;5;10;7;17;0
6c5a50ff3357c7ca913f9772a8f98a7edcecfcfd;Wed Jun 06 11:24:42 EDT 2007;Committer;ko1;2;8;1;9;0
7e5b2304c593371958fac489e596988a7ec95b0d;Wed Jun 06 07:26:27 EDT 2007;Committer;usa;2;5;1;6;0
bf544c05d26ec4cb151cd322e69a495a58924a0d;Wed Jun 06 01:57:36 EDT 2007;Committer;ko1;2;10;1;11;0
9c0b2b8b65dc27d27bcd2d417a116e7a343399a2;Wed Jun 06 01:56:49 EDT 2007;Committer;ko1;2;11;0;11;0
15b31b0d80dd9959873d1db0a76e269a556790ac;Wed Jun 06 01:55:09 EDT 2007;Committer;ko1;2;13;0;13;0
a96aacb08cefc3f712c5de29410e16299923b827;Wed Jun 06 01:54:44 EDT 2007;Committer;nobu;0;0;0;0;0
9a524fad38693240a0ac9c8dbfcb956516475861;Wed Jun 06 01:51:45 EDT 2007;Committer;ko1;2;8;7;15;0
b244c0dd3a6268c49ebebde8d935fb3d191aee33;Wed Jun 06 01:34:08 EDT 2007;Committer;nobu;2;0;6;6;0
64ffdb44402f365198ba45c84fa15e449f3411e6;Tue Jun 05 17:55:07 EDT 2007;Committer;ko1;4;32;2;34;0
5f05c269e943b7c633f999b5f046122ba39559fa;Tue Jun 05 17:39:52 EDT 2007;Committer;usa;3;11;4;15;0
78029f00d5e330ea7bb594d1abef54e490effc2d;Tue Jun 05 17:26:00 EDT 2007;Committer;ko1;9;97;74;171;0
d686a73d917ef73bd969c2085b89114f1a2ed2ea;Tue Jun 05 07:35:34 EDT 2007;Committer;matz;2;13;2;15;0
203286673d0c66fdcaf6e65acfa267aaebdc3400;Tue Jun 05 07:13:52 EDT 2007;Committer;ko1;3;25;2;27;0
8ef2289a494a16789cf4add22dbf7ad56595f90a;Tue Jun 05 05:48:45 EDT 2007;Committer;matz;2;8;3;11;0
931614a341b3113efd41893d1a95b22073dc2f68;Tue Jun 05 05:31:05 EDT 2007;Committer;matz;2;30;17;47;0
3c175900610215905772fc27cd63d3c7bf2d41f8;Tue Jun 05 05:11:04 EDT 2007;Committer;naruse;2;7;4;11;0
243cd204df3c949fb689078a73a82aaabddf1f63;Tue Jun 05 04:59:07 EDT 2007;Committer;nobu;1;1;1;2;0
194a01a484de0ed73256fea0321264b8aebfd258;Tue Jun 05 04:49:54 EDT 2007;Committer;nobu;8;36;34;70;0
35eb54258865b73ac83bca0f1375c6c1f42c61d9;Tue Jun 05 04:30:38 EDT 2007;Committer;nobu;2;6;4;10;0
3d3e46d4c720eb55d78c78d86318e6992a0e7ab9;Tue Jun 05 04:27:45 EDT 2007;Committer;nobu;2;4;6;10;0
99d65b14b4ec3a546a28b6b17b3b4553eaf27b2f;Tue Jun 05 04:25:10 EDT 2007;Committer;nobu;17;2261;2230;4491;0
f3dfa40734581b03b1c2565ff1d0a6675c92a213;Mon Jun 04 12:48:11 EDT 2007;Committer;usa;1;3;3;6;0
3fe5d6fa54e6b6ed3d3ae0202f458139161ebdb7;Mon Jun 04 12:40:51 EDT 2007;Committer;naruse;1;3;0;3;0
af1c4167287b9353fec766f932fe4afe97116ad4;Mon Jun 04 12:31:26 EDT 2007;Committer;naruse;69;8551;70;8621;0
6b3ef2249cc6d03b9e153a1bbfb24eb12d4032a5;Sat Jun 02 07:48:29 EDT 2007;Committer;ko1;3;68;47;115;0
66d4a354a874fb8539e0e421a684c34d8890ad22;Sat Jun 02 07:47:20 EDT 2007;Committer;ko1;2;5;2;7;0
2c4aff3fe045ea63f2dfafe69f61e221acc04ac4;Fri Jun 01 16:27:05 EDT 2007;Committer;matz;3;24;4;28;0
62872956b6fc70d43c39b0476962b509dbb96de8;Fri Jun 01 04:05:46 EDT 2007;Committer;usa;3;15;6;21;0
b8cb3679bbf1884b43271bc221df61aabe53a6ac;Fri Jun 01 02:32:17 EDT 2007;Committer;nobu;2;6;5;11;0
609ebfe51f12dd88c7d4c69553904661d23e51e7;Thu May 31 17:01:15 EDT 2007;Committer;matz;2;47;23;70;0
3d7439d56829f38226d4fcd3cacb402297488fa4;Thu May 31 16:59:12 EDT 2007;Committer;matz;3;12;6;18;0
44475bb20874b908160b2a9e6d1dda7fb0c10e88;Thu May 31 08:26:31 EDT 2007;Committer;nobu;3;9;4;13;0
284565992f487937080230d3ae2b5afae4c8ac3f;Wed May 30 05:56:13 EDT 2007;Committer;ko1;5;45;10;55;0
426fcba8916780c99c7280a8278f84d81ff3d05e;Wed May 30 04:39:07 EDT 2007;Committer;shugo;2;11;2;13;0
3306e785b543d157362dac016586cb2cbd39e575;Wed May 30 04:25:32 EDT 2007;Committer;shugo;2;9;0;9;0
daacec2b0ecb6f11b31bd2592a97e482a0fd5629;Wed May 30 00:41:32 EDT 2007;Committer;nobu;2;0;11;11;0
682a52e61cbc7ca5674e5bb546621b78fe4f7ab9;Tue May 29 19:28:25 EDT 2007;Committer;nobu;2;11;0;11;0
87e215b55db9c387090264c4d9497f31a00c803c;Tue May 29 19:17:18 EDT 2007;Committer;nobu;2;6;1;7;0
06eeec8a40fb9b78a2583fafe6247ed8c771ebcf;Tue May 29 17:13:05 EDT 2007;Committer;nobu;2;6;3;9;0
290569b06c3e9352a17b0aa55f63b2e4dd2d9e29;Tue May 29 17:08:37 EDT 2007;Committer;nobu;2;78;32;110;0
fd9aee1ca39171e2f585ea7db7c401bf1d901468;Tue May 29 15:49:30 EDT 2007;Committer;nobu;2;12;7;19;0
a196c4ff5cce1e0544a4d27f1ceb6ef40bbc19b2;Tue May 29 15:46:01 EDT 2007;Committer;nobu;2;12;7;19;0
0d2109239d99af0710937c4bfe96a3c6e9db25ad;Tue May 29 15:22:49 EDT 2007;Committer;nobu;3;12;7;19;0
82159c813bcf74b117ca37801a3fa527f1909a6b;Tue May 29 03:30:14 EDT 2007;Committer;nobu;2;15;23;38;0
d64609463fb755d94922e0d205283416542d9ea2;Tue May 29 01:59:53 EDT 2007;Committer;ko1;3;42;3;45;0
d15b7d0509e5174491814726bf28299baa22adf7;Tue May 29 01:53:14 EDT 2007;Committer;nobu;3;23;14;37;0
7f41ff0ff60bc1f8e1d4ba71ee17adea8a697cfb;Mon May 28 01:25:55 EDT 2007;Committer;nobu;2;7;1;8;0
57062d91b9bfb1688151cd2393011504fd26f0d8;Sun May 27 19:12:43 EDT 2007;Committer;ko1;9;441;89;530;0
b69b1af65002e9a70a4f33bafa35593b4618e7a4;Fri May 25 16:10:42 EDT 2007;Committer;nagai;4;12;3;15;0
9372d4565c891efebf8683a4f276cf6103d1a4d8;Fri May 25 16:10:37 EDT 2007;Committer;nobu;1;3;0;3;0
b904e87f0857eb3d1c0fdc5a8fbc693221baefab;Fri May 25 15:37:05 EDT 2007;Committer;nobu;3;13;4;17;0
a1cb9efd343c9150260d457dfea0005166858690;Fri May 25 15:04:05 EDT 2007;Committer;nobu;3;39;6;45;0
d289b8e8c6a730063723a2637c45e93cb4bc9a45;Fri May 25 07:03:30 EDT 2007;Committer;nobu;2;12;27;39;0
e8a529584197da790723f4f2f3c8c1b483f54b35;Fri May 25 02:13:18 EDT 2007;Committer;usa;3;14;4;18;0
e4aa7208e5b8b5aff35af4b262291ab2c39e66d9;Thu May 24 03:08:13 EDT 2007;Committer;ko1;4;19;2;21;0
7d200b94f946f0caffa3ea3a72783855e421df32;Thu May 24 02:47:22 EDT 2007;Committer;ko1;4;18;5;23;0
7c4ff2d3322753479b3974105e5100b6f4e43001;Wed May 23 22:52:19 EDT 2007;Committer;ko1;7;334;105;439;0
d086dfc513d319bae72002c8bb7e9da9d6d7cf1e;Wed May 23 06:38:46 EDT 2007;Committer;matz;2;8;0;8;0
f7575739f98814cbd2189d478a24863cff0083c4;Wed May 23 01:45:37 EDT 2007;Committer;matz;2;6;0;6;0
6ee2e542394a14a70acd12b3278b2a9fc5b861fc;Wed May 23 01:32:08 EDT 2007;Committer;matz;19;13885;5503;19388;0
2cdb1c33763d3dda6691ee4b7ffc53e684bd528e;Tue May 22 21:09:22 EDT 2007;Committer;nobu;1;0;3;3;0
80a0e2f7531dcb8260059209a6a0bab9ab3a08cc;Tue May 22 20:48:34 EDT 2007;Committer;nobu;6;26;12;38;0
64bffee8d630d2a18244cfa641bdbf3bc3958b7c;Tue May 22 07:38:50 EDT 2007;Committer;matz;3;18;13;31;0
affa7430b70336b53cd496496d889c2544d41322;Mon May 21 04:46:51 EDT 2007;Committer;ko1;12;174;37;211;0
696cbbd7a6c364687522cc41992b0896f3c0507b;Sun May 20 18:33:25 EDT 2007;Committer;aamine;2;10;4;14;0
374e3d42d4fd7df67a77fb26dbc02fd22ef608f7;Sat May 19 01:41:08 EDT 2007;Committer;tadf;1;1;1;2;0
8bf9e0829f06fb8d57e2d91fd01326bd113dadca;Sat May 19 01:27:53 EDT 2007;Committer;tadf;2;20;6;26;0
3d18c14e2c95b1c182932f074f6a55604df07498;Fri May 18 18:06:54 EDT 2007;Committer;nobu;2;44;51;95;0
9eec640e9da1110ccb0327077275bb3b5bded79e;Fri May 18 16:10:46 EDT 2007;Committer;matz;2;80;6;86;0
62b3932c9c6695e58732c614631e1eab0a32a403;Fri May 18 16:04:22 EDT 2007;Committer;nobu;3;9;5;14;0
dcb9f150e5c59dc4a4a09ff477f57a79d23a5d08;Fri May 18 07:57:51 EDT 2007;Committer;matz;2;5;0;5;0
635c599d6be1bc8bb4039caf7520d5f02e914298;Fri May 18 02:11:42 EDT 2007;Committer;nobu;3;22;12;34;0
b21d410d4ed805f2e2e1ad94240ba41e55dedb05;Thu May 17 08:02:02 EDT 2007;Committer;nobu;2;15;4;19;0
2d239b47453c91487a29518de246103d358fee99;Thu May 17 04:31:05 EDT 2007;Committer;matz;2;5;1;6;0
ebaec402a7b3ee6c88aaaaa7fa3dfb103f614a40;Thu May 17 04:25:18 EDT 2007;Committer;ko1;3;40;16;56;0
82068396594c85a3686cb73a52a57cb60745b394;Thu May 17 04:04:49 EDT 2007;Committer;ko1;2;7;2;9;0
84fbcb9694b01e47c9adbbcb4dbd4f46241940bb;Thu May 17 04:00:36 EDT 2007;Committer;ko1;3;9;5;14;0
dfc0ac429833da7c444304d5ba07c607ea7e2895;Wed May 16 12:52:52 EDT 2007;Committer;nahi;2;36;7;43;0
2b9cbceb5ea42f95e8901ef6565063fe197d0057;Tue May 15 07:38:59 EDT 2007;Committer;nobu;2;7;6;13;0
216dcd80ffaa233be3f61d7e21eeeb13bad58795;Tue May 15 06:01:33 EDT 2007;Committer;usa;3;9;3;12;0
46590a41321abd10239f069907bed04221e5d870;Sun May 13 17:15:25 EDT 2007;Committer;matz;2;18;9;27;0
aa77090aefa957855e69f83bbae43cea63101460;Sun May 13 16:54:58 EDT 2007;Committer;matz;3;12;5;17;0
2216212554d8b540fc55c63b9b382509e89c2558;Sat May 12 09:29:54 EDT 2007;Committer;eban;1;3;3;6;0
22d6ff16d35c34f8b8fac04e2455a80dd89840b4;Sat May 12 09:25:56 EDT 2007;Committer;aamine;3;27;1;28;0
a1295b0f79d65d04a07962acf8b2af1a930a6035;Fri May 11 06:26:06 EDT 2007;Committer;nobu;4;176;166;342;0
cb272b7c2dafe30b5823f6e6fc59bbc79c8f0cab;Thu May 10 06:20:33 EDT 2007;Committer;usa;1;1;1;2;0
54420c26147321080c6664ec095471172311cf9b;Thu May 10 06:17:07 EDT 2007;Committer;usa;2;21;0;21;0
adc782762b1fa585ed01c1ca35ef1f750a324eca;Thu May 10 06:13:58 EDT 2007;Committer;usa;2;5;1;6;0
dc2a434cf28d9372e172a68914809de27aa6276a;Thu May 10 06:08:20 EDT 2007;Committer;nobu;2;12;5;17;0
f563dc875cbcd697021602a9b648b0c50bdfcddd;Thu May 10 01:12:10 EDT 2007;Committer;nobu;3;14;7;21;0
ea758d28c35fac26d243f2b486bf85619ad2a8de;Wed May 09 04:11:41 EDT 2007;Committer;nobu;1;124;124;248;0
453366ceb90e23b70a6df738319f4aeba374075b;Wed May 09 03:49:18 EDT 2007;Committer;nobu;1;37;37;74;0
7de7d5ddeb6aec261a911343f1962ded776791ef;Wed May 09 03:28:08 EDT 2007;Committer;nobu;3;11;0;11;0
a78970e211677f74eb2763ba9bdd4bbe2ef61b65;Wed May 09 01:47:55 EDT 2007;Committer;nobu;1;3;3;6;0
147f75c3aba404bfcaa6ac26c42ac4886c9fee7c;Tue May 08 14:41:28 EDT 2007;Committer;tadf;2;110;41;151;0
91e5b6f1fa6e4499a04ef61fbf7162391d353878;Tue May 08 11:41:13 EDT 2007;Committer;usa;1;3;3;6;0
6bc8bcbc7f1810dc2e6169e638b1268c5555ec87;Tue May 08 11:23:38 EDT 2007;Committer;tadf;2;5;1;6;0
721eb816c94b1ea13cf336eb0f286b756a321623;Tue May 08 10:36:45 EDT 2007;Committer;keiju;2;9;1;10;0
1548542f214e5fa617f1d82e28d8dd626429df4f;Mon May 07 02:02:50 EDT 2007;Committer;kou;4;10;5;15;0
9f1c215f5a8e504cd87a738869e4a1701ee3749d;Sun May 06 09:43:26 EDT 2007;Committer;aamine;2;28;4;32;0
73e20674f62565116af5e9d91264efd351f68477;Sun May 06 09:13:52 EDT 2007;Committer;eban;1;3;3;6;0
094d3b1d7ce4106521c274f1e5d8178cde06f85a;Sun May 06 08:53:51 EDT 2007;Committer;aamine;2;34;19;53;0
84daaed84496f64701ccf1649e8a28a24716129f;Sat May 05 07:25:35 EDT 2007;Committer;nobu;3;9;4;13;0
1a89cc308d823033715131c2709a009ee971eb28;Thu May 03 13:19:11 EDT 2007;Committer;nobu;9;343;124;467;0
5bfe949dd543199a1776f1f816d47217837b896d;Thu May 03 13:04:42 EDT 2007;Committer;nobu;3;78;5;83;0
d942a9a1eef1636ebd98998f8e13dd6b9e615bea;Thu May 03 09:09:14 EDT 2007;Committer;nobu;6;44;37;81;0
fba2420be4f16a74ed867098ef256c3702ffb5d4;Wed May 02 09:59:38 EDT 2007;Committer;ko1;5;18;9;27;0
8269ab2e1fd073f2970535ccd796213db29cd2bd;Wed May 02 08:12:31 EDT 2007;Committer;nobu;2;68;6;74;0
1db71b2ecae2d35c700de5a4d8257c3617a093ae;Wed May 02 06:21:58 EDT 2007;Committer;ko1;2;17;4;21;0
f53a94c83124ce44a53e4262cdd30ffa53016f1a;Wed May 02 02:26:03 EDT 2007;Committer;ko1;4;36;15;51;0
0cc90b386573acd30b2256c7ff72e7da10d77bc3;Wed May 02 00:39:34 EDT 2007;Committer;nobu;1;3;3;6;0
50e6933b094ea9e5851617e7e464aa1f4c332a00;Tue May 01 21:45:48 EDT 2007;Committer;nobu;4;106;38;144;0
f8c2658700d600ea5636de580a146131300cb147;Tue May 01 20:44:25 EDT 2007;Committer;nobu;2;235;222;457;0
0c1f1fb5311f6470b0fef014941d722dec73146e;Tue May 01 20:39:48 EDT 2007;Committer;nobu;3;72;14;86;0
9ca1fec41b62d40d9cf3b6034e6364290592a7ee;Tue May 01 09:47:24 EDT 2007;Committer;ko1;2;30;26;56;0
82d5106e0913c1305d6a91ea0f56f16cd9dde7a9;Tue May 01 08:57:54 EDT 2007;Committer;matz;2;3;1;4;0
2b6252e64e47de5973218ec4655de169bdddc884;Tue May 01 08:45:28 EDT 2007;Committer;matz;3;27;1;28;0
f80841275d23122872e528f75f975270cb7b1624;Tue May 01 05:01:15 EDT 2007;Committer;ko1;2;18;7;25;0
75d28f887089c8582b63a64cf5df1d0270f15cc1;Tue May 01 04:35:58 EDT 2007;Committer;ko1;12;148;44;192;0
ea2cb282aeba0457aa775d5dbfa1da6810fafa45;Fri Apr 27 08:05:21 EDT 2007;Committer;nobu;2;4;2;6;0
5d2069cd566a2e1c616a91e4bda82f567d857498;Fri Apr 27 03:53:43 EDT 2007;Committer;nobu;2;8;2;10;0
9d89855052b008c4f366164e36ab88ed49c21e52;Thu Apr 26 16:54:58 EDT 2007;Committer;ko1;3;65;54;119;0
a379112975823550ab7b4493d4bd1244a6a1aeb5;Thu Apr 26 15:02:57 EDT 2007;Committer;nobu;2;38;20;58;0
93bdc98f33c0dfa2d7baf03787f0d8181062d9cf;Thu Apr 26 08:30:10 EDT 2007;Committer;nobu;3;45;8;53;0
f70f8173cd9ba0c359d87c0eb10b747f5abd6385;Thu Apr 26 08:18:00 EDT 2007;Committer;nobu;2;27;12;39;0
da4ad54e47972340399756467d682174601488ec;Thu Apr 26 04:54:01 EDT 2007;Committer;nobu;3;43;3;46;0
24af397fcdc96219ab4fc110d48aba7fad79a34f;Wed Apr 25 13:37:55 EDT 2007;Committer;akr;1;1;0;1;0
e3b9378f38e0ddc038b7a3032c115eebf9bec75a;Wed Apr 25 10:55:01 EDT 2007;Committer;akr;2;17;12;29;0
fb853dc2c2a932bb8b5a62b1e430d101b39733f0;Wed Apr 25 06:28:20 EDT 2007;Committer;usa;2;47;48;95;0
ec4a7ccf86c6be8d54934dd70c8e69fed328a612;Wed Apr 25 05:14:33 EDT 2007;Committer;ko1;2;7;2;9;0
5bda3debcf2493308afd8d5c7d5ee306d5980828;Wed Apr 25 04:10:55 EDT 2007;Committer;nobu;4;86;86;172;0
abcbd7ea38f64f942a934ba065aabf9da81a21bc;Wed Apr 25 03:50:00 EDT 2007;Committer;ko1;10;199;35;234;0
354844be45efe799031b1a9799e8c6d52cc6b16d;Wed Apr 25 01:35:13 EDT 2007;Committer;nobu;8;36;45;81;0
4134a542baa4e9a5c49adab53272d74edfc55f4d;Wed Apr 25 01:32:24 EDT 2007;Committer;nobu;3;11;4;15;0
787c3ead188aa95b2248601b60819fc4d5f968f7;Tue Apr 24 00:33:09 EDT 2007;Committer;nobu;3;17;6;23;0
42b3d60056f9ff4009f2398b5697e21a9b48986d;Mon Apr 23 13:13:53 EDT 2007;Committer;nobu;2;5;1;6;0
692010a2350a0dd981ed8b31ccd7a5a76dd6468a;Mon Apr 23 13:08:29 EDT 2007;Committer;nobu;3;32;16;48;0
138362834f6a2d536839f2a7764e4af642407b25;Fri Apr 20 09:38:16 EDT 2007;Committer;matz;2;29;13;42;0
22826be640c2beb16275862bdcdee65d6cf68a82;Fri Apr 20 07:04:35 EDT 2007;Committer;nobu;2;9;4;13;0
e110a86cc514fad7fd183228975e024597f4fdef;Fri Apr 20 06:48:23 EDT 2007;Committer;nobu;1;10;8;18;0
dc8147bca9715b114745ce8bea211fb40ec583cc;Fri Apr 20 03:26:19 EDT 2007;Committer;nobu;2;5;1;6;0
cc1757bce8abc852963b9253e930e2599055c653;Fri Apr 20 03:20:44 EDT 2007;Committer;nobu;2;21;12;33;0
52ecaf65b0ff40492c5a85cdd9f5cd34201b4a0e;Fri Apr 20 01:34:41 EDT 2007;Committer;ko1;2;8;0;8;0
3fc37d71c4a1a25c3a77464c614595703d63c2e6;Thu Apr 19 17:37:03 EDT 2007;Committer;nobu;9;169;55;224;0
a73894337a830cdd32a913964f3150bc35269975;Thu Apr 19 10:37:08 EDT 2007;Committer;ko1;15;472;313;785;0
2dd91facca2337ff611489f1ccd84441d8fc9bf2;Thu Apr 19 08:48:03 EDT 2007;Committer;ko1;3;8;4;12;0
b338d1d6a41d59885f718de2f800a19b84d42fa7;Wed Apr 18 01:40:38 EDT 2007;Committer;nobu;2;6;2;8;0
07cab8007ee3832adbb2fd7280ce26f3c50bf5cc;Tue Apr 17 17:50:05 EDT 2007;Committer;nobu;2;7;1;8;0
3c36d2d3c1c5458552df9a3a586d6d66c8479832;Tue Apr 17 17:29:39 EDT 2007;Committer;nobu;2;7;2;9;0
5f8b25745b15e42ade57449f657c4de7cb0e17bd;Tue Apr 17 17:17:15 EDT 2007;Committer;nobu;3;22;28;50;0
047f685d738cec6a1573f600da1e84d10975e61a;Mon Apr 16 13:56:19 EDT 2007;Committer;matz;2;8;2;10;0
a8c748d2773b6ce5d871360ee36f7d214ae1af11;Mon Apr 16 13:53:09 EDT 2007;Committer;matz;7;13;7;20;0
380ea10dfaf431ab14b92edb7154ccd4cacd159f;Mon Apr 16 08:12:51 EDT 2007;Committer;matz;2;7;0;7;0
0a612b8807be8b03fe8e360148af98258b7d62c3;Mon Apr 16 08:07:20 EDT 2007;Committer;nobu;2;7;2;9;0
ffa31c264500817f1579be5c6b2d9b943b3b9cf4;Mon Apr 16 07:48:50 EDT 2007;Committer;nobu;2;9;1;10;0
e7bab2a61b4df0463a094211f5501d8e091391a9;Mon Apr 16 07:29:30 EDT 2007;Committer;matz;2;9;4;13;0
9cd678b72f86ed312321cf04fc83f5a10978485b;Mon Apr 16 07:28:16 EDT 2007;Committer;matz;3;10;4;14;0
a68a11dd3191755b4cc978b7479e191c2a69e531;Sun Apr 15 00:17:02 EDT 2007;Committer;tadf;2;44;26;70;0
0089455e53628edf94060b56203279ad59c32553;Thu Apr 12 08:14:54 EDT 2007;Committer;ko1;3;17;4;21;0
e0943c481ab3fc3a5a35e3f7a71d97ad93f7036f;Thu Apr 12 08:13:20 EDT 2007;Committer;ko1;2;37;27;64;0
cc3871f9dcd8f89d6e554f59ff02c67dde42fc37;Thu Apr 12 07:08:28 EDT 2007;Committer;ko1;2;8;0;8;0
baeb828c03e96b1f78c296fe4e12602e57497401;Thu Apr 12 07:06:17 EDT 2007;Committer;ko1;3;8;4;12;0
314734add8ad699b1de13c3382e79dca6cca903a;Wed Apr 11 07:37:02 EDT 2007;Committer;usa;5;14;63;77;0
20e961458e9f34504dc07712ad6b0e8aa1d165f8;Tue Apr 10 08:02:38 EDT 2007;Committer;usa;2;9;0;9;0
00f60d074804e2d3a74c6108e40cd5910865f7fc;Tue Apr 10 07:16:42 EDT 2007;Committer;usa;2;14;5;19;0
f024801e1e1c5fe55bff16989026be0de6c91937;Tue Apr 10 06:53:39 EDT 2007;Committer;usa;3;12;4;16;0
b3e38e1819234ef34294f98a3f41e66063e9d011;Mon Apr 09 09:49:40 EDT 2007;Committer;usa;2;6;1;7;0
45b0d6590044b741be0368ceccb3cb865ba890cd;Mon Apr 09 09:30:50 EDT 2007;Committer;usa;1;1;1;2;0
14869595501ceb1bb82c8b006cc2e9d0acdec908;Mon Apr 09 09:29:45 EDT 2007;Committer;usa;4;11;11;22;0
6df7c0c7214c8f56ac61555a1b4da5abc2f58329;Mon Apr 09 00:28:35 EDT 2007;Committer;shugo;2;10;1;11;0
e12090b9b23d54f41175f7fb3528419048f8c2bb;Sun Apr 08 04:27:41 EDT 2007;Committer;nobu;3;15;7;22;0
31088109b728d2cd93051c2114ffef880b4fa8bb;Fri Apr 06 01:58:01 EDT 2007;Committer;usa;2;6;4;10;0
406389a9f31ab0e7de689a373b0a8c4b2d5905fa;Fri Apr 06 01:29:48 EDT 2007;Committer;usa;1;3;3;6;0
dcc5bd8bcf7fc2d8dd211e065c5d210af160f805;Thu Apr 05 19:03:28 EDT 2007;Committer;technorama;6;216;8;224;0
13513057c5cd1f155dc73e479fc915b1ad9fea45;Thu Apr 05 09:00:52 EDT 2007;Committer;nobu;1;2;0;2;0
22e4a7703fbcc4640fa5b764730e542dd75df743;Thu Apr 05 08:58:46 EDT 2007;Committer;nobu;3;150;86;236;0
22405dad926f9c898e08a4c5bf44dad81f050e70;Thu Apr 05 06:13:37 EDT 2007;Committer;usa;2;6;1;7;0
953e8aca2be6a74a4829f8729cd4ba8e501207fe;Thu Apr 05 05:59:22 EDT 2007;Committer;technorama;14;246;57;303;0
f1796fdb2c0473f2362a79402e1d9417cf2b6f96;Wed Apr 04 15:42:16 EDT 2007;Committer;nobu;4;25;20;45;0
8259e4aa9a140b9584dec2be4e542dfbd71a40ad;Wed Apr 04 08:08:46 EDT 2007;Committer;nobu;2;24;11;35;0
7f8eb55d6c3f6132d84ce46ee468d5e660253471;Wed Apr 04 03:29:31 EDT 2007;Committer;usa;2;6;1;7;0
1f9d0992aba18316b2e08ce2ce00b0b5eb524e48;Wed Apr 04 01:17:34 EDT 2007;Committer;nobu;3;16;11;27;0
9c64c3ed5c45084e62f46fc6b5d80948697c3f86;Wed Apr 04 01:00:49 EDT 2007;Committer;nobu;2;8;0;8;0
9ce7494cda368d85701058cea950912b5eeea237;Tue Apr 03 18:29:30 EDT 2007;Committer;technorama;2;111;5;116;0
013baa2b43a72aea8da9e7548a031f4a3695d229;Tue Apr 03 07:30:16 EDT 2007;Committer;nobu;1;6;3;9;0
043479247cfe70d6464293a0b070f9bfaba608fd;Tue Apr 03 07:21:53 EDT 2007;Committer;nobu;3;20;11;31;0
8b95ee24de750995a0ffa7881b0c190315a98598;Tue Apr 03 07:02:44 EDT 2007;Committer;technorama;7;1477;4;1481;0
eed46ac6337e995196430b18eca10c9cb15317da;Tue Apr 03 06:50:41 EDT 2007;Committer;usa;2;8;2;10;0
9a41f064fae5245df0a2d9dc7045d5e9705946c8;Tue Apr 03 00:37:13 EDT 2007;Committer;usa;2;9;2;11;0
7fa11815f8d47ed29b53f137732852b80fbbf186;Tue Apr 03 00:14:28 EDT 2007;Committer;usa;1;3;3;6;0
a05e89ca65c24dd4821e34172c891e5b8de33a54;Mon Apr 02 22:10:12 EDT 2007;Committer;technorama;5;723;7;730;0
3930d3b36bfbe7b380595ed835dbd6b36847aab9;Mon Apr 02 19:00:23 EDT 2007;Committer;technorama;10;138;21;159;0
790999028d75caa265cb66a8e44d200b8356ed8e;Mon Apr 02 12:54:42 EDT 2007;Committer;nobu;5;17;12;29;0
528e8517b8ed545ecd8aef678ec542275f08c8f7;Fri Mar 30 02:50:58 EDT 2007;Committer;usa;2;13;10;23;0
a2dba5be2dc43f69635e1c71482802428e973ec6;Fri Mar 30 02:08:31 EDT 2007;Committer;knu;1;11;1;12;0
d46b2615998caf6901bf0b6145c7e0f4ebb54f74;Thu Mar 29 17:32:56 EDT 2007;Committer;eban;1;3;3;6;0
41fa6056ba08e7a94d60e10825d271fbd1fa5596;Thu Mar 29 17:29:03 EDT 2007;Committer;technorama;9;570;19;589;0
240f1279aa7bca6a125b148e18955888f9bb4bd8;Fri Mar 23 02:30:53 EDT 2007;Committer;usa;3;58;51;109;0
69b8b645b5da1282423b2be663aedd0c52508ef6;Thu Mar 22 15:25:58 EDT 2007;Committer;keiju;4;49;53;102;0
0ce0d4a596b5059d04f3f79f9c3244c1415782fd;Thu Mar 22 04:32:55 EDT 2007;Committer;usa;2;5;1;6;0
fa36cffb3e97b2f073910d0d8e4f3b6906094195;Thu Mar 22 01:28:41 EDT 2007;Committer;usa;1;3;3;6;0
4be1dfb9faab78ffb2d2e16e80b358a9f233d147;Thu Mar 22 01:28:23 EDT 2007;Committer;usa;2;15;0;15;0
0d16b614bfef56f513a51caf604f6f5e13418ae5;Wed Mar 21 11:38:42 EDT 2007;Committer;usa;2;9;5;14;0
bb7a2d40ff6190f819feb3d9eef0caaffec1a3f9;Wed Mar 21 11:15:15 EDT 2007;Committer;ko1;15;561;1032;1593;0
df896a05608e4041c36488c60218f06ca74830b9;Wed Mar 21 08:04:11 EDT 2007;Committer;nobu;3;12;7;19;0
e6e5674156079ddd466e216593c2eb2da5590944;Wed Mar 21 02:27:16 EDT 2007;Committer;nobu;1;319;319;638;0
25ac9f24fdcda84e16615dafa868cc0d361492be;Tue Mar 20 23:29:49 EDT 2007;Committer;ntalbott;3;17;9;26;0
ed224698b56a06808c98b1db393eea5b84a20f09;Tue Mar 20 14:00:07 EDT 2007;Committer;matz;2;9;4;13;0
42a81120e510c2c2fb7822ff4d5738db6ba392bf;Tue Mar 20 12:38:58 EDT 2007;Committer;keiju;8;270;141;411;0
d9d838a45beff13576e4fba42e0d5b611d0df706;Tue Mar 20 07:37:34 EDT 2007;Committer;shyouhei;2;25;11;36;0
315f27836fec6a1fef162c066c5e6644eec6351b;Tue Mar 20 07:35:57 EDT 2007;Committer;usa;1;2;2;4;0
edec8b39f95bb6ed0b0e95f248e21beb110ffa34;Tue Mar 20 07:21:37 EDT 2007;Committer;matz;2;59;0;59;0
4503c8daebd2b8c572a313117b5d9c50e824ab14;Tue Mar 20 02:09:10 EDT 2007;Committer;knu;2;32;7;39;0
e1aec4aed8e745c41ab36ad8914285f011cd8b4f;Tue Mar 20 00:12:51 EDT 2007;Committer;nobu;2;14;3;17;0
56f2d0aa98e2cbddf20d8c382d4ee824ebd3a4f2;Mon Mar 19 16:38:30 EDT 2007;Committer;nobu;2;5;2;7;0
08b53aa67a5da8daf602424847c4aeacd0ac75eb;Mon Mar 19 16:02:05 EDT 2007;Committer;nobu;3;9;4;13;0
72408684245a2b1a45cb4e09906436e06b95bf60;Mon Mar 19 08:01:40 EDT 2007;Committer;usa;9;198;8;206;0
de3770d158d8c955e450f1c2359cbc85b7515ebe;Mon Mar 19 05:39:07 EDT 2007;Committer;matz;2;18;6;24;0
33163ad123a14488cf163c274d1af56c8e5e7bcb;Mon Mar 19 03:58:57 EDT 2007;Committer;matz;21;57;58;115;0
a20ecf3be4aa83647f243ff29fa9d0b23a9b9b63;Mon Mar 19 03:22:01 EDT 2007;Committer;usa;1;3;3;6;0
a7ec83b93a8967bc7ecd7c74c7b71ec884186088;Mon Mar 19 02:27:08 EDT 2007;Committer;aamine;2;7;1;8;0
f3cde2b5fbd1c936c297a248c4d277339db687ff;Sat Mar 17 23:42:00 EDT 2007;Committer;usa;4;23;12;35;0
966a25465aab5c2972e6c453f631a15fc2223256;Sat Mar 17 10:13:25 EDT 2007;Committer;kou;71;10244;3035;13279;0
53cbab048452742b537ac8bccf494630d1c184c8;Fri Mar 16 13:35:14 EDT 2007;Committer;eban;1;3;3;6;0
31015d2cca9966d891b1520ae845cf7a7fc7995a;Fri Mar 16 13:32:41 EDT 2007;Committer;aamine;2;12;6;18;0
d50f882cf0a129129a5120a2b570dc0d0bf005b1;Fri Mar 16 13:24:06 EDT 2007;Committer;suke;2;55;1;56;0
ae2c8b45d2c345faea6a7f2203603b4862f3a66c;Fri Mar 16 13:17:10 EDT 2007;Committer;aamine;3;387;16;403;0
30aa46db0b3983648cb9a5d2cc330acad022f165;Wed Mar 14 05:39:00 EDT 2007;Committer;matz;3;9;6;15;0
f6f313379bfa1625fd206bc3e07ceed758e41341;Tue Mar 13 10:13:41 EDT 2007;Committer;keiju;2;89;88;177;0
140fb1bae3e8110cc1070bdc66d51a84c7e875bd;Tue Mar 13 00:24:58 EDT 2007;Committer;nobu;2;9;1;10;0
060b6318963aba7516c7f3385d0385cc95bd4241;Mon Mar 12 22:24:32 EDT 2007;Committer;shugo;2;6;1;7;0
9d5c0ea4a316fab37436f7aaa9473b76a39f017f;Mon Mar 12 17:48:10 EDT 2007;Committer;knu;3;11;4;15;0
62d54a282e28fd38e032485aba4a434852f63686;Mon Mar 12 04:04:17 EDT 2007;Committer;knu;1;3;3;6;0
024a7fd7a4f82dafefed7c467d691e57b7236046;Mon Mar 12 02:01:19 EDT 2007;Committer;knu;12;73;0;73;0
5a347e064f4e0ac92734a11aea312945aaec846a;Sun Mar 11 09:46:46 EDT 2007;Committer;knu;2;6;1;7;0
7f4bbc6530c68ee5bf4f369676c3cc2d0c3bd2c4;Sun Mar 11 03:13:07 EDT 2007;Committer;eban;1;3;3;6;0
fb85abe0972ba25443a9a8de0b184c104fab3acf;Sun Mar 11 00:40:26 EST 2007;Committer;nobu;1;1;1;2;0
af2b2755ccc4b32fd04ea66088649055eb8f9d0b;Sat Mar 10 20:52:31 EST 2007;Committer;knu;3;149;6;155;0
c769454c0e17fce28a18b73e1800c49edea6fc7d;Fri Mar 09 22:21:59 EST 2007;Committer;suke;3;114;19;133;0
c49418522dec35ce043e0a9736fae32217002384;Thu Mar 08 00:23:14 EST 2007;Committer;aamine;8;33;10;43;0
835f040be29b1a32f93428a6a90de7978b7c2779;Tue Mar 06 08:50:51 EST 2007;Committer;keiju;2;9;3;12;0
4cd2a9864c9d215500dacef309c4eacb0db9ce3a;Tue Mar 06 02:56:32 EST 2007;Committer;nagai;2;10;1;11;0
92cea77f951c15ac7af1699fa4194cc80475974a;Tue Mar 06 01:23:02 EST 2007;Committer;nobu;1;1;1;2;0
8f676986bec676ed88f26c2f3721aff87ee00d42;Tue Mar 06 01:21:48 EST 2007;Committer;nobu;2;24;6;30;0
f24e3f227114441e06d4fff38033a6354fbf660b;Mon Mar 05 00:20:05 EST 2007;Committer;aamine;2;17;7;24;0
6dfd5fe95392ebffd7f5690430c7f39e70c6df15;Mon Mar 05 00:17:38 EST 2007;Committer;aamine;3;232;85;317;0
736f3c28b0ff8d75ad9bd26e0f7d567b682c214a;Sun Mar 04 22:14:23 EST 2007;Committer;aamine;2;79;108;187;0
da3558fddb385de8cd7d0ef4556b7073139a824e;Sun Mar 04 16:36:36 EST 2007;Committer;nobu;4;16;11;27;0
7b0f24634555aece61327c117e8d56d27310b281;Sun Mar 04 14:41:16 EST 2007;Committer;nobu;2;7;4;11;0
9b7ecc68a9e869143367556dba35f7368839ab32;Sun Mar 04 14:38:02 EST 2007;Committer;nobu;4;19;9;28;0
35fadee53d443e362cde1d429dd6d8c66a535132;Sun Mar 04 05:51:07 EST 2007;Committer;eban;2;7;1;8;0
ebba0b43406c3adea42160ed4392e6ca86d9ea2a;Sat Mar 03 16:04:57 EST 2007;Committer;knu;2;8;2;10;0
738bf0e8a44a3f5c297aec118638684d910f3323;Sat Mar 03 13:54:54 EST 2007;Committer;aamine;2;7;6;13;0
e089d1161da7e51f78a49a23c290cfcc30ee2457;Sat Mar 03 13:53:38 EST 2007;Committer;aamine;2;12;3;15;0
15dabe82163717bbdadab82d72e657f5fa731e99;Sat Mar 03 13:37:02 EST 2007;Committer;nobu;4;30;7;37;0
5d8187d77250484e7f72cbe08d87083a125b9c58;Sat Mar 03 06:53:38 EST 2007;Committer;knu;3;12;7;19;0
e8783d008c8944bb66ed7620d45f39286b5f948f;Fri Mar 02 12:35:02 EST 2007;Committer;suke;3;524;45;569;0
582f1ecdfbad7147e7c0668fc072441503cb7ba1;Thu Mar 01 22:59:12 EST 2007;Committer;matz;3;15;9;24;0
cd725929d7241166733f2028cc71640b055ce267;Thu Mar 01 12:38:05 EST 2007;Committer;nobu;2;7;0;7;0
75129a3608363be3c5f2562a5fafb08ac9ece836;Wed Feb 28 18:27:50 EST 2007;Committer;knu;1;1;1;2;0
04cd7cc62d8b16da8ccdff92f46e54e62ff26fab;Wed Feb 28 18:24:25 EST 2007;Committer;knu;2;14;4;18;0
50d3ece900d8592907eb06b8eb77b4612e7e5020;Wed Feb 28 17:05:18 EST 2007;Committer;nobu;3;14;5;19;0
4b285e22164ba03e61ba3037c46988cb4f0881bf;Wed Feb 28 12:47:01 EST 2007;Committer;eban;1;1;0;1;0
fc16d956cb1a06bf901138af35f9adaf5cd44ca8;Wed Feb 28 12:18:48 EST 2007;Committer;eban;2;9;2;11;0
7f005938cff3989e1f35981b8ab0619faf770920;Wed Feb 28 11:55:19 EST 2007;Committer;shyouhei;2;21;8;29;0
cebb4b5ca041f422c23e15bedb9abed8481777ba;Wed Feb 28 09:32:56 EST 2007;Committer;usa;2;6;2;8;0
bcb0b021e3a0216bcf6f64d2545caac7f8124c34;Wed Feb 28 09:26:07 EST 2007;Committer;usa;2;12;5;17;0
f9b349adb53b02ed1b3565be5b06e4881b0cdd41;Wed Feb 28 01:33:57 EST 2007;Committer;nobu;11;77;36;113;0
b2c25d56c59de27d7b03fc96a37f6a511000500e;Tue Feb 27 19:04:52 EST 2007;Committer;matz;2;7;6;13;0
a17065673c834143bc52e89c9e5c3990d83f225b;Tue Feb 27 16:30:20 EST 2007;Committer;usa;1;1;1;2;0
c67d0e35e7e77f21ec2c46978c4b66b4e89c30d0;Tue Feb 27 16:22:10 EST 2007;Committer;usa;3;9;4;13;0
e38fd64fcdf5e0f3db55eb507f758c8a6fc1f297;Tue Feb 27 15:12:18 EST 2007;Committer;shyouhei;5;64;4;68;0
7cd86a19c39e7d8a607a5568be41014c8bdc4e94;Tue Feb 27 13:28:48 EST 2007;Committer;eban;2;8;1;9;0
ce062c154587e75d577722cfeac33c68ed17ebe5;Tue Feb 27 13:27:14 EST 2007;Committer;eban;3;10;1;11;0
006f72e9209d29b564a7ba95bf1f100f1cabf331;Tue Feb 27 11:37:54 EST 2007;Committer;usa;2;24;22;46;0
42c647f6fc5c457b6c9d52790491cb750dd22903;Tue Feb 27 10:35:17 EST 2007;Committer;knu;2;12;5;17;0
43281c7297f046b1025edb86889c28d21b7b6292;Tue Feb 27 10:16:59 EST 2007;Committer;knu;2;6;1;7;0
0e6521aa5d13c12c33db0aa2010d738306f6552a;Tue Feb 27 10:08:39 EST 2007;Committer;knu;5;19;6;25;0
60c3c901fe536de977368580f36576f2948e7b60;Tue Feb 27 09:19:21 EST 2007;Committer;matz;2;125;0;125;0
8a1b1c2b41b475cc40a8013623b5b6fe5381d6da;Mon Feb 26 22:51:33 EST 2007;Committer;ko1;7;40;30;70;0
3623df9bc68adf445814f2d1ec5bc81e7e0450bb;Mon Feb 26 16:29:21 EST 2007;Committer;eban;1;3;3;6;0
c2d5527bff7ed498b22942ef85b7d391aab0554d;Mon Feb 26 15:45:52 EST 2007;Committer;aamine;2;34;84;118;0
9987d53e519cf84fe47ffbbd4f48be0bc40938c7;Sun Feb 25 16:29:26 EST 2007;Committer;ko1;9;70;27;97;0
e98f7e1eaa18c33d211e6a0cf245eaf4b175c3c7;Sun Feb 25 15:58:27 EST 2007;Committer;ko1;3;16;7;23;0
fd6f1f0a7174a412007f24d669790624927fb965;Sun Feb 25 02:48:19 EST 2007;Committer;ko1;2;5;1;6;0
757ed3ccf1047480729f848552dd360d827843d3;Sun Feb 25 02:43:43 EST 2007;Committer;ko1;4;11;38;49;0
571317ee309515494bcec3093b88b0c689a3bf0e;Sun Feb 25 02:36:58 EST 2007;Committer;ko1;2;5;2;7;0
565bcdcb30e5c4e88a1b44efe2eb539c23767c96;Sun Feb 25 02:10:38 EST 2007;Committer;aamine;2;24;5;29;0
71986ef6bc232455deca67017873fff0c3cbd860;Sun Feb 25 01:34:33 EST 2007;Committer;ko1;11;136;103;239;0
9c9b619799aea31eb2505749386ed3a530246bbb;Sun Feb 25 01:28:14 EST 2007;Committer;aamine;2;7;4;11;0
96110732f155a53d0e7e37a7975746d76ac10ba7;Sun Feb 25 01:16:58 EST 2007;Committer;nobu;2;6;0;6;0
f42150744cc0d65ee3d5b2f0064d959de6038802;Sat Feb 24 10:39:30 EST 2007;Committer;aamine;2;9;0;9;0
5b10c170e52d53e570b6335590552a12b002c361;Sat Feb 24 10:30:50 EST 2007;Committer;nobu;15;176;174;350;0
793c649f651945c995b4b95383d26495e6cacb7d;Sat Feb 24 10:28:36 EST 2007;Committer;aamine;2;11;2;13;0
e9ee00eead94368dfd26a31bd4a7adbca64e991c;Sat Feb 24 09:56:02 EST 2007;Committer;aamine;3;6;1399;1405;0
b1b44331de67e5b2e8343d8c74143ea4222007a2;Sat Feb 24 09:54:49 EST 2007;Committer;nobu;1;1;1;2;0
8ac59769bcf9676e58e3ec6f3f7fb927258f545d;Sat Feb 24 09:45:41 EST 2007;Committer;nobu;2;23;45;68;0
145f0b0f507f4e1e88c20ae34f0252f94b9e2fe5;Sat Feb 24 09:45:25 EST 2007;Committer;aamine;3;250;1;251;0
eb3f1f7aeb55778b13942b1823b460a15be693c5;Sat Feb 24 09:44:41 EST 2007;Committer;nobu;1;3;1;4;0
c034fce5cef74af6d1178eba4bec536e1fa70728;Sat Feb 24 09:43:40 EST 2007;Committer;nobu;4;52;19;71;0
f425798fdaca165c200091faf976c3cf9a52637d;Sat Feb 24 09:41:41 EST 2007;Committer;nobu;5;40;14;54;0
5374de14e34fcd5354289830ab7f2212884bc4f5;Sat Feb 24 09:39:25 EST 2007;Committer;nobu;2;37;3;40;0
b0d830174499044035053c9760e77b88fca8b427;Sat Feb 24 08:45:58 EST 2007;Committer;aamine;2;17;1;18;0
45c7ead6ae07a05e9d0301ab40a37fba4a2e33ac;Sat Feb 24 07:53:14 EST 2007;Committer;aamine;2;5;1;6;0
d7c2f391fc08ff5354c06b50b7170ce7afbee3b4;Sat Feb 24 07:51:52 EST 2007;Committer;aamine;2;11;0;11;0
18e1d27353a3abbcdc8c7d77c0cb3af095d3d099;Sat Feb 24 07:47:53 EST 2007;Committer;aamine;4;573;0;573;0
1930f14533b0fc16dab4a3c01996033a6c5763ba;Sat Feb 24 07:31:11 EST 2007;Committer;usa;2;4;9;13;0
02c147f04eeadb4e6229a9fd423288b6ec85b629;Sat Feb 24 07:05:48 EST 2007;Committer;matz;2;8;4;12;0
1adef150721a42b9efe97ebc18de535040810e7a;Sat Feb 24 07:01:18 EST 2007;Committer;shugo;4;17;4;21;0
dfd5c685c1db808fefa1992223b4d3ec4046ae21;Sat Feb 24 06:51:59 EST 2007;Committer;aamine;2;4;1;5;0
b2035db68457dcdfe6fd1569d1d9946a2503c116;Sat Feb 24 06:48:05 EST 2007;Committer;matz;2;7;8;15;0
97d26f32bbea750e4b3a6be8ee327f907d871166;Sat Feb 24 06:42:04 EST 2007;Committer;shugo;2;4;9;13;0
33a9e63ad9cbd673e84d0403fb7c72cdc9b1a616;Sat Feb 24 06:15:04 EST 2007;Committer;shugo;2;36;92;128;0
61d521117a4b37865ca779f50901138aafc8334d;Sat Feb 24 05:22:05 EST 2007;Committer;ko1;3;9;2;11;0
0fe72040e4c278bfafe232dc44551de2dfac85e2;Sat Feb 24 02:07:05 EST 2007;Committer;ko1;10;251;161;412;0
c5148e038316b3351b4c831773b83e08c11c20fb;Sat Feb 24 01:49:43 EST 2007;Committer;ko1;2;6;1;7;0
e3155f4200b3567b323d788c15031004ccc71b7d;Sat Feb 24 01:45:18 EST 2007;Committer;ko1;1;1;2;3;0
287aa3324af51a31acaf27c47ff73c9f76b8345e;Sat Feb 24 01:41:46 EST 2007;Committer;ko1;2;10;3;13;0
6a48d31ced11c36dd5614ec2546748f115e31409;Sat Feb 24 01:38:26 EST 2007;Committer;aamine;2;5;4;9;0
1fcf93350f2a7819916ebe0ea7553cdde48f32e3;Fri Feb 23 22:39:25 EST 2007;Committer;suke;4;456;87;543;0
bd3ee06295a54b714282d71bca309c86f1869aa9;Fri Feb 23 09:38:08 EST 2007;Committer;aamine;3;73;207;280;0
bb022bed3a0e20b6fee92ad8910d1e0651c43f18;Fri Feb 23 09:33:53 EST 2007;Committer;usa;5;61;136;197;0
bcd3345136047deb36943468bc4382074b96405f;Fri Feb 23 09:13:49 EST 2007;Committer;aamine;3;201;118;319;0
f52fd2165bae52154e2069dd35811441c6eaecac;Fri Feb 23 07:59:54 EST 2007;Committer;aamine;3;94;424;518;0
3207cd3897cd40d7801c7e8f422942b7fadb6807;Fri Feb 23 06:59:12 EST 2007;Committer;usa;2;9;0;9;0
f35a641adb2d08e264a70afad27f706d2d05972e;Fri Feb 23 06:41:25 EST 2007;Committer;aamine;2;397;585;982;0
583417190488ccbb668a3c149f9dd2ee2f0b837c;Fri Feb 23 06:07:55 EST 2007;Committer;usa;2;22;40;62;0
a9921d08f9378b44a30e5ff5624951da8a917a89;Fri Feb 23 05:23:33 EST 2007;Committer;aamine;2;188;0;188;0
9af03319fb83561340c7e5d13327de622781edeb;Fri Feb 23 03:44:46 EST 2007;Committer;knu;1;1;1;2;0
e17884c45cafd929008614fe17d6650921268cdd;Fri Feb 23 03:42:01 EST 2007;Committer;knu;3;12;2;14;0
67c94cae969538b2d442fcf8b37663e8aa141686;Fri Feb 23 03:25:26 EST 2007;Committer;aamine;3;18;13;31;0
606734f0b1689c3763c394a895355d814cf91940;Fri Feb 23 03:16:57 EST 2007;Committer;matz;2;4;2;6;0
b83ed6d1bd710c0f3397dafbba3b96e1311bcc6a;Fri Feb 23 02:49:41 EST 2007;Committer;matz;13;25;160;185;0
c56b2c10848b14e4cfa653bd73d372505ead499f;Fri Feb 23 01:56:43 EST 2007;Committer;shugo;2;7;7;14;0
6dde5de0228f9e61f409daa19fd26d12e2055843;Fri Feb 23 01:31:37 EST 2007;Committer;aamine;2;18;5;23;0
0c882f4c9d8115d5292c85aacc4860e8946661fb;Fri Feb 23 01:21:49 EST 2007;Committer;matz;3;8;8;16;0
4563573a6b762eab0acf96427d9d3b6f1d0c702f;Wed Feb 21 13:30:17 EST 2007;Committer;knu;2;6;3;9;0
f67795869db1cb62992d19e94bcf83abd0f0686b;Wed Feb 21 08:53:15 EST 2007;Committer;matz;2;15;17;32;0
e3b0b6d5fecf52402c333be90c31b32bb04c43ac;Wed Feb 21 00:14:07 EST 2007;Committer;nobu;3;15;3;18;0
975ce3add3c95ddb53351de9b90e71ed8e1aacd0;Tue Feb 20 12:25:40 EST 2007;Committer;suke;2;11;5;16;0
9f6cd833e602cf37bac7226a3ea6a46eb0d532a1;Tue Feb 20 07:35:33 EST 2007;Committer;knu;1;2;0;2;0
74adb2b8d436c2f28cd44aefc9d90ec305eff73e;Tue Feb 20 07:34:30 EST 2007;Committer;knu;2;17;13;30;0
90a192865a9a57e8acecfdfd653386b4f335787b;Tue Feb 20 06:16:04 EST 2007;Committer;ko1;4;12;8;20;0
db95cb49af50b005c26bdab8a80257f070f78fbe;Tue Feb 20 06:11:37 EST 2007;Committer;ko1;2;7;0;7;0
661955cc39db3a96f9adc731e3df7c2fef9882ef;Tue Feb 20 06:07:05 EST 2007;Committer;ko1;3;13;7;20;0
a29c96840dcadfbbf953f765b1909c9ca84098ed;Mon Feb 19 16:30:02 EST 2007;Committer;tadf;1;1;1;2;0
d429f631688f37d3e064267eead575ecb57c7b8b;Mon Feb 19 16:16:12 EST 2007;Committer;tadf;1;4;4;8;0
128cc954d0e17e871c657f1eaaadb927bc92b507;Mon Feb 19 13:16:12 EST 2007;Committer;nobu;3;49;36;85;0
085fee908733edc08dc79c3ac551479be6e07f22;Mon Feb 19 13:15:36 EST 2007;Committer;nobu;1;9;0;9;0
2551d9b534ba71b15ec4be0c64739656364bb5eb;Mon Feb 19 08:17:14 EST 2007;Committer;matz;3;10;4;14;0
9c79e14614869fbf3bb9132a554e28a5b85c0b72;Sun Feb 18 13:56:15 EST 2007;Committer;nobu;2;5;1;6;0
728fa4a66158541cba8b5940e9b9e051ebc19e22;Sun Feb 18 10:47:07 EST 2007;Committer;eban;1;3;3;6;0
c04f4aa0ee1a70768c785ac00160eb0e0f22d7fc;Sun Feb 18 10:34:58 EST 2007;Committer;tadf;2;14;9;23;0
562f256c54dbb1a0a26699ba3dceba24062a9b11;Sun Feb 18 04:13:09 EST 2007;Committer;nobu;5;16;29;45;0
bf6efa76c0abcd1a2577cf0ca49f8137d3483b60;Sun Feb 18 04:11:57 EST 2007;Committer;nobu;5;218;147;365;0
353cd251706d07ae4ffd66994a72acae06e98057;Fri Feb 16 12:36:49 EST 2007;Committer;ko1;3;12;5;17;0
b13c74bf82d7d919de5cc85cc2b1992b128ba559;Fri Feb 16 12:00:27 EST 2007;Committer;ko1;2;5;0;5;0
a9e13cc40c9854869594023571bfd03c44c33e77;Fri Feb 16 11:12:11 EST 2007;Committer;matz;2;8;0;8;0
163163afdfc6cc3f61a2a157b1242fe21a1152e3;Fri Feb 16 10:58:04 EST 2007;Committer;matz;3;9;4;13;0
d908340910d3dfbdb008586323def4fc0601d34b;Fri Feb 16 02:23:15 EST 2007;Committer;drbrain;3;15;6;21;0
691b6fb869f4d8d64da25f768589eb0eebb65634;Thu Feb 15 11:50:28 EST 2007;Committer;usa;3;59;2;61;0
ea51ff20ac92e33b0508ee1fc7ecfcb50c53426e;Thu Feb 15 07:43:37 EST 2007;Committer;knu;2;13;6;19;0
5e4e71a34852ccc8e871e384de19dccad347100c;Wed Feb 14 18:08:10 EST 2007;Committer;ko1;5;9;7;16;0
a8d47615da58b73423cf638f57b694d6ab463b9b;Wed Feb 14 16:53:00 EST 2007;Committer;ko1;4;10;3;13;0
970df0d1385ea23c453f4779050a31c4379d6d11;Wed Feb 14 16:50:16 EST 2007;Committer;ko1;4;29;23;52;0
fdf4aa982f8265402ec6ecfa137bf2bc4052560d;Wed Feb 14 13:57:59 EST 2007;Committer;suke;2;9;14;23;0
bee3de05ad672461623a0feef8c53dab2e4a5652;Wed Feb 14 13:13:52 EST 2007;Committer;ko1;3;8;2;10;0
559be019deb5b8996842456360291182da1898ba;Wed Feb 14 12:45:59 EST 2007;Committer;knu;2;16;8;24;0
b9084ef40826d53bfd3a09c926b6d1c0eaf1645e;Wed Feb 14 12:24:20 EST 2007;Committer;ko1;2;4;2;6;0
b1c1f4957f820b6599a074e9fdc4bc3cb28bbee3;Wed Feb 14 12:15:39 EST 2007;Committer;ko1;2;11;2;13;0
3044252bebc3e42530a6d90c7ef55c83e2f1ad74;Wed Feb 14 08:10:10 EST 2007;Committer;matz;2;15;10;25;0
3098d80818c9fbaa3b5ae392f7fad319e7a65323;Wed Feb 14 04:57:25 EST 2007;Committer;matz;4;42;11;53;0
f2586498f3bb38310f039e7532c034011e2aef82;Wed Feb 14 04:02:12 EST 2007;Committer;ko1;2;89;95;184;0
da06c63c66cd9901be498ab4a970332fbbeeceeb;Wed Feb 14 02:42:11 EST 2007;Committer;ko1;2;9;10;19;0
9895ce9f7706f1c941bee73ada4cb6ef2bd204b7;Wed Feb 14 02:19:02 EST 2007;Committer;ko1;4;26;10;36;0
9ba43ab6d48968eaced9b0452e6f6bd45ddee7fa;Wed Feb 14 00:08:45 EST 2007;Committer;matz;2;6;3;9;0
3e874eae07195440e6f8137f2f01084a6d3482a8;Tue Feb 13 23:44:26 EST 2007;Committer;matz;2;5;25;30;0
66a26a236701f88a0f9c9e71e2336043b2f976d6;Tue Feb 13 23:41:44 EST 2007;Committer;matz;2;30;20;50;0
bcbdd1f66014a682c0e6ba30a66aa27cc2ae6f92;Tue Feb 13 18:21:06 EST 2007;Committer;matz;2;12;2;14;0
1e41cf48858d68c335a34a7c68650160f6189693;Tue Feb 13 16:15:02 EST 2007;Committer;matz;2;6;1;7;0
76a27adfda7bd2c4c91b8d187f6921c0a87f096f;Tue Feb 13 15:31:18 EST 2007;Committer;matz;3;10;5;15;0
62815a50bced3770a53e46e2746ff47cd7d7fb9a;Tue Feb 13 06:20:51 EST 2007;Committer;eban;1;3;3;6;0
042f98830f97ada46e18a6fecd78b7cbe7a134db;Tue Feb 13 06:06:30 EST 2007;Committer;knu;2;7;0;7;0
fd81221a8e2c3a8c77599602fe38cd563d86191d;Mon Feb 12 23:01:19 EST 2007;Committer;shyouhei;81;13317;13317;26634;0
1a4b93cf920d0850061ce4b53351b4cdc7d464c7;Mon Feb 12 05:00:41 EST 2007;Committer;suke;2;33;2;35;0
4924197d1ce6c71d6e125a689d69a727fb8ee55d;Mon Feb 12 02:52:32 EST 2007;Committer;kou;5;26;6;32;0
777ad4ee755ceb534e13184a69b3ca82e86e9521;Sun Feb 11 13:45:57 EST 2007;Committer;suke;2;9;8;17;0
027eb16fca5addb840080b4b58b740b09eb865be;Sun Feb 11 13:12:16 EST 2007;Committer;kou;2;10;1;11;0
ef4273db33a68360d537aa8a0696e4c26b5f3002;Sun Feb 11 13:11:02 EST 2007;Committer;kou;2;6;1;7;0
70db47aadb2b353a46d7040e048534ad405bfb5b;Sun Feb 11 09:53:10 EST 2007;Committer;suke;3;106;97;203;0
8833abd5564896d0d49f1715c069f6753747ae4a;Sat Feb 10 22:46:37 EST 2007;Committer;knu;1;3;3;6;0
8b11e9e7781ce300c4bc0c2f31298219e9f64185;Sat Feb 10 22:46:08 EST 2007;Committer;knu;2;7;2;9;0
7634900b4e12f75bf34ef2c1dea878812df7734a;Sat Feb 10 11:29:49 EST 2007;Committer;suke;3;63;1;64;0
d274cf524ad0a8571d16f449301987af685a983d;Sat Feb 10 08:47:05 EST 2007;Committer;nobu;3;15;7;22;0
6ccbfd76a1f0948f1cff76bea4d8f54956c82c3a;Fri Feb 09 15:49:35 EST 2007;Committer;eban;1;3;3;6;0
1e37d92b0b0d97442a5bc0254ca2e818e70d8565;Fri Feb 09 15:30:32 EST 2007;Committer;nagai;2;7;2;9;0
a5abb1cb2199081dab0e8517ff6962517e389da0;Fri Feb 09 03:42:46 EST 2007;Committer;ko1;2;75;34;109;0
5ab816f7f7588f605299df7c545efb4545704a13;Fri Feb 09 02:07:34 EST 2007;Committer;ko1;2;5;5;10;0
a9026242f2292cc7df06628652f4254c55c37e22;Thu Feb 08 20:24:55 EST 2007;Committer;ko1;6;124;36;160;0
990ae267cdc73f954a3fa0b43135f2bbec9f76e8;Thu Feb 08 13:48:16 EST 2007;Committer;suke;3;100;23;123;0
eb6153b37d480222b034dd24dfe7212e46644078;Thu Feb 08 13:38:21 EST 2007;Committer;ko1;2;8;2;10;0
9e249508162c80974a815504cf96c78e240e3a42;Thu Feb 08 13:32:01 EST 2007;Committer;ko1;2;6;1;7;0
a0abd3c4b14f1387986fc87d273a305bb4bb16fa;Thu Feb 08 13:28:03 EST 2007;Committer;ko1;2;19;10;29;0
cff97cc9f0adbc40df8a05b5d3ce795f318bd489;Thu Feb 08 13:24:11 EST 2007;Committer;ko1;2;28;24;52;0
86846f0ee50d4cd2a8783bc414a6e7904a6ece4f;Thu Feb 08 13:03:54 EST 2007;Committer;ko1;2;6;2;8;0
dd4d9d63f08c78b9cffcdf106f6fa1e885774066;Thu Feb 08 13:00:06 EST 2007;Committer;suke;3;31;12;43;0
eb64061a384db53ca69dfdb1ab184a3b88d68f2d;Thu Feb 08 12:06:08 EST 2007;Committer;ko1;2;16;10;26;0
ae317b518c4dcbcbf0ed02bb9e6cd7513f0a34fe;Thu Feb 08 11:51:40 EST 2007;Committer;ko1;5;181;81;262;0
93b2cfbc4a5572f8f00cfda931fff543ab598c4a;Thu Feb 08 08:18:29 EST 2007;Committer;ko1;2;15;8;23;0
d592db9308fa8823e2d40f94cee8874b39c0dc65;Thu Feb 08 07:19:54 EST 2007;Committer;matz;2;12;5;17;0
ea2dd2e805fbaf1f5ee491397db9a16eb1d4dbe3;Thu Feb 08 06:48:34 EST 2007;Committer;ko1;3;26;12;38;0
9c574383a430c815406fb343e9adba18e348b5a3;Thu Feb 08 06:37:46 EST 2007;Committer;ko1;23;243;247;490;0
522f948a0ce5caaf3a44c06045a439c190d8f861;Wed Feb 07 14:25:47 EST 2007;Committer;nobu;2;4;2;6;0
ac6ed201bf2dd4792c0efae770c2ab12deac9d5c;Wed Feb 07 14:25:03 EST 2007;Committer;nobu;2;11;3;14;0
0eaefd202a7072aea6a17993c19c8704366ed9f7;Wed Feb 07 13:44:11 EST 2007;Committer;ko1;3;16;11;27;0
0b91bd56c2246f4a6dc313e0972a28074c68ecee;Wed Feb 07 13:38:29 EST 2007;Committer;ko1;3;4;73;77;0
4042176a9920b384d99152883fe6b7aed20d5827;Wed Feb 07 13:34:18 EST 2007;Committer;ko1;2;18;26;44;0
44aef0b53f3e73ec987a668a3284d5e28bdb8121;Wed Feb 07 01:25:05 EST 2007;Committer;ko1;25;294;370;664;0
8ee7d0767f7940baeae60ffa95afde93f3378c93;Tue Feb 06 19:00:03 EST 2007;Committer;ko1;34;822;814;1636;0
b1c6339b0c2d3288eab5c45cb86ecd30c9b0dc9d;Tue Feb 06 15:13:18 EST 2007;Committer;usa;1;3;3;6;0
47dae86617bad22722b809767ad5f102b4f56185;Tue Feb 06 15:08:59 EST 2007;Committer;naruse;3;236;91;327;0
8bc63849d5f2ba74098590a18b39234b04df0f68;Tue Feb 06 11:38:13 EST 2007;Committer;kou;3;8;3;11;0
cbcb626ee5110ccf752309683d04654e0a83585f;Tue Feb 06 11:33:50 EST 2007;Committer;kou;3;6;42;48;0
0d59cd79cc791047842a98d210b5a35267ba3602;Tue Feb 06 09:45:28 EST 2007;Committer;shugo;2;19;14;33;0
87861402065ac2f5f0578c897f28b4cb4409d75b;Tue Feb 06 07:41:30 EST 2007;Committer;ko1;2;53;47;100;0
979d021a8fa86ae02135397286c52b85989754c8;Tue Feb 06 07:02:55 EST 2007;Committer;matz;2;6;1;7;0
c27ef66dd7dc00fa22dce416dd2080f5da501a47;Tue Feb 06 06:50:40 EST 2007;Committer;ko1;3;28;1;29;0
42ce75cdff741d69927e407ac57b68dd58408111;Tue Feb 06 05:22:17 EST 2007;Committer;ko1;6;51;58;109;0
d4d5f27077dd356fb2bef031991864777cc54ef6;Tue Feb 06 02:19:01 EST 2007;Committer;shugo;2;19;0;19;0
46cceb5a741148766eadf60f57139123d396f6d6;Tue Feb 06 02:06:07 EST 2007;Committer;ko1;3;76;29;105;0
4102b12e1f763e6aae6a9eaa421ac84aa355a76c;Tue Feb 06 01:03:55 EST 2007;Committer;nobu;3;205;140;345;0
a4a81019653287291f88563964d482798da6221f;Mon Feb 05 18:50:35 EST 2007;Committer;ko1;3;234;216;450;0
0d70d8864359e6d8c410dd2727de618ba7cc3dc7;Mon Feb 05 18:31:08 EST 2007;Committer;ko1;2;29;45;74;0
27172b8e6fcd14f07fa5ea5be803cb04bde04559;Mon Feb 05 16:22:38 EST 2007;Committer;ko1;7;34;22;56;0
48002b881e49ff76f869e0f383fd5419cbca9af3;Mon Feb 05 12:28:38 EST 2007;Committer;ko1;2;5;0;5;0
025cfde57d14b12504595130cb1b222372881143;Mon Feb 05 12:21:01 EST 2007;Committer;ko1;13;576;877;1453;0
72f2d2a00d8ae3861a15ca92bf9322951a22b6cf;Sun Feb 04 19:17:33 EST 2007;Committer;matz;13;281;27;308;0
71364da03fcae2e0fb7b2641b6ac1e507ee03da6;Sun Feb 04 19:15:38 EST 2007;Committer;matz;4;16;11;27;0
cbee6e017de269d902e870d5f52d15df1a4dac2e;Sun Feb 04 19:12:52 EST 2007;Committer;matz;3;16;4;20;0
d9046f918d8c703ee2497fc630f37c738a461292;Sun Feb 04 11:36:12 EST 2007;Committer;kou;2;5;13;18;0
900ff1276f6f425c0a8c81bae08ccfef1c9569b0;Sat Feb 03 18:01:58 EST 2007;Committer;eban;1;3;3;6;0
48e30fa965c553fca6b092898da0070afbfd4f92;Sat Feb 03 17:24:13 EST 2007;Committer;knu;2;5;1;6;0
d4b866914bc76958f956eeb36c441968440668ee;Sat Feb 03 05:41:03 EST 2007;Committer;suke;5;234;192;426;0
e22d0bf7238edc56f0486a2241b42d906dad90cc;Fri Feb 02 18:35:40 EST 2007;Committer;nobu;2;12;9;21;0
fddaf76b679f083776634c9f9ed5f92077670f79;Fri Feb 02 18:23:07 EST 2007;Committer;nobu;6;32;4;36;0
f41d55aec886425b3e1577b0ca31e1c7b8a6b94b;Fri Feb 02 17:36:59 EST 2007;Committer;nobu;2;6;3;9;0
205f310c2963edec5fabebdce6aaae076d8af5fb;Fri Feb 02 16:26:04 EST 2007;Committer;nobu;29;186;204;390;0
d08112a656c4715d509f2b2ac7e1e2199068eed6;Fri Feb 02 15:50:11 EST 2007;Committer;nobu;2;5;1;6;0
497220616ab3eb07224bb612f0fb08eb3e7d3319;Fri Feb 02 15:24:35 EST 2007;Committer;eban;1;3;3;6;0
c1f5d2271974b3b36a472a3af3c2acd275c69a65;Fri Feb 02 15:21:41 EST 2007;Committer;nobu;17;2850;2850;5700;0
6cee897b59eafc2d8e2d4390f9f60f1e89e8733d;Fri Feb 02 14:41:50 EST 2007;Committer;matz;3;29;5;34;0
6e0fed271c1d2e6f2b13b99d89d43e7d00e81472;Fri Feb 02 13:19:44 EST 2007;Committer;matz;5;155;176;331;0
0abfa1c532bfa73eccdb5e8f05957c0935f5b1d9;Fri Feb 02 10:24:06 EST 2007;Committer;matz;5;9;9;18;0
d99bcbe583eb9f95022f8bcc51674cbdecf40d3b;Fri Feb 02 09:47:55 EST 2007;Committer;matz;3;52;23;75;0
e137ee9ac4019ca0002005ec6d3806c09797250d;Fri Feb 02 09:45:19 EST 2007;Committer;matz;2;5;1;6;0
fe8d1cfdfd50b5ea2116a2b0428fedc7f636dd15;Fri Feb 02 09:41:47 EST 2007;Committer;matz;4;9;6;15;0
aeec0f84457d2d5877ca5befaaf30b7e756953f6;Fri Feb 02 09:39:20 EST 2007;Committer;matz;2;7;2;9;0
0cd337b1f0a766294bd340d235b49664445eb28a;Fri Feb 02 09:32:28 EST 2007;Committer;matz;3;9;7;16;0
88ca8baef966f6f1cd754ea7dff857b857e6cc66;Wed Jan 31 06:10:06 EST 2007;Committer;matz;2;0;9;9;0
ff95fbdea88e010188809a25832ebf3b0ace4fa7;Wed Jan 31 05:54:42 EST 2007;Committer;matz;2;17;0;17;0
900546717ef0be7fcc991575e99659d9a9d11144;Wed Jan 31 05:47:33 EST 2007;Committer;matz;2;9;0;9;0
f5883fbe87ebb92cc65e9c71af433d704e8f0dc3;Wed Jan 31 05:43:47 EST 2007;Committer;eban;1;3;3;6;0
138052edb2dc20416f614972fba3fd6345bc4fc9;Wed Jan 31 05:37:31 EST 2007;Committer;nagai;1;12;37;49;0
2fc900dac88f5023afde41ad5a4f3d7f011f60a8;Tue Jan 30 08:02:30 EST 2007;Committer;usa;2;7;1;8;0
8418ea8bb86d5e205e3bc11c5d034e112418500e;Tue Jan 30 04:27:04 EST 2007;Committer;matz;2;26;0;26;0
bfc2a070b1c1d877dee7050bb5fa89ec56dabc12;Tue Jan 30 03:06:02 EST 2007;Committer;nobu;2;32;3;35;0
dbee7c9072aabc1ffafcd3343622d1e8f9b7ebe8;Mon Jan 29 19:56:28 EST 2007;Committer;nagai;1;1;1;2;0
c93ca8ee38683f0422ccbf0b66667ac26311d454;Mon Jan 29 15:42:23 EST 2007;Committer;eban;1;3;3;6;0
24b92a848cd707cb903f097fda97a4027ca2c928;Mon Jan 29 15:11:32 EST 2007;Committer;matz;2;7;3;10;0
883f34f7776b68f9c0090ce59f03923a5ee66fbe;Mon Jan 29 12:41:50 EST 2007;Committer;suke;4;178;21;199;0
024c694c9519cdeffdc410b137db87b33d41a0b3;Mon Jan 29 05:16:38 EST 2007;Committer;matz;3;9;4;13;0
f74039ec5148f8c2015a5846574c9b853959f785;Sun Jan 28 03:54:19 EST 2007;Committer;eban;1;3;3;6;0
7cc6cded594864ec6897a818b953c5a73fc85114;Sat Jan 27 23:46:27 EST 2007;Committer;suke;2;303;66;369;0
68daaab409c6b93423260756417756009cad38e6;Sat Jan 27 09:46:34 EST 2007;Committer;suke;3;102;81;183;0
c91a817032ce1933eb8ce50459c750951064efba;Fri Jan 26 15:09:43 EST 2007;Committer;eban;1;3;3;6;0
bb435c7a6c7519547c26ab708894d1357d35bcda;Fri Jan 26 15:03:43 EST 2007;Committer;suke;3;85;9;94;0
8c74a181614dca02ea416e5e338b57450967ee02;Fri Jan 26 03:18:45 EST 2007;Committer;nagai;11;47;17;64;0
369b098721cff440a9f962f30df869e5470a2675;Thu Jan 25 22:52:38 EST 2007;Committer;matz;3;24;3;27;0
df7c570713e7f59537348bfa91a13d0111c81d93;Wed Jan 24 11:35:52 EST 2007;Committer;kou;2;4;8;12;0
14476c3beaaac46e66507b48e9ed10b0f228df83;Wed Jan 24 09:09:51 EST 2007;Committer;matz;2;6;1;7;0
cd8e10d609e1a0a427d2500fc81ef7d49c02229e;Tue Jan 23 09:27:57 EST 2007;Committer;matz;2;6;1;7;0
b69642052686971d0694732ee02d742f11982deb;Tue Jan 23 06:41:22 EST 2007;Committer;usa;14;68;4;72;0
06720d45c74de5b0a000ebb04148623e4bb03fc2;Mon Jan 22 06:01:17 EST 2007;Committer;matz;3;10;5;15;0
0fe77cd26b04c652a0dae30f0f04980a324ea95d;Sat Jan 20 14:25:07 EST 2007;Committer;matz;2;64;0;64;0
3b5dbc4b0656a5a540fb1beff4748fa085e1fbf9;Sat Jan 20 12:12:36 EST 2007;Committer;suke;3;67;20;87;0
fa4bfa6af585589e4465831f1489fee83ce26f09;Sat Jan 20 03:56:02 EST 2007;Committer;ser;13;142;83;225;0
f700c1354f19ca5ad73f4e119dcbff493a3e6e00;Sat Jan 20 02:36:54 EST 2007;Committer;suke;1;1;1;2;0
e16e6a66ae0eb3630ae11c787d7f062945f93986;Sat Jan 20 02:28:49 EST 2007;Committer;suke;4;34;6;40;0
b44bd4c6d35a98e4e9fb2e49a7d6b600cf140baa;Sat Jan 20 00:37:35 EST 2007;Committer;suke;4;153;207;360;0
59835fe8650136364766d1a313fadab4f42c6b63;Fri Jan 19 15:17:56 EST 2007;Committer;suke;3;204;274;478;0
e538fe570388fb5b596f4799eed1eca6441c22dd;Fri Jan 19 08:22:45 EST 2007;Committer;suke;4;99;9;108;0
72cc74655f620c2cceaa5a46d33b72b51b9e676e;Thu Jan 18 22:08:29 EST 2007;Committer;suke;4;45;21;66;0
dbee678630736a5d873cde1f262bf2cfc87e8dfe;Wed Jan 17 08:48:52 EST 2007;Committer;ko1;13;1650;1686;3336;0
ca46eab09073c2d91bb21939b32aa6d767dafa36;Tue Jan 16 08:52:22 EST 2007;Committer;ko1;3;2461;2445;4906;0
5078c85782efc2d1245377d9a49c71eedd40c170;Tue Jan 16 08:50:13 EST 2007;Committer;ko1;2;5;1;6;0
63315f63054890397a19a1cbefe10166cb1768c8;Tue Jan 16 08:43:18 EST 2007;Committer;ko1;2;8;4;12;0
c22416a87fe3d4979ba698ba2d14a1cb4a98cdee;Tue Jan 16 03:14:26 EST 2007;Committer;ko1;2;4;90;94;0
7eb928624f84135634075ea575d6f10d759f2263;Tue Jan 16 03:06:01 EST 2007;Committer;ko1;6;72;63;135;0
d2907d42bea13a670d5fb52c32e8761fa57efff1;Sat Jan 13 14:40:54 EST 2007;Committer;suke;3;22;5;27;0
77619b3a566441daea5e9e50e1b82e9c002d25d3;Sat Jan 13 13:24:35 EST 2007;Committer;nobu;1;0;77;77;0
82e937f511eb61b1726ffdc57f71c2a067e31974;Tue Jan 09 15:11:01 EST 2007;Committer;nobu;3;15;8;23;0
42b298560b3ac5df01b139d6d4e9b91b0760c466;Tue Jan 09 11:52:26 EST 2007;Committer;shyouhei;3;19;18;37;0
61fbdef3496e6733ae73cc8432f06431fc9e5ac1;Tue Jan 09 08:50:04 EST 2007;Committer;usa;2;8;1;9;0
ef05955d2f1e8d6eeee8eff90f7ceabf89c0182f;Tue Jan 09 02:43:17 EST 2007;Committer;eban;1;3;3;6;0
0143945146dfd68e224ca7f1aa1c708094482e84;Mon Jan 08 20:11:40 EST 2007;Committer;matz;2;3;1;4;0
af040cb612f793ee86dacfadccdb1ad7fc4542db;Mon Jan 08 18:58:31 EST 2007;Committer;matz;2;6;1;7;0
fe6e7164249767d1ee80ea461a01449b4e61bc1c;Sun Jan 07 10:51:21 EST 2007;Committer;suke;1;0;294;294;0
84f8da11579b8b655505dc8abffc31c715784794;Sun Jan 07 09:47:52 EST 2007;Committer;ko1;5;61;22;83;0
4e4eec7016037f051a6d1173bb5829de9c4840c3;Sun Jan 07 09:36:30 EST 2007;Committer;ko1;3;12;4;16;0
b84ff5ccb390581242c34f67453802c34b97dcea;Sun Jan 07 08:56:04 EST 2007;Committer;suke;3;45;6;51;0
d9591028f28606a6e855088eb15538d1730f3918;Sun Jan 07 03:33:19 EST 2007;Committer;drbrain;3;165;3;168;0
d7dbd877ff890462fd138434d170094bf8fae638;Sun Jan 07 00:32:57 EST 2007;Committer;tadf;2;8;2;10;0
0ad41807a52bee0c7ab9d5734721488fedb54aaf;Sat Jan 06 09:47:19 EST 2007;Committer;nobu;2;182;146;328;0
ad4213d6feaa3f8c79b4c3de6753b11ae2d46a84;Sat Jan 06 04:48:11 EST 2007;Committer;ko1;3;16;1;17;0
52296cdee134593ec3a18c3420c7c6b7251c24f9;Sat Jan 06 04:44:56 EST 2007;Committer;ko1;2;13;9;22;0
c9c8cf3e50af27b857fae825f96923bdfb3207f8;Sat Jan 06 02:53:34 EST 2007;Committer;matz;2;5;1;6;0
ce55b4c0e0062cd59eb3d5e05ffc5d75bdcde85a;Sat Jan 06 00:24:59 EST 2007;Committer;ko1;7;138;12;150;0
a782fa12681c106fe6516955f72ec048bb27bbc9;Fri Jan 05 23:38:15 EST 2007;Committer;suke;3;12;1;13;0
384cfd3871c1839d0f167f9f4bf39ef3dcd42069;Fri Jan 05 18:54:33 EST 2007;Committer;ko1;4;34;34;68;0
d22d3b5a7a37bc2ff723fa5acc4ce2d85539d189;Fri Jan 05 13:52:16 EST 2007;Committer;ko1;7;80;254;334;0
c5a0c3be2e604e64ffa9cb77d758ac10eedecce9;Fri Jan 05 12:04:15 EST 2007;Committer;ko1;2;5;1;6;0
ed9d4087f6bcccf82f08de670942cf51c4a0a54c;Fri Jan 05 12:00:08 EST 2007;Committer;ko1;6;49;17;66;0
21e39197e6351aa786a555f7304cbb5b98b599ef;Fri Jan 05 11:51:52 EST 2007;Committer;ko1;2;6;1;7;0
91a0e26a5234cf5f98aacc802c8910279d9a8195;Fri Jan 05 11:29:25 EST 2007;Committer;ko1;2;12;0;12;0
716b91a5f72102483a56af9a3694531a30f9fd37;Fri Jan 05 11:22:25 EST 2007;Committer;ko1;2;6;0;6;0
20f8b25d1df4bfe1e7e23fbf3458f9742394b728;Fri Jan 05 07:02:48 EST 2007;Committer;ko1;2;5;1;6;0
d880d4382ffca5a9deb083ba0acc69dfa5f5d306;Fri Jan 05 05:24:48 EST 2007;Committer;ko1;2;7;3;10;0
c5bd0c8e3bf602e082cfd8f95bc28b06aeea2694;Fri Jan 05 03:43:12 EST 2007;Committer;ko1;4;98;53;151;0
f189294d04ba8c05a03964c622327369c0773829;Fri Jan 05 03:40:38 EST 2007;Committer;usa;1;3;3;6;0
76ddb7e7acfbef1b402e4e9bc83e85eee213d385;Fri Jan 05 03:33:40 EST 2007;Committer;gotoyuzo;2;8;0;8;0
3e5b3dac1f3b847161fa914f3e4cb3e85198c4a4;Thu Jan 04 11:30:37 EST 2007;Committer;ko1;4;137;150;287;0
31d815aacf57d5d61d9e04683c6c4b9a36a4fbee;Thu Jan 04 10:15:20 EST 2007;Committer;ko1;2;10;5;15;0
7cb6d7a2fead8b13bfed265b00a24f1af5f12ef1;Thu Jan 04 08:32:37 EST 2007;Committer;gotoyuzo;2;6;1;7;0
a7028afec0bc880372b7e6b307cbf05b2be6a540;Thu Jan 04 08:27:19 EST 2007;Committer;ko1;4;10;38;48;0
74909a2d68682e32a8e18f1ace26c5e6b913a170;Thu Jan 04 08:05:08 EST 2007;Committer;gotoyuzo;2;10;4;14;0
2589412b70b9a26a6af03c12fb562819051b9b0d;Thu Jan 04 04:54:30 EST 2007;Committer;eban;1;3;3;6;0
424eec36a63bfc3b35297f54bc3c3b5d671edae3;Thu Jan 04 04:47:59 EST 2007;Committer;ko1;2;8;7;15;0
26608663cd480f265ada34856aaebdcae133a222;Thu Jan 04 04:44:48 EST 2007;Committer;ko1;2;193;50;243;0
784dedc5f06db04b1fd51d30c126508061e05a50;Thu Jan 04 01:38:01 EST 2007;Committer;ko1;2;16;4;20;0
a7911f55a4fc59d8d460b15b5e19cc17f0d725d5;Thu Jan 04 01:32:37 EST 2007;Committer;ko1;2;5;1;6;0
1e46ba3439a25eb684cad2a0e4b1f5a15c762931;Wed Jan 03 10:29:36 EST 2007;Committer;eban;1;3;3;6;0
265aaee91cc9ebe9015df33c11176870a66bb9cd;Wed Jan 03 10:12:02 EST 2007;Committer;matz;2;9;2;11;0
16f70ed4ba2a094d77eada4532fe50dd4d4a2a8a;Wed Jan 03 04:03:47 EST 2007;Committer;matz;2;5;1;6;0
0ecf102274b446fe0b840635a3e05c17763688a8;Tue Jan 02 03:49:54 EST 2007;Committer;usa;1;3;3;6;0
0fe6b888c9180bfcd61815f2093b10e8e56aee6d;Tue Jan 02 01:31:36 EST 2007;Committer;drbrain;2;6;1;7;0
e7a993656c84c166278d9f6e77babd4aa6fd31c9;Sun Dec 31 23:12:35 EST 2006;Committer;ko1;2;47;41;88;0
939357f0d846c0b50cdd8db5258b42c90504cbd4;Sun Dec 31 23:09:46 EST 2006;Committer;ko1;2;13;3;16;0
47eea500020f55fddad93916de8a8079952a21db;Sun Dec 31 21:27:31 EST 2006;Committer;drbrain;2;112;92;204;0
3443bacdc8bc2ff01f3f2851f3ce8266e0f4f0ac;Sun Dec 31 21:15:44 EST 2006;Committer;drbrain;2;48;25;73;0
4e6f681b40d237c70671c6b3e831a9ad1e7fb26d;Sun Dec 31 21:13:27 EST 2006;Committer;drbrain;3;184;3;187;0
a3e1b1ce7ed7e7ffac23015fc2fde56511b30681;Sun Dec 31 15:02:22 EST 2006;Committer;ko1;233;47359;15008;62367;0
3e7566d8fb5138bb9cd647e5fdefc54fc9803509;Sun Dec 31 07:24:56 EST 2006;Committer;drbrain;2;7;1;8;0
dcf4a0a1f699b9094b6f900b47efe5cfaf077981;Sat Dec 30 15:49:29 EST 2006;Committer;tadf;3;4;6;10;0
b58aef095a53fe47107c0e5460a827f1fc17508b;Sat Dec 30 15:36:41 EST 2006;Committer;eban;1;3;3;6;0
7290b6925c43db94330056074e132d56c7635a25;Sat Dec 30 15:27:01 EST 2006;Committer;tadf;3;585;549;1134;0
5ba025477764bb87251894ebec5c62780f8ebb65;Fri Dec 29 19:49:23 EST 2006;Committer;matz;2;48;15;63;0
873b2f9fe3672f9006f0b73c96a103d73bac7092;Fri Dec 29 19:27:27 EST 2006;Committer;matz;2;20;10;30;0
465fa424f00c8d8b6db61a3612a7d53bf39e233a;Fri Dec 29 19:25:11 EST 2006;Committer;matz;2;153;60;213;0
424f8ec44fa2ee315f72c1f9384d0c8a4796f8ac;Fri Dec 29 19:21:50 EST 2006;Committer;matz;4;198;110;308;0
0d2e0eb6cbc536a32c370b10d3666d2eefb066a4;Thu Dec 28 06:36:14 EST 2006;Committer;eban;1;3;3;6;0
703532aa1c71addb3640d597c86f17c4e7feeb48;Thu Dec 28 06:34:02 EST 2006;Committer;matz;3;16;8;24;0
a77bb6b7a761ed7cab8e615284ef7344a571b8f4;Wed Dec 27 12:25:09 EST 2006;Committer;eban;1;3;3;6;0
c6defdfa80221df1824bdfebcbe1dd05ad57d6b9;Wed Dec 27 12:00:54 EST 2006;Committer;suke;3;15;72;87;0
0aa4340d81c673bdf093c3a3691dea28bda82bd5;Tue Dec 26 12:09:57 EST 2006;Committer;suke;2;14;6;20;0
a17e7d92a2d7791094d76d57dd43f1305f321eca;Tue Dec 26 06:37:14 EST 2006;Committer;eban;1;3;3;6;0
618b9c5fec823c5d4acbb8cdc90f76782240dcd2;Mon Dec 25 21:14:25 EST 2006;Committer;aamine;2;5;12;17;0
219fafd4d2654ba54d4c0164871ee61262b4b210;Fri Dec 22 00:13:57 EST 2006;Committer;usa;1;3;3;6;0
2126364501dc332f18b9679c47fc2f855f9d5849;Thu Dec 21 16:47:01 EST 2006;Committer;matz;2;6;1;7;0
2b38c2e0fbd96eb4f0049dfb6c4f923ba84bd33d;Thu Dec 21 16:41:17 EST 2006;Committer;matz;2;6;4;10;0
3d519d2d602d21a0bd4364d5d3be0c472ab4be5b;Thu Dec 21 16:36:31 EST 2006;Committer;matz;2;6;1;7;0
eb7b81158a21798a49110bcb673205e680a12852;Thu Dec 21 15:38:39 EST 2006;Committer;nobu;0;0;0;0;0
17a6c41e4358b8ee6b0dff4761591a0ffd6fa2f4;Thu Dec 21 06:59:03 EST 2006;Committer;usa;0;0;0;0;0
5bcb3797cb1a56a035fe5842ad36796e150a9009;Wed Dec 20 04:04:54 EST 2006;Committer;matz;1;3;3;6;0
21db43bfe70b597bda21fc6f65c7933087f8aa18;Wed Dec 20 03:56:25 EST 2006;Committer;ko1;1;4;0;4;0
51172af82be3fa435cf9bbbd19d5e3e4c461e7e7;Sun Dec 17 23:37:49 EST 2006;Committer;matz;2;6;1;7;0
3fe65950265b4c598b8a0f2cdd9b5aed9b4c9c86;Sun Dec 17 23:37:45 EST 2006;Committer;matz;1;3;3;6;0
66c4ad19cf8c9db4f1e8afe8b66e88dfa43ae740;Fri Dec 15 13:39:12 EST 2006;Committer;nobu;1;1;1;2;0
d63cf3fa2a6800f4a5e57f8ed8017651c226921a;Thu Dec 14 15:20:14 EST 2006;Committer;nobu;2;7;3;10;0
4409259c939e3dc56c151b8486a901d24d81d8b1;Thu Dec 14 15:07:53 EST 2006;Committer;nobu;2;5;1;6;0
a6563ee8c7d72064e843d009d0c9d81ac041e97b;Thu Dec 14 15:07:49 EST 2006;Committer;nobu;1;3;3;6;0
460d84633f6c6feca75989e7c97367cd293d8e00;Thu Dec 14 09:41:37 EST 2006;Committer;matz;3;13;0;13;0
c89e82837f9b30705088835170951de8e3834aff;Thu Dec 14 09:27:36 EST 2006;Committer;matz;2;6;1;7;0
1275a05824f5655a40befabf7dc7e4dffe26f7c1;Thu Dec 14 09:27:32 EST 2006;Committer;matz;1;3;3;6;0
aea5a17fc4de4cceb9189a558c172321989d1a4e;Tue Dec 12 14:34:26 EST 2006;Committer;nobu;2;7;3;10;0
2b38044b26c1918d1f2d40aeb5cd6b141ecdcdc8;Tue Dec 12 14:34:22 EST 2006;Committer;nobu;1;3;3;6;0
33b2ccf041cd584230c48e59218d44b45bd95dc3;Mon Dec 11 02:59:43 EST 2006;Committer;knu;3;78;73;151;0
5ea3e44fa29a3b7f91c79ea1482df3925f23d9c6;Mon Dec 11 02:49:37 EST 2006;Committer;matz;2;5;1;6;0
d3b50bf9dc1edc93e20cd13f32da2b3a532619dd;Mon Dec 11 00:45:35 EST 2006;Committer;matz;1;3;3;6;0
f70c171f8c8198b54d08d0c09b594a512d4997ae;Mon Dec 11 00:45:32 EST 2006;Committer;matz;2;6;1;7;0
a7784d0048ba71bb619286b3256d88d35655c254;Sat Dec 09 12:40:17 EST 2006;Committer;nobu;2;5;1;6;0
2bd4f109f4fa5c6024056b03e0583d8dcc88c068;Sat Dec 09 02:31:08 EST 2006;Committer;matz;1;2;1;3;0
6a37ae2f9dbe373f1536bc212df94327a130ab2f;Sat Dec 09 02:26:19 EST 2006;Committer;matz;2;7;2;9;0
d88c0d1c93277f66fa7211b992fa9383718465c4;Sat Dec 09 02:26:06 EST 2006;Committer;matz;1;3;3;6;0
f1b36f299793d8a64b6af26468e2ffff9b3700dc;Fri Dec 08 09:13:04 EST 2006;Committer;usa;2;10;9;19;0
1636105e7413d8f2c8b91f9c899d879acdc9464a;Fri Dec 08 08:01:06 EST 2006;Committer;usa;2;5;1;6;0
7c964185267d8d2252e2e13eb46a11af5907b0a2;Thu Dec 07 15:18:14 EST 2006;Committer;matz;4;109;74;183;0
dc859c017d45b204533e7491a193c0d4cb1fa5ad;Thu Dec 07 15:17:14 EST 2006;Committer;matz;3;19;15;34;0
e03d9621a6fd80d9fe4b9cb56c495c0cfc0603ce;Thu Dec 07 15:17:10 EST 2006;Committer;matz;1;3;3;6;0
4abaf3a579a3fd4a748dcaef83f3a2912db48c23;Wed Dec 06 14:58:46 EST 2006;Committer;nobu;2;16;4;20;0
24f3250be10d111b2f9455bb21245caf23938f1f;Wed Dec 06 14:57:07 EST 2006;Committer;nobu;3;6;1;7;0
4c35d6720f828574027f92f55a228d70a7dc57f8;Wed Dec 06 14:56:32 EST 2006;Committer;nobu;1;3;3;6;0
ff48018c280d2b14151f220a84c9be1280ec0065;Tue Dec 05 10:04:19 EST 2006;Committer;eban;2;6;1;7;0
bf74ef51a2b0f42bb0148b811a7ec8054ee7b20c;Tue Dec 05 09:59:45 EST 2006;Committer;matz;2;9;0;9;0
cd3a5e2bb257ad23af9a10338314cb8cdb09f965;Tue Dec 05 09:56:18 EST 2006;Committer;matz;2;7;2;9;0
3acd34fd646439913e7745660d2e752e96081cee;Mon Dec 04 15:19:36 EST 2006;Committer;nobu;1;3;3;6;0
f4aca06c84eb57e1b7048e5c28daa03f39258ddc;Mon Dec 04 15:19:33 EST 2006;Committer;nobu;5;40;10;50;0
8d69c7f116d8f9053c91d86f437d6bccf4ab4a7b;Mon Dec 04 14:49:47 EST 2006;Committer;nobu;3;18;11;29;0
ce6af3e8a0f9add5e5ef4e5567af3eb74ba4a5d2;Mon Dec 04 10:27:28 EST 2006;Committer;knu;2;5;0;5;0
4df88e463d1aead09915453a45d35ae88bc268b0;Mon Dec 04 08:06:32 EST 2006;Committer;matz;2;7;0;7;0
6b279c3d0941b72ead04ed660de0a8d3462a93c4;Sun Dec 03 23:35:45 EST 2006;Committer;shugo;2;8;2;10;0
5ce38775ba8d9a5fc0386e80170c32416304c5ed;Sun Dec 03 23:35:32 EST 2006;Committer;shugo;1;3;3;6;0
d65ee2e9f891482223bc862ca9ae7eb20e378c71;Sun Dec 03 07:54:10 EST 2006;Committer;knu;1;5;0;5;0
16df52eb40f2fb29ca306f59de549e95e48d73c2;Sun Dec 03 07:54:08 EST 2006;Committer;knu;1;3;3;6;0
bd2df89b142c3a43b0f0e082a21dc7672e415b9d;Sun Dec 03 07:36:06 EST 2006;Committer;knu;1;6;2;8;0
b326623cef742e63a076abcab010b6e2fea977a3;Fri Dec 01 22:38:47 EST 2006;Committer;gotoyuzo;2;14;3;17;0
38093bc1299653d4fa8d012f930f99525aab41dd;Fri Dec 01 22:11:51 EST 2006;Committer;gotoyuzo;2;6;1;7;0
542d9e97fc4872e679617daa4212f08fb50f7c81;Fri Dec 01 22:11:37 EST 2006;Committer;gotoyuzo;1;3;3;6;0
938d00b54ba5c121909291a1edd07e066fa5601f;Fri Dec 01 07:43:05 EST 2006;Committer;nagai;2;33;13;46;0
e546b71285f03b94d21d60bb5de6a507ed3fd9e3;Fri Dec 01 07:41:55 EST 2006;Committer;nagai;1;4;4;8;0
3eb1250575b095dcb28ba28f8088c1c617765f26;Sun Nov 26 09:57:00 EST 2006;Committer;eban;1;2;2;4;0
b9d64f433b694cf1f88c828cb69ddbe3886f8996;Sun Nov 26 09:34:32 EST 2006;Committer;shyouhei;3;11;2;13;0
0d9c33d14be362e51eb189472351a1f78299b4b9;Wed Nov 22 08:37:12 EST 2006;Committer;matz;2;22;0;22;0
5dd8f6e20cb982a5598f3f8977d844b17cf2e6b8;Wed Nov 22 08:37:11 EST 2006;Committer;matz;2;9;4;13;0
c97ed5ef9a33f40940a2546e5d6cd7f8d34ae878;Wed Nov 22 07:06:11 EST 2006;Committer;nagai;4;32;3;35;0
135a96accc80519ec5933b48b37d7065be6c4d90;Wed Nov 22 07:06:07 EST 2006;Committer;nagai;1;3;3;6;0
bd580c48556e509aee516e1fc051fd6044650f2c;Tue Nov 07 09:38:12 EST 2006;Committer;matz;2;10;10;20;0
ce99fd222e6dca8482cb2dba0956d6061afd6763;Tue Nov 07 09:13:40 EST 2006;Committer;nagai;1;1;1;2;0
32c61a1b59643560df5de45b57903e3a9627ab00;Tue Nov 07 09:11:38 EST 2006;Committer;nagai;6;86;33;119;0
6f1c934bc361ec5d01a0b4b1a45d07840af02dc3;Tue Nov 07 08:56:18 EST 2006;Committer;matz;4;28;5;33;0
568602aeeaa1636a8f74dcf967e15ebd0e843da7;Tue Nov 07 08:51:15 EST 2006;Committer;matz;2;11;4;15;0
84ad9c0a26c7046f5074b2a9a3f8ffabd1542dc8;Tue Nov 07 07:46:00 EST 2006;Committer;matz;1;3;3;6;0
f54e979d36e226fb2f9aca78efddd46422ce25f1;Tue Nov 07 07:45:57 EST 2006;Committer;matz;2;10;2;12;0
0ee03fefad15b93f5320b5270aaf03d518969708;Mon Nov 06 13:24:57 EST 2006;Committer;matz;2;5;1;6;0
862e723d03878cd7a3b2ad72cb99302084db8a71;Mon Nov 06 10:27:59 EST 2006;Committer;matz;4;68;33;101;0
2ec88c167b2dd0e3c13a77dadb9518f8d06d0c59;Mon Nov 06 06:56:37 EST 2006;Committer;nagai;10;1676;190;1866;0
ced53248ff41863ef7adf62db215380d5089bc24;Mon Nov 06 06:37:43 EST 2006;Committer;matz;1;3;3;6;0
6d32246b31a698dfe22ed64ed478ea40683bb330;Mon Nov 06 06:37:40 EST 2006;Committer;matz;3;6;1;7;0
d304aa6382747bc2c5094c9d3081f6e8260e5d96;Sun Nov 05 10:55:20 EST 2006;Committer;tadf;2;39;9;48;0
c676ed3b4d21189da6eda643f942fb37faf4c010;Sun Nov 05 10:55:07 EST 2006;Committer;tadf;1;3;3;6;0
ffdb9dc6bd9b621330be9f97f2e7295b5bae5a24;Sat Nov 04 04:13:34 EST 2006;Committer;shugo;2;5;1;6;0
8625520d4c861fc56f648c2fbe31f76447bb05a4;Sat Nov 04 04:13:29 EST 2006;Committer;shugo;1;3;3;6;0
66b90161cfe1743247e87c1534621c4bbdf4df54;Thu Nov 02 15:38:59 EST 2006;Committer;matz;3;38;0;38;0
63c55ef265475b1c150f82f61e0f6e9d7b0a27f6;Thu Nov 02 15:38:55 EST 2006;Committer;matz;1;3;3;6;0
7571fd71b4813f79541b807a3b96596efd35493b;Thu Nov 02 13:27:56 EST 2006;Committer;matz;1;1;1;2;0
12f9e1b64d2044031bed427ebffd6d225d05fc22;Thu Nov 02 05:45:12 EST 2006;Committer;knu;2;14;2;16;0
8368499bcc29deb64e0dc5582d75ea315fb02c31;Thu Nov 02 04:45:12 EST 2006;Committer;matz;1;2;2;4;0
07c4bb10e093f1d296c92492d7340fec090b7bf3;Thu Nov 02 04:44:52 EST 2006;Committer;matz;2;10;1;11;0
030204ccf377c510fc6c08b8b86f72b1db5b017c;Thu Nov 02 01:27:58 EST 2006;Committer;matz;2;61;1;62;0
84e2f5268a4844d7999a9424c7f6a94fd4a68cb7;Thu Nov 02 00:21:28 EST 2006;Committer;matz;10;37;21;58;0
92ca42cb3e2fcfcee94a1f9718fcf94a9b31d947;Thu Nov 02 00:20:00 EST 2006;Committer;matz;1;3;3;6;0
eca2b4b0682d40048af38f339fb9c1b414e68f4e;Thu Nov 02 00:19:57 EST 2006;Committer;matz;2;24;91;115;0
15df557a4d843f0c2882d710f3e2ccbcf2360d1a;Wed Nov 01 14:42:39 EST 2006;Committer;matz;4;114;207;321;0
11e562f34afff4d657da12e85f959200207d6bd5;Wed Nov 01 14:23:42 EST 2006;Committer;matz;2;118;88;206;0
dd937ba9dce30fb761da032ffda03f8b08c35e6e;Wed Nov 01 05:01:43 EST 2006;Committer;knu;3;14;5;19;0
70aa19b6c6498c3b609b4788cf50a848cb77a354;Wed Nov 01 04:57:01 EST 2006;Committer;knu;1;4;4;8;0
0f519375ab0fe774ccbca66104fe6234709cd466;Tue Oct 31 08:08:46 EST 2006;Committer;matz;3;14;6;20;0
d9ec86f41017e2adeae4fa087fca88593bfa1a6b;Tue Oct 31 07:28:41 EST 2006;Committer;matz;1;3;3;6;0
7ab214d982d208b6578f599b2477664e67fc39f4;Tue Oct 31 07:28:37 EST 2006;Committer;matz;2;6;0;6;0
491a7ee7a662b4a8dddaaf850f58798b16bbe3b8;Mon Oct 30 14:41:43 EST 2006;Committer;nobu;3;19;14;33;0
66d43b5fd6f97289b907f60be52246f8abc82b4b;Mon Oct 30 14:23:46 EST 2006;Committer;nobu;3;108;30;138;0
3679754a95df33dd576cf9f81ae2ef70a84a6649;Mon Oct 30 10:31:01 EST 2006;Committer;usa;2;6;2;8;0
e9f4ae6f0e24b2386127e5b848dbc7365be6d989;Mon Oct 30 09:40:24 EST 2006;Committer;matz;1;2;2;4;0
7e69efba5e69527ea028dc8c7b702d13d411ebc1;Mon Oct 30 09:37:52 EST 2006;Committer;matz;2;6;1;7;0
5ece4a8da55ff22976e4dd415362247f342512ef;Mon Oct 30 03:40:11 EST 2006;Committer;matz;2;5;1;6;0
0b77f586bb3a0f654ccb34abd1938250600574da;Mon Oct 30 03:39:47 EST 2006;Committer;matz;1;3;3;6;0
6e62aeb9bc0a1abf50e107a909370ef461d157f5;Mon Oct 30 03:39:44 EST 2006;Committer;matz;4;31;13;44;0
ab984108d7f37ecd70e7d51b819a2f996d3ec834;Sun Oct 29 10:55:27 EST 2006;Committer;kosako;3;9;4;13;0
92d805753bf9264d35bb6ac44a740f71898654ab;Sat Oct 28 11:15:41 EDT 2006;Committer;kosako;7;97;26;123;0
972cb0fb5b18349a8dbae1d56f1819a20304a00e;Fri Oct 27 22:57:22 EDT 2006;Committer;matz;1;3;3;6;0
1b8d6cea5a60077bbcde1486af6c8e9fbec43e1b;Fri Oct 27 22:57:19 EDT 2006;Committer;matz;2;5;0;5;0
2c82a6a65b6c929072a000bd1cd6876e9316cfed;Fri Oct 27 08:31:13 EDT 2006;Committer;matz;1;3;3;6;0
833551800d494276c1da7d1c471733c4ccd061b7;Fri Oct 27 08:31:10 EDT 2006;Committer;matz;2;6;1;7;0
270ba8d81e79d18d212517cee9094670656706ff;Thu Oct 26 12:06:39 EDT 2006;Committer;gotoyuzo;3;10;0;10;0
d4b775fe45120af2bbc7e52a6cd4187460ee3bcc;Thu Oct 26 06:24:32 EDT 2006;Committer;matz;2;10;67;77;0
d94124b80f2e818b2267143e6b9d14f3ad60932a;Thu Oct 26 06:15:57 EDT 2006;Committer;usa;2;5;1;6;0
1d214f8087909eaa4b7f574202c28875bbb463cd;Thu Oct 26 06:15:53 EDT 2006;Committer;usa;1;3;3;6;0
541ecc66d86f6f5158da29f4db39596e9b010aa3;Wed Oct 25 08:16:48 EDT 2006;Committer;knu;2;7;0;7;0
5038db866f9aadca2cac36ec61fa9176521a31c8;Wed Oct 25 07:35:45 EDT 2006;Committer;knu;2;5;4;9;0
805e130d20dd3f776f809836cbd251417ed6d382;Wed Oct 25 00:21:54 EDT 2006;Committer;matz;2;70;0;70;0
f1e4b10a84d43ec15424f86a692957f3f94cb860;Wed Oct 25 00:21:22 EDT 2006;Committer;matz;2;10;43;53;0
6adef5abe5c37f5b3626383b12d569df78a0c3df;Wed Oct 25 00:11:16 EDT 2006;Committer;matz;2;5;0;5;0
a95d67ebf754728986f2506ea507be14dd4d24a4;Tue Oct 24 23:04:52 EDT 2006;Committer;tadf;2;10;5;15;0
e32943363088035c04b63b54cbe5179c4f5cd527;Tue Oct 24 15:58:51 EDT 2006;Committer;nobu;3;7;5;12;0
23a68ff2ff8264faef9ad22679e91caf6e76b78b;Tue Oct 24 15:58:46 EDT 2006;Committer;nobu;1;3;3;6;0
e0dc7383125bcaa0faffede10c7f2f78110cdb83;Sun Oct 22 22:27:58 EDT 2006;Committer;matz;1;1;1;2;0
a4045e27b413aa096df19ac3547b61bc9bd34cf5;Sun Oct 22 22:24:14 EDT 2006;Committer;matz;2;32;23;55;0
7365e8064592dc42d75bbe701adbe5caca90e55c;Sun Oct 22 22:23:15 EDT 2006;Committer;matz;1;0;5;5;0
12d0578dcc56d59d82a0cfaed5235055cd3f3eeb;Sun Oct 22 19:28:46 EDT 2006;Committer;matz;1;5;0;5;0
0184f73bc8f0160d4f42755209868a53d2ded02e;Sun Oct 22 19:09:11 EDT 2006;Committer;matz;1;3;3;6;0
8c1f64eaddfe9817f895cb4e99bfecd50f061b8d;Sun Oct 22 19:09:08 EDT 2006;Committer;matz;2;16;1;17;0
65aa6b9a51021d30f106191f6747eccb20e9f579;Sun Oct 22 08:07:12 EDT 2006;Committer;matz;2;7;3;10;0
be21791e57c1779933696f26968d1562e6cf2218;Sun Oct 22 08:06:16 EDT 2006;Committer;matz;2;15;0;15;0
899b4a3e0c57a7a4b11d7822ed41874f8767d2bc;Sun Oct 22 07:48:56 EDT 2006;Committer;nobu;1;3;3;6;0
13661316426b677dd08438a983463b0218b154af;Sun Oct 22 07:48:53 EDT 2006;Committer;nobu;2;15;4;19;0
0c80ce785d85482d574b5a212218034a6ec12397;Sat Oct 21 08:52:09 EDT 2006;Committer;knu;2;16;5;21;0
d754c11644e9849f004a321e99519f696f90498d;Sat Oct 21 08:52:05 EDT 2006;Committer;knu;1;3;3;6;0
670887f5f697c57a61fa837d4cf505d3d18a0bc6;Fri Oct 20 13:01:55 EDT 2006;Committer;knu;3;16;9;25;0
b2c7fe1bbffe9e5fe741b7dd3725017b55250c1e;Fri Oct 20 12:48:35 EDT 2006;Committer;knu;13;595;404;999;0
03f19e27ed9dc0b0110dce0108626d414e00fca2;Fri Oct 20 02:33:49 EDT 2006;Committer;eban;2;5;2;7;0
40fc1a802516f5cd51d9bf741528bc06d3330c5f;Thu Oct 19 23:44:00 EDT 2006;Committer;nobu;3;26;6;32;0
96117996a0996df65e02984d17f396687f184f17;Thu Oct 19 16:03:45 EDT 2006;Committer;nobu;1;7;5;12;0
bbb0bf8049b2c65790177af415f02f886b1ed20f;Thu Oct 19 15:38:31 EDT 2006;Committer;nobu;3;16;2;18;0
105712fe42496689a7565769d2291917cb858c72;Thu Oct 19 15:38:18 EDT 2006;Committer;nobu;1;3;3;6;0
450fc7bb5706d63834807790f9f779393f5ad0c1;Wed Oct 18 14:03:43 EDT 2006;Committer;nobu;2;14;5;19;0
e18aabc7dbea54420435d3d6639f23805ce6ce76;Wed Oct 18 13:59:19 EDT 2006;Committer;nobu;2;6;1;7;0
6da8a20bb7f7898c35e5be9ad7641f024d3dfa1b;Wed Oct 18 13:57:43 EDT 2006;Committer;nobu;2;5;1;6;0
f87431ce95461ce9552146cef2a1845db477b968;Wed Oct 18 04:30:40 EDT 2006;Committer;matz;2;28;25;53;0
fd4b559c95d4b3c36b4ab1724f6d7e9cf61d72b0;Wed Oct 18 04:29:44 EDT 2006;Committer;matz;2;6;0;6;0
d8b77db1ae0d84bf636d4059c118727f331f01dd;Tue Oct 17 15:56:32 EDT 2006;Committer;nobu;1;3;3;6;0
c85347f8b185db92452277e739f4b65c91404b97;Tue Oct 17 15:56:28 EDT 2006;Committer;nobu;2;6;2;8;0
2f32af52c4a03ed483690bab660b65a8237abedd;Tue Oct 17 13:03:24 EDT 2006;Committer;aamine;2;7;3;10;0
1fe4c7af5bedf6d517a11bc3c21cbb7cb16d3865;Mon Oct 16 23:07:10 EDT 2006;Committer;matz;1;3;3;6;0
24691fa633a71d5ea831e23b83886a1ce6ef0117;Mon Oct 16 23:07:07 EDT 2006;Committer;matz;3;44;4;48;0
58c0100a779a354cd53a53cf1c2fbc6cfc88240f;Mon Oct 16 14:35:51 EDT 2006;Committer;matz;3;50;38;88;0
eb2661510da89086de52f185d19289831332e692;Sun Oct 15 23:32:12 EDT 2006;Committer;nobu;6;13;6;19;0
2ff7e8fb74ee15627e77072688a03c5548b92001;Sun Oct 15 22:57:40 EDT 2006;Committer;matz;1;3;3;6;0
eb68fb0c58a435b06e01f574cafcaf8150f54aeb;Sun Oct 15 22:57:37 EDT 2006;Committer;matz;2;51;37;88;0
499d04674c64e71afd7350648803513d183d1afe;Sat Oct 14 16:04:16 EDT 2006;Committer;nobu;2;11;2;13;0
1b4f46a7f02517374e4a995e54f0e7428a506014;Sat Oct 14 16:04:02 EDT 2006;Committer;nobu;1;3;3;6;0
c6effd018238a263f32f5c1ec854e506fc5f2779;Sat Oct 14 14:46:16 EDT 2006;Committer;matz;2;7;7;14;0
41f3f0eb66c306d33c7c59c7ca4b199416be8196;Sat Oct 14 14:33:10 EDT 2006;Committer;matz;6;24;10;34;0
9c0cb98f28e4cebd6aa6def1785e047605c850e5;Fri Oct 13 23:34:05 EDT 2006;Committer;knu;1;2;2;4;0
d87fc2bdd418fb71718375f3acb45a026a1352fa;Fri Oct 13 23:23:18 EDT 2006;Committer;knu;8;207;62;269;0
694b2c7a29dc8e0f468053cafe85df7c63b20580;Fri Oct 13 20:55:33 EDT 2006;Committer;knu;2;17;2;19;0
bf8cd1e929d3f1ad2c1a6aefda9da08ebdc11d05;Fri Oct 13 19:40:01 EDT 2006;Committer;knu;3;55;21;76;0
703d2d1612beb26a7449566f8d6c1f868865fc46;Fri Oct 13 19:08:11 EDT 2006;Committer;knu;1;4;0;4;0
5a82e540790870f33e1120aa9396b67d6d4382df;Fri Oct 13 15:56:48 EDT 2006;Committer;nobu;3;21;5;26;0
17435a4e5a9beb3f5c3ae16e7587c08f5fc3c3f9;Fri Oct 13 15:56:44 EDT 2006;Committer;nobu;1;3;3;6;0
a9530990074419ad528c15f00ed3cde10aea509b;Fri Oct 13 14:48:51 EDT 2006;Committer;tadf;1;1;0;1;0
2361ebc2f270c344cead445c4c22cddb43ae92fc;Fri Oct 13 14:09:40 EDT 2006;Committer;nobu;1;3375;3375;6750;0
c454e4ee04258ff882fdeeb46110c3898b5e2d88;Fri Oct 13 13:51:43 EDT 2006;Committer;tadf;2;5;1;6;0
ea194ce47701e0c7e86caaba765d560660e35780;Fri Oct 13 13:44:26 EDT 2006;Committer;nobu;1;3401;3401;6802;0
3a4ce48c7502afbfd9303b31ada124e892a249fb;Fri Oct 13 12:02:32 EDT 2006;Committer;knu;2;23;3;26;0
f678390e1f7e2e8556b160202a482baa64d67f9d;Fri Oct 13 11:58:05 EDT 2006;Committer;knu;3;11;14;25;0
5cafaa674431aeb3bdddca88867372adbc1dbc9c;Fri Oct 13 11:52:18 EDT 2006;Committer;knu;8;98;243;341;0
2125aafc273147f183925556f1ee28b6568fd512;Fri Oct 13 11:46:03 EDT 2006;Committer;knu;4;145;76;221;0
b9dea008c7bea3457108875a306aee5508c3452e;Fri Oct 13 10:55:51 EDT 2006;Committer;knu;2;7;1;8;0
3873d0fba36db7aa8d6a0b57e1dd1f1df1fa4e46;Fri Oct 13 09:25:15 EDT 2006;Committer;matz;2;33;1;34;0
53b4c90110c78fa8b9560b81ededa01f48bed72d;Thu Oct 12 17:43:17 EDT 2006;Committer;knu;2;8;3;11;0
272560359a3ec52a00de51b5c8d01fe72d44348d;Thu Oct 12 17:31:15 EDT 2006;Committer;nobu;3;39;7;46;0
d947750eb067f092c90122366a1ee57d2c8fc808;Thu Oct 12 16:51:14 EDT 2006;Committer;matz;2;6;1;7;0
7df8b0501a9913aae81d565e3441395348ab3b36;Thu Oct 12 16:07:21 EDT 2006;Committer;matz;3;10;6;16;0
e478cd7c116fb4d1afd6851eb3693b6dade98b5e;Thu Oct 12 15:39:21 EDT 2006;Committer;matz;1;3;3;6;0
1115039a0b84df3c08e3db4de9b1210a3e058a19;Thu Oct 12 15:39:19 EDT 2006;Committer;matz;2;13;4;17;0
f6bf2b3746135a8e099b226fc7a1744ebdc3337d;Thu Oct 12 14:05:17 EDT 2006;Committer;matz;2;14;9;23;0
f8a90f1c0cee7c67e436b0b55b664ac72a1c2aa4;Thu Oct 12 09:28:28 EDT 2006;Committer;matz;3;11;3;14;0
e85f3debc4ef72fbe812b90ae3c74237814f3ef2;Wed Oct 11 18:21:35 EDT 2006;Committer;knu;1;3;2;5;0
23913850609716cad2f43be9e84bddef6fc0f948;Wed Oct 11 17:16:27 EDT 2006;Committer;knu;2;5;7;12;0
9b81e26df274eb430e66a43408d8e76165e61c3d;Wed Oct 11 17:14:54 EDT 2006;Committer;knu;6;25;10;35;0
a0d758f8247582bdd46258ca1e240869fb42a9e9;Wed Oct 11 17:14:48 EDT 2006;Committer;knu;1;3;3;6;0
945a76d97b00f9c0d24b6d14da86b18284316000;Wed Oct 11 12:43:58 EDT 2006;Committer;knu;21;25;120;145;0
76f721470b854fca0139f8aeab472341aade62c9;Wed Oct 11 08:12:17 EDT 2006;Committer;matz;2;15;0;15;0
11674f4a3e25b3bb5079d648b7feabe16c25e9b4;Wed Oct 11 08:06:16 EDT 2006;Committer;matz;2;13;26;39;0
9681d8791b4a85e3dc8acb1a7a5e4e7b2c4d1ac8;Wed Oct 11 08:01:25 EDT 2006;Committer;matz;2;10;1;11;0
513d286ed0054491fed7528471ada0040fd227d2;Wed Oct 11 07:38:47 EDT 2006;Committer;matz;1;0;36;36;0
02d76d03875f2bcc2729490c65fc0afbcbd767d1;Wed Oct 11 07:00:29 EDT 2006;Committer;knu;2;268;0;268;0
8eb7570850980e1849f07bbed57d1bda8351f064;Wed Oct 11 06:05:32 EDT 2006;Committer;knu;2;15;5;20;0
4d49ec8d3f96d2d675cbeb930bd548739e123240;Wed Oct 11 05:59:41 EDT 2006;Committer;matz;2;41;0;41;0
fedfa6e5fac9ffc3b1ac7fbbcbaec39ca0cf54a1;Wed Oct 11 05:57:19 EDT 2006;Committer;matz;3;30;13;43;0
cd58f3313e1dd60895e1888290f7e433bec67208;Wed Oct 11 05:15:15 EDT 2006;Committer;knu;10;64;9;73;0
55b9887f970c21fcf483e14f940e860498a9606c;Wed Oct 11 05:15:09 EDT 2006;Committer;knu;1;3;3;6;0
775e54fe7beda13076b0296db830a25da9995c0d;Tue Oct 10 07:49:00 EDT 2006;Committer;knu;2;17;4;21;0
f7579abceccc77f8e7912c0117bcb3c19f95017c;Tue Oct 10 04:22:30 EDT 2006;Committer;knu;3;5;4;9;0
e6580176283d8db0d5b4bf7a0b844a17c74a56da;Tue Oct 10 04:22:26 EDT 2006;Committer;knu;1;3;3;6;0
bb9f40a725e780c279ebcc908fc39084d8bd2545;Mon Oct 09 14:49:49 EDT 2006;Committer;matz;4;110;35;145;0
88d6c083ea969b5e7b24315fd612958755afcc54;Mon Oct 09 14:41:24 EDT 2006;Committer;nobu;6;45;43;88;0
c009be97e8f940912888885284ca78b0797ea655;Mon Oct 09 14:00:59 EDT 2006;Committer;matz;3;10;3;13;0
bd62057a8baa26e6637b6025c58b7e057ff853c2;Mon Oct 09 13:46:56 EDT 2006;Committer;matz;2;15;0;15;0
f84ef3d3c3f9bc856b1b5e247379e38127951ac4;Mon Oct 09 13:44:28 EDT 2006;Committer;tadf;1;3;3;6;0
616044e47eafdb4ace89a62c5466f237b834f242;Mon Oct 09 13:44:26 EDT 2006;Committer;tadf;1;4;4;8;0
d2133ab996a48110c72da25855d1e6f59d9788b4;Sat Oct 07 15:55:17 EDT 2006;Committer;matz;2;6;1;7;0
f25b74a4e03ae864d0701950c8ed1d34e6f894bd;Sat Oct 07 15:49:02 EDT 2006;Committer;matz;1;3;3;6;0
2b972a7f8030f0d96d4c66675dee5ddb1662931a;Sat Oct 07 15:49:00 EDT 2006;Committer;matz;2;9;0;9;0
b067aef7c0a26a6d689f214bff66ee318fa9ad17;Sat Oct 07 14:35:19 EDT 2006;Committer;matz;2;12;2;14;0
4632511aa9723ecf1de5d255f58d6537f6006438;Sat Oct 07 02:53:24 EDT 2006;Committer;nobu;2;6;1;7;0
dd529e98045e98083071198b8d76dd63d22065c2;Fri Oct 06 15:32:11 EDT 2006;Committer;matz;1;3;3;6;0
f6fcd8635152dcc05e5439dc89de792db0b9e049;Fri Oct 06 15:32:09 EDT 2006;Committer;matz;2;5;3;8;0
0522cf503c95b0337c1eb50b9fabe284029f0d83;Fri Oct 06 06:22:56 EDT 2006;Committer;knu;2;6;1;7;0
cbefc993aca66a37dff5b186e679174db2f9f717;Fri Oct 06 00:59:09 EDT 2006;Committer;usa;4;5;9;14;0
4c6084c4cd1db4e51af9330efb2bcd48481cfefa;Thu Oct 05 22:33:56 EDT 2006;Committer;matz;1;3;3;6;0
2d096851501ba172ab1d50c97a65a8f066d5a519;Thu Oct 05 22:32:04 EDT 2006;Committer;matz;4;49;60;109;0
8d6db94ec7d4acc5944d64fe67089029fdc968df;Thu Oct 05 19:48:11 EDT 2006;Committer;knu;2;10;0;10;0
8f0bce5ddc9263b02d34f31bf0874a4cee3bc74e;Thu Oct 05 19:31:50 EDT 2006;Committer;knu;2;5;3;8;0
ed6886efb5b6096951f01d4e64b88f73edb7f4d8;Thu Oct 05 19:25:31 EDT 2006;Committer;knu;3;5;28;33;0
60f63ff93d13de2f5da10cf431489a3fd0bb6620;Thu Oct 05 19:13:00 EDT 2006;Committer;knu;2;78;45;123;0
17398b1960a9b883dc324ec57dabd692a6c976ce;Thu Oct 05 19:05:33 EDT 2006;Committer;knu;1;4;0;4;0
0ad60d4f284ef8a715ff3ac352bb5deae1dfd003;Thu Oct 05 17:39:51 EDT 2006;Committer;knu;1;82;12;94;0
8d0e66afdf4c7efedc33dedcc90e6414dde93ccb;Thu Oct 05 17:07:59 EDT 2006;Committer;knu;2;12;1;13;0
d93a35b55455d2d615f3c7df2057a62031f78d2f;Thu Oct 05 17:07:55 EDT 2006;Committer;knu;1;3;3;6;0
b9673f64f10197b4c2742331e0cccb9c1352c7bc;Thu Oct 05 11:09:42 EDT 2006;Committer;knu;28;123;631;754;0
9b616442e26cf50f42b13f7584493ae96bb3aedd;Thu Oct 05 11:09:36 EDT 2006;Committer;knu;1;3;3;6;0
438e33e3d29d098ba8fb3f243ca93a6367c15322;Wed Oct 04 09:52:54 EDT 2006;Committer;nagai;10;147;42;189;0
feafc463634bd4d771d70bb8dd491fc5dd402a19;Wed Oct 04 08:38:23 EDT 2006;Committer;matz;2;33;21;54;0
ffedafffba2f713eba454a04948d7326b204b240;Wed Oct 04 07:17:16 EDT 2006;Committer;matz;2;6;1;7;0
004d00757ae5b73d998a659090c29efdb0472fe4;Tue Oct 03 23:53:24 EDT 2006;Committer;nobu;2;6;1;7;0
c4e5ec23d3cea5fb991a4ff3b1da733168731864;Tue Oct 03 15:59:45 EDT 2006;Committer;matz;6;65;26;91;0
eebdfca0b255768092b4c6d8aa828d6518f51f16;Tue Oct 03 15:58:17 EDT 2006;Committer;matz;2;5;14;19;0
3f700df9afc68fcd458fc13ea7962b6aa48d3c53;Tue Oct 03 15:09:14 EDT 2006;Committer;matz;1;3;3;6;0
c8d3d9ed3d2a9a1a984832db66685dc9f0135dad;Tue Oct 03 15:09:12 EDT 2006;Committer;matz;2;5;7;12;0
9317700a5dc77053b84180456fa0ae10a3d33218;Mon Oct 02 17:39:57 EDT 2006;Committer;matz;5;56;3;59;0
2c875a0fde1c0b3190b56b7637624ea70b95a434;Mon Oct 02 16:39:24 EDT 2006;Committer;matz;1;3;3;6;0
4392e94d96e5278390c49f3fd1c1110dc33a3938;Mon Oct 02 16:39:21 EDT 2006;Committer;matz;2;27;23;50;0
27841c008e0d22c4ebaed88af90f850c931da49d;Mon Oct 02 14:48:44 EDT 2006;Committer;nobu;2;5;2;7;0
7d054f8913c824143b5c82aada2dba55d81f4f1e;Mon Oct 02 13:29:07 EDT 2006;Committer;nobu;2;9;2;11;0
8e1455a16e0dba91e271b1ab7512526aa5329749;Mon Oct 02 06:55:16 EDT 2006;Committer;usa;1;2;2;4;0
d7522827862b2ed95b5624fb6b031b15f3da3ab3;Mon Oct 02 06:50:14 EDT 2006;Committer;usa;2;6;2;8;0
5cfcbb2aca708d96d3c46e22392eef45774a535c;Sun Oct 01 16:25:37 EDT 2006;Committer;nobu;4;48;9;57;0
536cbbb20034d19c70c710f2fb5cde8968fc7fe7;Sun Oct 01 16:24:52 EDT 2006;Committer;nobu;1;3;3;6;0
b004fa242818626bb581ea7e060ce0ef7b582e1b;Sun Oct 01 15:00:45 EDT 2006;Committer;nobu;6;18;5;23;0
eba3d4587f96a113ea0a7792de6eadb56c893b53;Sun Oct 01 14:13:16 EDT 2006;Committer;nobu;2;14;8;22;0
4d24c82ccf5283db42486b0b4934412e419d2703;Sun Oct 01 14:13:06 EDT 2006;Committer;nobu;1;4;4;8;0
41b80c47d0c6bd0f0e7bcd9e2a28e073291f9760;Sat Sep 30 06:13:17 EDT 2006;Committer;tadf;3;482;583;1065;0
cd408b970e43a3ba177ca8d6e252ba6e97bb4064;Sat Sep 30 06:13:07 EDT 2006;Committer;tadf;1;3;3;6;0
480496a8065d952352800cb58bbf92aeb5a0a6a3;Fri Sep 29 04:21:30 EDT 2006;Committer;knu;2;7;0;7;0
cab3b4e92fdd3fd1685ec6972a33ba3b5189eba2;Fri Sep 29 03:31:01 EDT 2006;Committer;eban;2;6;1;7;0
5f1caf89e4dd695796c637bc8d8fed25acb9a21d;Fri Sep 29 02:44:37 EDT 2006;Committer;nobu;2;11;1;12;0
60a289741c3c67e4738d693b1ea90548a5fc4be2;Fri Sep 29 00:57:47 EDT 2006;Committer;nobu;2;6;5;11;0
d5195959bf2cb24f224eff386483f5df547d7bdc;Fri Sep 29 00:37:20 EDT 2006;Committer;nobu;2;5;2;7;0
05c1ab35fce472a25b0db2fa1bc189ce12ca2302;Fri Sep 29 00:30:49 EDT 2006;Committer;nobu;2;6;2;8;0
402d2ca7a9841bba18fa4523d82179150c4f454f;Thu Sep 28 15:01:06 EDT 2006;Committer;nobu;1;3;3;6;0
562b6f1db2041823e906c1a5a99d642f00fd9fc4;Thu Sep 28 15:01:04 EDT 2006;Committer;nobu;2;8;2;10;0
406479b3b58517cdbcad5700b0b971ff9bec8edf;Thu Sep 28 11:54:37 EDT 2006;Committer;usa;2;6;2;8;0
31fd0d60290c5aaa291d1401ff7270d70e5f3c6b;Thu Sep 28 11:53:52 EDT 2006;Committer;usa;1;3;3;6;0
3c29f3feef648804558ebf5654ecf5f2fd783386;Wed Sep 27 14:34:49 EDT 2006;Committer;knu;5;15;4;19;0
62ad417517e92bf2612b65ef943b3005fd882fdf;Wed Sep 27 12:45:29 EDT 2006;Committer;matz;2;11;6;17;0
02a8f15c9bc59946222a83de211a8daf373d928f;Wed Sep 27 08:37:48 EDT 2006;Committer;matz;2;10;5;15;0
9856258cd0aa8b74d77a86a22d36f2bc328cf151;Tue Sep 26 23:31:35 EDT 2006;Committer;matz;1;8;0;8;0
1113d54edecb68eaa55aa07996dec3b6fd8422f6;Tue Sep 26 22:46:16 EDT 2006;Committer;matz;5;124;48;172;0
4f6f0b1066be455ccc3f1ad80dd42c3f54068c7f;Tue Sep 26 16:05:52 EDT 2006;Committer;nobu;2;10;13;23;0
f3846ac51b56905737be955c9c0fcf61161c208f;Tue Sep 26 15:49:44 EDT 2006;Committer;nobu;1;1;1;2;0
a65ee0811c6380cd47de93635b5be8d296526878;Tue Sep 26 15:20:07 EDT 2006;Committer;nobu;1;3;3;6;0
3986bdc4a78e99257bbc6753af8b98542f71d2a4;Tue Sep 26 15:20:05 EDT 2006;Committer;nobu;1;22;2;24;0
6b55a461145fa22ec9a48086183050397f04b047;Tue Sep 26 14:59:20 EDT 2006;Committer;nobu;1;11;0;11;0
5da1743e3f5938eeb568956a020eea7cb7957821;Tue Sep 26 14:57:48 EDT 2006;Committer;nobu;2;26;11;37;0
c24faf6703b9eb380c59a39d6d4d1c80f04c44d2;Tue Sep 26 06:34:15 EDT 2006;Committer;usa;2;2;2;4;0
8af68b08a0049d8662207562893a8edbf8ecff52;Tue Sep 26 06:32:09 EDT 2006;Committer;usa;2;5;1;6;0
d2dd0c30d1cc6533b8ab6f6ec295359da3fe622a;Mon Sep 25 22:58:15 EDT 2006;Committer;matz;1;3;3;6;0
94fa180c07049483a57f24dbe2b8dab27f8909df;Mon Sep 25 22:58:13 EDT 2006;Committer;matz;2;7;1;8;0
500a5c34acf968b390f17cb65024858c3930d0c6;Mon Sep 25 14:19:57 EDT 2006;Committer;matz;2;9;3;12;0
c7908b19b002ff26b35ff68ba6a21e9e06fd9827;Mon Sep 25 13:26:40 EDT 2006;Committer;nobu;2;8;3;11;0
b96af08adda6e5e47088e7299567f8cb4cfb104b;Mon Sep 25 12:25:29 EDT 2006;Committer;nobu;2;3417;3406;6823;0
db7f24b362bf9a0831f9a6f12ac0f1a21e476cf0;Mon Sep 25 06:07:36 EDT 2006;Committer;matz;3;8;2;10;0
5cc2093ccd5c91fe2eeb0e9a7757985569eed1c2;Mon Sep 25 05:57:37 EDT 2006;Committer;matz;5;14;6;20;0
8366008bcf2e71002c7338f9400968ddac2aad40;Mon Sep 25 00:59:03 EDT 2006;Committer;matz;1;1;1;2;0
fe2b0129cc64c9e2feeba200a8b176dc6d4b45ca;Sun Sep 24 23:17:42 EDT 2006;Committer;matz;3;14;6;20;0
860b9bf47fc09218c34ae0afc46db82a7f7791b6;Sun Sep 24 23:14:16 EDT 2006;Committer;matz;1;3;3;6;0
2a0c02c27d21855ff707ef6cd1cc121066c0ce7e;Sun Sep 24 23:14:14 EDT 2006;Committer;matz;2;6;1;7;0
84103149613d2125dbc0f4b2a3c6318463ca589a;Sun Sep 24 14:51:08 EDT 2006;Committer;matz;1;1;0;1;0
830573a7f784947e791720c8497319c15e34592a;Sun Sep 24 14:47:43 EDT 2006;Committer;matz;2;8;1;9;0
8ec17dab6a3e8cbf744cf94d02a28fc8aad82633;Sun Sep 24 13:28:53 EDT 2006;Committer;nobu;2;5;1;6;0
ffc6df2b67a2e84116888efb108a43a1d9c2afae;Sun Sep 24 03:11:56 EDT 2006;Committer;tadf;3;101;24;125;0
3537afda471cb29cc07d68c46dbe0f8f7a4577a4;Sat Sep 23 21:55:46 EDT 2006;Committer;nobu;2;9;11;20;0
e441b922b983bfab59b9f7512a2dae32d9e9e555;Sat Sep 23 21:29:51 EDT 2006;Committer;why;1;3;3;6;0
dcb6131f78704196e749125c8877e63061180542;Sat Sep 23 21:29:47 EDT 2006;Committer;why;4;195;102;297;0
9911bca1e2774c959993093814c46f05b3c8b7ff;Sat Sep 23 12:47:11 EDT 2006;Committer;matz;2;6;1;7;0
d5a00279f44dcb9dcd37c767bcd2c51a5101431d;Sat Sep 23 12:01:58 EDT 2006;Committer;kosako;4;24;9;33;0
b6ec2b7c6de88f457d480e9a6892b84c133bd92c;Fri Sep 22 23:41:47 EDT 2006;Committer;matz;2;5;0;5;0
55eab2a01159e668d32331ea4dec78eb28177dfd;Fri Sep 22 16:05:19 EDT 2006;Committer;tadf;3;132;84;216;0
057cea0cfb93b5ff193e81d7d4e4bcd5d8cd6307;Fri Sep 22 16:05:11 EDT 2006;Committer;tadf;1;3;3;6;0
a2fc608087a3ffd347bab13e9029968e0bd66fa1;Fri Sep 22 09:08:58 EDT 2006;Committer;matz;2;7;5;12;0
70360efac388686eb848b5bfbbb3be7a755451c6;Fri Sep 22 08:36:02 EDT 2006;Committer;matz;3;90;14;104;0
51281b961be085be5a29088ada5118699035306b;Thu Sep 21 22:52:38 EDT 2006;Committer;matz;3;11;10;21;0
5b950717b7bbcf8fa3b9362060c02badd87d2b5a;Thu Sep 21 22:50:32 EDT 2006;Committer;matz;2;16;5;21;0
e4800cabfbc85b6f581de1e111bd61602ed9f406;Thu Sep 21 17:06:50 EDT 2006;Committer;nobu;2;6;1;7;0
f0a108f408f599f7e71c7d1e58a07b4075221c70;Thu Sep 21 16:37:05 EDT 2006;Committer;nobu;2;5;0;5;0
c550f673c0d97fa845a0662427cb12f0681674e0;Thu Sep 21 15:36:20 EDT 2006;Committer;nobu;1;3;3;6;0
ae7ea70a3a442b11484224c7981849d7f3b219a8;Thu Sep 21 15:36:17 EDT 2006;Committer;nobu;2;7;2;9;0
e8454ae7765c245432758b53345ea2601a84cbfe;Thu Sep 21 13:58:33 EDT 2006;Committer;nobu;4;47;14;61;0
f5ec2b0d75e1f29705aa6b04fdf9e03791b99997;Thu Sep 21 08:47:03 EDT 2006;Committer;matz;2;55;1;56;0
ee9bae8cd7b058a678ec0d0b633ecfb6df3da344;Thu Sep 21 07:29:56 EDT 2006;Committer;eban;2;6;2;8;0
255702be8ca169429867294d4a1fd818b53af928;Thu Sep 21 06:09:26 EDT 2006;Committer;matz;2;75;0;75;0
4e37427ee5ecabda3e59ffd3ad1a6c85d4d9327b;Thu Sep 21 05:57:20 EDT 2006;Committer;matz;2;5;2;7;0
c35290824a75b8edfffc6d809873d4f2cbd38bd1;Thu Sep 21 05:12:57 EDT 2006;Committer;matz;2;19;2;21;0
77fef79f107679eadb10cafb3ed22f6732825115;Thu Sep 21 01:10:25 EDT 2006;Committer;matz;2;10;4;14;0
e79002a022da8387de96b393f564627eda41613f;Thu Sep 21 00:43:16 EDT 2006;Committer;matz;2;41;0;41;0
3b9c22137883b0f53bea0b4e2c139f774b20bffb;Wed Sep 20 16:41:59 EDT 2006;Committer;matz;1;3;3;6;0
71afefd5d1f0d3d43f5ca3fb3c416bad3821c46f;Wed Sep 20 16:41:56 EDT 2006;Committer;matz;2;108;1;109;0
8978bfe7f9531a91466b8976a68ddac8d7bc19c6;Wed Sep 20 14:18:19 EDT 2006;Committer;nobu;3;11;2;13;0
4e259f90940288de23a1755db5eb74d50b17c3e7;Wed Sep 20 13:41:55 EDT 2006;Committer;nobu;2;6;1;7;0
803591e9003482258de5fa695257b0bcd1685710;Wed Sep 20 04:18:25 EDT 2006;Committer;matz;5;65;9;74;0
2ec2878d559391d22d593691971fc3e0d4f8935d;Wed Sep 20 01:42:03 EDT 2006;Committer;shugo;1;5;5;10;0
a0a0a0fb72215cae3772d9ae266dbb1ec4467fe9;Wed Sep 20 01:36:49 EDT 2006;Committer;shugo;1;5;0;5;0
a32b61147b2c636703e1e8d9b773f31dd9f1e2af;Wed Sep 20 00:54:45 EDT 2006;Committer;usa;4;12;1;13;0
92d28f6b8fd2ca3f0851af4aa02df96b96ff83eb;Wed Sep 20 00:45:08 EDT 2006;Committer;shugo;1;1;1;2;0
d3f545235a00b1ae8f01e4cc9132885411b0bdd8;Wed Sep 20 00:30:38 EDT 2006;Committer;matz;2;414;72;486;0
eede22f0bb2d0a7f2e6ba32372d55943bf9958d9;Wed Sep 20 00:30:30 EDT 2006;Committer;matz;1;3;3;6;0
a388c7dd9e15d8b25705951d8906eacf76f50d7b;Mon Sep 18 15:43:06 EDT 2006;Committer;nobu;3;3436;3375;6811;0
e273f67f6b8bd706868c3117ff21519650471871;Mon Sep 18 15:42:58 EDT 2006;Committer;nobu;1;3;3;6;0
6bf30a90ef7b7795b6259a523816c1f28267722d;Mon Sep 18 06:33:03 EDT 2006;Committer;matz;3;11;2;13;0
3851ac03b597c9ab90783cdc60937c95d8792f0e;Mon Sep 18 03:17:06 EDT 2006;Committer;nobu;2;5;1;6;0
4048548f7fc21d3c83881227cbcf08a91256cd14;Mon Sep 18 01:59:03 EDT 2006;Committer;matz;1;3;3;6;0
749df1d0fd6252b73d0f283feebb597f6f750bdf;Mon Sep 18 01:59:00 EDT 2006;Committer;matz;8;17;14;31;0
392f342f04b8039bb5a352b17dac02311e260276;Sun Sep 17 14:46:13 EDT 2006;Committer;nobu;3;53;17;70;0
8114a2edb0eff269e0f8897a059656c8e0973053;Sun Sep 17 08:43:19 EDT 2006;Committer;nobu;4;121;68;189;0
cd5cfab0e70f1e2e1ba23310ede87ef31a92a2bf;Sun Sep 17 01:42:28 EDT 2006;Committer;nobu;2;7;3;10;0
6580c026051738dc7386722d69a1d91bd01bc86e;Sat Sep 16 15:30:51 EDT 2006;Committer;akr;1;3;3;6;0
026cc75b9ac662cd7ad9b94cb7d7b95615cd49fd;Sat Sep 16 15:30:49 EDT 2006;Committer;akr;1;1;1;2;0
f208b3ad51d4f6c040d255672ab45f28496f4577;Sat Sep 16 10:51:35 EDT 2006;Committer;matz;3;16;8;24;0
46799937ee259e85df53bda7d65693ccfbefe8b2;Sat Sep 16 07:41:07 EDT 2006;Committer;nobu;1;4;0;4;0
4b6a1b7f9cb6586643f94c9f4a78b00825a8bbc3;Sat Sep 16 07:22:49 EDT 2006;Committer;nobu;2;23;14;37;0
b1ad30b2f72b0802ddfb363ff3b4477d9a3c1e15;Sat Sep 16 07:21:02 EDT 2006;Committer;nobu;2;18;20;38;0
006f77a2f143e85e8cc699a9f0ad8ac530e3502c;Sat Sep 16 07:15:22 EDT 2006;Committer;nobu;2;4;2;6;0
5e6bf721d59f372a66207c38d9b3f5f7a2e3f468;Sat Sep 16 07:14:37 EDT 2006;Committer;nobu;2;29;35;64;0
f06362a4f9aab177009dbedb0242fd90811cfca2;Sat Sep 16 07:06:57 EDT 2006;Committer;nobu;6;289;124;413;0
efc605aeadf6f428b3ceecb749ed325290f79d66;Sat Sep 16 02:24:58 EDT 2006;Committer;matz;3;7;1;8;0
23c5ee8a9db3539549f40a177913072a85948901;Sat Sep 16 02:21:01 EDT 2006;Committer;matz;1;3;3;6;0
de4f255da2a3fab60e057bfaaa2075d9d7abee00;Sat Sep 16 02:20:59 EDT 2006;Committer;matz;2;11;1;12;0
5300eecfb324f3a29d891b3e229baef631dc6aeb;Fri Sep 15 11:26:07 EDT 2006;Committer;naruse;4;131;31;162;0
976b4e5f8bedcd8285578c6da5117b6883ef1c02;Thu Sep 14 20:27:56 EDT 2006;Committer;naruse;2;501;254;755;0
2043c39808d80fa4c011041864390545c80462e5;Thu Sep 14 15:05:22 EDT 2006;Committer;akr;2;6;1;7;0
af05fa6a40440b0ce65870952284bb992e4d08bf;Thu Sep 14 15:05:18 EDT 2006;Committer;akr;1;3;3;6;0
49f0e92f2889de1923f022ea52758340d3f29787;Thu Sep 14 08:23:28 EDT 2006;Committer;matz;2;25;3;28;0
2a23c281a1d7d61b866cb01867dbe5ebff1e2263;Thu Sep 14 07:36:53 EDT 2006;Committer;matz;2;5;3;8;0
23d2c8b62426853ad84d8889ae191347680b566e;Thu Sep 14 07:27:14 EDT 2006;Committer;matz;4;25;5;30;0
803cabaceddb46579270e2470de6ed7bd157e8dc;Thu Sep 14 06:21:56 EDT 2006;Committer;akr;1;4;0;4;0
d6ff7b526a6b102940d06c0e70a21990203606cc;Thu Sep 14 05:39:40 EDT 2006;Committer;akr;2;18;0;18;0
29d039601206933b1a9e5a585807576d1ba8b780;Thu Sep 14 00:39:37 EDT 2006;Committer;akr;1;2;0;2;0
be02cb10f85b313e6c66469d5818115c8b049d8c;Wed Sep 13 23:32:12 EDT 2006;Committer;akr;2;26;0;26;0
9bcbcb054a0c7d716026b3c7422096eb56b0f031;Wed Sep 13 16:15:48 EDT 2006;Committer;usa;2;19;1;20;0
3d9fc0d7d07b821c932f05bb52eb7557670576bf;Wed Sep 13 16:03:23 EDT 2006;Committer;akr;2;12;0;12;0
cc8ed209fce95d1da5c174af1b31c0a6b6fceab3;Wed Sep 13 16:03:19 EDT 2006;Committer;akr;1;3;3;6;0
9cfc88d2d211f045b04b61a2ca9ab7f8840232d7;Wed Sep 13 14:45:21 EDT 2006;Committer;matz;1;6;6;12;0
c0012d9ca84118419035756a38b505befeecbfe5;Wed Sep 13 09:49:58 EDT 2006;Committer;matz;2;35;30;65;0
f2e069ad2bc54e1eea6f514889ba1961af5266e5;Wed Sep 13 09:29:41 EDT 2006;Committer;matz;2;7;5;12;0
e6340674d16049c9d93270d00a93941abe557e64;Wed Sep 13 08:19:54 EDT 2006;Committer;matz;2;8;5;13;0
96a8a44317a27320d7c4359c17559826bd4276ed;Wed Sep 13 08:15:21 EDT 2006;Committer;matz;2;7;0;7;0
62f8f1419c2d666a113d02f021c20673a0f49d48;Wed Sep 13 08:10:28 EDT 2006;Committer;matz;2;13;13;26;0
5cb7d10ee065d6141a6d6e796aecbb278b54f171;Tue Sep 12 16:14:50 EDT 2006;Committer;nobu;2;33;18;51;0
f11f59972fa4940d36327640db1eb2997aa31046;Tue Sep 12 16:14:44 EDT 2006;Committer;nobu;1;3;3;6;0
716979b8ffc7a76a60bb24caf04f7701231a14fc;Mon Sep 11 19:08:29 EDT 2006;Committer;matz;1;3;3;6;0
026f734f4c26b5c28e258a9581c021303ec62083;Mon Sep 11 19:08:25 EDT 2006;Committer;matz;3;19;21;40;0
ad0b87727df89ea54edb2d6a6b295147fbca55f8;Mon Sep 11 08:09:19 EDT 2006;Committer;matz;4;70;15;85;0
f2ad09d5b7cdea64963433af13a9525bebc19a78;Mon Sep 11 02:48:17 EDT 2006;Committer;matz;4;35;16;51;0
390b340d52ffe7e7d09601dc7c4ba189cfe11f21;Sun Sep 10 22:41:55 EDT 2006;Committer;matz;1;3;3;6;0
a36197bd5817a6b0611d9f1e7f6b5bf4725ab480;Sun Sep 10 22:41:52 EDT 2006;Committer;matz;2;10;3;13;0
f16b5afcac605643011c74948a993e6fb81d65d2;Sun Sep 10 13:59:59 EDT 2006;Committer;nobu;2;5;1;6;0
d78b26583960d06527742833573022cb0be2fe2e;Sun Sep 10 11:27:56 EDT 2006;Committer;tadf;3;178;70;248;0
352303c906a30ba2abc174eb8eafa9a00cd335a2;Sun Sep 10 00:41:44 EDT 2006;Committer;nobu;2;6;0;6;0
166ee9719f323f7337124eb6288181d128fd4806;Sun Sep 10 00:20:03 EDT 2006;Committer;nobu;2;9;5;14;0
36e79167ab7a763a0733eec7c69689bce9417afd;Sun Sep 10 00:18:39 EDT 2006;Committer;nobu;2;12;7;19;0
4569783b2c2b2cb0dbc036dac06890132da03602;Sat Sep 09 16:19:36 EDT 2006;Committer;matz;1;3;3;6;0
0f785c3840d3dab5eb59ecca82e9a045dfdd77c0;Sat Sep 09 16:19:33 EDT 2006;Committer;matz;3;19;11;30;0
7d3fc8ff2b6205ebc0123ac6196acf14257a5cf5;Sat Sep 09 05:14:40 EDT 2006;Committer;drbrain;2;15;2;17;0
d70fc5798ef641a071c9e72d13bd3fe8d35c2974;Fri Sep 08 20:02:54 EDT 2006;Committer;nobu;1;1;1;2;0
fbe8d44d5c62148ee2993c19d8887f1761dfd7b3;Fri Sep 08 19:56:37 EDT 2006;Committer;nobu;2;15;11;26;0
b000ee600fec7e554b07496941a2864b8285c4bd;Fri Sep 08 19:48:54 EDT 2006;Committer;nobu;1;3;3;6;0
f594f850a495da1d73dc8586301a76135eec8cf1;Fri Sep 08 19:48:22 EDT 2006;Committer;nobu;8;58;30;88;0
82f7f29c59bf97dcaf77d06269e03a936fa7a2cb;Fri Sep 08 07:55:51 EDT 2006;Committer;matz;2;8;1;9;0
3d1b573946ee26775da3268ba585b2276c659342;Fri Sep 08 07:38:53 EDT 2006;Committer;usa;4;11;3;14;0
ec847fad4e0c1b96c6cf91e7ff14ef0820f7ccc3;Fri Sep 08 02:03:44 EDT 2006;Committer;ser;8;87;47;134;0
b2a8ca6dd61358ed72c3d4f5f61767052c9b4d27;Fri Sep 08 01:04:52 EDT 2006;Committer;gotoyuzo;3;44;0;44;0
eba74dc219404e746f5e9273794e27c71be003db;Fri Sep 08 00:00:12 EDT 2006;Committer;nobu;4;24;4;28;0
58b0275a4c337c78cdec47575489fb5f808ba065;Thu Sep 07 23:25:56 EDT 2006;Committer;nobu;2;10;6;16;0
d1cb9e75d054d06f0a80aeb112b894e82952c6d0;Thu Sep 07 16:33:08 EDT 2006;Committer;matz;5;29;49;78;0
b06a278942c0041fd4b81df2ac3c10a29eb40a21;Thu Sep 07 16:11:28 EDT 2006;Committer;matz;2;8;3;11;0
aa4f653fb97582d1c2acd6150a9c421ef0b3ac51;Thu Sep 07 16:10:36 EDT 2006;Committer;matz;1;3;3;6;0
ddfc925c8dd3e864d915f1b1cc67b0bfe0d581d9;Thu Sep 07 16:10:33 EDT 2006;Committer;matz;2;22;15;37;0
585c61691e9877bae84bb71acf0e2f3d1377ce52;Thu Sep 07 14:28:36 EDT 2006;Committer;nobu;2;16;3;19;0
c390e61a865910d0c23524da7acc722779e19011;Wed Sep 06 16:59:13 EDT 2006;Committer;matz;1;3;3;6;0
d314a7dd8540293dae14e1e2cfd2f80ca143a56e;Wed Sep 06 16:59:10 EDT 2006;Committer;matz;2;21;0;21;0
301c9f1265ee471a5697623d3bb928cb73544057;Wed Sep 06 04:25:53 EDT 2006;Committer;matz;2;8;0;8;0
103f6728df2607a5e8b785d429c0e9cac42c19e5;Wed Sep 06 03:20:10 EDT 2006;Committer;naruse;2;5;1;6;0
847c10fa3e3a3550348d8966717c51c3a0350ec5;Wed Sep 06 03:20:05 EDT 2006;Committer;naruse;1;3;3;6;0
ca9d8f09301bac7f07546da1a69e213899f1405f;Tue Sep 05 13:07:06 EDT 2006;Committer;nobu;3;82;107;189;0
6a0636b2d40424faa55cd864db28649d0de1b942;Mon Sep 04 21:48:47 EDT 2006;Committer;nobu;2;9;1;10;0
b9a508bb9613b10e88611284448c4b7dfbeefc81;Mon Sep 04 20:50:13 EDT 2006;Committer;nobu;2;10;7;17;0
5f61a22950233184db0771ef743706f7c3f99371;Mon Sep 04 20:10:45 EDT 2006;Committer;matz;3;15;8;23;0
bedda2d27f84ae4b28eed87671abc000e8a0eaf0;Mon Sep 04 17:21:55 EDT 2006;Committer;matz;1;3;3;6;0
cbe89cef1a8b0f96fc8e39b66f5545f39c869429;Mon Sep 04 17:21:53 EDT 2006;Committer;matz;2;17;17;34;0
eff9686dedf3525fe6ec6ea60d7a598893fe3dd3;Mon Sep 04 12:44:33 EDT 2006;Committer;nobu;2;9;4;13;0
7f0f585f322b141bfd2eea4e8ca99d20f847ab78;Mon Sep 04 12:43:20 EDT 2006;Committer;tadf;3;81;12;93;0
448154a7daa92447e2446fff517e72b70de6818e;Mon Sep 04 12:14:47 EDT 2006;Committer;nobu;2;5;1;6;0
5b93abf50e01ac2d91a07abe46beb47f10adbab9;Mon Sep 04 07:42:10 EDT 2006;Committer;matz;1;0;21;21;0
52817c3654518c55de31666848f08d7ac58f8787;Mon Sep 04 07:40:46 EDT 2006;Committer;matz;5;37;6;43;0
9e0a2170fd9ae9ee3a7545630a685a4a3e2f795a;Mon Sep 04 05:57:35 EDT 2006;Committer;matz;2;15;6;21;0
65e965a12ff85b06dd111d821465cc95cb6e00da;Mon Sep 04 05:46:51 EDT 2006;Committer;matz;1;3;3;6;0
b4afac07bc230f1b574dd634df17d490ede899da;Mon Sep 04 05:46:47 EDT 2006;Committer;matz;4;19;7;26;0
85073d276ac1fb6a021b5192cc25be9272473035;Sun Sep 03 11:47:34 EDT 2006;Committer;nobu;2;5;1;6;0
0dbe4950441278ecb65a2da5b8cadb652ca48f7f;Sun Sep 03 06:34:13 EDT 2006;Committer;nobu;2;10;6;16;0
94bfd049fdb8b499ead7451b029f6b33a5aa9e84;Sat Sep 02 22:23:14 EDT 2006;Committer;akr;2;0;8;8;0
f80cbcf912a98eb84ced8c8699f24956557a826d;Sat Sep 02 21:27:16 EDT 2006;Committer;akr;2;6;1;7;0
c76ff0753e4ac2ab389369227add0fe008159616;Sat Sep 02 19:44:42 EDT 2006;Committer;akr;3;12;1;13;0
b23b5ed620e2fd4f1f8af52f80c6b0c87deec110;Sat Sep 02 19:09:56 EDT 2006;Committer;akr;2;8;1;9;0
10a0dea1f5fddd26d2b29f41fa190049eec95550;Sat Sep 02 15:20:24 EDT 2006;Committer;matz;3;11;10;21;0
d064c0bf13b47356757e4dc9f678a2f0ff84e624;Sat Sep 02 15:13:26 EDT 2006;Committer;matz;2;4;2;6;0
777aed2b15c28f7afc25feab9ef338b7eb83fd25;Sat Sep 02 15:05:30 EDT 2006;Committer;matz;1;3;3;6;0
ccf5372b252a229ddb6693db132edc013419ccdc;Sat Sep 02 15:05:27 EDT 2006;Committer;matz;7;301;219;520;0
2156870525be05f0bd769af141c3f6cff9fff8c4;Sat Sep 02 14:42:08 EDT 2006;Committer;matz;39;804;684;1488;0
8581164ea67a13fad5e7d56aa4aa75a87f9eafb3;Sat Sep 02 14:36:22 EDT 2006;Committer;matz;3;11;17;28;0
965b0d38071a0ef6cbb23913bb7e90447f75729d;Sat Sep 02 04:26:40 EDT 2006;Committer;akr;2;6;0;6;0
40cefc9844100474eba84d33ab77362d69321db9;Sat Sep 02 03:11:02 EDT 2006;Committer;nahi;2;19;7;26;0
97c6bc5ffd1deb626795057f01efda9ebdd9296f;Sat Sep 02 03:06:33 EDT 2006;Committer;nahi;2;7;1;8;0
f7429344aa5b6ea9cfb7a82ff2e2325c71ae6715;Fri Sep 01 17:27:26 EDT 2006;Committer;akr;1;3;3;6;0
a20d60c8196b10860eb4d919735fe6a82b1950b5;Fri Sep 01 13:11:16 EDT 2006;Committer;matz;1;1;1;2;0
ba9066bd84f7dcb33fe91a1c2e90797d90d3b198;Fri Sep 01 13:08:29 EDT 2006;Committer;matz;2;6;1;7;0
9ba40029603e4385e47b606a192f6ab8f0b52e41;Fri Sep 01 13:07:05 EDT 2006;Committer;matz;3;15;3;18;0
85c476a342403499de298ed6e1a5544b4cbdc827;Fri Sep 01 12:45:01 EDT 2006;Committer;matz;2;6;1;7;0
54b7c5d56058c8c56f6a8602b039679a86b915f0;Fri Sep 01 05:24:05 EDT 2006;Committer;eban;2;6;2;8;0
c22af575a18f689e31ce07b24a8034b1f751a681;Fri Sep 01 05:09:51 EDT 2006;Committer;nagai;3;11;6;17;0
8cf47d14abdc9e3462fd40d0c2a5cfe3b78f77a3;Fri Sep 01 04:15:45 EDT 2006;Committer;matz;2;7;1;8;0
04f01ce2f560ff79fef6957f3bfda93e53b83c7a;Fri Sep 01 04:15:42 EDT 2006;Committer;matz;1;4;4;8;0
6a640106d2158cf8369f4ce77c50444ca09b76b2;Fri Sep 01 00:37:09 EDT 2006;Committer;matz;1;2;2;4;0
079ec46b4b2994100466d4cfb191918255880ef3;Thu Aug 31 14:59:43 EDT 2006;Committer;nobu;2;8;3;11;0
974037a54272cd86a36bffafa22578a0ab15def7;Thu Aug 31 12:10:08 EDT 2006;Committer;usa;6;14;7;21;0
6790891ef083b77faaf9d779463dfa0569a96ae5;Thu Aug 31 11:56:42 EDT 2006;Committer;usa;8;146;135;281;0
5b5e4a6fc1e2829e6a2e1fb41986e951070646c7;Thu Aug 31 11:24:44 EDT 2006;Committer;usa;5;33;22;55;0
54af80844fbcf132f85e9275673eaa66b72da996;Thu Aug 31 10:47:44 EDT 2006;Committer;matz;23;900;788;1688;0
25c50cd193d89ad0737219142bab191f12b8abe8;Thu Aug 31 10:30:33 EDT 2006;Committer;matz;43;484;512;996;0
22f249ebd7a142faacdf5edd7e196bd2149feae5;Thu Aug 31 08:24:36 EDT 2006;Committer;matz;4;65;9;74;0
b8597ccb1c5c56a701be13959661be11f1662b55;Thu Aug 31 05:58:20 EDT 2006;Committer;nagai;2;8;2;10;0
50068c98ab7fe96acce05e93bc9813828c52d3f6;Thu Aug 31 04:14:55 EDT 2006;Committer;why;1;3;3;6;0
a6487b236a7a34fbd164777a927cc7b185a98ff5;Thu Aug 31 04:14:53 EDT 2006;Committer;why;3;15;5;20;0
b22fc4ebb6d1e6d97587d750378db249b07b3109;Wed Aug 30 09:49:41 EDT 2006;Committer;matz;2;5;1;6;0
e8f43ad081e35d8779666f79f01d9c59a4122c29;Wed Aug 30 09:46:57 EDT 2006;Committer;matz;3;18;6;24;0
51525e12b8e61979567ccf12da300a11237ba9a3;Wed Aug 30 09:39:47 EDT 2006;Committer;matz;2;8;1;9;0
2aaf22a9a1da4bb429d922003129d7c026fa47c5;Wed Aug 30 03:02:37 EDT 2006;Committer;nobu;1;3;3;6;0
59b1cef2f12112cbd515bf1bcfb8b1997538db48;Wed Aug 30 03:02:35 EDT 2006;Committer;nobu;4;21;12;33;0
74ef5a647fa0b42e6be22c4734a98150473825c2;Tue Aug 29 10:11:29 EDT 2006;Committer;nobu;1;3;3;6;0
99bed88c85e15704f6b9015133ce33d03b7fa061;Tue Aug 29 10:11:27 EDT 2006;Committer;nobu;2;19;5;24;0
5d7609be1b07034b5a36a67bcbd19860b93c69f6;Mon Aug 28 02:33:40 EDT 2006;Committer;drbrain;1;15;0;15;0
657b6268994700dfdb01c4553f8f38286411c73f;Mon Aug 28 02:33:04 EDT 2006;Committer;drbrain;2;3;4;7;0
a4e85a53e5f7eddca6c3249175c4c65e3122dbc4;Mon Aug 28 02:32:47 EDT 2006;Committer;drbrain;1;1;0;1;0
cfdb83349e2be4f97f8f1fd56d87d511cd34cf9e;Mon Aug 28 02:31:58 EDT 2006;Committer;drbrain;1;1;1;2;0
6322272ceabcb84d41404d968f79963421f22098;Mon Aug 28 02:31:34 EDT 2006;Committer;drbrain;1;3;5;8;0
6e83a71d3bb260cf2e02cd88e6a6f72fab50e910;Sun Aug 27 23:03:20 EDT 2006;Committer;drbrain;8;46;39;85;0
92b0eb1f42352ccb0ef64c294427a0c7308f9c08;Sun Aug 27 22:52:21 EDT 2006;Committer;drbrain;1;45;23;68;0
ddec6278cbb19bd1b603dd55c4e17d7383a9916c;Sun Aug 27 22:25:11 EDT 2006;Committer;drbrain;1;3;3;6;0
b963ffbf1daa3a5117bf1c3e9d9c2c2351d3da5e;Sun Aug 27 22:25:08 EDT 2006;Committer;drbrain;2;8;3;11;0
0046f355c1109dfc2883f1a3c64c61222aab0ce9;Sun Aug 27 12:58:22 EDT 2006;Committer;kosako;8;828;130;958;0
0384b2330ca1b8461c86b9cd2ddae234f75c8417;Fri Aug 25 23:09:30 EDT 2006;Committer;tadf;4;1097;533;1630;0
9b4bc065feec2175237a857c1440e94f8a8499f0;Fri Aug 25 23:09:24 EDT 2006;Committer;tadf;1;3;3;6;0
1384f4689b787c52166ad570ecfcce12181251a9;Fri Aug 25 12:38:28 EDT 2006;Committer;kosako;3;12;4;16;0
8c65115c20e090cca569088d2775e97aea1ba531;Fri Aug 25 11:38:34 EDT 2006;Committer;usa;3;8;93;101;0
dc46d4a455966bb41d27feaedd7bda6f7194d273;Fri Aug 25 07:06:18 EDT 2006;Committer;nobu;1;3;3;6;0
2e61b69722b781724a02dd6d2d59a2dc82a56183;Fri Aug 25 07:06:15 EDT 2006;Committer;nobu;2;9;1;10;0
319d2b185be7dda1fc9778da3039e12d347e5e72;Tue Aug 22 15:25:43 EDT 2006;Committer;nobu;3;10;5;15;0
4da7e2b955a6f8f794c646c452e19fa46370baf3;Tue Aug 22 15:25:39 EDT 2006;Committer;nobu;1;3;3;6;0
575f94043fba1fb7cfd9600bc0839477c0014a35;Tue Aug 22 10:21:31 EDT 2006;Committer;aamine;2;6;1;7;0
2d99616ec8513ce83fd3d626caa80d948862f95b;Tue Aug 22 03:41:46 EDT 2006;Committer;naruse;2;7;2;9;0
e7c9022cffd7071f32f6abab20e57a230902c508;Tue Aug 22 03:41:42 EDT 2006;Committer;naruse;1;3;3;6;0
a35efc05adf6aaf98c99a12411ff7c518c879754;Sun Aug 20 02:47:13 EDT 2006;Committer;nobu;2;7;1;8;0
b8e1343f5e4ff3f72c6e7e1616d0577ab4904730;Sun Aug 20 00:45:45 EDT 2006;Committer;drbrain;1;3;3;6;0
28b7dd0d53403ed35086d5d3a88113a64e142afc;Sun Aug 20 00:45:42 EDT 2006;Committer;drbrain;1;150;0;150;0
0c2571d62116fb79263627d056387e88afbcc34a;Sat Aug 19 07:53:27 EDT 2006;Committer;suke;3;61;6;67;0
ddf79e9b6d789cc7133e9635ff5db1b3f3cd6e6c;Sat Aug 19 02:29:21 EDT 2006;Committer;nobu;1;3;3;6;0
f50c13da99266c8486d1d59942179a65251457dc;Sat Aug 19 02:29:18 EDT 2006;Committer;nobu;2;12;1;13;0
34deabcbac30a0411b6946f0c810cd73e1051b7e;Thu Aug 17 17:06:52 EDT 2006;Committer;matz;2;9;4;13;0
41388768820d37767d2bcee30146977f57c6d793;Thu Aug 17 17:06:16 EDT 2006;Committer;matz;1;3;3;6;0
79b82a874964b343179a5e7d6d947a828b5dcb0c;Thu Aug 17 10:15:55 EDT 2006;Committer;nobu;2;32;1;33;0
5d863ccbac17982907a1867bb6b0afa05be3ccaa;Thu Aug 17 06:21:20 EDT 2006;Committer;nobu;1;1;1;2;0
74eced22e9e23b73f253407c916769d7203087df;Thu Aug 17 05:47:50 EDT 2006;Committer;nobu;2;122;4;126;0
eb73164cec56a3db93b9bb12a4d494c981e35b53;Thu Aug 17 05:47:30 EDT 2006;Committer;nobu;1;3;3;6;0
81b5dcb2a11f8a032cdb859f24937d08022ef8a4;Wed Aug 16 08:47:18 EDT 2006;Committer;nobu;2;6;1;7;0
f2cc27721631aed6c69473fbda012623ea8f4156;Wed Aug 16 08:24:00 EDT 2006;Committer;usa;2;5;2;7;0
efff5bc946ad67ff9c884d711585cf22d4e4585b;Wed Aug 16 02:46:10 EDT 2006;Committer;nobu;2;36;3;39;0
59f4ea73873bd6f456ed049f48de940fbb0d9f23;Wed Aug 16 02:11:21 EDT 2006;Committer;nobu;2;11;11;22;0
615543bf1f7d4bf1edad995a3badc2552d8913a2;Wed Aug 16 02:09:48 EDT 2006;Committer;nobu;1;3;3;6;0
f4f7bc09e48f9b7b602ae8d49aff2aa6e7939fc3;Tue Aug 15 02:27:19 EDT 2006;Committer;aamine;1;1;1;2;0
a03909606ed96f97588879b8effb8585899356c0;Tue Aug 15 02:21:59 EDT 2006;Committer;aamine;2;313;157;470;0
e86b8053d2cbfd215957bb9ed8c8f8badbdd4b04;Tue Aug 15 02:21:55 EDT 2006;Committer;aamine;1;3;3;6;0
1f84a162df294e01452ca369cf3745903effa7c3;Sun Aug 13 09:44:16 EDT 2006;Committer;akr;6;29;85;114;0
8b827f1a7d5828bdee506da5cc8f42ce54f589bd;Sun Aug 13 05:35:35 EDT 2006;Committer;drbrain;2;7;1;8;0
4bc2a9860ca52b497b6a5367d9036aff9bec5fd6;Sun Aug 13 03:09:59 EDT 2006;Committer;akr;2;6;4;10;0
fbdff22c79f0670e37900a66eb165fbebff1fd29;Sun Aug 13 03:09:55 EDT 2006;Committer;akr;1;3;3;6;0
edcb8975ac13b9b0dd392b3a8c18cef64546b010;Sat Aug 12 06:56:09 EDT 2006;Committer;nobu;7;248;23;271;0
0fe7592d74ce3553a949af420455362564b8e7b7;Sat Aug 12 04:18:44 EDT 2006;Committer;nobu;1;128;128;256;0
e8f04ce44ac067b3080ae083b4ccb2cf066b2654;Fri Aug 11 22:45:09 EDT 2006;Committer;drbrain;1;8;0;8;0
c3321a0266d93df206186461c0d53fe1c01b1ca0;Fri Aug 11 22:39:12 EDT 2006;Committer;drbrain;1;1;1;2;0
d7ca9c352c94e013006594c4476e3ba878704893;Fri Aug 11 22:31:05 EDT 2006;Committer;drbrain;1;3;3;6;0
d7181ca93e7bcc30a983e7a840e53704614274d9;Fri Aug 11 22:31:02 EDT 2006;Committer;drbrain;1;3;1;4;0
2c303028794b8e888d94b7ca8cef10438640c959;Fri Aug 11 11:13:11 EDT 2006;Committer;nobu;1;3;3;6;0
a2328a92b4eb6d5607d9bf51dbbcb6282be9e463;Fri Aug 11 11:13:05 EDT 2006;Committer;nobu;1;2;2;4;0
8ce57567b998b0f7a750718edf03d4ffebbd0469;Thu Aug 10 02:44:07 EDT 2006;Committer;akr;1;3;3;6;0
303a9831a5786d7224e3146f50df743bbbfe9d31;Thu Aug 10 02:44:02 EDT 2006;Committer;akr;1;2;2;4;0
2ff719fcd190dd297e191a3f0cf086d6204af853;Wed Aug 09 07:56:30 EDT 2006;Committer;matz;2;10;2;12;0
7e5324e6c110616dc7082962e78dc6af939743b2;Tue Aug 08 15:17:06 EDT 2006;Committer;matz;2;11;5;16;0
8adcd1d2b8b62fb728fbc3b05d51558625038b6d;Tue Aug 08 15:16:23 EDT 2006;Committer;matz;1;3;3;6;0
8b5942801d0d947ffccb2e5ec250e6863db0d5d5;Tue Aug 08 10:29:02 EDT 2006;Committer;matz;3;12;3;15;0
6297f4c8bc06ad4c49871601f11f28a0c38b1dc6;Tue Aug 08 03:29:01 EDT 2006;Committer;nobu;1;3;3;6;0
41066ad0b75cf568879d42f574b05edaa2600691;Tue Aug 08 03:28:58 EDT 2006;Committer;nobu;2;11;7;18;0
0c724c2734a079513776b541fa4979bd6ba7b4ad;Mon Aug 07 13:19:14 EDT 2006;Committer;tadf;2;4;10;14;0
1293d0dbc6416cf9f05eee9a0c36eae83dd34ad3;Mon Aug 07 09:01:27 EDT 2006;Committer;matz;6;18;4;22;0
e382f7f00ebf19497c4956ef7744381eba875d43;Mon Aug 07 06:17:38 EDT 2006;Committer;matz;2;10;4;14;0
50ef220b5a60260dd44d994a99f2baee9f8582f4;Mon Aug 07 05:44:43 EDT 2006;Committer;matz;4;38;18;56;0
275f12623df02daf3ee121da50997b224cfa593a;Mon Aug 07 03:37:47 EDT 2006;Committer;matz;5;10;13;23;0
2104a366f6c6796d08834e5946aeeee976244066;Mon Aug 07 03:36:56 EDT 2006;Committer;matz;1;3;3;6;0
92077ee68799ea9eacc59c1a98f0c481632c67de;Mon Aug 07 03:36:52 EDT 2006;Committer;matz;2;7;2;9;0
50ef71fa1e6a003da57d764858a134d220242f44;Sun Aug 06 11:41:12 EDT 2006;Committer;tadf;2;6;2;8;0
6839b72dc54dad0b48a2e98f70996b7f3342be8a;Sun Aug 06 08:14:09 EDT 2006;Committer;akr;1;3;3;6;0
e91bdce87766118b9be77839fb7db65b11e38015;Sun Aug 06 08:14:05 EDT 2006;Committer;akr;2;8;5;13;0
d92db05a27d7c97386dfa8bc77fb865aba9df751;Sat Aug 05 13:54:40 EDT 2006;Committer;kosako;8;437;133;570;0
7e10b0c4de56dd727ca6adb3264b0867b275437d;Sat Aug 05 04:55:00 EDT 2006;Committer;tadf;2;13;4;17;0
08c031f3214915e4ca8a6d78537e2bfeface0284;Sat Aug 05 02:07:23 EDT 2006;Committer;matz;1;1;1;2;0
6ffe2a4dbfae85ad971b2806b978656e7725d0d5;Fri Aug 04 21:47:55 EDT 2006;Committer;drbrain;1;12;12;24;0
8bd9d238b7f0381d8a74519101b1fca684faa5ee;Fri Aug 04 21:00:31 EDT 2006;Committer;drbrain;1;2;0;2;0
e2c017a8ceb84a95da28fe54b51afb6e58a0d8f9;Fri Aug 04 20:39:28 EDT 2006;Committer;drbrain;1;22;23;45;0
47cc055023fd93018cfe5b4cf4ecef02893d5836;Fri Aug 04 19:21:20 EDT 2006;Committer;drbrain;1;8;0;8;0
54441753a495065853717f9cf23e56b919213e9a;Fri Aug 04 19:12:47 EDT 2006;Committer;drbrain;1;56;3;59;0
75a60a817427d0aa6c632d8d21ef14ae1f97a3ef;Fri Aug 04 19:07:41 EDT 2006;Committer;drbrain;1;1;3;4;0
2311929dd170de91319b0e6bd0fee910f6d2c551;Fri Aug 04 18:12:07 EDT 2006;Committer;drbrain;1;2;0;2;0
050f637941f0e91e62233c0722c2c0f4faabe450;Fri Aug 04 18:10:34 EDT 2006;Committer;drbrain;1;1;0;1;0
52c034aecb365c6cf2a41b8648c3e87fb335fdaf;Fri Aug 04 18:05:50 EDT 2006;Committer;drbrain;34;327;314;641;0
4db2df633cc784c40e21b3df38fe9a6dd1b0ff0b;Fri Aug 04 18:05:42 EDT 2006;Committer;drbrain;1;3;3;6;0
a97af1c6aa2a8cb0be79ceb9c4b51acf3b70bbaa;Fri Aug 04 11:46:44 EDT 2006;Committer;matz;2;9;3;12;0
90ba0eac46b92f0249992fa056877d1b6e55d063;Fri Aug 04 10:16:56 EDT 2006;Committer;keiju;1;5;0;5;0
c5f550c06918c7a0158f8f4e843b4a16dfb03c8a;Fri Aug 04 10:06:17 EDT 2006;Committer;keiju;3;38;24;62;0
d040c69a585f2a05385a81b5a3d34d80bc7118fa;Fri Aug 04 05:02:54 EDT 2006;Committer;nobu;2;8;2;10;0
9b4a611547f5c294a85200e26d66125ed990ce8b;Fri Aug 04 04:58:25 EDT 2006;Committer;nobu;2;10;3;13;0
140fad80c9f0857d6625eb95297e6fb6d2eec149;Thu Aug 03 16:30:50 EDT 2006;Committer;akr;1;3;3;6;0
a5be27e2cf41d22a5fa57bd9fe8566acf7dde0cd;Thu Aug 03 16:30:46 EDT 2006;Committer;akr;2;9;2;11;0
bba7dd463077009e8222b3fcbaa7d77ef789148e;Thu Aug 03 06:21:07 EDT 2006;Committer;matz;1;4;4;8;0
0d15c66aafdbc537a1331c2b93d26cb7348a34cf;Thu Aug 03 06:21:03 EDT 2006;Committer;matz;2;8;0;8;0
800c7ad39bbb1871b510b1393045601c1d2b8c4b;Mon Jul 31 08:32:22 EDT 2006;Committer;usa;1;0;1;1;0
2982c5289210c02120172bf631270858681d031d;Mon Jul 31 07:58:34 EDT 2006;Committer;usa;2;45;19;64;0
ed2c204a2f60cae73de2071b5648b60d83efb353;Mon Jul 31 07:18:43 EDT 2006;Committer;akr;2;11;1;12;0
ec85d62a07de9ad25abda9d95285097117cb403f;Mon Jul 31 06:34:10 EDT 2006;Committer;matz;2;18;5;23;0
4c86e4a580fc172b0f524a371c133d6d990022d0;Mon Jul 31 06:31:38 EDT 2006;Committer;matz;3;22;7;29;0
ddc38a6abbd94df58a99c6aff43e4ab71a7132a2;Mon Jul 31 04:39:45 EDT 2006;Committer;gotoyuzo;3;65;1;66;0
b3e961b32b521bf92cb74520393683fd22497e91;Mon Jul 31 04:39:39 EDT 2006;Committer;gotoyuzo;1;3;3;6;0
799a6bc67ba9e076a8b75c5ce076b010df17df94;Sun Jul 30 14:27:01 EDT 2006;Committer;nobu;2;12;1;13;0
d28d1a2e0a0162a3930f17e0181b0a0197291701;Sun Jul 30 14:06:50 EDT 2006;Committer;nobu;3;14;24;38;0
eafe72d8cf7e38fbb63815cb3250e7966423cf4f;Sun Jul 30 13:30:23 EDT 2006;Committer;nobu;1;3;3;6;0
782d8df4f526f01f35765add20f8bbde7407d884;Sun Jul 30 13:30:19 EDT 2006;Committer;nobu;2;6;0;6;0
567ded60735fde0bb0e7d0eb9c319651d39c5146;Fri Jul 28 21:14:30 EDT 2006;Committer;nagai;2;5;1;6;0
2a0b4cc13c167208035c363a96b67a4f08bc393d;Fri Jul 28 21:14:26 EDT 2006;Committer;nagai;1;3;3;6;0
dab5f82b81a738c38fa34a17645232baf2736dea;Fri Jul 28 08:18:22 EDT 2006;Committer;nobu;2;18;16;34;0
35526b1b00e7c47bd0736b1d2dcaadbaea736355;Fri Jul 28 05:10:03 EDT 2006;Committer;matz;2;5;1;6;0
94f9fc2b6efa59a6636c25d263f09bd0964ebab9;Fri Jul 28 01:43:10 EDT 2006;Committer;matz;2;7;2;9;0
ae832cfa6636bd9f17fa8ed36eb602dfd646ffdb;Fri Jul 28 01:23:55 EDT 2006;Committer;matz;2;12;1;13;0
9121d687c5ec1322ce65543d377e4a025ba91908;Fri Jul 28 00:47:26 EDT 2006;Committer;matz;2;5;1;6;0
f0dff3c67789523efd8ae930a8b2aa071fcde071;Thu Jul 27 15:29:30 EDT 2006;Committer;matz;2;8;4;12;0
793a952bc6fa889ecd46aa536f10aae5cc828321;Thu Jul 27 15:26:17 EDT 2006;Committer;matz;1;3;3;6;0
21f5f472875cff6f0b2d1e106876fe6ad36cc55c;Thu Jul 27 15:26:14 EDT 2006;Committer;matz;2;40;27;67;0
41005d43a899e04b21057883b0a626d499c4dfd0;Thu Jul 27 13:23:18 EDT 2006;Committer;nobu;2;5;1;6;0
a78b09b110ed3d4a3e3f9488f52512439a00746f;Thu Jul 27 09:14:38 EDT 2006;Committer;eban;2;5;0;5;0
10496cefeb08b60c3b0bd9f4502934fa39e30ee6;Thu Jul 27 08:25:18 EDT 2006;Committer;matz;2;12;5;17;0
b0283eed4377fee555ac7703a5d329092d018f04;Thu Jul 27 07:48:04 EDT 2006;Committer;matz;3;15;12;27;0
b6151bcebe327a8f8a2cfd6c708f2fb2fc4c77a7;Thu Jul 27 00:15:10 EDT 2006;Committer;matz;1;3;3;6;0
e8ed635174402f9f99bde387bd1daa25c0310447;Thu Jul 27 00:15:07 EDT 2006;Committer;matz;2;22;2;24;0
d09827ad50b9da30c33ea124a20aa4999b783c90;Wed Jul 26 13:28:17 EDT 2006;Committer;matz;3;13;0;13;0
1c499989ee1001e56d72d9b7dfce3641728db217;Wed Jul 26 13:27:18 EDT 2006;Committer;aamine;1;1;1;2;0
429c03eb2a95fe7e9cd74ef4acf94e3765693e4e;Wed Jul 26 13:23:40 EDT 2006;Committer;aamine;1;74;3;77;0
e1173b2c78ad8537da935606d61ecbc775c152b1;Wed Jul 26 13:00:26 EDT 2006;Committer;aamine;3;69;12;81;0
c9500ee8d94e0ff1ac600b14998ba23bc7e743ef;Wed Jul 26 09:41:08 EDT 2006;Committer;aamine;2;9;1;10;0
c0a80890440ff24e8dbd704204856d62feb3142c;Wed Jul 26 09:40:05 EDT 2006;Committer;matz;4;32;14;46;0
0cd59e5b59750989ead8bf5c52f34c6cd16eccc9;Wed Jul 26 09:15:31 EDT 2006;Committer;nobu;2;32;20;52;0
544789bd79bc3d63d52c69fa820e1ae768a9057e;Wed Jul 26 08:44:57 EDT 2006;Committer;aamine;3;15;7;22;0
79c5eb1af36690c6d45975b3db93613819230bc3;Wed Jul 26 08:28:57 EDT 2006;Committer;nobu;2;21;18;39;0
69be57eb57a7318f8fd806e806f6a092d9689e8f;Wed Jul 26 07:43:16 EDT 2006;Committer;matz;2;7;0;7;0
b8034ca54f62a3e85970114a86729b1c4b9c1a8f;Wed Jul 26 07:09:32 EDT 2006;Committer;matz;2;9;0;9;0
790b03ca0073f933efb03b869fb9d53fa4d42bda;Tue Jul 25 16:04:38 EDT 2006;Committer;nobu;1;3;3;6;0
d485f6e7d0751a65a19e98bb8867a71d04b7e07d;Tue Jul 25 16:04:35 EDT 2006;Committer;nobu;2;9;5;14;0
c0eb19d91a59f49255f9a6758234fe604a976048;Tue Jul 25 05:50:45 EDT 2006;Committer;usa;2;5;1;6;0
911835137412ad0fc487e9cd9273558a6f5a3cd6;Tue Jul 25 04:58:18 EDT 2006;Committer;matz;1;3;3;6;0
cb657243da67646d0e97d92c70b3b04afb7edac0;Tue Jul 25 04:58:15 EDT 2006;Committer;matz;2;17;12;29;0
c0e5d45a1ef899bce5104ac95ff48ba3a5cb809c;Mon Jul 24 14:53:42 EDT 2006;Committer;nobu;1;1;1;2;0
2e7a8bf228873763d15c3c2842fb8f909a406b81;Mon Jul 24 13:04:39 EDT 2006;Committer;nobu;2;7;1;8;0
b8d19fa683a5c2277695920cccbac76a84c6604b;Mon Jul 24 07:21:45 EDT 2006;Committer;akr;1;2;2;4;0
93d5566170ad74e41a764bf622e9852422616e67;Mon Jul 24 07:02:20 EDT 2006;Committer;matz;2;5;1;6;0
77146ae7cb6f6a5c7b081c93476ba9918d9a08c5;Mon Jul 24 06:55:26 EDT 2006;Committer;akr;2;8;1;9;0
b8b993c182f82294bdef30d2939f551e04ca526f;Mon Jul 24 06:54:53 EDT 2006;Committer;akr;1;3;3;6;0
fd7f570cb267e74d47d687da6a5f55a325910fa2;Sun Jul 23 14:03:28 EDT 2006;Committer;akr;2;6;1;7;0
9ca1b5fc8efe491ae4acda5f9bcf0c9d00adad11;Sun Jul 23 14:03:22 EDT 2006;Committer;akr;1;3;3;6;0
b4f1270f6d0249894bd57ed42db8595655245eca;Fri Jul 21 14:58:18 EDT 2006;Committer;nobu;2;10;7;17;0
7265bd401d5c68697bfa1405a7e45be80be60595;Fri Jul 21 14:53:11 EDT 2006;Committer;matz;2;8;3;11;0
252d273832fd0baaed91f01d96c5381ac4707fef;Fri Jul 21 12:22:08 EDT 2006;Committer;nobu;2;6;0;6;0
53f6b89e7e2f9c602e12ed840e374690ef04a4d4;Fri Jul 21 03:12:45 EDT 2006;Committer;nobu;3;15;6;21;0
58f09b091649b5e575c16f6a6b98fcac32ac7c84;Thu Jul 20 19:20:31 EDT 2006;Committer;matz;4;51;299;350;0
c09cea5e1ba4e6d103fad9e6c6cbf29560abf78b;Thu Jul 20 17:36:36 EDT 2006;Committer;matz;18;44;41;85;0
b5d9cbe8e8bb5c0eb826ce68a81aa5579359b5e8;Thu Jul 20 17:30:01 EDT 2006;Committer;matz;2;24;41;65;0
8eb21778d88a40f9b7b3fa74b6a2104e41227e38;Thu Jul 20 17:26:32 EDT 2006;Committer;matz;2;10;6;16;0
0a7abb6a6c0f67eb5364ed4c471914e216d56deb;Thu Jul 20 17:25:53 EDT 2006;Committer;matz;1;3;3;6;0
3cd703f160ccc035f2fd71e90ecfef123344358d;Wed Jul 19 14:18:20 EDT 2006;Committer;keiju;1;20;4;24;0
cb3e51e712717ca58c004cea31a5a998d78c6433;Wed Jul 19 13:52:03 EDT 2006;Committer;matz;2;8;2;10;0
f724560996316019d298c6ca0df2a8891bea2da3;Tue Jul 18 18:28:20 EDT 2006;Committer;ryan;1;3;3;6;0
491d4412a804e04e3ac41398213af7f023283a97;Tue Jul 18 18:28:16 EDT 2006;Committer;ryan;1;1;1;2;0
553bba0b4734f2fbf4ccf09523ba1c91d5659ad6;Tue Jul 18 14:55:28 EDT 2006;Committer;usa;2;9;0;9;0
6b87ac68dba3d8967d76233766a174c8a82813e3;Tue Jul 18 14:36:15 EDT 2006;Committer;matz;2;20;10;30;0
1921fbce45fc87ca7932b11881a5714ae12b5d0c;Tue Jul 18 14:13:07 EDT 2006;Committer;usa;2;11;1;12;0
7318a6db760e28e023fec51375f3efdf9e8fb416;Tue Jul 18 07:54:26 EDT 2006;Committer;matz;2;8;1;9;0
df80a7b4bb326d701cbee9849cd47f19a45ff32e;Tue Jul 18 07:02:35 EDT 2006;Committer;matz;2;19;5;24;0
9d6e1cdb73e59ac188fa10a35cbc8a11f1d2a4d7;Tue Jul 18 06:22:28 EDT 2006;Committer;usa;4;79;3;82;0
ddbebabd25dd8031bda5e31f061b89433c72b9e3;Tue Jul 18 05:48:01 EDT 2006;Committer;matz;2;6;0;6;0
e7d8263f77fe59d60686e6a6ddc1dce29d27fae7;Tue Jul 18 05:08:37 EDT 2006;Committer;matz;2;6;1;7;0
4a1513e2fb71b3fe8a67fdde3189e3857daa855d;Tue Jul 18 01:55:15 EDT 2006;Committer;nobu;3;22;6;28;0
575f1320d419d53c43eb4e0b7e52cfb674fcdadb;Mon Jul 17 18:22:16 EDT 2006;Committer;drbrain;2;109;125;234;0
894c9e5e45cc499212602434d098dae66609501e;Mon Jul 17 16:19:19 EDT 2006;Committer;nobu;1;5;0;5;0
3687809c6aed9741c25b9f14de2cb77242fbd73f;Mon Jul 17 15:43:47 EDT 2006;Committer;nobu;1;2;2;4;0
99f9ac64a7099ba31c00e0c23bcfad0f27fc9ec0;Mon Jul 17 15:03:19 EDT 2006;Committer;nobu;2;7;0;7;0
1427f340b1c1805f179136c0921099e14b2ee63c;Mon Jul 17 15:03:12 EDT 2006;Committer;nobu;1;3;3;6;0
c993c31c541d875596128ec15d038992ca6554dd;Mon Jul 17 14:32:02 EDT 2006;Committer;nobu;2;12;7;19;0
13556ea5ee72c4d0fd94693ebf58d3bcde8d59f7;Mon Jul 17 13:59:09 EDT 2006;Committer;matz;4;15;7;22;0
0227035dd379c4345084fe3fccb1925147549a9e;Mon Jul 17 04:22:46 EDT 2006;Committer;eban;2;2;2;4;0
92a6541a3f5c98bc19d91d20770a7e9f560b604a;Mon Jul 17 04:04:15 EDT 2006;Committer;eban;2;5;0;5;0
14824b508440a5c13abd5ccfcfe7a9cfa9e0b59c;Mon Jul 17 02:49:05 EDT 2006;Committer;usa;1;3;3;6;0
c5aae656e5d0f6f16cb58fd94411665dc53c086f;Mon Jul 17 02:49:01 EDT 2006;Committer;usa;2;5;0;5;0
b3fd4cf8334dcf5fa6e1e999a013348ef90a651f;Sat Jul 15 02:38:26 EDT 2006;Committer;akr;1;0;1;1;0
59f6a1a5d4c74a3550e741361afe32cbda4888de;Fri Jul 14 16:13:45 EDT 2006;Committer;matz;1;3;3;6;0
434c9e7b9f4a97240f69ab0d8cc46cf726f96d52;Fri Jul 14 16:13:41 EDT 2006;Committer;matz;2;12;1;13;0
89e1e190835430068472d12450b538ad351871b9;Fri Jul 14 04:10:51 EDT 2006;Committer;nagai;3;40;4;44;0
58f761cf82ad0815f3dfad065576c1b5523bb8f8;Thu Jul 13 19:00:52 EDT 2006;Committer;drbrain;1;1;0;1;0
1378251dc19c411703dff32b9ef492a1f30a0167;Thu Jul 13 17:33:04 EDT 2006;Committer;matz;2;31;0;31;0
7faec1fb7290fc13e5b71c234786b8d77525ef48;Thu Jul 13 15:13:00 EDT 2006;Committer;matz;1;3;3;6;0
05a34a764d376a9e4a400bd6989bb6a2e6ea6d17;Thu Jul 13 15:12:56 EDT 2006;Committer;matz;2;7;1;8;0
5d11f0072c0a9b1e2dacd9b21fc6db0974c62d4f;Thu Jul 13 13:27:20 EDT 2006;Committer;nagai;3;107;1;108;0
0c699701ff642f828fd38c4a40da9b2ab5b9694d;Wed Jul 12 15:54:57 EDT 2006;Committer;matz;1;3;3;6;0
d50b2d8d49f4ebaa837d8948b202a464072c21de;Wed Jul 12 15:54:53 EDT 2006;Committer;matz;2;10;3;13;0
04b473c5cdd4a81f75bedee0553beabc4358e716;Wed Jul 12 11:10:26 EDT 2006;Committer;matz;1;3;3;6;0
ead9b197be96f9eacf462b5539f71c43422495d0;Wed Jul 12 11:10:22 EDT 2006;Committer;matz;4;56;7;63;0
56b42dec015337f6a1a30aee1a6e6364ded3e468;Tue Jul 11 10:15:47 EDT 2006;Committer;nagai;2;9;2;11;0
2ea953a7e776ac63f14d196f2717a556a76d7506;Tue Jul 11 09:04:00 EDT 2006;Committer;nagai;3;11;3;14;0
6f535f34c54e06689f30178cc2bef2b511eac6a9;Tue Jul 11 08:34:28 EDT 2006;Committer;usa;2;5;1;6;0
1db0db3ba0b90787e9db8c2dc72bfed879d5ee20;Tue Jul 11 06:47:09 EDT 2006;Committer;matz;6;65;42;107;0
4bacdc1e46ab788f9285ccd8eccd2776260f9528;Tue Jul 11 05:00:02 EDT 2006;Committer;matz;8;63;22;85;0
fd66442a1d8cec73a14601f8056b9fad238f92be;Tue Jul 11 00:26:19 EDT 2006;Committer;akr;1;3;3;6;0
599de8d7f182f4e9e15adc92dc19f609d68c7c1d;Tue Jul 11 00:26:15 EDT 2006;Committer;akr;1;0;2;2;0
6d67a688f2a4115654811945257177b75b29f94f;Mon Jul 10 10:26:45 EDT 2006;Committer;akr;2;15;2;17;0
203c2e18f50efd0323bd9236debea8daee8b5d13;Mon Jul 10 10:01:36 EDT 2006;Committer;nagai;2;5;1;6;0
d2271cbdd18ea55851f21abd8862e5a3b6b98c9b;Mon Jul 10 09:52:30 EDT 2006;Committer;nagai;9;543;40;583;0
a1a07fbfa1c0263cf3e51eca2bf2907a917bde5c;Mon Jul 10 08:37:37 EDT 2006;Committer;matz;4;37;22;59;0
c4ad5309f9cb4cd5c579360d36552f58a7239b35;Mon Jul 10 05:48:10 EDT 2006;Committer;matz;2;5;1;6;0
c258ca6012ac4df80e1387b780e4586a6496554a;Mon Jul 10 05:01:08 EDT 2006;Committer;nagai;2;12;0;12;0
c1699f2a2ec9ecfe22fbfde7bd591c4715b317cf;Mon Jul 10 02:02:54 EDT 2006;Committer;usa;1;1;1;2;0
672549bb47cdf3ccbd6d91697941dadf7328617e;Mon Jul 10 01:08:15 EDT 2006;Committer;matz;7;124;40;164;0
021336c36f9154b71bcd4a3cd9f18dcf73e1e6c9;Mon Jul 10 00:30:46 EDT 2006;Committer;nobu;1;3;3;6;0
4696270c72b7eb45e4007e24fff858e3e08945aa;Mon Jul 10 00:29:43 EDT 2006;Committer;nobu;2;7;1;8;0
624ae6837937edb369020a9dabdb2a9e8ee5ae6b;Sun Jul 09 09:07:42 EDT 2006;Committer;nobu;2;5;2;7;0
c27f8d5b3a939befbbb7d206195693835a8e0dcb;Sun Jul 09 09:05:47 EDT 2006;Committer;nobu;2;30;29;59;0
2bf2f48a0be06e57d596968358ff60f57e488b0d;Sat Jul 08 23:17:53 EDT 2006;Committer;ryan;7;55;18;73;0
8e1789ded76520406b9aba9ab47194b9257e83aa;Sat Jul 08 22:25:45 EDT 2006;Committer;ryan;1;1781;59;1840;0
b3c82bacc6494c5fd1ac3121549fd897f90c330e;Sat Jul 08 15:55:43 EDT 2006;Committer;nobu;1;3;3;6;0
b922355c0d386e7f20f9299eff69307677f791d8;Sat Jul 08 15:55:37 EDT 2006;Committer;nobu;2;34;3;37;0
e6948e5334d0d18b517fb8536fa4f527464c4620;Sat Jul 08 08:57:05 EDT 2006;Committer;akr;1;4;0;4;0
4f559b97769f43fbf73b555db756df86820b14cb;Fri Jul 07 22:19:51 EDT 2006;Committer;suke;1;3;3;6;0
96921c919c4248d696d65aa1503c6b5023cdba90;Fri Jul 07 22:19:49 EDT 2006;Committer;suke;2;2;2;4;0
a5b2d039d1ee21703ce478de4650e9f3ac597e47;Fri Jul 07 14:19:41 EDT 2006;Committer;ttate;1;7;0;7;0
0fbcc455bd4601ed39919379058fc63f44923cfb;Fri Jul 07 08:49:34 EDT 2006;Committer;nobu;3;12;3;15;0
9dc29ddfd78c9bfb68161d1da922089ab859cbae;Fri Jul 07 05:08:05 EDT 2006;Committer;usa;2;7;0;7;0
d01f22ec7cf339902e82b3c27f227db5117b20ed;Thu Jul 06 19:59:31 EDT 2006;Committer;ttate;4;9;45;54;0
57fe65940c5db82ab6d932c3590578679a95ef6c;Thu Jul 06 19:59:28 EDT 2006;Committer;ttate;1;3;3;6;0
ac2348271a90f724ed3254b5e7a06e9064ec255f;Thu Jul 06 14:30:20 EDT 2006;Committer;nobu;3;35;8;43;0
69aeed5065cdedaa48c9fcc09185a8df354391a7;Thu Jul 06 12:50:51 EDT 2006;Committer;aamine;3;98;61;159;0
c3e411ee8aa346f72e308d331c262128fa111dc1;Thu Jul 06 12:50:45 EDT 2006;Committer;aamine;1;3;3;6;0
8b1d611da4bac7b94a4feb6e3f961fd01c3cd207;Tue Jul 04 18:10:38 EDT 2006;Committer;matz;2;6;1;7;0
845d5d651d454e06036fa3c149b783d5fdafc78d;Tue Jul 04 18:09:27 EDT 2006;Committer;matz;1;3;3;6;0
50a1f9ffbb3ff159b34b4818143e51dfe8257edc;Tue Jul 04 12:50:30 EDT 2006;Committer;usa;2;6;1;7;0
6243e4092053dd53f87fc00a7e5e8a6bb8bcac92;Tue Jul 04 06:22:11 EDT 2006;Committer;matz;2;16;7;23;0
ba5a0701e44c24495728204ca00af0a1a048df7f;Tue Jul 04 06:16:49 EDT 2006;Committer;matz;1;1;1;2;0
1564ed2f0a54c16fb054304edd6514f2fce5ac30;Mon Jul 03 20:07:10 EDT 2006;Committer;matz;9;109;93;202;0
ff1a30b17f5ee8da023b8737195edb7c332eade0;Mon Jul 03 20:06:32 EDT 2006;Committer;matz;1;3;3;6;0
835ea57cd3652919f7e9eb78b9d74245de0510e1;Mon Jul 03 10:08:11 EDT 2006;Committer;nagai;6;317;11;328;0
6f10dfaca7af1d69725b8a9c3a5ee011d1a2d2aa;Mon Jul 03 08:47:54 EDT 2006;Committer;akr;1;3;3;6;0
3051dabd08bb2c3c4a83393edd906744a9c36019;Mon Jul 03 05:42:35 EDT 2006;Committer;nobu;3;10;5;15;0
3dd092d0cef1e074486a04fc8c8d60350480ae33;Mon Jul 03 01:44:05 EDT 2006;Committer;nobu;2;6;5;11;0
e382c5dde3a4fd6664f941dedd74515c41ae7618;Sun Jul 02 20:17:50 EDT 2006;Committer;gotoyuzo;2;5;1;6;0
9a7153419d6e84e5edf940ef4dc1abce81db6a61;Sun Jul 02 16:20:19 EDT 2006;Committer;matz;1;3;3;6;0
d4e2d4ea963207eb969970dabaaa382dd5a89c82;Sun Jul 02 16:20:16 EDT 2006;Committer;matz;2;15;0;15;0
9cd3e4c11c1177f5ffd8f3d2053560f02c049395;Sun Jul 02 14:32:49 EDT 2006;Committer;tadf;1;0;3;3;0
fe42e405abd72e8005b043f33a06d124531e0d1f;Sun Jul 02 10:04:14 EDT 2006;Committer;aamine;2;10;3;13;0
cafdfd306e06a9dcb3168bf27dd9190353ad821f;Sun Jul 02 09:43:11 EDT 2006;Committer;aamine;2;47;48;95;0
62a7c8fb13487b34dcc4c5531231bb5544584231;Sun Jul 02 02:25:11 EDT 2006;Committer;akr;2;9;2;11;0
034b25f79786e1914996d3792d04fa7db678c8f6;Sat Jul 01 16:40:17 EDT 2006;Committer;matz;1;3;3;6;0
bb0687f680dd8d6139a8546e149e3ce47bcef0f8;Sat Jul 01 16:40:13 EDT 2006;Committer;matz;3;10;3;13;0
760e0e2a936ea7bdb2a6a3b65351dbf69659a10c;Sat Jul 01 09:04:51 EDT 2006;Committer;gotoyuzo;1;5;0;5;0
ab0a7bd2fa6991b133dd70ce1cff37d9dc67b9cb;Sat Jul 01 08:03:18 EDT 2006;Committer;gotoyuzo;1;1;1;2;0
8a15f889013afb5c185b1f456754bf8d6ad3e583;Sat Jul 01 07:27:55 EDT 2006;Committer;akr;1;6;2;8;0
ef908a25d8e2d5b1796d9f0d92c2df5dec8c6d78;Sat Jul 01 06:23:21 EDT 2006;Committer;akr;2;11;2;13;0
e587cf273099ee1e0dbaafdc47f220ea8b81e2e9;Fri Jun 30 18:05:40 EDT 2006;Committer;ttate;4;50;34;84;0
abbe9742673fbfc2962a2e11e365e70843e59e9f;Fri Jun 30 18:05:36 EDT 2006;Committer;ttate;1;4;4;8;0
a391419dbbdd4a115a41b6ecf97de46f5ea8d023;Fri Jun 30 14:50:40 EDT 2006;Committer;matz;2;8;1;9;0
02c8eb1ba809ffe9f41228e5152199a9bc607556;Fri Jun 30 10:46:40 EDT 2006;Committer;gotoyuzo;2;7;1;8;0
8fa6e7909d9639423f5d3fed5c6f23b6afe857cb;Fri Jun 30 10:46:35 EDT 2006;Committer;gotoyuzo;1;3;3;6;0
0d2b05ee134a967d9f4c8164455b07cd8e79131a;Thu Jun 29 14:57:42 EDT 2006;Committer;matz;2;7;3;10;0
4df2cb80531c7cd4b10b0dea26f4687c4f74ff30;Thu Jun 29 14:05:40 EDT 2006;Committer;matz;4;22;2;24;0
d7ac2f0cd22999401c6057e7c05c87f474e22306;Thu Jun 29 13:49:23 EDT 2006;Committer;akr;2;7;1;8;0
865dd6f4e79f8770a16fc31ded328f025b3d61fe;Thu Jun 29 10:03:40 EDT 2006;Committer;matz;2;5;2;7;0
60bf66e0cd2c9f519f7dfb27eca134b86ea5dd8b;Thu Jun 29 09:09:33 EDT 2006;Committer;matz;7;705;38;743;0
0c11152794d4f07970a5c36981e95eb176d5fdc8;Wed Jun 28 22:27:20 EDT 2006;Committer;drbrain;1;1;1;2;0
1210bc255cf019cb7de61825ff48792d61b497c0;Wed Jun 28 21:56:01 EDT 2006;Committer;drbrain;2;491;638;1129;0
323746df24bf554c76e08cae532495549a8a42c1;Wed Jun 28 21:55:55 EDT 2006;Committer;drbrain;1;3;3;6;0
47eb32f56424b63ecb6d7fa9c5e1b7355fa1e5f1;Wed Jun 28 14:28:11 EDT 2006;Committer;matz;2;9;7;16;0
91ea1529c69e6c38be71ebe15f8204144c8b7991;Wed Jun 28 10:07:52 EDT 2006;Committer;akr;2;5;18;23;0
ab15a714f875b44f95d18a5e7cc0f67b1c518276;Wed Jun 28 04:51:27 EDT 2006;Committer;nobu;2;8;2;10;0
b6630a375d9c79de6b7ec0d684f7053292be0df5;Wed Jun 28 00:23:57 EDT 2006;Committer;matz;2;5;16;21;0
c7d9ba96cb2d848d3931a2075378daa17b3d62a2;Tue Jun 27 23:13:20 EDT 2006;Committer;matz;2;4;1;5;0
4a497026b6270d6d7d066007e1a2a85b0490b554;Tue Jun 27 16:51:08 EDT 2006;Committer;matz;2;64;52;116;0
197535b5ebfd311e491fbda601a6c26899f81bed;Tue Jun 27 16:15:28 EDT 2006;Committer;matz;1;3;3;6;0
30492d9d53f1d79c1713f3ed4e7c623cd1490884;Tue Jun 27 16:15:22 EDT 2006;Committer;matz;3;10;13;23;0
471e41ec70e18339f72539a6331dcf2fb80d2238;Tue Jun 27 14:14:25 EDT 2006;Committer;matz;5;51;31;82;0
3b989706df0af7d7a3a042cd3470fcee90f208cf;Tue Jun 27 14:02:26 EDT 2006;Committer;matz;1;11;21;32;0
efb806f46c702eabb86e3911f3b5375bf7d6c1b9;Tue Jun 27 13:51:45 EDT 2006;Committer;nagai;3;14;7;21;0
3ea6bebbad4c3b1ce6dd28b543e9931dfa150fb7;Tue Jun 27 07:21:31 EDT 2006;Committer;eban;3;10;0;10;0
6de2f53f986465a0d0d86eb8619ebd7cf5bce1e8;Tue Jun 27 02:37:01 EDT 2006;Committer;nobu;3;25;7;32;0
8ae45d642f086128e9f632cb8320d78bf5528735;Tue Jun 27 01:48:29 EDT 2006;Committer;akr;2;8;1;9;0
90952d32f80e3733e9895f296aea067a828d0143;Mon Jun 26 18:10:30 EDT 2006;Committer;drbrain;4;124;36;160;0
b73e6801e30e4bd8f57d2f54cb479deaf95b74fb;Mon Jun 26 16:39:59 EDT 2006;Committer;akr;4;141;135;276;0
018c600103391f39ba6b0ecd28c939f6058fe7a2;Mon Jun 26 16:05:24 EDT 2006;Committer;eban;1;3;3;6;0
dcb5d04374748714f8fea2bbf75391c236e1a93d;Mon Jun 26 15:52:50 EDT 2006;Committer;nobu;2;6;0;6;0
429cb7c025157e21aae2de4ab2072a6d1b10f88d;Mon Jun 26 15:09:45 EDT 2006;Committer;akr;2;21;4;25;0
61f3ff8d78192b0cc9115059e9340a8e57781705;Mon Jun 26 14:43:06 EDT 2006;Committer;nobu;2;6;1;7;0
e5f2b421c0b5134a58a4cf45234f54c376fd1297;Mon Jun 26 14:15:49 EDT 2006;Committer;matz;7;475;373;848;0
6fa7d6cb014334082f020e57c248de6ea4a30b94;Mon Jun 26 09:41:34 EDT 2006;Committer;nagai;2;5;2;7;0
439600afbd818eebde13580a7cf9f9152c3cbe4a;Sun Jun 25 14:03:10 EDT 2006;Committer;nobu;3;20;20;40;0
6f9183d6506b68d2cdb7a33a02c14c2718241629;Sun Jun 25 09:42:05 EDT 2006;Committer;akr;2;2;0;2;0
1615bce205048207caa5b1465cd59b8ab4bfbbf5;Sun Jun 25 08:47:31 EDT 2006;Committer;akr;1;1;1;2;0
6143716587d9ead0d3f632c5e61cd5592e1047f2;Sun Jun 25 08:45:44 EDT 2006;Committer;akr;2;6;1;7;0
afdc2b89bd11699fc44a473c8f890e175c728f52;Sun Jun 25 08:21:29 EDT 2006;Committer;suke;3;57;14;71;0
38321af30c6c797262c1e8c24da74d979dc88028;Sun Jun 25 08:16:44 EDT 2006;Committer;suke;1;4;4;8;0
b2df5084b47abbb14de6401e6a70054c22af722c;Sun Jun 25 08:15:06 EDT 2006;Committer;suke;1;1;1;2;0
abeddbf66a95929dc0255ad580e840b7a711708f;Sat Jun 24 16:31:45 EDT 2006;Committer;eban;1;3;3;6;0
32f499f9d54e53f2456bae58ab556275d75ec4a4;Sat Jun 24 15:38:21 EDT 2006;Committer;akr;1;1;1;2;0
f20b5c99957a01d246b95d100046fb4d57d6fcec;Sat Jun 24 14:58:22 EDT 2006;Committer;akr;1;2;1;3;0
bb87f28346746d02aa7cb9ea7d49d03a3d8452ef;Sat Jun 24 14:52:59 EDT 2006;Committer;akr;3;16;6;22;0
b72f065343d876c6ea59cc7c883b8ee01b4e7506;Sat Jun 24 03:42:23 EDT 2006;Committer;eban;1;3;3;6;0
934847fbeb7e6b08012c8049d8b2dc2f4d89f702;Sat Jun 24 01:15:08 EDT 2006;Committer;akr;25;26;0;26;0
a1dc1d6a8cf4d1d4776a13dbb8574a8c28e1a5bb;Fri Jun 23 14:39:01 EDT 2006;Committer;akr;4;7;3;10;0
f6ef26c41103952641cca36fe51eba1e804fdce7;Fri Jun 23 13:03:23 EDT 2006;Committer;nobu;1;1;1;2;0
ac9910e7279237182f53196499b337d98fb23cbd;Fri Jun 23 08:28:04 EDT 2006;Committer;nobu;2;10;81;91;0
ab639803258fef9234a271c34ca62417e2de76d0;Fri Jun 23 02:01:26 EDT 2006;Committer;eban;1;3;3;6;0
dd01cf986908b70ce9c2a0e7758d442364ba33ea;Fri Jun 23 01:52:11 EDT 2006;Committer;matz;2;6;1;7;0
40247309592de8592e5c023fd74a4d207caa202f;Thu Jun 22 02:49:28 EDT 2006;Committer;matz;2;7;2;9;0
cb6f1b4f2e402e02d469c5168e410e38ec913431;Thu Jun 22 01:41:32 EDT 2006;Committer;eban;1;3;3;6;0
66de9ef3496793095176fb9cfa12480d7386b379;Thu Jun 22 01:39:44 EDT 2006;Committer;matz;2;11;0;11;0
b77a4e2a4eeec6e5b55a0a8a662eff05f1f0a326;Wed Jun 21 20:19:07 EDT 2006;Committer;akr;2;14;7;21;0
274ae70db28a10ef2c25c65b595d0e3820a22229;Wed Jun 21 12:23:58 EDT 2006;Committer;tadf;2;7;2;9;0
bc6a1d8dcfae8b3cdc85fd1f7e6ba66a88a2a867;Wed Jun 21 08:32:22 EDT 2006;Committer;usa;4;12;5;17;0
7dd70df4b014f4bd87e02641c60ecdd929b2797b;Wed Jun 21 08:20:12 EDT 2006;Committer;matz;2;8;3;11;0
2ca2a4a43bb018bfd84fccc75e395c1f0e58acc6;Wed Jun 21 08:08:36 EDT 2006;Committer;matz;6;60;38;98;0
ad5f0fc6ccba716676a40c0a635fd41a8a782d4a;Wed Jun 21 07:08:34 EDT 2006;Committer;akr;1;12;7;19;0
7b5d9d70860a5441b8084c255b2fc493418f0baf;Wed Jun 21 05:13:48 EDT 2006;Committer;matz;4;34;19;53;0
1b7465e893131c8a8b27078704223ecfb2311119;Tue Jun 20 18:02:17 EDT 2006;Committer;matz;25;254;567;821;0
866e083484738db8ba8b8b37674d9292ef7cb84a;Tue Jun 20 16:46:41 EDT 2006;Committer;eban;1;3;3;6;0
e394fed724ade7b8669d6d793dc09e270f0d3d7e;Tue Jun 20 16:40:35 EDT 2006;Committer;nobu;2;6;1;7;0
8446b6c59b3c9eb7c3b6c2163e1c7b26b9359e79;Tue Jun 20 14:28:49 EDT 2006;Committer;nobu;3;16;6;22;0
3be20019c163681f0de4dd8185ed46dace888520;Tue Jun 20 06:09:04 EDT 2006;Committer;matz;3;82;71;153;0
765c807219e388ecd32b49a8598e124ff20d445c;Tue Jun 20 02:34:53 EDT 2006;Committer;eban;1;3;3;6;0
905cd041c9b5a8f7de52357341a08d41cf972c05;Mon Jun 19 22:07:42 EDT 2006;Committer;drbrain;1;3;0;3;0
a6db3fc7b8702b485d87f6bdd7e914905104ab16;Mon Jun 19 14:44:30 EDT 2006;Committer;naruse;1;7;0;7;0
a59c6fe7c953e2f427cf3f622cd94e1634828a43;Mon Jun 19 14:40:23 EDT 2006;Committer;naruse;1;35;16;51;0
5c691de4421e7a5c397781a61e1826bc46a892eb;Mon Jun 19 14:25:06 EDT 2006;Committer;naruse;4;739;734;1473;0
cd15cdca77ec21a740a8dfff19062d65fd87a7f0;Mon Jun 19 11:00:12 EDT 2006;Committer;suke;1;18;13;31;0
9612bd51f4bf7da06c34081d7b7e81e826746fdd;Mon Jun 19 08:19:18 EDT 2006;Committer;matz;2;15;2;17;0
e3cd29bc634381f198f1d3d4d445dd658986098a;Mon Jun 19 07:14:28 EDT 2006;Committer;matz;3;9;2;11;0
4ee699999d448d18f84df6e8031253df504ec2bf;Mon Jun 19 04:10:42 EDT 2006;Committer;matz;2;13;13;26;0
3cbe44686706250108f2c31dd56d3cd3bc049e47;Sun Jun 18 15:07:23 EDT 2006;Committer;eban;1;3;3;6;0
60976b119fc87722a52fe886b1cb3a76592f1d11;Sun Jun 18 15:05:01 EDT 2006;Committer;nagai;2;7;2;9;0
6dea5cdb5be0761b42dd8dc7fb7c32aebd2c3d9e;Sun Jun 18 13:59:01 EDT 2006;Committer;usa;1;3;3;6;0
33311b653cca4bb3ac0b209f3b7ce23e3e4defb8;Sun Jun 18 11:34:53 EDT 2006;Committer;suke;4;74;4;78;0
20afef590bf76cb1a65eb327b7582cce3b3b0565;Sun Jun 18 03:04:48 EDT 2006;Committer;drbrain;1;1;0;1;0
7b484902220ded077a37a3a2e4587df2fe27f5e0;Sat Jun 17 14:50:04 EDT 2006;Committer;matz;7;363;356;719;0
7d274ff6fbb97c3ac8ee0ce6903f0e77b05e0b07;Sat Jun 17 05:59:29 EDT 2006;Committer;akr;3;54;6;60;0
eeda97f8e39354d8a57c5bdd3ab0b5e4bda22a0d;Fri Jun 16 17:05:22 EDT 2006;Committer;akr;2;14;1;15;0
53a31d9df49cd67a57240d52c881ebf609583fc6;Fri Jun 16 15:31:00 EDT 2006;Committer;eban;1;3;3;6;0
9d070290493e52d31b0fcc4f35e4651b14dd8283;Fri Jun 16 15:24:40 EDT 2006;Committer;nobu;2;5;1;6;0
2bb2f41d37c8469fc95489040004a9c6d9bbd468;Thu Jun 15 16:43:55 EDT 2006;Committer;eban;1;3;3;6;0
e0648d6cf540d92983fd8ec232e4e666290c8e7a;Thu Jun 15 16:41:28 EDT 2006;Committer;nobu;3;8;2;10;0
c703f58807c35f9166886f993d91dfdda6643d65;Thu Jun 15 08:29:15 EDT 2006;Committer;akr;1;20;1;21;0
8317037ce50f06bbe047a8df55312ab6f116fc2d;Thu Jun 15 07:07:09 EDT 2006;Committer;akr;1;2;2;4;0
bd7bd6427bdda2558470e38781252f9cfc33c111;Thu Jun 15 06:43:29 EDT 2006;Committer;akr;1;0;4;4;0
511626799f475557c00220e807d84c94769cde36;Thu Jun 15 03:39:20 EDT 2006;Committer;akr;1;13;0;13;0
919d775dfb2ed057b796c2127e6664c8f3182e92;Thu Jun 15 01:49:18 EDT 2006;Committer;eban;1;3;3;6;0
bb58656b741544f9c9a36c3ccd79722331323723;Thu Jun 15 01:15:11 EDT 2006;Committer;drbrain;2;5;1;6;0
9a811c98e60fd1f613e185d13808bc908759ff88;Wed Jun 14 22:24:36 EDT 2006;Committer;drbrain;1;4;2;6;0
df05423ad8f82cfbb74e0cb81aa49f74fe1fc34a;Wed Jun 14 22:09:28 EDT 2006;Committer;drbrain;2;15;3;18;0
bf29d2d7366bee948654f8c0032368f30e7d3a37;Wed Jun 14 07:13:51 EDT 2006;Committer;usa;1;3;3;6;0
96c4899738c60c0354a313fcc4f88fb995498a41;Wed Jun 14 07:13:27 EDT 2006;Committer;usa;2;6;2;8;0
806793cd862530ebf6e38b2ef61bf0520b1effcb;Tue Jun 13 13:04:08 EDT 2006;Committer;nobu;1;0;1;1;0
ed1ed86962462c38ebacc58969754d653fa0e6aa;Tue Jun 13 11:52:40 EDT 2006;Committer;usa;1;3;3;6;0
5a712cfb8ce6947dfc5bcd8b7f27153dd576e13a;Tue Jun 13 11:31:27 EDT 2006;Committer;matz;5;34;15;49;0
f2ded65a58f6fed573df3e33f5278796ea2bf26a;Sun Jun 11 14:21:08 EDT 2006;Committer;nobu;2;5;2;7;0
7ba9ce8a7ee8eac00d8e7319b658eda765730d8b;Sun Jun 11 14:16:27 EDT 2006;Committer;nobu;2;8;4;12;0
2059d39e981a884a7c03a933ababca2835773c1c;Sun Jun 11 01:00:10 EDT 2006;Committer;usa;2;5;2;7;0
8ee8a3edcdcdcccd29aa1f8c771d0fbf77a35791;Sat Jun 10 23:55:56 EDT 2006;Committer;nobu;1;1;1;2;0
b55f60b59ff56a608df134df7b753b8a352a0750;Sat Jun 10 23:31:32 EDT 2006;Committer;nobu;2;55;1;56;0
85c86a4e294aeee92b78c075628ec88cdf54d1ea;Sat Jun 10 22:28:42 EDT 2006;Committer;usa;2;6;2;8;0
fc7c0532444a66dc868a0c9a504a98d3c7080ef2;Sat Jun 10 19:40:45 EDT 2006;Committer;nobu;1;1;1;2;0
ac4d6ddfa3219c212d2865ed600a0ab568d5f0b5;Sat Jun 10 19:38:45 EDT 2006;Committer;nobu;2;31;1;32;0
36d0a4eab0ffaac6891c361ac3fab3d13bce777c;Sat Jun 10 16:31:57 EDT 2006;Committer;eban;1;3;3;6;0
d1a5aa5685cfa12724116ce650cb5af3119cf103;Sat Jun 10 16:09:12 EDT 2006;Committer;matz;5;47;10;57;0
c053ad38cf8f92b64a0cc3e97d0accacd44df429;Sat Jun 10 06:17:11 EDT 2006;Committer;usa;1;19;0;19;0
d1a664a464639645acde4b49e98c2886309e4603;Sat Jun 10 06:15:02 EDT 2006;Committer;usa;2;56;0;56;0
8686ee186197b3aeea3cfbe53014e36fb5ce9eac;Sat Jun 10 01:20:24 EDT 2006;Committer;usa;5;32;25;57;0
3e5f70a8153f8ec955af1c6bc721f2e3ea1814a5;Fri Jun 09 23:18:04 EDT 2006;Committer;nobu;11;68;39;107;0
4b731d3bc973dae866211d6f6f9574300718cfe7;Fri Jun 09 21:56:59 EDT 2006;Committer;usa;2;7;1;8;0
3b6f1b9b898ce638ffb1dfb8c492fa6e93c85ee3;Fri Jun 09 21:40:31 EDT 2006;Committer;usa;1;3;3;6;0
9b383bd6cf96e1fe21c41528dec1f3ed508f335b;Fri Jun 09 21:20:17 EDT 2006;Committer;matz;91;2665;2345;5010;0
f83f236f258ebda680006027a03d75fbf98bd5b3;Thu Jun 08 05:02:15 EDT 2006;Committer;usa;1;3;3;6;0
da617f7f79e11bfa92adaaa48be1d2cb0f16096a;Thu Jun 08 05:01:51 EDT 2006;Committer;usa;3;33;0;33;0
a0261afccd73ab4907958ee0f7de27ca5a62d6aa;Wed Jun 07 10:57:26 EDT 2006;Committer;akr;1;6;4;10;0
af19c6657066c18a739ee08eadadbc522d9bbcbb;Wed Jun 07 06:44:24 EDT 2006;Committer;usa;2;14;14;28;0
301f4076f8c5763489edf26133d546f80377f9cc;Wed Jun 07 05:53:46 EDT 2006;Committer;usa;2;11;1;12;0
141295c12441064f21d5e0739de361eec722f5a0;Wed Jun 07 05:52:29 EDT 2006;Committer;usa;1;3;3;6;0
8b074b244207a47219f583df6189c989d4b5f25c;Mon Jun 05 09:16:14 EDT 2006;Committer;akr;4;33;3;36;0
219a6edf8f07768b0010d9571ce12d012df7939c;Sun Jun 04 12:20:22 EDT 2006;Committer;eban;1;3;3;6;0
9fcf44697a8516c6dd9077bd39e0b6cfd940954e;Sun Jun 04 12:15:01 EDT 2006;Committer;akr;2;6;5;11;0
ae96b6e60b6630337a6b9c87d5c58a70cc41af34;Sun Jun 04 11:49:01 EDT 2006;Committer;akr;1;1;0;1;0
d3fde50de7eb4b0df8dc98e0d21df233be2d29c2;Sun Jun 04 11:45:09 EDT 2006;Committer;akr;3;175;26;201;0
e0fd4ffc1c05be733e87fa42c0fb4fce2168bb28;Fri Jun 02 12:06:22 EDT 2006;Committer;akr;1;52;50;102;0
d995f01f67ba20828c2ece2614887ff86ce512a9;Fri Jun 02 10:03:16 EDT 2006;Committer;gotoyuzo;4;15;0;15;0
5fc8821161833c93256572ac3528af4962e3a045;Fri Jun 02 08:16:44 EDT 2006;Committer;nobu;2;6;2;8;0
7fd1a4b424624f3ffa2cb0dab12ee27788dc9287;Thu Jun 01 17:04:24 EDT 2006;Committer;akr;1;6;6;12;0
b8bac4111eeb10b9f8af0d24deed610e0e8bef69;Thu Jun 01 15:44:23 EDT 2006;Committer;eban;1;3;3;6;0
5f4ad759f1c5591a2161c374d45585d97e1e4e4d;Thu Jun 01 15:33:09 EDT 2006;Committer;akr;3;465;61;526;0
da7472ee99258e332edaff0f029f9aab2d03806b;Thu Jun 01 10:13:41 EDT 2006;Committer;nobu;2;7;2;9;0
e4602e1d275752f38a84c89ce4ddb87826f4fa17;Thu Jun 01 07:18:12 EDT 2006;Committer;usa;2;36;19;55;0
2a9733a5c24cf57bc4774a97c1bb1b08337284e1;Thu Jun 01 02:35:10 EDT 2006;Committer;usa;1;4;4;8;0
f85ebe0963bca1dd2a578a666b5b43684391c5b4;Thu Jun 01 02:34:30 EDT 2006;Committer;usa;2;12;0;12;0
e0337774ed9bef3a491863290bc01476aa5b9743;Sat May 27 13:45:47 EDT 2006;Committer;nobu;2;14;7;21;0
5a7d4b7a981de8c0d1f7a190c85c402f1b0829ac;Sat May 27 03:00:37 EDT 2006;Committer;eban;1;3;3;6;0
2ad6b5a8874bdd5bff924415e8103d8d6183f0f4;Sat May 27 02:30:10 EDT 2006;Committer;nobu;3;20;10;30;0
3449f576f4e66e1146b94b3e173c8ef880a623ea;Fri May 26 00:05:23 EDT 2006;Committer;nobu;2;4;2;6;0
b9287e46abf94e85de60b8e9edb52c710def5ab5;Thu May 25 23:45:24 EDT 2006;Committer;nobu;1;3;3;6;0
e34b2a73e6eea423c41d46750e1306c8396dd7bf;Thu May 25 23:44:08 EDT 2006;Committer;nobu;15;107;96;203;0
1a8871fa13f9fb9c643af5743eeece4b978e0280;Wed May 24 16:56:12 EDT 2006;Committer;eban;1;3;3;6;0
0ca603c1bc9a4b3d583a0ad42d4b013d8ea62738;Wed May 24 16:52:00 EDT 2006;Committer;nobu;5;43;8;51;0
32a75c9dcb00864e24acc5f8e76e987300addf27;Wed May 24 16:43:45 EDT 2006;Committer;nobu;2;4;7;11;0
18cf07cc7cc9af85a5e6d0e35bc3c306c93729be;Wed May 24 15:51:03 EDT 2006;Committer;nobu;2;24;10;34;0
865efd821e9db20419bd869d2574500fc90aeb2d;Wed May 24 14:52:10 EDT 2006;Committer;nobu;2;7;1;8;0
31328e55fe15efa69bec9cfa3e2f5553011ab354;Wed May 24 05:06:59 EDT 2006;Committer;akr;1;9;2;11;0
6c3879a612ca8af4339589e6c66c383c23fd7f17;Tue May 23 23:30:46 EDT 2006;Committer;eban;1;3;3;6;0
cffba3b471ce9e408991563a7a9926ee45ece0fd;Tue May 23 18:14:05 EDT 2006;Committer;gotoyuzo;2;8;3;11;0
b44f09c880421153d3c3c8154db44e516fa7199b;Tue May 23 01:19:19 EDT 2006;Committer;eban;1;3;3;6;0
3ef6ba3d12909dbdd58c4570fc76f6fd802fb4db;Mon May 22 22:34:20 EDT 2006;Committer;akr;1;1;2;3;0
078a760999a4ee00f59db3f07047070e71316e13;Mon May 22 22:12:57 EDT 2006;Committer;akr;1;5;3;8;0
dc3037bc487010b8e9368ce09aa6e7c92b6ce3da;Mon May 22 22:11:30 EDT 2006;Committer;akr;1;25;160;185;0
720ce6a1155b1742159595fe13a017e8855195d4;Mon May 22 07:50:15 EDT 2006;Committer;eban;1;3;3;6;0
0773471eacc63fc7803efd3657a323b8c753a2dd;Mon May 22 07:45:00 EDT 2006;Committer;akr;1;18;1;19;0
04cbb0925eb885ffdfc09f6210b1c96704af2667;Mon May 22 07:39:30 EDT 2006;Committer;akr;1;1;1;2;0
096ff284ca82cce0d5afb84411f647f06312b8e7;Mon May 22 07:38:42 EDT 2006;Committer;akr;3;472;12;484;0
baedd2b4f7ea3d9e5a37d2c19184b75dfdcc68e9;Sun May 21 00:56:05 EDT 2006;Committer;kosako;3;10;4;14;0
9a012539baf79006b2c6b25b4eaf8d2cdd40e123;Thu May 18 13:42:52 EDT 2006;Committer;gotoyuzo;7;172;14;186;0
9e365254a64be2e1eff5ac5aa57ebe72b31ecc51;Wed May 17 15:48:29 EDT 2006;Committer;nobu;1;3;3;6;0
fbbc511d65e7d21f25c5ca14a1a495b278e03d2c;Wed May 17 15:42:21 EDT 2006;Committer;nobu;3;10;6;16;0
8c5f9ef2eab6fe7e9f0531d0c670d053616d69be;Mon May 15 12:39:25 EDT 2006;Committer;kosako;3;18;10;28;0
2d80e59b76d67617e08d9f6f2c455c2255fc2ecc;Sat May 13 08:55:39 EDT 2006;Committer;akr;1;1;1;2;0
4bd4ea12adc2507cf4d507d53d743a3efd59e906;Sat May 13 08:24:46 EDT 2006;Committer;akr;1;1;0;1;0
3780530a644fda8f29a885e13cd02819434ca74a;Sat May 13 07:50:44 EDT 2006;Committer;eban;1;3;3;6;0
52d0a1624c7bad9213c26b3443beda383dd6a273;Sat May 13 07:43:41 EDT 2006;Committer;akr;1;11;7;18;0
55fc4f0c276978c22dd887f11ef23505a83fe007;Sat May 13 07:35:50 EDT 2006;Committer;akr;2;22;3;25;0
a673b243194887bd927a4507206612a8deca9136;Thu May 11 12:16:22 EDT 2006;Committer;eban;1;3;3;6;0
1fbcb92ec801fd1bb8c8bf67ea22484162e5021f;Thu May 11 09:31:27 EDT 2006;Committer;gotoyuzo;2;6;0;6;0
8e57e208a743b656428e3b97a4550188bc7ba930;Wed May 10 14:41:20 EDT 2006;Committer;kosako;4;11;5;16;0
dfa0b1cc31cc348e163717d5b218db54e85d94cd;Tue May 09 02:13:19 EDT 2006;Committer;eban;1;3;3;6;0
400fa512cfe7ba4da8bf44594f4db34421bf9cd9;Tue May 09 02:12:11 EDT 2006;Committer;akr;1;1;1;2;0
9b9de890dc38b004cee8f8da20f29ac4df6516d1;Mon May 08 00:14:57 EDT 2006;Committer;usa;1;3;3;6;0
55ef220fe08ddaafdc874f423e92d6d23bddf1eb;Mon May 08 00:12:00 EDT 2006;Committer;gotoyuzo;8;180;62;242;0
911655fd17b2787ac3a3042b738a58eb749ce4d4;Sun May 07 03:28:43 EDT 2006;Committer;eban;1;3;3;6;0
8afbf5cc03e5dc94a22dea209e50db7c64bf9eda;Sun May 07 02:56:06 EDT 2006;Committer;akr;2;6;1;7;0
08b5a86487d16b32c7dd6704ec350d775be6120e;Sat May 06 23:40:08 EDT 2006;Committer;suke;10;223;11;234;0
119b7a05340859c76f42114964f5e77fa3a33f37;Sat May 06 23:35:47 EDT 2006;Committer;suke;2;0;221;221;0
2bdd9d6eba7f2088e017ae80e0029c236eeb47e0;Mon May 01 09:05:08 EDT 2006;Committer;suke;9;218;194;412;0
0cf4abaa278e338f3aa6e4633f06ef2da934ccf8;Mon May 01 03:19:07 EDT 2006;Committer;eban;1;4;4;8;0
9154b19baeef87742e2f854bce091f98fdd00809;Sun Apr 30 23:37:54 EDT 2006;Committer;suke;6;129;115;244;0
5c1ae872f40be7c33033cf2b45d7c8a929860a7f;Sun Apr 30 13:18:40 EDT 2006;Committer;eban;1;3;3;6;0
2b5beeed15b39b48c6797c5824a0533c0d49a1d4;Sun Apr 30 13:11:12 EDT 2006;Committer;suke;4;364;788;1152;0
09d313fa8550ef45b3f5b4c498ac804de8060961;Sat Apr 29 13:58:17 EDT 2006;Committer;eban;1;3;3;6;0
968eb23418010acfdc76481dbf94e78c9353352b;Sat Apr 29 13:52:15 EDT 2006;Committer;gotoyuzo;2;6;1;7;0
08968d685db4b95657179d88a4e5200684d5b34a;Tue Apr 25 09:05:31 EDT 2006;Committer;eban;1;3;3;6;0
3df4f07a6bc5674215983097cfbf589ea11cc610;Tue Apr 25 09:02:00 EDT 2006;Committer;nagai;2;8;2;10;0
105e1deba77b8c27558fc497e6c7525205d1f69f;Fri Apr 21 06:27:46 EDT 2006;Committer;usa;1;3;3;6;0
09cc0b160eb14aa52e7cd345835485122e9c8c89;Fri Apr 21 06:22:43 EDT 2006;Committer;nagai;2;10;3;13;0
55cc0dd1487cb3e86d1b591d5480e03288c11fb5;Tue Apr 18 08:44:21 EDT 2006;Committer;eban;1;3;3;6;0
bce4ed2f72db35fe870a226f53fbb4dc24eaedab;Tue Apr 18 08:43:10 EDT 2006;Committer;nagai;5;42;12;54;0
ef658049031108b4b592aef1740e9eeff5c4264e;Sat Apr 15 05:23:37 EDT 2006;Committer;eban;1;3;3;6;0
78d9dd71a619ae6b822063d13944c86c5d834eb8;Sat Apr 15 04:11:04 EDT 2006;Committer;ser;23;1436;1287;2723;0
406c1cb48567a0e86fb731a125e22970200a65e6;Sat Apr 08 09:31:03 EDT 2006;Committer;eban;1;3;3;6;0
93f080c12f19232340aeca50a62484030009a13d;Sat Apr 08 09:16:58 EDT 2006;Committer;suke;1;0;1;1;0
29ba4ff416d20334e8553b50f4d5f994e0c62090;Sat Apr 08 09:13:30 EDT 2006;Committer;suke;4;123;4;127;0
de558c7995f3c4dcd31b261be0488b547b931715;Sat Apr 08 09:11:39 EDT 2006;Committer;suke;1;0;74;74;0
b2f55389b8046d23ec56b33f3cb06cf9b64e5183;Fri Apr 07 13:29:32 EDT 2006;Committer;eban;1;3;3;6;0
11974f3b6d06991e3b82fda99174c7e9719a4eb8;Fri Apr 07 13:16:46 EDT 2006;Committer;suke;3;60;18;78;0
3b7c8b34889eb4333335e10d04f6e612953b1a09;Thu Apr 06 07:45:33 EDT 2006;Committer;nagai;2;6;0;6;0
495d872fac55470a3573b5e2c8d34f5dbfcfc289;Thu Apr 06 02:21:20 EDT 2006;Committer;nagai;2;5;1;6;0
659e09e7410e270ea8de32ad72060b5c09e6662a;Wed Apr 05 16:24:14 EDT 2006;Committer;eban;1;3;3;6;0
8ba823c485d481979600000a111b3b108f98ad6f;Wed Apr 05 16:08:45 EDT 2006;Committer;nagai;6;87;39;126;0
5ebb8ad06bb936c048f890fbfd1495134a825912;Tue Apr 04 15:32:30 EDT 2006;Committer;eban;1;3;3;6;0
62123eff4f017b937dcd070f42d5189a3d543b32;Tue Apr 04 15:29:59 EDT 2006;Committer;akr;2;29;21;50;0
ec8e6b07ba84c697e6cd6165741ac60d7854df94;Sat Apr 01 09:28:59 EST 2006;Committer;suke;1;4;4;8;0
b4d47bcff305d6d122dd9dbd1f763eeab019dad1;Sat Apr 01 09:22:58 EST 2006;Committer;suke;1;132;0;132;0
3ca351ec2397e85b989017500361df1f5b88afa7;Sat Apr 01 09:21:27 EST 2006;Committer;suke;2;0;93;93;0
63fa2de637659ab56824165e9f2295d9ef5528b0;Sat Apr 01 06:25:41 EST 2006;Committer;suke;3;0;296;296;0
3ff87cc53f6705959db82c8a4270bbdd5b8eabbd;Sat Apr 01 06:23:07 EST 2006;Committer;suke;6;355;16;371;0
53efc383503c42a5c19d947c53f6caad25ee9de8;Fri Mar 31 05:30:49 EST 2006;Committer;eban;1;3;3;6;0
8e1d0d7cc384887e9768d7ac1ca4abfc8346952e;Fri Mar 31 05:25:00 EST 2006;Committer;nobu;2;21;18;39;0
801443f3acc174e46e8919175785582373ddb8f0;Wed Mar 29 14:12:49 EST 2006;Committer;suke;4;156;32;188;0
6ac8bca0f0d289491a9e64ba9afea6a0a4c5f7fb;Wed Mar 29 01:12:50 EST 2006;Committer;usa;1;3;3;6;0
e72073102cc10153e49c120eda75e92482d253df;Wed Mar 29 01:12:22 EST 2006;Committer;usa;2;8;3;11;0
5e37739debc9afb9888903987ea1e2a5168e55a5;Tue Mar 28 01:55:32 EST 2006;Committer;eban;1;3;3;6;0
afde18c5f5f7d9f49bd9787f6e76addbd0187fbe;Tue Mar 28 01:50:11 EST 2006;Committer;akr;1;8;1;9;0
f1ad74301564bf1fb03802a83a1d58511c575999;Mon Mar 27 14:03:44 EST 2006;Committer;eban;1;0;12;12;0
588a5332861d770f38e06ba51b47d075a54710f8;Mon Mar 27 14:02:12 EST 2006;Committer;eban;1;15;3;18;0
e49d87454290194b304f768f0ff734460b492e96;Mon Mar 27 13:48:21 EST 2006;Committer;naruse;7;2257;1730;3987;0
6e154b9743fd753bbc314e73f588e1b4c32f73f8;Sun Mar 26 13:04:13 EST 2006;Committer;kosako;4;157;154;311;0
2025346077b7a514d7fed11cac52c125e9a188c1;Fri Mar 24 12:14:18 EST 2006;Committer;kosako;4;31;15;46;0
50091c990d268285097b2be5ce5331317227ba0c;Thu Mar 23 12:43:51 EST 2006;Committer;kosako;2;13;2;15;0
f69c1f18ee4d5ddd0aa5e865360f8b14c34e37de;Thu Mar 23 12:08:08 EST 2006;Committer;kosako;5;65;23;88;0
0fa1086760eb0a5964789eb619769764107458ca;Wed Mar 22 15:03:40 EST 2006;Committer;kosako;5;62;17;79;0
a350e9c6e2935b2c2d358b94327a0c7028668c11;Tue Mar 21 13:16:21 EST 2006;Committer;kosako;5;53;6;59;0
1e608d0dffa714e65390d428c1f6fa48a9dbbba8;Mon Mar 20 02:16:55 EST 2006;Committer;usa;1;3;3;6;0
5bc9512a0b41f44ad3cfdf107695e35fd3a15269;Mon Mar 20 02:14:24 EST 2006;Committer;usa;2;9;3;12;0
b619a8859fdecc12bfb9f0c793f8218a1bd546da;Sun Mar 19 07:27:34 EST 2006;Committer;eban;1;3;3;6;0
6c0256933be0dd43356fb80b4824cfbb70dc4e88;Sun Mar 19 00:56:59 EST 2006;Committer;suke;3;68;4;72;0
597cfafb88f31e58e50aa9da327e4e165322b39c;Wed Mar 15 07:55:10 EST 2006;Committer;usa;2;5;1;6;0
f8dd2546be8fa3cb9e9b9abe88d41b9389b6fbd9;Wed Mar 15 07:44:17 EST 2006;Committer;eban;1;3;3;6;0
1b3ca9aa3a538609f67af13fc11d9393e9b0274b;Wed Mar 15 07:42:00 EST 2006;Committer;gotoyuzo;3;7;2;9;0
9432599e6cd2aa407e0e8e84cc6619046f808c99;Sun Mar 12 08:18:45 EST 2006;Committer;eban;1;3;3;6;0
88ea87db21a45da7f803155bdf66de0290acba43;Sun Mar 12 08:09:48 EST 2006;Committer;suke;4;221;23;244;0
7e69ffb1b6aae147060a3d4e69b78dd61d6fd5c0;Sun Mar 05 09:44:37 EST 2006;Committer;eban;1;3;3;6;0
16b6d69f6305f4eaf3b39332939a9be3cbd95ace;Sun Mar 05 09:41:33 EST 2006;Committer;aamine;2;58;52;110;0
63079969660592d464734b70ac2a2a90a1d297ea;Sun Mar 05 09:35:32 EST 2006;Committer;aamine;2;7;2;9;0
ec6122bc2a5604cb386c9585f4faf14cdf564087;Sat Mar 04 06:43:26 EST 2006;Committer;eban;1;3;3;6;0
5172b5a8488b4f980ba76ad9bd4410678fc34ec6;Sat Mar 04 06:39:25 EST 2006;Committer;akr;1;3;2;5;0
989fb4fec7c3575249e4e04efbf7c37986bad694;Sat Mar 04 06:28:51 EST 2006;Committer;akr;3;42;3;45;0
192fcacebf45f6344a5edf6d560f88ef3883273b;Fri Mar 03 12:24:53 EST 2006;Committer;akr;3;18;6;24;0
469f1f7b491d58c26553ccf7d5cb60f5f48c7d39;Fri Mar 03 05:41:53 EST 2006;Committer;aamine;4;11;0;11;0
7f435d3d02a3ec516f6db111f3a4b4d157dd5df4;Fri Mar 03 01:55:57 EST 2006;Committer;eban;1;3;3;6;0
1d05d97c45c40d96446d6fa57079a832660f400d;Thu Mar 02 17:40:38 EST 2006;Committer;akr;1;1;1;2;0
6f09379196fda978b7815f45c51a35f051daf959;Thu Mar 02 09:01:51 EST 2006;Committer;ocean;2;13;0;13;0
ecebbcce1f58687bdcc1028bc8813f004bc22427;Thu Mar 02 05:22:30 EST 2006;Committer;akr;4;101;53;154;0
b6572b687349e70d47616655d1ebaf13bd2279eb;Thu Mar 02 04:07:16 EST 2006;Committer;eban;1;3;3;6;0
be70a6ebec5a1c4d361a841db9cfa4fbe5d140ef;Thu Mar 02 04:01:31 EST 2006;Committer;ocean;2;7;0;7;0
2b25baff72412deb6075fe3a3bcba3bf7d0e8401;Wed Mar 01 10:06:03 EST 2006;Committer;ocean;7;42;56;98;0
5ed418b594ad4e45fb6ac302fbb93a2a610e43ff;Tue Feb 28 16:03:37 EST 2006;Committer;eban;1;4;4;8;0
0ecd958d9701b2ef97d408c1d12f43923300e854;Tue Feb 28 15:21:24 EST 2006;Committer;ocean;2;10;4;14;0
e54adb7d1d472ddcf0be99d7bdf6df508ce73245;Tue Feb 28 13:50:55 EST 2006;Committer;eban;1;3;3;6;0
64040f2daa1ab5c3525f5050e14c65d1b2e5f7f7;Tue Feb 28 13:47:48 EST 2006;Committer;keiju;1;5;5;10;0
a2bd4d594df404218cb6e93beb07439bf4f42038;Fri Feb 24 11:23:25 EST 2006;Committer;seki;2;7;1;8;0
6f43cc18a49c003d1a89d94d351bd01c97d0a873;Fri Feb 24 03:12:27 EST 2006;Committer;usa;2;34;18;52;0
20f3ea3f6c084733dfbc76f8a0efe1335ce66428;Fri Feb 24 02:19:44 EST 2006;Committer;usa;2;15;0;15;0
a4e21b2cd6a30fc861eec0ceb5b50a6115a51fdb;Fri Feb 24 01:39:22 EST 2006;Committer;eban;1;3;3;6;0
4ce506cc084337bb169f2f86328e29c6d9c298f4;Thu Feb 23 14:59:15 EST 2006;Committer;ocean;1;1;1;2;0
b122590f5a273333c9b2ccb7b5342d7d6f15e48b;Thu Feb 23 13:46:03 EST 2006;Committer;ocean;4;31;1;32;0
5373331d039f69df297598b073d6075d1a939e37;Thu Feb 23 04:27:26 EST 2006;Committer;eban;1;3;3;6;0
c8e364cc2805059142f16d27397dd6e7ab0ccc11;Thu Feb 23 04:24:39 EST 2006;Committer;ocean;2;5;1;6;0
cb8d34855e7374f7a28b115f8d3a5e2020072f0e;Wed Feb 22 12:18:58 EST 2006;Committer;akr;3;12;1;13;0
bea93efc42f1e50e759888e53dbcd1ec624d3d80;Wed Feb 22 07:27:20 EST 2006;Committer;usa;2;13;0;13;0
145b7e1b8b1424f8199b772199a2cbf3e2862093;Wed Feb 22 05:26:33 EST 2006;Committer;matz;2;8;1;9;0
3647fb485cfd027d9dfe54cf9795a4cbe90ed0dd;Wed Feb 22 02:05:31 EST 2006;Committer;eban;1;3;3;6;0
e94633b9b2a45e975c42d1e587d0a66c38335d0a;Wed Feb 22 00:27:27 EST 2006;Committer;matz;2;10;5;15;0
c270c82ebb443e72746ad97b766cc70f8d473cf5;Tue Feb 21 10:24:18 EST 2006;Committer;akr;1;1;1;2;0
00610f75f7eda49567fb809d982810150a5c7b1b;Mon Feb 20 17:22:09 EST 2006;Committer;usa;1;3;3;6;0
2507699bb85ca9328a45a828d785489f1cc52e86;Mon Feb 20 17:12:56 EST 2006;Committer;matz;2;7;0;7;0
b3697c2dcb72294b893d261254aa572dfc4cfdc3;Mon Feb 20 13:33:20 EST 2006;Committer;akr;2;5;0;5;0
2b2910c71346c40fa867a1ae79efd0c804d9dba7;Mon Feb 20 09:23:26 EST 2006;Committer;akr;2;9;0;9;0
04946de81b657c439c46f3f3780182b3cc7f4821;Mon Feb 20 08:34:53 EST 2006;Committer;akr;20;70;56;126;0
2d956bea23588a9a16a0d42149d8544e9a049689;Mon Feb 20 04:48:55 EST 2006;Committer;usa;2;6;1;7;0
3ef1b8086e962830a7672b02449d48fb3cabc001;Mon Feb 20 04:26:13 EST 2006;Committer;matz;2;6;1;7;0
61ef2fa9f683c9591f68f96bae3b4ecd793857f2;Mon Feb 20 01:07:40 EST 2006;Committer;matz;2;15;10;25;0
a25ab421375ebcdd860a01bf14870053868b74a5;Mon Feb 20 00:53:57 EST 2006;Committer;matz;2;6;1;7;0
6fec28d1a2bf752325814c31de62ace73c5a9b3c;Mon Feb 20 00:33:18 EST 2006;Committer;matz;2;7;3;10;0
f816b8b167ae60d266172d9eb6544990cbc228b7;Mon Feb 20 00:15:36 EST 2006;Committer;matz;4;33;42;75;0
a6c936c15b2145b2a4219e2503301e5cd167f3e2;Sun Feb 19 16:00:04 EST 2006;Committer;gotoyuzo;2;6;1;7;0
2e7efc6413d9b05b370bca0c5ad31757897c7455;Sun Feb 19 15:36:18 EST 2006;Committer;eban;1;3;3;6;0
6701de8e1eaf745d577521ead3ff63b0ba08fad9;Sun Feb 19 15:17:16 EST 2006;Committer;akr;2;32;1;33;0
5d95ecbd1a2fbc065addb3b57e44a3731e7602b6;Sat Feb 18 15:59:50 EST 2006;Committer;eban;1;3;3;6;0
7bd38510a8f6522ef3c070da716a1b7a9d8ef529;Sat Feb 18 15:38:56 EST 2006;Committer;matz;3;11;2;13;0
b070abfc2045a4484e7bce34172764bbce5d3ff1;Sat Feb 18 12:18:27 EST 2006;Committer;matz;3;12;3;15;0
d16c035975f45d67a09a84d3d7e574fb80aa0a55;Fri Feb 17 16:08:08 EST 2006;Committer;matz;4;19;8;27;0
110a9f783d1ae87a059fdb20f711ef5b9b8e49cc;Fri Feb 17 16:05:07 EST 2006;Committer;eban;1;3;3;6;0
3442be4e84eaebcd718c1ba5b89818830653dcb5;Fri Feb 17 15:40:32 EST 2006;Committer;matz;2;14;13;27;0
ccf99b9ce600ceb1f0360db7af4164a916f03882;Fri Feb 17 08:40:52 EST 2006;Committer;matz;6;84;69;153;0
d0a3c64fb4af21a911f2b7553bbddb45dd9e4484;Fri Feb 17 02:21:39 EST 2006;Committer;ocean;5;26;6;32;0
dd0fa838d94ad91b1ab993e41b7ad113aac3b3f5;Fri Feb 17 01:10:23 EST 2006;Committer;usa;1;3;3;6;0
4839151263a58bc8de8dc11ae6543ebc42c41021;Fri Feb 17 01:06:48 EST 2006;Committer;matz;2;6;1;7;0
8f5278b52527b134b41f1a8b6b446334e10178fe;Wed Feb 15 08:46:55 EST 2006;Committer;matz;3;37;28;65;0
a95a1eff2071cd6671b8886b2a48334a1cf3e3c6;Wed Feb 15 06:22:13 EST 2006;Committer;matz;2;8;5;13;0
7d863d5c977f26fc9d7745bbd4f81fd8c5cdcb34;Wed Feb 15 01:24:20 EST 2006;Committer;matz;2;7;3;10;0
ba8954361dbe61e7fc4aaf507f19d3546dea7a73;Wed Feb 15 01:17:39 EST 2006;Committer;usa;1;3;3;6;0
c3f5a736a878aaf573d40e5c8d1753a7faa77cd3;Wed Feb 15 00:26:14 EST 2006;Committer;matz;2;6;1;7;0
d4cecea858137cd4ca07388bf9cd977c45041b87;Tue Feb 14 12:36:11 EST 2006;Committer;matz;2;8;1;9;0
76210570540cf5065992037cc496dcf1c066b479;Tue Feb 14 11:38:29 EST 2006;Committer;ocean;1;1;1;2;0
14afb530730fced6454334c07ce1fa5f2c22e864;Tue Feb 14 10:12:21 EST 2006;Committer;matz;2;8;1;9;0
3770f989922d909ef201aef7d3bba1950982b15e;Tue Feb 14 06:17:24 EST 2006;Committer;ocean;2;33;8;41;0
f0ab5bdea254cedc620cd8de6add6e76ac57cabc;Tue Feb 14 04:49:01 EST 2006;Committer;usa;2;10;0;10;0
8fe090790d6af1e5943cb6589eee16f9dd1c4250;Tue Feb 14 04:39:32 EST 2006;Committer;usa;2;8;0;8;0
45ccbcc078ef475a8c6e1d48fa0b3f0ebac7cd6e;Tue Feb 14 02:52:26 EST 2006;Committer;usa;1;1;1;2;0
fd2660d9c3f5c7f05ea8a0636624eb0d0f2e463e;Tue Feb 14 02:48:28 EST 2006;Committer;usa;1;3;3;6;0
93ff2adbed2c6b3ee2a2456d5223753921b2fee0;Tue Feb 14 02:48:08 EST 2006;Committer;usa;3;28;12;40;0
3d0c93a90750e4cb01947c14c462f1b96c361d3c;Mon Feb 13 09:07:57 EST 2006;Committer;matz;2;12;4;16;0
7f7236025953af6e0308995e073f9babbe149473;Mon Feb 13 04:53:22 EST 2006;Committer;matz;13;473;579;1052;0
c37c5419d251c5e72d413a4759eac2a34c1de3e4;Sun Feb 12 15:05:19 EST 2006;Committer;kosako;8;34;16;50;0
1232adbcf92e014d771339d6e2ae71c42e1a4b0f;Sat Feb 11 13:03:29 EST 2006;Committer;eban;1;3;3;6;0
9a59edfb4e38600dc68f2442afe8a6e9559471d4;Sat Feb 11 13:00:46 EST 2006;Committer;suke;3;40;1;41;0
898f5b315c2d8e412fdd585533400d1b8049af8b;Thu Feb 09 02:22:36 EST 2006;Committer;usa;1;3;3;6;0
910a436d33f2daac82e1bda305588f3f3d270502;Thu Feb 09 02:22:00 EST 2006;Committer;usa;1;1;1;2;0
49125bd07c741f4632cb58e2c5eebf8cb71b13db;Tue Feb 07 14:43:47 EST 2006;Committer;eban;1;3;3;6;0
0a8f5ad543f42fb80265b75b33afa92ab826a630;Tue Feb 07 14:05:55 EST 2006;Committer;ocean;2;51;56;107;0
488b3d6819299fbab0959d5dd3ba77635fc5d39b;Mon Feb 06 07:26:16 EST 2006;Committer;ocean;1;0;3;3;0
b29ad4cd95d4f56f60f1099caebfc92fb1019891;Mon Feb 06 07:13:53 EST 2006;Committer;eban;1;4;1;5;0
895778951ed1f79da411453e6eb93e9592730a35;Mon Feb 06 07:06:22 EST 2006;Committer;eban;2;25;3;28;0
3007dab16f87779b6f0fc2be4da455afae69a682;Mon Feb 06 02:49:37 EST 2006;Committer;eban;1;1;1;2;0
9f69352c97d25faa48023653ab9aac303751bbb3;Sun Feb 05 15:31:17 EST 2006;Committer;eban;1;3;3;6;0
645890629294602cf7722e7667ea10eb067697ff;Sun Feb 05 15:26:53 EST 2006;Committer;matz;2;45;0;45;0
84aa2febd665e9d9457361b5198281d0e6b2d863;Sun Feb 05 15:10:01 EST 2006;Committer;akr;1;16;0;16;0
4f245852bc12454674e9f9efe52a009a682389e2;Sun Feb 05 15:06:41 EST 2006;Committer;akr;1;4;3;7;0
ed0fd0279617024a608a8ee4c1aa931db61e92c4;Sun Feb 05 14:40:01 EST 2006;Committer;akr;5;109;64;173;0
2746f3352b0b6854420529a6432167b4cf03c13f;Sun Feb 05 14:31:34 EST 2006;Committer;matz;1;1;1;2;0
08cb01f07320aa58c5f03fb5a9d3ef83e462f4b4;Sun Feb 05 12:09:31 EST 2006;Committer;ocean;2;6;4;10;0
0ff14af9faf3fc06b1608437d83939f910dbac21;Sun Feb 05 09:50:38 EST 2006;Committer;aamine;2;13;6;19;0
13d62dfa79ae5f174279b0dabee14cc53c5e8857;Sun Feb 05 09:42:05 EST 2006;Committer;eban;1;3;3;6;0
258f80c82f67b4c5efc2daa862a16a4dd26e1222;Sun Feb 05 07:37:38 EST 2006;Committer;ocean;2;5;1;6;0
4f4ea9db28aa51fcb578e1fcaac06bea07b3def7;Sun Feb 05 05:28:11 EST 2006;Committer;ocean;2;10;5;15;0
1d2a56a60aa9b82a1b0ff8d6378cb854bbc5f174;Sat Feb 04 13:54:53 EST 2006;Committer;akr;2;6;1;7;0
086e235f035d44c3554cab364cd70644e537a919;Sat Feb 04 12:31:19 EST 2006;Committer;matz;13;469;365;834;0
f0432871fd3f9489c87199700efa32a7597f135c;Sat Feb 04 12:21:55 EST 2006;Committer;usa;2;19;1;20;0
a98d2cd4a9aaee452f695ca932cc29d045753329;Sat Feb 04 07:04:37 EST 2006;Committer;eban;1;3;3;6;0
4c9c7a82ac21a6e0c675f263e8a8d434c8a52996;Sat Feb 04 06:58:43 EST 2006;Committer;ocean;2;9;1;10;0
22d575747921a5290c58a6e6cd711f56c7b77bff;Fri Feb 03 10:28:27 EST 2006;Committer;ocean;3;13;6;19;0
5675cdbd418509bdb1abbc4442a681b808ed35e8;Fri Feb 03 09:15:42 EST 2006;Committer;matz;27;653;587;1240;0
e4f1feac3e807e2e3790237749cfdb7a6104fd90;Fri Feb 03 06:11:13 EST 2006;Committer;ocean;2;6;3;9;0
69e975903783b20ddcf881dcc3e2aa45197a3f85;Thu Feb 02 15:05:39 EST 2006;Committer;eban;1;3;3;6;0
8913015f04fdeab5676c411f8641dfc8d2fdb039;Thu Feb 02 15:02:49 EST 2006;Committer;ocean;2;6;1;7;0
63b79786250f32c0fac7a9f01eb52f8c4e6c5397;Thu Feb 02 08:16:30 EST 2006;Committer;usa;2;11;2;13;0
4f34c296da801d6c4f9464870721c8431a9f698f;Thu Feb 02 05:59:14 EST 2006;Committer;eban;1;3;3;6;0
f9e61846768ab63123480f705bd9955ea709a499;Thu Feb 02 05:52:17 EST 2006;Committer;ocean;2;8;0;8;0
10c288003e77f8c5ac3741da7689bd70e9865980;Wed Feb 01 13:47:16 EST 2006;Committer;eban;1;4;4;8;0
88f3b6efb4105b17998a22befdfd42244314935e;Wed Feb 01 13:27:47 EST 2006;Committer;ocean;4;21;7;28;0
598451429c20db4bbb2249f59d9641ad22126269;Tue Jan 31 03:01:31 EST 2006;Committer;nagai;3;114;4;118;0
09d952c5439c28244fcdf2e53846d73e39c4daf0;Mon Jan 30 15:15:07 EST 2006;Committer;eban;1;3;3;6;0
8f8f21d16824c1a2f1c0b0b45ba72b040e5a0d8f;Mon Jan 30 15:13:11 EST 2006;Committer;ocean;2;9;0;9;0
c5266ef55ab0180afe77f329db8f6a0b6a8ea269;Sat Jan 28 05:22:17 EST 2006;Committer;eban;1;3;3;6;0
a0dc66d0b51da14d6906de0751a6cf072a89f994;Fri Jan 27 22:58:07 EST 2006;Committer;ocean;2;7;1;8;0
bd2ea061ff5d86f89298bfc21850f13c1b9bde98;Thu Jan 26 08:06:18 EST 2006;Committer;eban;1;3;3;6;0
85176676e5067117a8494ad207bbaf0796564bc3;Thu Jan 26 07:50:53 EST 2006;Committer;matz;2;5;1;6;0
76e9d7900dd81a062bae407959e3b092a1f29f22;Wed Jan 25 13:32:08 EST 2006;Committer;nobu;1;3;3;6;0
a26039acbce7999f85757ac1ea77fafc1c0ab81c;Wed Jan 25 13:30:11 EST 2006;Committer;nobu;6;12;4;16;0
06f4b438fb72e46410b0ee1337bd2efbb4813262;Sun Jan 22 14:28:02 EST 2006;Committer;nobu;2;7;2;9;0
2afb25bc808fa18253a554194e31cdebb83e08b8;Sun Jan 22 13:34:41 EST 2006;Committer;akr;2;2;2;4;0
fb5d5d48db1c095e263a662435665d48da5106b1;Sun Jan 22 13:32:40 EST 2006;Committer;akr;1;5;5;10;0
205e7c74ea0f0ae998f49d65b50f875a342566cf;Sun Jan 22 13:17:39 EST 2006;Committer;akr;2;58;44;102;0
8902cab770c1237e0d8c79d079472eb4e91f1e20;Sun Jan 22 11:38:01 EST 2006;Committer;eban;1;3;3;6;0
b8f013542a3ef0411042eee621b372ab198fc8ec;Sun Jan 22 11:36:08 EST 2006;Committer;akr;3;40;26;66;0
3efb9e43b63217dfd4743c0b06cda791f7b27894;Thu Jan 19 13:22:13 EST 2006;Committer;aamine;2;6;0;6;0
835d90b94ec66ecaf4ff4c54e080e50555c1ed3a;Wed Jan 18 16:20:19 EST 2006;Committer;eban;1;3;3;6;0
77a71cf16005960ff163e9e3b83f1df66dd6ee05;Wed Jan 18 15:01:22 EST 2006;Committer;akr;2;24;1;25;0
f2367ae3953bdb2e9fc1da0390957a2efed751db;Tue Jan 17 16:18:18 EST 2006;Committer;eban;1;3;3;6;0
4055d842fa8780aa2d7c4431b952a8fd50c3908e;Tue Jan 17 15:00:25 EST 2006;Committer;nobu;2;24;6;30;0
dd677b700c1a8a1017d3265450fb58e1be4b11d3;Tue Jan 17 14:05:49 EST 2006;Committer;nobu;2;43;14;57;0
dc2732c84f1005821904080543783f302002193a;Tue Jan 17 02:33:29 EST 2006;Committer;usa;2;5;0;5;0
6471c4dcf49506fa98764dcff919e3134be402a9;Tue Jan 17 02:11:52 EST 2006;Committer;usa;1;3;3;6;0
1aada80f78a40dfc0991aa6155cb7d03079e1f0a;Tue Jan 17 02:08:33 EST 2006;Committer;usa;2;7;3;10;0
bac69d798d279e4ad29ab4e1cd0f2fafbb6f9bab;Mon Jan 16 01:37:56 EST 2006;Committer;eban;1;3;3;6;0
d54f7b05e8b2e516451fb50c816cec311db570bf;Mon Jan 16 01:29:58 EST 2006;Committer;ocean;3;40;21;61;0
44bf6c8f492cc87d3faf7891bbb8fee989293cf7;Sat Jan 14 06:31:24 EST 2006;Committer;eban;1;3;3;6;0
4678e9340a5073f8ff1b4658bf6d3f72774af156;Fri Jan 13 18:44:34 EST 2006;Committer;ocean;2;7;2;9;0
eb24aaf576ab0dc4f690445ea6e44d3f8ee04090;Fri Jan 13 10:49:27 EST 2006;Committer;eban;1;3;3;6;0
c9bfc9bb43bf39e70d5e9a25054641817238a83e;Fri Jan 13 10:27:52 EST 2006;Committer;ocean;7;75;60;135;0
016f0e0c84e616f17ddadd20ac783009332c5245;Thu Jan 12 03:46:17 EST 2006;Committer;eban;1;3;3;6;0
3866e487663fb40858c52d4efec1ecff7aa30b98;Thu Jan 12 02:56:11 EST 2006;Committer;nagai;2;111;2;113;0
b87f44cec9b5ad1674bfd581cfa208324eac08a5;Tue Jan 10 15:57:20 EST 2006;Committer;eban;1;3;3;6;0
b468b45f7a09817ba7c043d0cd4ced531326a58d;Tue Jan 10 15:21:45 EST 2006;Committer;seki;2;9;4;13;0
3428af761c3dec31cbe8a4076c36ef674b6c4b49;Tue Jan 10 11:02:36 EST 2006;Committer;akr;1;1;1;2;0
11afa4f4d07b1ef4139c1932b91bbcbfdf40c4e6;Tue Jan 10 10:50:17 EST 2006;Committer;akr;2;10;0;10;0
53cc7ba5701a31a2ff33b53ae3e4d16617866565;Tue Jan 10 04:54:10 EST 2006;Committer;ocean;1;3;4;7;0
8e4f2a50da43a821aa3f6031682f50dc87d0a30c;Tue Jan 10 04:38:23 EST 2006;Committer;ocean;2;19;5;24;0
12d3325346842b309e58e6eabd11e34ec5a8c615;Tue Jan 10 03:50:28 EST 2006;Committer;ocean;3;37;10;47;0
163224f639a17980319ca6cd1942a7159b233b81;Tue Jan 10 03:05:40 EST 2006;Committer;ocean;3;20;2;22;0
f825f3508ea109ae8f21c94fec9a0ff20c96d7aa;Tue Jan 10 01:41:51 EST 2006;Committer;eban;1;3;3;6;0
7d8790cdc468a3f3743e580338567f4a16c4ef05;Mon Jan 09 22:32:55 EST 2006;Committer;akr;4;50;13;63;0
ccbf4ea1193d2d995ff9e5195a2add2c8851cb6f;Mon Jan 09 11:00:40 EST 2006;Committer;ocean;2;6;1;7;0
5bd9ba4d5c7673fac76106d52c4c32959cf31d7a;Mon Jan 09 08:46:36 EST 2006;Committer;eban;1;3;3;6;0
65ebb02460fbca9081c0d410ee8334fddc1fa43f;Mon Jan 09 05:27:43 EST 2006;Committer;ocean;3;13;1;14;0
eea27ee2ec16e2b2a5c24bf4b9a3f78d32113a4c;Sun Jan 08 19:24:21 EST 2006;Committer;akr;1;1;1;2;0
46043b22944ea3493b01d888a7c7a6f7b002c8e6;Sun Jan 08 05:21:17 EST 2006;Committer;akr;2;7;1;8;0
990d4c3fbe3750189f88ba24cf0b09885208b888;Sun Jan 08 04:25:14 EST 2006;Committer;eban;1;3;3;6;0
5695c588c0c49967c7dc4787b79044c8331a0e98;Sun Jan 08 04:14:11 EST 2006;Committer;akr;2;4;4;8;0
94fc5c9878cbc01299c9f7f8944d0d1e552e5227;Sat Jan 07 06:45:14 EST 2006;Committer;eban;1;3;3;6;0
b1860ba7dc2988e99d77391a3696a04b9d2ef2f8;Sat Jan 07 06:41:24 EST 2006;Committer;nobu;2;6;1;7;0
199ef57934de0fd0bf2d1682df8714f85b65dfcc;Fri Jan 06 21:28:54 EST 2006;Committer;akr;2;9;1;10;0
969519f1649c8dec38c6e3ea0fc63e7bd0d175fd;Thu Jan 05 18:06:51 EST 2006;Committer;eban;1;3;3;6;0
d08d6a0d142a7c79ae75b58398c394aad51b83e4;Thu Jan 05 17:51:00 EST 2006;Committer;akr;1;1;1;2;0
842b4d7d9a6aabadd4c72c4e8e0e982eaca352c9;Thu Jan 05 17:26:23 EST 2006;Committer;akr;3;17;7;24;0
1669ac380e0d2ed27006335139947b5f6130878e;Thu Jan 05 05:32:58 EST 2006;Committer;eban;1;3;3;6;0
69981b5348b5e1e42caa1b848151a3334049b570;Thu Jan 05 05:29:48 EST 2006;Committer;ocean;2;9;18;27;0
b81154cbdf05f6b8b517fffde0edc90c7beab93b;Tue Jan 03 07:21:01 EST 2006;Committer;eban;1;3;3;6;0
7ac4e60f08a172cf0485bc7d18fa544415c37529;Tue Jan 03 07:14:28 EST 2006;Committer;akr;1;8;8;16;0
238b52e1e28991672cd9e29d25161c7d4406bf82;Tue Jan 03 06:45:16 EST 2006;Committer;akr;1;3;3;6;0
2b6231b940d7ddffae6b4dae7cc0435d7ab7aead;Sun Jan 01 06:50:37 EST 2006;Committer;eban;1;5;5;10;0
861e7f276601c8e41bf7da562eb02cc4d49db0f9;Sun Jan 01 06:35:54 EST 2006;Committer;akr;1;1;1;2;0
40e0fa4c1ef0e9715ffb366d6c2a829948b8ff64;Sun Jan 01 06:34:48 EST 2006;Committer;akr;2;13;4;17;0
88a3caaafeef4600f597d64f640054937c4d9ff4;Sun Jan 01 05:49:01 EST 2006;Committer;ocean;4;83;19;102;0
a5e6541ad6d382ca35c9b0f90d40f674951ae731;Sat Dec 31 13:57:36 EST 2005;Committer;nobu;2;6;0;6;0
a711b321b755a94275c616e070eff8f411e3f250;Sat Dec 31 10:57:06 EST 2005;Committer;ocean;2;14;12;26;0
12cb36f9bb2d8e6089ef1a88b90ff449b0025926;Sat Dec 31 05:20:09 EST 2005;Committer;eban;1;3;3;6;0
162338d75510b98d9d2fbbedf7c4fd2beabcc3c7;Sat Dec 31 02:56:46 EST 2005;Committer;ocean;2;8;0;8;0
eaa1cca60129b60eb4331572dd7634c31b8a06d7;Fri Dec 30 10:17:39 EST 2005;Committer;ocean;1;1;1;2;0
c0c75769b689b34be85e2b7e1b92016e7b67563e;Fri Dec 30 09:57:49 EST 2005;Committer;ocean;2;30;36;66;0
2c1706fffb3fed17085af23de26ce84ed8ebae1a;Fri Dec 30 09:29:07 EST 2005;Committer;ocean;2;36;30;66;0
dc94d09ad5866ed445683f253bea343c383af6dc;Fri Dec 30 09:23:15 EST 2005;Committer;nobu;2;15;3;18;0
cd5cd3c6729c4c7917f4c0c69a8c323763a69968;Fri Dec 30 09:15:56 EST 2005;Committer;nobu;2;16;9;25;0
e0524956374b720c0c0f6c66853f56237150240b;Fri Dec 30 06:23:25 EST 2005;Committer;ocean;2;8;3;11;0
5f82802aec753cf0fe4613a34d67fada2e7d17df;Fri Dec 30 03:24:18 EST 2005;Committer;ocean;2;6;0;6;0
2b1319b03a61bb7c70ac20820bdf3d5ea9fbabd3;Thu Dec 29 17:11:28 EST 2005;Committer;akr;1;2;0;2;0
5b8e80e9eb209bfd3d536a2e3bd969235efb3e50;Thu Dec 29 17:03:27 EST 2005;Committer;akr;1;0;13;13;0
8733060106d0fe2b5e292ef0d9fff8a3507bbcdb;Thu Dec 29 16:19:44 EST 2005;Committer;akr;1;3;0;3;0
0cb24bf1b90372951967b1b1e2d7982d6354aa72;Thu Dec 29 16:08:44 EST 2005;Committer;ocean;2;17;7;24;0
84dd69741722b11f836f7473a28f20a5a460ff7b;Thu Dec 29 15:53:16 EST 2005;Committer;eban;1;3;3;6;0
fe3cba8e6fdb00b2cb50fcabe14c45463df5943f;Thu Dec 29 14:59:55 EST 2005;Committer;nobu;3;43;0;43;0
6779556b23018b057236668d8a9f6cb2c0bb64e0;Thu Dec 29 14:54:13 EST 2005;Committer;akr;1;1;1;2;0
de3bff164c3b8405f40d2e89cf726f7e865102d1;Thu Dec 29 12:05:16 EST 2005;Committer;matz;13;338;366;704;0
e5226ea394da345a1abf7719d4e0482de89df26e;Thu Dec 29 11:53:33 EST 2005;Committer;matz;1;7;7;14;0
99ee69b9f2634e9ba8868d8fff964bcf98ed5748;Thu Dec 29 08:05:26 EST 2005;Committer;akr;2;9;4;13;0
a274020ff7fb3bf6e23a97550ee8144a6fe903be;Thu Dec 29 05:56:49 EST 2005;Committer;eban;1;3;3;6;0
b29384860cd2cc7b8162bcc3955fd7487e360180;Thu Dec 29 02:29:26 EST 2005;Committer;ocean;2;45;45;90;0
056561c5dd3aa2842b260293b3034efe56eb350d;Wed Dec 28 05:14:10 EST 2005;Committer;akr;2;5;1;6;0
ebd3d34ff0e05cce8d5a815a88ccceac490b5679;Tue Dec 27 16:35:57 EST 2005;Committer;akr;2;19;4;23;0
a17dc68aa0e418a9129ea9a5d4f7c2185227b4b7;Tue Dec 27 15:07:34 EST 2005;Committer;eban;1;3;3;6;0
c3144a39a75c3f0ab2052e1e92ecdcae33889f2a;Tue Dec 27 15:00:21 EST 2005;Committer;nobu;2;5;1;6;0
c1bf7315ae9e6bf2708ec0a7a9a9abdd8f5fc238;Tue Dec 27 11:52:54 EST 2005;Committer;akr;1;7;4;11;0
ae2e26b23f024b6e6acf6f6a71764873a60e47db;Tue Dec 27 10:21:56 EST 2005;Committer;akr;1;2;0;2;0
f59bd226b3bb82566d6931723f98efa8060232a9;Tue Dec 27 05:40:04 EST 2005;Committer;akr;10;262;158;420;0
baf0ba45881d545b02f736eac799012beb334c0e;Tue Dec 27 05:10:38 EST 2005;Committer;aamine;2;6;1;7;0
f1466bc60a41b506f7e5ab7dd92c1f10174a2b6e;Tue Dec 27 04:48:13 EST 2005;Committer;eban;1;3;3;6;0
6f640b29cc6e2a28e04c4a93718ac6fc36ef3e93;Mon Dec 26 23:26:21 EST 2005;Committer;gotoyuzo;2;8;2;10;0
7982996bd4dc9f24bd105ab909b9d1e1aaeb2f07;Mon Dec 26 13:36:35 EST 2005;Committer;nobu;1;3;3;6;0
81e5a7c6928a769451d9c21795734980e3fcdfec;Mon Dec 26 13:34:16 EST 2005;Committer;nobu;1;4;0;4;0
935712e8e46ebc307a3844e3e60e381712d246ee;Wed Dec 21 09:20:15 EST 2005;Committer;akr;1;11;1;12;0
b36585ce422acfe6ae61204794a81fa4d165f0f2;Wed Dec 21 07:53:55 EST 2005;Committer;ocean;2;21;14;35;0
e40aef464a059de675afdafb11e3f8567e6fd88b;Wed Dec 21 05:31:48 EST 2005;Committer;eban;1;3;3;6;0
c7f66bdef98b74128cc23ce1fd1dcd3d329677fa;Wed Dec 21 03:14:39 EST 2005;Committer;akr;2;7;5;12;0
7c52d5f8cf2987ceddf8e70ae99c11ac22a0a056;Tue Dec 20 13:41:29 EST 2005;Committer;nobu;2;9;0;9;0
cda674e39cec9ea7a9ba2274ffbe656bc6a3fd43;Tue Dec 20 04:25:48 EST 2005;Committer;why;2;6;1;7;0
fb7f646086311493502a172b09fcfd17f51f6d0f;Tue Dec 20 03:34:39 EST 2005;Committer;ocean;2;9;4;13;0
e4413741de74c61f15a8c735be17e96c825c4479;Mon Dec 19 17:35:37 EST 2005;Committer;eban;1;3;3;6;0
0e1642ebbfdcca88498b032e057d89e43a456705;Mon Dec 19 17:11:20 EST 2005;Committer;akr;2;7;1;8;0
a88e840f77ec13386617a8353d6f4a772d6c4805;Mon Dec 19 15:51:11 EST 2005;Committer;ocean;1;2;0;2;0
6df4e18914e9d3a4ad76b46df5cc6683ee38bf21;Mon Dec 19 14:33:11 EST 2005;Committer;nobu;3;34;2;36;0
47084e129c41ec05d8149f634b3d3ae09b38756d;Mon Dec 19 14:31:09 EST 2005;Committer;nobu;3;12;3;15;0
9488784157d833fcc8c6b40978821be98e94ef6c;Mon Dec 19 14:13:27 EST 2005;Committer;ocean;3;74;93;167;0
56479b7346bbe9d428746fbe53755e7c790dee78;Mon Dec 19 14:10:36 EST 2005;Committer;ocean;2;19;24;43;0
c6c0e6f26bce5ea20243c493ae53b90314b7804b;Mon Dec 19 08:28:12 EST 2005;Committer;akr;1;2;4;6;0
dba815326696d902598cdee7335379af513941c3;Mon Dec 19 03:23:24 EST 2005;Committer;akr;2;23;0;23;0
f511d52438535a3d091e44568b1e05ebb3e26889;Mon Dec 19 03:14:19 EST 2005;Committer;eban;1;3;3;6;0
af5edce080363018934906720203b125aeb53e85;Mon Dec 19 02:42:33 EST 2005;Committer;ocean;2;13;5;18;0
8ed2a927e87a5a70a3a93c43e3ee0994a9eb98ff;Sat Dec 17 12:57:05 EST 2005;Committer;ocean;2;25;2;27;0
74a077aabafad5dc6b7526e7df509212e4976264;Sat Dec 17 08:47:04 EST 2005;Committer;eban;1;3;3;6;0
de85bb0efe9d226374fe2941b0bbbefb81b75d40;Fri Dec 16 18:59:31 EST 2005;Committer;akr;2;7;1;8;0
3ab3b5b3c897e8551fdc74d3caf7b17915d5da7d;Fri Dec 16 18:34:57 EST 2005;Committer;akr;2;9;1;10;0
44ebf5de3439fdce0c38627e716b5f1369186fb4;Fri Dec 16 08:56:09 EST 2005;Committer;ocean;2;9;1;10;0
5700ea57ffeb901135256c6daace0b76856e6900;Fri Dec 16 04:58:51 EST 2005;Committer;akr;1;2;2;4;0
7d2880ddb33658e61429b29972395debf805c0e3;Fri Dec 16 04:49:46 EST 2005;Committer;akr;1;2;2;4;0
87ea59c208fc792b54049caf2b6029cc79244b73;Fri Dec 16 03:17:16 EST 2005;Committer;ocean;2;3;1;4;0
f4f242b6d2ca28a6ec44510b21f1e7df906dc79c;Fri Dec 16 02:47:32 EST 2005;Committer;eban;1;3;3;6;0
7680ca8d2612a6a5e452f616e271ef3c02bec3f6;Fri Dec 16 02:45:35 EST 2005;Committer;ocean;2;20;8;28;0
2d6dad4f4f9cca79764289d6b1e61392dccc7e89;Thu Dec 15 03:41:13 EST 2005;Committer;matz;4;10;1;11;0
7d62299a27ae90b904293caba02d0fad40341f4a;Thu Dec 15 03:35:04 EST 2005;Committer;akr;1;1;1;2;0
1d745974b133928edd1ad0409723e3c925ece0ae;Wed Dec 14 16:50:07 EST 2005;Committer;eban;1;3;3;6;0
73b88f6be8dfd4cd28d184872e518606a547d4bb;Wed Dec 14 16:37:56 EST 2005;Committer;akr;2;6;0;6;0
55c4223064cf7dbaa5a05dab784dc226d34b2b8a;Wed Dec 14 14:50:42 EST 2005;Committer;nobu;2;6;1;7;0
8e4090f4b5ad8363120df6853b47e1231666a26c;Wed Dec 14 14:40:14 EST 2005;Committer;nobu;2;32;7;39;0
6e23e595cd9f71781f8c0be4a0da5211eb5e2529;Wed Dec 14 04:00:15 EST 2005;Committer;eban;1;3;3;6;0
07611afdc2db8646761de9fdf3b759bade1411a5;Wed Dec 14 03:04:14 EST 2005;Committer;akr;2;6;1;7;0
51f4d6645ba78fdb7342c2e58e65026643b21e17;Tue Dec 13 03:27:51 EST 2005;Committer;akr;2;7;2;9;0
682292ea7dd6a2508e97dc2388ef3769ab16fb6b;Mon Dec 12 16:47:17 EST 2005;Committer;akr;2;10;1;11;0
d223611bff26154eabb8af54fe1ae4ee82a082d1;Mon Dec 12 15:12:12 EST 2005;Committer;eban;1;3;3;6;0
2da40f048ede054fec9f172464effdd8eb3f0d91;Mon Dec 12 15:09:50 EST 2005;Committer;akr;2;7;1;8;0
2a0604d7b8029bec1815bc871efa3c0109923458;Mon Dec 12 06:56:08 EST 2005;Committer;gotoyuzo;2;6;0;6;0
0158c706458eb092ddf9619275457a29b3318c80;Mon Dec 12 05:15:33 EST 2005;Committer;akr;1;0;3;3;0
a357c6a92649010b51d2e00e04abf9c09c3920cd;Mon Dec 12 03:49:46 EST 2005;Committer;eban;1;3;3;6;0
87ebe712f7bb16cfc1f09510f50c46ccfbd8a6f6;Mon Dec 12 03:08:35 EST 2005;Committer;akr;1;3;2;5;0
c423d3cbf2b8413560c20cc44a4424e7c5062109;Mon Dec 12 03:04:53 EST 2005;Committer;akr;4;11;12;23;0
81be0398848dba163cf9f04263c8f3753133ab32;Mon Dec 12 01:01:29 EST 2005;Committer;matz;2;40;0;40;0
4d467a08650273f3e20dbc4dc78592a2237362a9;Mon Dec 12 00:36:54 EST 2005;Committer;matz;15;73;88;161;0
1ca94a03074888fe3c2b725a82bbbe539c5fdd98;Sun Dec 11 14:59:49 EST 2005;Committer;nagai;5;266;6;272;0
53895067703dc283481670d4497952deefc2cb89;Sun Dec 11 13:25:58 EST 2005;Committer;eban;1;3;3;6;0
5fdf643637360a7be0bb2b464f85ddeba891bea1;Sun Dec 11 13:17:55 EST 2005;Committer;seki;2;11;2;13;0
937731e7f8f036143e0f9435e115d6eec084b4ce;Fri Dec 09 16:10:45 EST 2005;Committer;keiju;2;143;12;155;0
00f96715f32cfc6a150294ced5a14d553a447fe2;Fri Dec 09 15:32:00 EST 2005;Committer;nobu;2;37;26;63;0
fc0434bc1dcad5724901851565c6ca50c13b021e;Fri Dec 09 15:30:31 EST 2005;Committer;eban;1;3;3;6;0
ed75a38f76609a9559ee88918fcb13497d65b708;Fri Dec 09 15:29:03 EST 2005;Committer;akr;1;0;1;1;0
2eac4d0fb43792401ed4c467e9cc1ce3f617ccf6;Fri Dec 09 14:31:47 EST 2005;Committer;nobu;5;62;33;95;0
c7143d77799d62997f40176e8a20c98a7d1283a8;Fri Dec 09 14:19:27 EST 2005;Committer;eban;1;3;3;6;0
c4c90eca3453cdfe888fce59c8806bdca5e09c97;Fri Dec 09 14:17:09 EST 2005;Committer;nobu;2;9;5;14;0
949f6fe394817675aee9277fbd7777bf360fabdf;Wed Dec 07 17:08:40 EST 2005;Committer;nobu;2;21;6;27;0
074313aed9130b68ab19e3359753479c1b768086;Wed Dec 07 15:50:31 EST 2005;Committer;eban;1;3;3;6;0
41c48d1ee8626699c345a86ede86cbada70d2b2c;Wed Dec 07 15:46:49 EST 2005;Committer;matz;3;7;2;9;0
da32ce1a67677bd0f5df8fa31e0ab05c26c7d401;Wed Dec 07 08:41:59 EST 2005;Committer;matz;5;58;17;75;0
e122cca1791b38e089776bfeb39f0bd1d07afdae;Wed Dec 07 06:36:38 EST 2005;Committer;matz;2;16;3;19;0
dfcbc92614bdaff1c16feb1d34c5bfeae810f024;Tue Dec 06 16:24:22 EST 2005;Committer;nagai;3;12;4;16;0
ff6a6a0e28016abee5b38402bee77f04f407d8d6;Tue Dec 06 16:16:32 EST 2005;Committer;eban;1;3;3;6;0
976124788e561be61b595ae555a75f24c5293753;Tue Dec 06 16:05:50 EST 2005;Committer;nagai;10;203;39;242;0
6b6ddb6cdf64e246c5e06300ae705666feee596c;Tue Dec 06 08:20:04 EST 2005;Committer;matz;1;0;1;1;0
088fb2a36ecc4e264e5952bf8157ee30c935fd0a;Tue Dec 06 07:52:18 EST 2005;Committer;matz;8;54;30;84;0
445d6076d8f44e31bb04e45d9337c0ecfb763729;Fri Dec 02 11:24:44 EST 2005;Committer;eban;1;3;3;6;0
47debbfa60087b183c314d94cc887a4eb376d009;Fri Dec 02 10:10:19 EST 2005;Committer;ocean;2;5;1;6;0
ff5e9fecede8b497630417ca8b8bda0de1be2c15;Wed Nov 30 15:55:48 EST 2005;Committer;eban;1;4;4;8;0
7d3b09acf2b38b0061654b3928b88fa281430a5a;Wed Nov 30 15:51:05 EST 2005;Committer;nobu;2;8;3;11;0
2267384c1b38b82fbbb43ca11c518425d7355ff6;Wed Nov 30 14:52:30 EST 2005;Committer;nobu;2;371;355;726;0
1717014d72dc5daed81f739bbb8751792bc3e1e3;Wed Nov 30 05:02:37 EST 2005;Committer;akr;1;0;1;1;0
cced56ef7c45d74fb1593e18f7137c144d8b8b44;Wed Nov 30 04:50:04 EST 2005;Committer;matz;6;15;16;31;0
0711cf3cd8f890de7ba4cfb5936d6849a5f2d948;Wed Nov 30 04:47:50 EST 2005;Committer;eban;1;3;3;6;0
1ebb90495827893026fe41294db238fab6e3a86c;Wed Nov 30 04:44:12 EST 2005;Committer;akr;2;14;1;15;0
96aa0c2a8fc63976d1f28af6a0681a749b8b2bde;Tue Nov 29 14:57:18 EST 2005;Committer;nobu;3;29;16;45;0
684b527b58a609a7806b19b21fa4398f4ebcc9c1;Tue Nov 29 14:19:44 EST 2005;Committer;eban;1;3;3;6;0
e5857628fc39bb3a85c377a2de0a28f0f2b83e87;Tue Nov 29 13:50:27 EST 2005;Committer;seki;2;16;10;26;0
5a6ed851fe726644dd1d528aed7bb222319e3fd3;Mon Nov 28 11:26:39 EST 2005;Committer;akr;2;12;1;13;0
3be312869dd62faecc679d2989ff62212ee6f234;Mon Nov 28 09:56:45 EST 2005;Committer;usa;2;8;3;11;0
21d45159de003fcfec86a70b46eca16715429dae;Mon Nov 28 04:26:46 EST 2005;Committer;usa;2;6;5;11;0
c43a23d49e407d8109d4540e6ae7205c261a1f97;Mon Nov 28 04:24:26 EST 2005;Committer;ocean;2;8;3;11;0
1e85f1642319d245f29178bce1c370d711c017d0;Mon Nov 28 00:27:02 EST 2005;Committer;usa;1;3;3;6;0
bb4507588c00af87236868bde0cc3858ad698236;Mon Nov 28 00:22:53 EST 2005;Committer;ocean;2;7;1;8;0
66283e1c0fff38f9a814603e7171a1121d5f436a;Sat Nov 26 20:43:08 EST 2005;Committer;akr;4;705;531;1236;0
14a0dd769e8869ecd76c95461c3d60311a7bf8e3;Sat Nov 26 16:05:41 EST 2005;Committer;eban;1;3;3;6;0
269558f209a9e6399d5c20bb5a4b41f48f3a86f5;Sat Nov 26 16:01:31 EST 2005;Committer;nahi;2;58;49;107;0
f18ce88411888b086e1182a9d5d9fc96cd084328;Sat Nov 26 11:01:20 EST 2005;Committer;eban;1;3;3;6;0
ceefeadd4f969700c9925b7188b425fd34f59839;Sat Nov 26 11:01:01 EST 2005;Committer;eban;2;5;0;5;0
8245833fb4f48fc541491498e5013f9b5d17d8bc;Fri Nov 25 07:12:58 EST 2005;Committer;nagai;14;29;204;233;0
b244f5d57ba0215f69d048facb266ea60543ea05;Fri Nov 25 07:05:22 EST 2005;Committer;nagai;111;716;10;726;0
9c5a4caf72e0674f19e346487f6acb0dafab22c1;Fri Nov 25 05:42:28 EST 2005;Committer;matz;3;37;6;43;0
689cc98238867859689928d07f9355dd181274ff;Fri Nov 25 04:45:38 EST 2005;Committer;usa;1;3;3;6;0
254670b3bc1143e6a71ea203dae8c31cf2908730;Fri Nov 25 03:54:29 EST 2005;Committer;kou;6;50;10;60;0
456ba712fe921f2387611055b67090d70dfad071;Fri Nov 25 03:43:48 EST 2005;Committer;kou;21;461;218;679;0
ea0e7c1599d1163b70b952775a55222ea90c5ae3;Fri Nov 25 01:39:16 EST 2005;Committer;kou;3;22;4;26;0
ce4befa48818ef11eea2ce06f3cf9f1ad3e2f741;Fri Nov 25 01:33:50 EST 2005;Committer;kou;5;413;27;440;0
8449be98d1e24b4228c26c185e252dbb8393651e;Fri Nov 25 01:30:57 EST 2005;Committer;matz;2;67;0;67;0
207b7ca66aacab4379218f94fd1b37a80344f8d2;Wed Nov 23 16:38:30 EST 2005;Committer;eban;1;3;3;6;0
427c2754e990184d675e4adbda750925b84935a3;Wed Nov 23 16:32:47 EST 2005;Committer;ocean;2;8;1;9;0
4f85b9edfbe5906ba69c36af0139d69d4f243706;Wed Nov 23 14:54:43 EST 2005;Committer;matz;2;8;1;9;0
93402a2f179abbb89bca9337b85a420596cc7753;Wed Nov 23 13:35:11 EST 2005;Committer;kou;6;80;19;99;0
4b87fa9de2b62d553f56671fef792a357d0996f7;Wed Nov 23 12:01:24 EST 2005;Committer;nagai;6;181;1;182;0
29bcbe5c5e03fac304816862892375033f7d6dd9;Wed Nov 23 09:56:23 EST 2005;Committer;ocean;2;28;16;44;0
73cd292fcd50f301180c536461001df2f3f9c7e9;Wed Nov 23 09:49:02 EST 2005;Committer;kou;17;117;99;216;0
4cfc20b20d70280c293927c9d4ccc008c4e00c8a;Wed Nov 23 09:33:49 EST 2005;Committer;kou;1;2;2;4;0
d32f46ad4b7fdaba1c67576f595a87f3c074f544;Wed Nov 23 09:32:22 EST 2005;Committer;kou;3;40;34;74;0
4ef7ec62cab725ad1dea2be9a26ca0f9fd195729;Wed Nov 23 09:24:17 EST 2005;Committer;kou;14;585;21;606;0
f988ceb53b731f7465f8ace09c76cd69e9abef22;Wed Nov 23 08:44:05 EST 2005;Committer;kou;4;37;12;49;0
7ff5d02f8b7d5af37032b55e2066245914c9a6cb;Wed Nov 23 05:11:18 EST 2005;Committer;matz;3;16;9;25;0
67673f6b478302f7350057e46961a7b25e56a0f3;Tue Nov 22 22:29:13 EST 2005;Committer;gotoyuzo;4;108;4;112;0
462c97ebd7ae6358a6638947b2d490b52c7dd861;Tue Nov 22 16:32:54 EST 2005;Committer;eban;1;3;3;6;0
4ef75249df459cd06003f770a707f8d7cd9b3a9a;Tue Nov 22 16:26:39 EST 2005;Committer;nobu;4;121;31;152;0
e8a83b54cb2321c3b6de9ea2f3df81064a1b18f7;Tue Nov 22 14:53:16 EST 2005;Committer;nobu;2;9;4;13;0
abcbaa5c6fb2b5e5b02b255044f6ddda94a6fcd5;Tue Nov 22 09:42:09 EST 2005;Committer;ocean;2;5;1;6;0
333e8b294d4c7afb7a56cb4ea2b2c2820d5b17a6;Tue Nov 22 05:39:50 EST 2005;Committer;usa;3;124;16;140;0
886f33e199edd5a0a85980baececbdd8837bbdae;Tue Nov 22 04:32:39 EST 2005;Committer;ocean;2;112;1;113;0
93722650262ebf4659da0579040563a353f8d51a;Mon Nov 21 23:58:10 EST 2005;Committer;ryan;3;37;16;53;0
1eee80577fa23a640a44e501dd0fb4b77436e773;Mon Nov 21 17:36:31 EST 2005;Committer;eban;1;3;3;6;0
63e6a0a91f3705d5c9977ac5c4952b23eef480c6;Mon Nov 21 17:34:12 EST 2005;Committer;nagai;4;16;2;18;0
1ce26d09fe53acce08905ead8e5ebee39d82456a;Mon Nov 21 16:47:13 EST 2005;Committer;nobu;2;8;3;11;0
cc24146adc931f1797c8469faa9fa9e68c8d4a47;Mon Nov 21 13:52:49 EST 2005;Committer;nobu;2;12;2;14;0
e4b2293712c52b089aa5e179a1b3d5571e93e733;Mon Nov 21 13:21:47 EST 2005;Committer;nobu;2;31;3;34;0
cbb5d57a2a0c17a562b557f90d7995dac5e105d6;Mon Nov 21 07:21:50 EST 2005;Committer;ocean;1;1;1;2;0
873cfd06b3247d75541ce97c6ccaa03a9d7a9ce2;Mon Nov 21 07:17:40 EST 2005;Committer;eban;1;3;3;6;0
90382d8aab6829ed17f53bf10627c73687544b28;Mon Nov 21 07:12:57 EST 2005;Committer;ocean;2;7;2;9;0
36fbf43b09574529d7922941f64f88e5867aa894;Sun Nov 20 13:42:57 EST 2005;Committer;matz;2;7;0;7;0
479a05bf898513c0a0565f35523647b22472e623;Sun Nov 20 13:36:05 EST 2005;Committer;nobu;2;11;5;16;0
e125f5f1713d7e90963b5210451f8ff8af65e1d1;Sun Nov 20 04:15:59 EST 2005;Committer;eban;1;3;3;6;0
a27ce746ad9fd36db1d38d9320fb603f5436052f;Sun Nov 20 03:30:47 EST 2005;Committer;akr;1;3;0;3;0
fbf2bcf37d52fa26304fe1d428bbfddb7d2409c1;Sun Nov 20 01:26:39 EST 2005;Committer;ocean;1;11;0;11;0
9ad68774c1ea1b5c19d4ab00e6577852009b4df1;Sat Nov 19 11:42:51 EST 2005;Committer;matz;3;7;1;8;0
9549ee64e164b53a8d58a4cae1e67cc2c74a0901;Sat Nov 19 06:09:23 EST 2005;Committer;eban;1;3;3;6;0
0e97a81adf463ceb9598494d4997ab8be23d24f8;Fri Nov 18 23:34:06 EST 2005;Committer;ocean;2;432;0;432;0
bfab52caff4e490113779554667e20757a20467c;Fri Nov 18 22:37:53 EST 2005;Committer;nagai;6;82;52;134;0
a8abed1256fe6e800d240b5ca3ddce1b4fec67a5;Fri Nov 18 09:09:25 EST 2005;Committer;usa;3;22;9;31;0
ed9a1f3e8fc3f8ccc6fd824dd11e28afb3582e76;Fri Nov 18 08:39:29 EST 2005;Committer;nagai;6;393;24;417;0
e93a1c580ef8ea27fcb153835539ace16900ae47;Fri Nov 18 07:52:09 EST 2005;Committer;usa;1;1;1;2;0
7b692e55cde4634209942cca197acf392ca51558;Fri Nov 18 07:51:19 EST 2005;Committer;usa;3;87;1;88;0
4378916e95c0dc7ff8452764dfdc690166fbd27a;Fri Nov 18 03:36:16 EST 2005;Committer;eban;1;3;3;6;0
4c307921032a144a9339b40911230b7fbe33538a;Fri Nov 18 03:22:26 EST 2005;Committer;ocean;2;11;2;13;0
02c5d7e79a79b6fc09c31c90931c599b817eadba;Thu Nov 17 09:01:22 EST 2005;Committer;kou;5;33;5;38;0
fb1d1a917d25a1e79282f269e6f70fdbe3ac76ac;Thu Nov 17 08:56:03 EST 2005;Committer;kou;3;335;15;350;0
9680ebebe12788b03a32a7126251b415d7c53c32;Thu Nov 17 08:42:13 EST 2005;Committer;kou;2;77;28;105;0
8c84da7bc51db471685adbac693aca3bc7abfa75;Thu Nov 17 04:57:16 EST 2005;Committer;eban;1;3;3;6;0
88a13516ece41a15f992b9b195bf60e89447d26d;Thu Nov 17 04:53:59 EST 2005;Committer;kou;3;8;4;12;0
f3727f59288e152d7b95c57d8b5390cf1cfeaf9d;Wed Nov 16 14:25:53 EST 2005;Committer;nobu;3;19;6;25;0
45c7551c59a23ca2bab090cb8c7dbac747b6612e;Tue Nov 15 16:41:36 EST 2005;Committer;eban;1;3;3;6;0
d3f1204ede7ef4acd62bdca967aff8d7c929e907;Tue Nov 15 16:31:31 EST 2005;Committer;kou;3;37;13;50;0
0d2c16d145cd9ebd2ccb5a00288293b88e1763e3;Tue Nov 15 16:29:02 EST 2005;Committer;kou;3;8;2;10;0
1867a3f4981a3a51c7d92f6012149446af24dcae;Tue Nov 15 14:55:16 EST 2005;Committer;nobu;2;6;1;7;0
fb10e93036279b422ff566c92d91133623e8596b;Tue Nov 15 07:51:30 EST 2005;Committer;nagai;1;286;0;286;0
ea4a254de5b2b369c96e1e7591230bee54a2b4ab;Tue Nov 15 07:38:38 EST 2005;Committer;ocean;2;11;6;17;0
d0f784a071bbca9c2fbc4dc1ff7a2027fc8004c8;Tue Nov 15 07:16:46 EST 2005;Committer;matz;3;19;8;27;0
011e0a5148d3330d9f6a279719e88f74966c6078;Tue Nov 15 07:06:00 EST 2005;Committer;ocean;3;37;5;42;0
54e04efc1099c60a14a2c9d8cb87864aec635e49;Tue Nov 15 05:46:03 EST 2005;Committer;eban;1;3;3;6;0
956296495b58e9a39cb8179f941ad7a8699b7be8;Tue Nov 15 05:42:36 EST 2005;Committer;matz;2;9;4;13;0
a1fe60779bb4fc4aa893ac830874510aff5cd82d;Mon Nov 14 14:57:01 EST 2005;Committer;nobu;1;1;0;1;0
c90546cac6a3bcfabe95e39789d8471e87189c7a;Mon Nov 14 14:52:55 EST 2005;Committer;nobu;1;4;6;10;0
ab1acb357cc4e1a520088d31046c959a9890a41b;Mon Nov 14 14:50:57 EST 2005;Committer;nobu;1;4;0;4;0
8710590f8faa89390061d56c985691e36dc21285;Mon Nov 14 08:48:46 EST 2005;Committer;eban;1;3;3;6;0
8741340545cb8daa05dcac1209171be9aa7255f6;Mon Nov 14 08:39:34 EST 2005;Committer;matz;2;10;4;14;0
18ab4853279c29279433cbed81550ee7f34dfb08;Sun Nov 13 03:29:47 EST 2005;Committer;eban;1;3;3;6;0
31f8181095ad815fa9fba25a10518bd46772c3ea;Sun Nov 13 02:02:24 EST 2005;Committer;aamine;2;10;1;11;0
03ab81258512ed3ddc46c7e01f66fc3252e22c45;Fri Nov 11 23:37:32 EST 2005;Committer;nobu;2;4;2;6;0
55a72de52b088ecba42ad380823ba253e8e80d70;Fri Nov 11 17:14:05 EST 2005;Committer;eban;1;3;3;6;0
d7f9e2d7ab7a62fb852d72eb5afbb3748c9dbcdb;Fri Nov 11 17:11:05 EST 2005;Committer;nobu;4;8;4;12;0
f69091fabc37019f495bda40707a7aa7c3c7cf6d;Fri Nov 11 11:08:17 EST 2005;Committer;ocean;4;29;8;37;0
52486197bc9e9df20752ea5630a72254b8ad8c94;Fri Nov 11 01:35:58 EST 2005;Committer;eban;1;3;3;6;0
bf203228cfa6003b79f363161ccda944d01f89d9;Thu Nov 10 23:22:03 EST 2005;Committer;nobu;3;29;17;46;0
0535fc9cac00ca44938713ebc0a849272baf9b8b;Thu Nov 10 22:43:38 EST 2005;Committer;ocean;3;38;1;39;0
dd7a195a218db5895a73a74c14c036ffbe853676;Thu Nov 10 12:09:14 EST 2005;Committer;eban;1;3;3;6;0
7145ec7bb2a5d5efaead6ec523c105837397c3ff;Thu Nov 10 12:05:57 EST 2005;Committer;nobu;2;10;9;19;0
c51b9bacec5d007931185cca0d4f5e3a93213b16;Wed Nov 09 01:55:24 EST 2005;Committer;eban;1;3;3;6;0
e8201d12db87546249e23871b959317580ff81ff;Tue Nov 08 23:41:40 EST 2005;Committer;nobu;3;60;22;82;0
6ddd56a1308703c4ee26d942e3012531c7f80973;Tue Nov 08 13:50:38 EST 2005;Committer;ttate;1;1;1;2;0
59ffb8a8463e79fac666923e3bf6ac4555b02dbf;Tue Nov 08 08:49:45 EST 2005;Committer;ocean;4;18;22;40;0
9e55ce10682af724ce4c561f062b105098b42c91;Tue Nov 08 06:45:33 EST 2005;Committer;eban;1;3;3;6;0
871384c0c522d92711c9850ecf01c9ff1af46900;Tue Nov 08 06:42:15 EST 2005;Committer;ocean;2;6;1;7;0
1aa48a4ea943eb1d1c9b931fa735f2cf68eb4368;Mon Nov 07 11:55:48 EST 2005;Committer;nobu;3;340;15;355;0
f4413f14870550a7fb01200f4f41027b505ff96f;Mon Nov 07 07:25:25 EST 2005;Committer;usa;2;6;0;6;0
f1d4dfca2b64a115fd4b8f4c9300113ec957d269;Mon Nov 07 04:47:08 EST 2005;Committer;nagai;4;45;34;79;0
f38216d43bf8a51ceaa426a74813c5fbe6ff954e;Sun Nov 06 15:12:40 EST 2005;Committer;eban;1;3;3;6;0
c8769246c973be9970cc8c821752b8c6326ef376;Sun Nov 06 15:09:06 EST 2005;Committer;ocean;2;5;1;6;0
7665deeb12f26a62d5677eecfe2b51a7abc5882d;Sun Nov 06 14:41:53 EST 2005;Committer;nobu;2;21;1;22;0
62bb03bf5a8195a6515c203015b5fce281234ac1;Sun Nov 06 14:08:56 EST 2005;Committer;nobu;1;1;1;2;0
84c2dc95de2fd6b41b374b1a2659707377929cff;Sun Nov 06 12:48:43 EST 2005;Committer;ocean;2;7;2;9;0
556a7ac35fb1e64c35c56d9c09f2c6f6ee0a1209;Sun Nov 06 11:18:57 EST 2005;Committer;nobu;2;12;1;13;0
563ff316254eca0d19be0d88d288ee39deb85490;Sun Nov 06 11:16:14 EST 2005;Committer;eban;1;3;3;6;0
aec1ef45bf50e94b0090a72c19e3a3eca414719c;Sat Nov 05 04:46:44 EST 2005;Committer;eban;1;3;3;6;0
49775b88e9cc4381f6e43e4465c7003bdba2b228;Sat Nov 05 04:43:46 EST 2005;Committer;nobu;8;261;185;446;0
479b27ac41a3d1d6d8fc04854a60df19d0389f45;Thu Nov 03 05:21:45 EST 2005;Committer;eban;1;3;3;6;0
d923e58850bf3bdaa444cffa8cadac3a3a1aa1ea;Wed Nov 02 22:58:39 EST 2005;Committer;aamine;2;6;1;7;0
2b684f793889d5049479a53ea23737217edf0b23;Wed Nov 02 11:40:08 EST 2005;Committer;eban;1;3;3;6;0
5b34104f74a3d92a2d372a350f617853147fd956;Wed Nov 02 11:28:40 EST 2005;Committer;nagai;2;6;1;7;0
284ac594b3976751c2fd8893e479887159c8d27e;Wed Nov 02 10:12:20 EST 2005;Committer;nagai;2;12;4;16;0
0e05806f364a979436e413fd9b595428c5202ee7;Wed Nov 02 10:06:29 EST 2005;Committer;nagai;3;24;16;40;0
9974cb96d3c2ca18ab27aa37081fa4a8b37cb074;Tue Nov 01 13:04:35 EST 2005;Committer;matz;11;262;14;276;0
cc1b72bc22453ac85b9308eb1c0e985b6e53cb7a;Tue Nov 01 01:58:43 EST 2005;Committer;eban;1;4;4;8;0
79bf99f7b27c02428e7807e044a241626553d407;Tue Nov 01 01:52:13 EST 2005;Committer;gotoyuzo;3;14;1;15;0
ab509c0edb4d2631772018cebbbb5dd3c06b0582;Sun Oct 30 20:50:48 EST 2005;Committer;gotoyuzo;3;14;1;15;0
aa57e68b06852f69677a9c5fbf6c7937d18b77e2;Sun Oct 30 20:40:05 EST 2005;Committer;gotoyuzo;6;87;0;87;0
8ffc7573102c021a135a89bf666f80db6c3274d3;Sun Oct 30 17:43:19 EST 2005;Committer;eban;1;3;3;6;0
58c20fbf61037c19cb38f70bd801a2893c6b5626;Sun Oct 30 17:37:31 EST 2005;Committer;ocean;2;9;4;13;0
5e9627d80aa353d742023875f6473d8d2adffd2c;Sat Oct 29 08:40:42 EDT 2005;Committer;eban;1;3;3;6;0
bb6bcd18656f56f5f9f04a9cdb471865c75317ca;Sat Oct 29 08:03:46 EDT 2005;Committer;tadf;2;14;0;14;0
ea2b0febf0a7b2abfc851f133c842db53b746f22;Thu Oct 27 11:35:24 EDT 2005;Committer;nobu;2;6;2;8;0
c6b9f162317bcd287a8983f67049d0cb9ba1566f;Thu Oct 27 08:18:38 EDT 2005;Committer;matz;8;589;77;666;0
563742204dcf1d8348a5dd51fd5e43ff50669f55;Thu Oct 27 03:04:50 EDT 2005;Committer;eban;1;3;3;6;0
c0851c650ff75d11d301ce4965f610bae9a565be;Thu Oct 27 02:55:18 EDT 2005;Committer;ocean;4;19;16;35;0
f44333cbff95e520e8c41b9cd455b1a16ed7cf22;Wed Oct 26 00:28:39 EDT 2005;Committer;ocean;2;8;2;10;0
c3da3df2f6918abf2dca90265f0d279a9dded30f;Tue Oct 25 17:01:42 EDT 2005;Committer;eban;1;3;3;6;0
8a2612b33585e832f12f1865811a6b6db8c36a24;Tue Oct 25 17:00:03 EDT 2005;Committer;nobu;7;26;5;31;0
ed91275a9889d780cc44d56992bd439d45656838;Tue Oct 25 11:21:08 EDT 2005;Committer;ocean;2;12;4;16;0
a31918d6353dc46d07caec9a6ef30af3eb4b2cac;Tue Oct 25 05:30:10 EDT 2005;Committer;ocean;2;6;2;8;0
d8e5ec121a88393d695b20f7c5cc23e9b6e8cc74;Tue Oct 25 04:44:51 EDT 2005;Committer;ocean;2;6;1;7;0
020df2c92b11d27b6eb756c9a0e71004bd4225f7;Mon Oct 24 17:31:00 EDT 2005;Committer;eban;1;3;3;6;0
a7f4a9dc03c0e262bce6df73edfd307fed053183;Mon Oct 24 17:13:42 EDT 2005;Committer;nobu;2;6;2;8;0
def653cd80e55d9e760e3803f815cc9dcdc1131e;Mon Oct 24 15:38:47 EDT 2005;Committer;seki;4;448;92;540;0
141666b1e2738844532266a81be5c6438ee6e400;Mon Oct 24 12:15:26 EDT 2005;Committer;nobu;3;15;8;23;0
c90f3b2d90885b36ec82b0803eaf59de2eb81a47;Mon Oct 24 11:41:15 EDT 2005;Committer;usa;2;7;2;9;0
e03da456b98ab7db80440227fa58799a13bfc6ac;Mon Oct 24 06:55:02 EDT 2005;Committer;eban;1;3;3;6;0
7aae276e6ba8ffb159ea014d829dfb7d5e9a82f4;Mon Oct 24 02:06:53 EDT 2005;Committer;nagai;4;11;3;14;0
51e3a4402ab41e8b51dc1d9cc975373e5eb6d19d;Sun Oct 23 07:22:05 EDT 2005;Committer;eban;1;3;3;6;0
3dd3b2136b0050c669d0881ae804b1fae8ea6567;Sat Oct 22 22:17:08 EDT 2005;Committer;nagai;127;3453;106;3559;0
d6837060becd0cb4586eca08515fc4ee6c8bb2f0;Sat Oct 22 14:55:07 EDT 2005;Committer;nobu;3;39;5;44;0
755a8aa07fbdebbe2c8fda220984dc3b2e13e89e;Sat Oct 22 05:53:39 EDT 2005;Committer;eban;1;3;3;6;0
eb82473a39e9d5b432f4fa4f36793a33a2fdfd05;Sat Oct 22 05:26:44 EDT 2005;Committer;ocean;3;25;27;52;0
0cfe16bc21697d135c35fcb329c49cdd728da7bb;Sat Oct 22 04:48:34 EDT 2005;Committer;nobu;13;36;28;64;0
fbeb59ac288bf0cff10054088ced9fb39e8866f0;Sat Oct 22 04:30:59 EDT 2005;Committer;nobu;1;50;0;50;0
973e630f0319470eed8909d7a8aa7a1c89c62cea;Sat Oct 22 04:30:03 EDT 2005;Committer;nobu;1;0;50;50;0
e819e0c7789b5a802d1d59fdffcb0037b59ccb3f;Sat Oct 22 04:27:48 EDT 2005;Committer;nobu;2;13;11;24;0
62af481d0ed527a889520368cd21cf5decfbd501;Sat Oct 22 04:09:24 EDT 2005;Committer;nobu;5;174;8;182;0
9c60701e4f39d7039da73e7dd5a36f5edade308a;Sat Oct 22 01:28:00 EDT 2005;Committer;ocean;13;37;55;92;0
1a61008f18e651ef8848813a34cdebd6d8fd5eba;Fri Oct 21 10:23:03 EDT 2005;Committer;ocean;2;8;4;12;0
5b014a7427ef87fecb54c368cf3fe1efabb03f03;Fri Oct 21 09:00:02 EDT 2005;Committer;matz;9;214;87;301;0
73f94bb851588f04e5189d37544e87884fc489c7;Fri Oct 21 06:46:41 EDT 2005;Committer;ocean;9;33;30;63;0
b4236d6e71852135dd24c80da46b96ee55e1c0c4;Fri Oct 21 06:33:00 EDT 2005;Committer;ocean;2;6;5;11;0
ee2434851bb22974e0dbfd0cfaf3ebced6b38d68;Fri Oct 21 06:28:41 EDT 2005;Committer;ocean;2;12;4;16;0
9857cc6036a973e663f6ae057f7479ac1ce0f5d3;Fri Oct 21 06:28:21 EDT 2005;Committer;eban;1;3;3;6;0
d284e44687ae8075941833e6867654a2b76e846a;Thu Oct 20 13:23:26 EDT 2005;Committer;nobu;2;6;3;9;0
14029df9302ba632bc271ae4149571d8b4a98675;Thu Oct 20 13:15:19 EDT 2005;Committer;nobu;2;23;16;39;0
e29bce0750285f53efc74932487b972aeb461738;Thu Oct 20 02:56:22 EDT 2005;Committer;ocean;6;27;22;49;0
64c8c730d752e90591b44384ef4663fa06db4213;Thu Oct 20 02:22:50 EDT 2005;Committer;ocean;7;27;40;67;0
7f60c0289c1e682b622610ca9d36ded21356f532;Thu Oct 20 00:42:43 EDT 2005;Committer;ocean;2;15;9;24;0
efbe6c1d7d304f3ad29152d27a3a65bef27c93af;Wed Oct 19 22:57:23 EDT 2005;Committer;nobu;1;3;3;6;0
834bd9db0bee977bf4f94bf10562ab073c7bb57f;Wed Oct 19 22:55:51 EDT 2005;Committer;nobu;3;11;2;13;0
c033f534c6964da851f05016ace710bda0709145;Wed Oct 19 15:07:04 EDT 2005;Committer;nobu;1;2;2;4;0
23ac67ac43ca82cd41763206c9e80eb03a6e7c70;Wed Oct 19 14:58:57 EDT 2005;Committer;nobu;1;2;3;5;0
d32dc2b9fe115f3e477e364a412f3f58cb13e647;Wed Oct 19 14:58:51 EDT 2005;Committer;nobu;1;5;0;5;0
62de00b7d103b456fbf6bf8dec58c50c364fa16a;Tue Oct 18 23:29:24 EDT 2005;Committer;nobu;2;6;1;7;0
41771ae6c1a8164a6666aad436dc3031da761beb;Tue Oct 18 17:37:47 EDT 2005;Committer;eban;1;3;3;6;0
9c871d5a5ae478a7a1fc7ba97dcd50ba854ab8d0;Tue Oct 18 17:35:18 EDT 2005;Committer;nobu;8;13;8;21;0
404faedbaab52bdc184eaba2332ec4cae55b7e01;Tue Oct 18 02:03:50 EDT 2005;Committer;usa;2;2;2;4;0
0245c7aa161548fd176794f1b3495cb634b96049;Tue Oct 18 02:01:24 EDT 2005;Committer;usa;6;13;5;18;0
a2f8339f6f3ddc665c92cff7a83cea62aa5dea08;Tue Oct 18 01:18:29 EDT 2005;Committer;usa;1;3;3;6;0
2b8887590d78a870ad6f87a8bd1ef6409601f592;Tue Oct 18 01:18:05 EDT 2005;Committer;usa;1;1;0;1;0
71aa77ef8ac228fa032981a494999faa7f4b570f;Mon Oct 17 00:45:19 EDT 2005;Committer;usa;1;3;3;6;0
fa31502b801c5ff70334a4bf0ef33b3d92158137;Mon Oct 17 00:44:54 EDT 2005;Committer;usa;2;8;2;10;0
64a1809ce259945e3928a256bc47b38b8429148d;Sun Oct 16 13:17:43 EDT 2005;Committer;nobu;2;13;6;19;0
898f094d8dc58ceafb1329784cc5c2c01f12f710;Sun Oct 16 05:43:19 EDT 2005;Committer;seki;3;20;1;21;0
6de9ca76512b616df2575c83dd11ea472a10755b;Sat Oct 15 15:16:22 EDT 2005;Committer;usa;1;3;3;6;0
45cab7d1044f81fffccf473bcbdf53a191bf1248;Sat Oct 15 15:15:58 EDT 2005;Committer;usa;2;5;1;6;0
65867866a870be8fbef90d67bd0fef8776aee09e;Sat Oct 15 14:54:03 EDT 2005;Committer;shugo;2;41;17;58;0
190909c0ce92dde386ca7c7584447870d2fdd67a;Sat Oct 15 11:07:17 EDT 2005;Committer;eban;1;3;3;6;0
59f296ffb4131d05e34abdff2f5bc927010fc31e;Sat Oct 15 10:57:50 EDT 2005;Committer;seki;2;5;1;6;0
f76f6155e11f1d9bae9a9a1f61bb8a5646b6ec2e;Fri Oct 14 14:10:08 EDT 2005;Committer;nobu;4;65;3;68;0
b367743e929b0bdd726736810163caf76c45a185;Fri Oct 14 13:09:11 EDT 2005;Committer;usa;2;5;0;5;0
55aba8a1fc2e99138ce77891d6e8b2fc4c8ab7ce;Fri Oct 14 07:43:37 EDT 2005;Committer;eban;1;3;3;6;0
8c293539cdaa659e724e9e55a0df5dbd145b53bf;Fri Oct 14 07:40:47 EDT 2005;Committer;gotoyuzo;2;7;1;8;0
1f15b5fb487ad9d4e68dfc3773a859e0fa8307d8;Thu Oct 13 14:35:58 EDT 2005;Committer;eban;1;3;3;6;0
61bd5fb4dcf56d9660d95c893703fcca698d42e9;Thu Oct 13 14:33:30 EDT 2005;Committer;nobu;2;10;6;16;0
0ccc5dbe83218c981261240c4973d42919bf6d29;Thu Oct 13 14:30:54 EDT 2005;Committer;nobu;6;14;3;17;0
ee499a8745c36e36ab9ce6ea619525b496b6bb42;Thu Oct 13 14:26:00 EDT 2005;Committer;nobu;2;6;1;7;0
ff2b8b31c2d1646034f227ab99927b1714f41cb2;Wed Oct 12 03:56:04 EDT 2005;Committer;gotoyuzo;2;6;0;6;0
b559d863a517d3c34797635fc1d61e0f5ef3d72f;Wed Oct 12 02:26:52 EDT 2005;Committer;eban;1;3;3;6;0
94e64bd88dc2b8e5151dd573575e8dad727867c4;Wed Oct 12 02:15:06 EDT 2005;Committer;eban;1;3;3;6;0
fea2b2378f9ab9ee63b781e7f6127d225a1ecf54;Wed Oct 12 02:14:50 EDT 2005;Committer;eban;2;5;1;6;0
cc2334bd7bdeae8e91397576020d397a3d04af5f;Tue Oct 11 12:42:50 EDT 2005;Committer;nobu;4;23;23;46;0
a3cb2093ef475648c1845b70122639e9f69e85e7;Tue Oct 11 12:39:26 EDT 2005;Committer;eban;1;3;3;6;0
1b03efee58ee4c825b278a7bcb4ac80e41e7c18a;Tue Oct 11 12:30:48 EDT 2005;Committer;nobu;8;31;28;59;0
32f264bfef9ef6eb96c791ee33ffad8d5e461578;Tue Oct 11 12:29:11 EDT 2005;Committer;nobu;2;6;1;7;0
1f6620a6b9c737922e5e02566df58919642ab732;Mon Oct 10 04:24:07 EDT 2005;Committer;nobu;3;25;58;83;0
a01e8895a489019ba2c4ed1b2b064f66047b1032;Sun Oct 09 16:23:00 EDT 2005;Committer;eban;1;3;3;6;0
ab81f8730266376dcea70a8f26b45bcac588e253;Sun Oct 09 15:10:24 EDT 2005;Committer;nobu;2;15;1;16;0
9a87cff60c160278d43e226de6df6d5694c488d4;Sun Oct 09 06:13:38 EDT 2005;Committer;eban;1;3;3;6;0
5fad2a15d19ae3ba8644c0a1b9853fe7bc179f1a;Sun Oct 09 05:04:30 EDT 2005;Committer;suke;2;30;0;30;0
68b062d402aab49f21a69bd8b791d8fcba2c2b48;Sat Oct 08 10:50:08 EDT 2005;Committer;nobu;2;13;14;27;0
ec12edb11ca8667cacca36030b36150dab1d8173;Sat Oct 08 10:45:52 EDT 2005;Committer;nobu;6;18;69;87;0
8fb6f790fed6f8d6fa33a80d83e55d793c9eb516;Sat Oct 08 10:33:24 EDT 2005;Committer;nobu;2;6;1;7;0
ea6b149fd8249ece25926b64d87940af32e800be;Sat Oct 08 10:19:51 EDT 2005;Committer;nobu;2;3;4;7;0
2b291d3806d85d6a87963dfcc88750e89e147b2c;Sat Oct 08 10:15:50 EDT 2005;Committer;nobu;3;41;13;54;0
04bdcf84328eec8e144b3b9e0a1ee4407d71d594;Sat Oct 08 09:58:25 EDT 2005;Committer;nobu;5;101;20;121;0
1022702acf4f25b0d6e11ce5ad6743fbde59bb25;Thu Oct 06 11:11:23 EDT 2005;Committer;aamine;2;5;1;6;0
c8f3c6b170ac79e87bf22e60d54722de7afc140b;Wed Oct 05 16:18:12 EDT 2005;Committer;eban;1;3;3;6;0
22f1926644a213a39cd8a3f83a80518e5c15797f;Wed Oct 05 16:15:16 EDT 2005;Committer;matz;21;492;215;707;0
313e0cb56aedfceb0bfaab2e430d2211c5e2043b;Wed Oct 05 01:31:16 EDT 2005;Committer;eban;1;3;3;6;0
0c8d8b3f55fbc1751dc5472068b1df0f7b1c17f1;Tue Oct 04 19:46:35 EDT 2005;Committer;gotoyuzo;2;6;1;7;0
1355933d89ffbef59b09a9ab9100720b0ad9dce5;Tue Oct 04 19:09:56 EDT 2005;Committer;gotoyuzo;2;6;1;7;0
ab3dde0da35e02b61818cf210b0e3a5089160102;Mon Oct 03 15:37:18 EDT 2005;Committer;eban;1;3;3;6;0
5369103f871e30741d49e51f1a52332cb50728d5;Mon Oct 03 15:34:37 EDT 2005;Committer;nagai;3;10;5;15;0
1110e7123c8af68ba6a91ce1b46d92d6fb911e6a;Sat Oct 01 14:57:06 EDT 2005;Committer;usa;2;75;48;123;0
36941b8465e3185769deceee7280b592f874ffa0;Sat Oct 01 04:11:43 EDT 2005;Committer;akr;3;4;20;24;0
e0f041a27969fd5dd8b9c8010d55be70a175c5d3;Fri Sep 30 16:51:57 EDT 2005;Committer;eban;1;4;4;8;0
372809129df72ab92534bb5e944cbcef34eeda9b;Fri Sep 30 16:48:46 EDT 2005;Committer;akr;2;22;5;27;0
fc1bdda026f296ca3955a2338a72971821eb034a;Thu Sep 29 01:28:56 EDT 2005;Committer;akr;2;6;1;7;0
44594b243ddde479a6d3aae4c6afc3a852109d83;Thu Sep 29 01:18:14 EDT 2005;Committer;akr;2;52;12;64;0
c7ffe40f116749455e3b8f9fcaff70c22203d684;Wed Sep 28 22:22:44 EDT 2005;Committer;nobu;2;6;1;7;0
d4849b189da3f59724e4c0ead34ce91a4eb4bc69;Wed Sep 28 16:02:38 EDT 2005;Committer;eban;1;3;3;6;0
962bcf1394762f297331f0a5a79c8fc3cc55ed10;Wed Sep 28 15:58:32 EDT 2005;Committer;nobu;4;14;6;20;0
2a05d8c7fb304a24f716458104128b830d435322;Wed Sep 28 14:40:25 EDT 2005;Committer;nobu;2;7;3;10;0
08ec75e4272e0a92c615cc9735c67a0207420602;Wed Sep 28 06:16:59 EDT 2005;Committer;gotoyuzo;3;11;2;13;0
3284ccb55ac6ec448eb5f688a408c8085a2386a6;Wed Sep 28 03:51:52 EDT 2005;Committer;akr;1;1;1;2;0
64edb6d31d93aef7813680062b18d1ec6e46aa72;Wed Sep 28 01:48:53 EDT 2005;Committer;nagai;2;11;7;18;0
462fd870d70a13713e13f78bb058ee0e06b0e31c;Tue Sep 27 22:57:53 EDT 2005;Committer;nobu;5;63;41;104;0
63e58214602bba961af15dac35e160427ffd5c12;Tue Sep 27 18:25:06 EDT 2005;Committer;usa;1;3;3;6;0
b1d08eabdad09ff5b6d955b369331e4c43a6a187;Tue Sep 27 18:24:11 EDT 2005;Committer;usa;2;6;1;7;0
0377141da6b0bb62e0fcde2e36bf70655c88e749;Tue Sep 27 07:18:00 EDT 2005;Committer;eban;1;3;3;6;0
546e4aa194daee37cde7a5bd26429489567dc4bf;Tue Sep 27 07:08:58 EDT 2005;Committer;ocean;1;2;2;4;0
7aefa8e580f06ff869411092e38b7a18ba44240d;Mon Sep 26 12:44:47 EDT 2005;Committer;nobu;2;14;15;29;0
1a6ce22dfad999cd1ad92fc87ba8ec3a52ca4340;Mon Sep 26 12:01:29 EDT 2005;Committer;ocean;2;166;442;608;0
37706bf2ee2649403866d973325bb2254d4f679d;Mon Sep 26 01:45:07 EDT 2005;Committer;eban;1;3;3;6;0
cd5a5a30c026d898a5637bbc1897b71ba7302437;Sun Sep 25 22:56:15 EDT 2005;Committer;nobu;2;16;15;31;0
977176d702da8ce0317285f4449c795d277c2d09;Sun Sep 25 03:06:23 EDT 2005;Committer;seki;2;5;1;6;0
14b6275a0212bcb5d3d19f731d86101025af5d3a;Sun Sep 25 02:56:26 EDT 2005;Committer;seki;2;105;108;213;0
159642bc75e770c4d3bb0ab271c4575eabea4cba;Sun Sep 25 00:39:22 EDT 2005;Committer;ocean;2;89;85;174;0
3d89ecbdfd1c60130a430f9839ba1e5057828d30;Sat Sep 24 23:45:46 EDT 2005;Committer;akr;1;1;0;1;0
9b9a3dc54eb2fe6e37163def8ce2ba2832d46cf5;Sat Sep 24 23:20:15 EDT 2005;Committer;nobu;3;13;8;21;0
4a774a787f568da80ea49a4526e21d44dbb4082b;Sat Sep 24 23:11:11 EDT 2005;Committer;akr;1;5;5;10;0
d95e8e013b571c81cbe847e6bb18a53e81ccab13;Sat Sep 24 22:34:56 EDT 2005;Committer;akr;1;5;5;10;0
9e12dc5ce92cfb4319ee4d10069a2ec73c4880fe;Sat Sep 24 16:47:20 EDT 2005;Committer;nobu;2;11;2;13;0
dd5564b5fd0efb13b83396328cfcdb809148b247;Sat Sep 24 16:36:11 EDT 2005;Committer;akr;2;29;12;41;0
973fec3719511aabdceca40accbdf4fb8394e501;Sat Sep 24 15:44:22 EDT 2005;Committer;eban;1;3;3;6;0
62c220a74aa52eb5d52a342d039b853f51a5dffc;Sat Sep 24 15:43:17 EDT 2005;Committer;nobu;2;15;6;21;0
0c65f6675770f230d346ad1531dc49219d823eb5;Sat Sep 24 13:34:26 EDT 2005;Committer;akr;1;3;5;8;0
d277603d5e039255377e3849f5071f08a0f9ef50;Sat Sep 24 12:20:14 EDT 2005;Committer;aamine;2;42;50;92;0
51cb36cc0e1af1f8b8df04fb7baf82ffb14ec0d9;Sat Sep 24 11:42:40 EDT 2005;Committer;aamine;1;3;2;5;0
8e1d3e549872b621b018cfab925cc6677938d258;Sat Sep 24 11:25:29 EDT 2005;Committer;aamine;2;10;0;10;0
038555995ff56a25db0379fb9b5e03af3af4850c;Sat Sep 24 03:42:31 EDT 2005;Committer;eban;1;3;3;6;0
74b34477e26849771485da02a7b3cefe211fb692;Sat Sep 24 02:45:02 EDT 2005;Committer;aamine;2;381;0;381;0
0517b43c5b58ccc2acddea80cdfa4e16e19aa84d;Sat Sep 24 00:17:43 EDT 2005;Committer;akr;13;8;32;40;0
8a6eb889e03a76464af1f42576cf7d9f096433ca;Fri Sep 23 23:54:57 EDT 2005;Committer;aamine;2;6;1;7;0
9bfb4dc6ac6815aa600575c8745870b6ee8f9f91;Fri Sep 23 23:32:29 EDT 2005;Committer;akr;2;13;1;14;0
a33aa9c9f4f9d692f184415aebbb60dc4e75a902;Fri Sep 23 23:30:09 EDT 2005;Committer;aamine;5;102;8;110;0
4a092d08f48f65f7114daca133cbb92bc7ff4057;Fri Sep 23 22:59:57 EDT 2005;Committer;aamine;3;118;30;148;0
1d62cc0ecc3e0ad8336972596c6a7bdab3d68921;Fri Sep 23 21:37:38 EDT 2005;Committer;aamine;11;186;157;343;0
2d683b3190f60e82ed791381d21c2a3530beb824;Fri Sep 23 11:10:59 EDT 2005;Committer;nobu;5;69;72;141;0
5d71328bca0ebb29859d574d204d74c499030232;Fri Sep 23 08:39:24 EDT 2005;Committer;suke;4;38;5;43;0
883c6bf7420613c690bd0e924915337b580c0bed;Fri Sep 23 02:54:00 EDT 2005;Committer;eban;1;3;3;6;0
bafc88f1f1cebc53c82a8c8d45d3d6783cc4ae94;Thu Sep 22 22:08:47 EDT 2005;Committer;aamine;3;72;28;100;0
42d9ecc12567ff6e08659a0b02c21dae2223fe68;Thu Sep 22 22:01:32 EDT 2005;Committer;aamine;2;38;33;71;0
a6149d7f31663d38864917f9397e87a0357a3cdd;Thu Sep 22 21:22:23 EDT 2005;Committer;aamine;1;3;3;6;0
9c1469ee80602ffb55368659a0bb690d3f8a0e0c;Thu Sep 22 21:13:40 EDT 2005;Committer;aamine;1;0;1;1;0
373a19b736db02231c7942e24698c5b850c0ac05;Thu Sep 22 21:12:11 EDT 2005;Committer;aamine;1;2;2;4;0
f5354619751ad85540494e6fe688aad4ee4b8573;Thu Sep 22 21:01:58 EDT 2005;Committer;aamine;2;20;0;20;0
ec4689b1649c4d68257d1704e26c6010033f4096;Thu Sep 22 20:58:31 EDT 2005;Committer;aamine;1;180;0;180;0
a697b1f6029c215f8a7c14e8b696a19d838708ec;Thu Sep 22 20:58:10 EDT 2005;Committer;aamine;18;87;1589;1676;0
6fb86f740b994108254982b954f8ad9df64bf5b4;Thu Sep 22 14:40:37 EDT 2005;Committer;nobu;2;4;10;14;0
4857e1d30018e0fc7449af149449745410db01a6;Thu Sep 22 14:37:02 EDT 2005;Committer;nobu;2;16;2;18;0
759410a8c9c1aa222b2dfb1fd562b41aa6945b3b;Thu Sep 22 08:33:05 EDT 2005;Committer;shugo;2;24;14;38;0
941af2749069a165d6a37cd75c29f9725e9f9e88;Thu Sep 22 05:20:30 EDT 2005;Committer;eban;1;3;3;6;0
140a4cd9d4c4b5322fa210b736bb6d0c2ef257c8;Thu Sep 22 05:01:14 EDT 2005;Committer;nagai;1;0;513;513;0
c6b5ca0e217d7767a2db48fa4a40ba59acb0a8f8;Wed Sep 21 14:31:20 EDT 2005;Committer;nobu;2;11;1;12;0
5cbb885ce177e2e3462a87499a72bc7645051069;Wed Sep 21 05:17:54 EDT 2005;Committer;usa;2;7;2;9;0
db06d0ff5aefa84c3523507f6275db36497829ea;Wed Sep 21 01:31:55 EDT 2005;Committer;eban;1;3;3;6;0
741179662da3c829e1a0dfa55a945cead1be8166;Tue Sep 20 23:58:18 EDT 2005;Committer;why;2;120;110;230;0
7f249811e10c4871f3150a46c603083f733a9e9c;Tue Sep 20 23:20:58 EDT 2005;Committer;nobu;3;44;4;48;0
898c734378ddb060152660fd58a91505351bc1a9;Tue Sep 20 22:45:06 EDT 2005;Committer;nobu;2;14;3;17;0
66e67afd453dc6826c76d8b99522a5d7e1be123a;Tue Sep 20 14:59:51 EDT 2005;Committer;nobu;1;9;9;18;0
c59306cccb0c584c79dce54416e6faf5a36f8e49;Tue Sep 20 13:25:59 EDT 2005;Committer;nobu;2;41;39;80;0
ca829d5926fa476efc98075fc5788e6e70358cf8;Tue Sep 20 12:26:58 EDT 2005;Committer;nobu;2;18;13;31;0
e41b0ce6a323806317573d91ecb8ab3a1d9c988f;Tue Sep 20 09:26:35 EDT 2005;Committer;akr;2;5;0;5;0
cc29d740b6462c584fe9e908a19256ff7a81d8f8;Tue Sep 20 08:35:52 EDT 2005;Committer;ocean;2;9;0;9;0
184766e02e4d140fcbad714b12bc810708bff05b;Tue Sep 20 08:14:56 EDT 2005;Committer;ocean;2;13;0;13;0
d578f9d32e4c13df9ebf51873ae335c5e5a795ce;Tue Sep 20 06:50:20 EDT 2005;Committer;why;10;395;356;751;0
34b3f481dc2e92aaf477f4ec49a0b3bf0274bbf1;Mon Sep 19 20:51:36 EDT 2005;Committer;ocean;2;17;5;22;0
a6eb4609c215fb04b9b5a40bd065826c7b6f1954;Mon Sep 19 16:44:08 EDT 2005;Committer;matz;1;0;9;9;0
75ee37707e1c8cc8431b102b80098a1d7679f8dd;Mon Sep 19 16:09:19 EDT 2005;Committer;eban;1;3;3;6;0
4e07664e19c0e702416e98a606af88572554f81a;Mon Sep 19 16:02:55 EDT 2005;Committer;matz;3;6;9;15;0
7559d2fd7accfd9eab2c8ab5864a5c61d6016d1d;Mon Sep 19 16:01:06 EDT 2005;Committer;matz;6;56;7;63;0
5363e91dba3d2bd1dffaf8eeff53bc3f0a2a3ce4;Mon Sep 19 09:58:52 EDT 2005;Committer;aamine;2;7;3;10;0
b24efbebaa17243dcb5070575a91934929b02035;Mon Sep 19 06:23:31 EDT 2005;Committer;aamine;1;1;1;2;0
7ce50d8dd51e20f169ea4a939f6a963b321a8920;Mon Sep 19 06:22:04 EDT 2005;Committer;aamine;1;3;0;3;0
70373e2e549d028fe28a6d2303903329e8490c49;Mon Sep 19 06:12:35 EDT 2005;Committer;aamine;2;12;6;18;0
ae860f9a569206fff8c1372ef21dc6ac88ad3215;Mon Sep 19 05:50:17 EDT 2005;Committer;aamine;3;31;24;55;0
dfd45277d09d7126898d4929a81ae2f7c39dea48;Mon Sep 19 05:49:08 EDT 2005;Committer;aamine;1;1;2;3;0
04165c20fe286d3123eff634412bdf871fc9da41;Mon Sep 19 05:40:47 EDT 2005;Committer;aamine;3;20;10;30;0
1e63c302db089512f5376ee7778943b662b53d84;Mon Sep 19 04:33:00 EDT 2005;Committer;ocean;1;17;0;17;0
246f5cfe67fda9fa2fed869c2fffb48effcdc6b9;Sun Sep 18 22:56:11 EDT 2005;Committer;gotoyuzo;6;42;23;65;0
8885a8720d55bd881e7083adf38a21d73e095e4b;Sun Sep 18 21:38:40 EDT 2005;Committer;aamine;2;10;5;15;0
b7083f661d13414c69eb9e949e7d039e7e519d0c;Sun Sep 18 20:59:29 EDT 2005;Committer;aamine;3;258;20;278;0
14d206dbb53c97f1b3dc68d9bd97cdcc39a37b17;Sun Sep 18 20:33:01 EDT 2005;Committer;aamine;2;35;24;59;0
af8d063aca068e18c7c5baf6545da5ab993356f1;Sun Sep 18 18:31:33 EDT 2005;Committer;eban;1;3;3;6;0
1ad103b7f83ccd0229ed3f61ef2de8c832cb329b;Sun Sep 18 18:29:19 EDT 2005;Committer;akr;4;24;1;25;0
9af6e57230e0c47b91b249e1892f444d0f9cea2b;Sun Sep 18 00:25:20 EDT 2005;Committer;nobu;1;1;1;2;0
fb5dd968ec23014d25f694c2e88604f14578e68f;Sat Sep 17 21:44:24 EDT 2005;Committer;ocean;1;13;6;19;0
f3d9f34537779e2ed3d29519c6a29346b74409d7;Sat Sep 17 17:22:49 EDT 2005;Committer;why;7;541;568;1109;0
17f4f5f507715b8b832305f71b2375ca9f830ff4;Sat Sep 17 16:14:56 EDT 2005;Committer;nobu;1;3;0;3;0
22cfbc23710c9636248e1ddbdaf0ba34b28b46fa;Sat Sep 17 16:10:53 EDT 2005;Committer;nobu;1;2;7;9;0
273c4d116b1f6ac393b4fd34895f59b24045cfd9;Sat Sep 17 16:10:53 EDT 2005;Committer;nobu;2;7;3;10;0
b99bee41edb2730b554b0f969e862f185fc78374;Sat Sep 17 16:10:06 EDT 2005;Committer;eban;1;3;3;6;0
48dcf7ad36c88be62d6b2d06eed44b4045523b45;Sat Sep 17 16:00:23 EDT 2005;Committer;matz;3;11;3;14;0
ffe229399843b3ddb86511c0627e208e989efc49;Sat Sep 17 14:40:06 EDT 2005;Committer;matz;5;26;7;33;0
f2107f2ec1cfcc9e86bb69949faf21e161516076;Sat Sep 17 12:20:07 EDT 2005;Committer;ocean;2;43;33;76;0
f34cec631eced2302f34124d3a3e9902ac3da5a3;Sat Sep 17 08:50:53 EDT 2005;Committer;eban;1;3;3;6;0
eca8977b34f86fa8f2d2769b0592c41dc3b75536;Sat Sep 17 06:32:20 EDT 2005;Committer;ocean;1;2;2;4;0
bf4e0d73531128d42ca121b3a164c3ea46b8c9a0;Sat Sep 17 05:57:53 EDT 2005;Committer;ocean;2;5;2;7;0
f0bcbbef671e7ba3592cdb730bbc9d9f8f3cfc10;Sat Sep 17 05:22:33 EDT 2005;Committer;ocean;2;29;8;37;0
aa21055faf3e8e02038fee143ba322e1ed3b26f1;Sat Sep 17 04:53:26 EDT 2005;Committer;ocean;2;51;1;52;0
846b1c35e5c6d0ab787b9415ea586ccc843df562;Sat Sep 17 02:42:59 EDT 2005;Committer;ocean;2;129;223;352;0
762ed0d68c7cfb96c8e4c1a67030a01e7825c9a5;Sat Sep 17 01:44:28 EDT 2005;Committer;nagai;3;12;5;17;0
446eef82cfea0d634266489f79d901f6c50be1f0;Fri Sep 16 23:48:17 EDT 2005;Committer;kou;3;67;1;68;0
aa6393778a0255ce0fe3dbe9403218d20ad3cd5c;Fri Sep 16 23:05:13 EDT 2005;Committer;shugo;2;117;7;124;0
5a2f770fb1d235993fcc3d951ab4c027e7eba84f;Fri Sep 16 13:46:05 EDT 2005;Committer;nobu;4;121;38;159;0
2b205913b8f4aaa812e9838cf9a3188963b11170;Fri Sep 16 13:44:59 EDT 2005;Committer;nobu;2;22;10;32;0
c8b2171c669c5421fa7c430ee75b902c2b29948d;Fri Sep 16 13:42:17 EDT 2005;Committer;nobu;2;21;6;27;0
38aeed1f947f58433a1c8f98630a062d13db39fd;Fri Sep 16 09:37:45 EDT 2005;Committer;matz;2;7;1;8;0
56d82da97cd141231f72d9919def6a1ce8fd8445;Fri Sep 16 07:22:49 EDT 2005;Committer;matz;2;43;8;51;0
e0166cd8f6e8e3f29683e39ef5ff91822aa7c9d8;Fri Sep 16 05:50:56 EDT 2005;Committer;nagai;3;6;2;8;0
1b644555aee0692006c3f4efaae16e5e0f9160e9;Fri Sep 16 03:09:51 EDT 2005;Committer;matz;6;26;11;37;0
8b02984629490751af2a4cb0a9bc0b48ceaf1bdb;Thu Sep 15 15:17:53 EDT 2005;Committer;nahi;2;7;0;7;0
94dc8ca41e385cfff674283dd49444d4f45c85aa;Thu Sep 15 15:09:12 EDT 2005;Committer;eban;1;3;3;6;0
7d520ab9fa3ee275d75de2f47f9f427d778a48e6;Thu Sep 15 15:07:34 EDT 2005;Committer;nahi;3;113;60;173;0
563cac1f6967b52e2efe39450e29f62a4ff20f64;Thu Sep 15 15:07:05 EDT 2005;Committer;gotoyuzo;2;6;0;6;0
29c5ab0b77feaf975d83ab340d7194c9c4dffc9d;Thu Sep 15 14:33:53 EDT 2005;Committer;nahi;80;3853;597;4450;0
071c45df939e962e8cd6ecc51bd402b6a7cc91f6;Thu Sep 15 13:42:15 EDT 2005;Committer;usa;2;15;0;15;0
80fb5e0584644131bdd10372a932a563373717d5;Thu Sep 15 04:56:25 EDT 2005;Committer;akr;2;16;0;16;0
a2e57fd16006cefdbab2c165b7abd7fcbb29dcc4;Thu Sep 15 02:41:17 EDT 2005;Committer;nagai;3;13;7;20;0
8bfc6d7493d098f4ced7abbdd5fe441ca24de7ff;Thu Sep 15 02:04:06 EDT 2005;Committer;usa;1;3;3;6;0
7c5eaf70a3754452ecdb432d5430b6ee00460a83;Thu Sep 15 02:03:43 EDT 2005;Committer;usa;2;102;9;111;0
e2472dafa07c491954c3e81ee9643ade1252ce00;Wed Sep 14 14:30:37 EDT 2005;Committer;usa;4;136;15;151;0
9d2b69a27306058af38a7e5c1b57dd419a57fd05;Wed Sep 14 13:41:02 EDT 2005;Committer;nobu;4;60;44;104;0
ca32aea6a24d443434f1fa40b9091edc16ef03bf;Wed Sep 14 08:30:16 EDT 2005;Committer;ocean;11;30;23;53;0
6c32e232d90c3347dbb52366a378265f19022e38;Wed Sep 14 06:36:29 EDT 2005;Committer;usa;1;3;3;6;0
08c1738c512e2e3be60da17638e2857b547b2933;Wed Sep 14 06:32:32 EDT 2005;Committer;ocean;36;832;822;1654;0
6b1239a8203a6150762eb8856c72771784b33bd0;Tue Sep 13 13:13:41 EDT 2005;Committer;nahi;3;109;81;190;0
7c44a27cb256345cf3eb9c242909fd3cb13d03aa;Tue Sep 13 12:47:43 EDT 2005;Committer;nobu;2;11;4;15;0
6cdf50d8be3d80f8da875d3cedc256a066ea6553;Tue Sep 13 12:39:45 EDT 2005;Committer;nobu;2;2;2;4;0
6c255d0dde4be530ae1cc09859721c6d20c985c7;Tue Sep 13 11:26:42 EDT 2005;Committer;akr;3;25;15;40;0
97c7c50245253a92b3ab86fc8c57e417c7e76cdd;Tue Sep 13 06:41:59 EDT 2005;Committer;aamine;2;126;40;166;0
54b23dd6b5a9799ff2e14f910f925caf23ec6a59;Tue Sep 13 05:35:27 EDT 2005;Committer;ocean;3;8;2;10;0
f1827a2fafaa50ba89f35c8c05beffd28b1dd6e6;Tue Sep 13 03:58:33 EDT 2005;Committer;why;20;4298;2495;6793;0
2007d73102b29e7bf50d08f6690ae5e6ffa5ea9a;Tue Sep 13 03:45:01 EDT 2005;Committer;why;1;247;0;247;0
9852657e8614b3e720b81c3eb5eb1764453449df;Tue Sep 13 03:43:45 EDT 2005;Committer;why;3;38;354;392;0
ef1ccbbc40cbfa512b2be0eeb7793c3532ff5e20;Mon Sep 12 23:09:39 EDT 2005;Committer;nobu;6;20;8;28;0
40816e8ba28ffd52e6e02a258a8819cb288ab713;Mon Sep 12 16:29:08 EDT 2005;Committer;matz;2;2;2;4;0
db05a0096a989a6b2c9fe1579909a368b0127026;Mon Sep 12 16:23:14 EDT 2005;Committer;matz;1;1;0;1;0
82e8e747df8e9b5ab184b446b0ccf4f80e6b743b;Mon Sep 12 16:21:50 EDT 2005;Committer;matz;5;14;12;26;0
35a84adff01996abe5d21dec423cc45691774199;Mon Sep 12 15:23:54 EDT 2005;Committer;matz;4;7;4;11;0
757f06fdc75263b16cb041e003de968e63c285ce;Mon Sep 12 15:12:52 EDT 2005;Committer;matz;1;0;77;77;0
86f0a80d7d4fd758e1f939aaa2b05cfebe2b08c4;Mon Sep 12 15:02:48 EDT 2005;Committer;nobu;1;3;3;6;0
ef86852451fc003f0f1eff390968aa054dcfcda4;Mon Sep 12 15:02:46 EDT 2005;Committer;nobu;3;31;37;68;0
7877b56572b07988c9994625093be884d3136c79;Mon Sep 12 11:55:25 EDT 2005;Committer;gotoyuzo;2;13;0;13;0
bf102e8a356b457ac5063d75a9e539fcae8f1ab0;Mon Sep 12 11:40:40 EDT 2005;Committer;ocean;3;16;10;26;0
4409f88ad81e5a9317caa554deb26c770d34d95f;Mon Sep 12 11:03:24 EDT 2005;Committer;ocean;5;30;21;51;0
7ecb12dc27fa57b7d0ebae0584f9cef86c8dcb65;Mon Sep 12 10:44:24 EDT 2005;Committer;ocean;1;3;3;6;0
dda5dc00cff334cac373096d444a0fd59e716124;Mon Sep 12 10:44:21 EDT 2005;Committer;ocean;44;2211;5308;7519;0
51e25545aeb1555051b95c5b31b4f3ca6ec6b6fe;Sun Sep 11 14:26:27 EDT 2005;Committer;shugo;2;22;0;22;0
48a9b6170e7221c4e96b777d2bf0a497c5c44239;Sun Sep 11 13:18:59 EDT 2005;Committer;seki;2;82;75;157;0
f610eab08260a3bde1129e887e2d70c71cbd87e2;Sun Sep 11 13:18:56 EDT 2005;Committer;seki;1;3;3;6;0
ef0502168608a73d205af700127c956d1ac3d8f8;Sat Sep 10 13:34:53 EDT 2005;Committer;matz;3;149;321;470;0
9207bf104126987ca0f0cc23cd17816aaf6361a7;Sat Sep 10 02:07:50 EDT 2005;Committer;ocean;1;3;3;6;0
6e88336c2d1c3ccb854aefb6e212642fa63cf0da;Sat Sep 10 02:07:48 EDT 2005;Committer;ocean;1;1;1;2;0
b3d2a8aaedb27c56461aaf236654bb8386b0c6a1;Fri Sep 09 07:45:36 EDT 2005;Committer;nobu;3;41;199;240;0
f5451f4fca8e02df500668c77ba7bbe6043690ac;Fri Sep 09 07:35:34 EDT 2005;Committer;nobu;1;3;3;6;0
7d4115921291c8691ce46061a924f08a9607b07b;Fri Sep 09 07:35:31 EDT 2005;Committer;nobu;2;9;4;13;0
40a77284e5158e51e1099b09c50f79a3abe381b5;Thu Sep 08 06:00:56 EDT 2005;Committer;matz;4;6;9;15;0
f1efc08bb14af80efa44fe9a61e53654ddf48b61;Thu Sep 08 04:42:46 EDT 2005;Committer;matz;3;20;8;28;0
b40d12a5f8f796a373093d69c0f5ed9a11440588;Thu Sep 08 04:33:30 EDT 2005;Committer;matz;1;3;1;4;0
51c919b387070e9d75bbabd2f70986d378df16fa;Wed Sep 07 16:07:43 EDT 2005;Committer;ryan;3;29;2;31;0
7591606c528a371de07acc9b08ac30b1bb317e4f;Wed Sep 07 16:07:40 EDT 2005;Committer;ryan;1;3;3;6;0
23bde288c6888cea9580052c51bef2007ac487f3;Wed Sep 07 09:24:21 EDT 2005;Committer;gotoyuzo;1;22;0;22;0
c4b83bb93fcf1ff9be56b363186033ecf95e3b25;Wed Sep 07 08:29:47 EDT 2005;Committer;gotoyuzo;1;58;3;61;0
9147e519ba5abad72672a61912dc16dde9aea3a7;Wed Sep 07 07:40:55 EDT 2005;Committer;gotoyuzo;6;329;17;346;0
5197f6773a873d905215312d0de801d0d7a8cebc;Wed Sep 07 03:58:39 EDT 2005;Committer;akr;2;7;2;9;0
17a4e4b1ad0bd14a5fd03b810dd1a146a09ec5a8;Wed Sep 07 01:45:40 EDT 2005;Committer;nobu;2;12;0;12;0
8955a2d930d0b7a607b376afd8f637833868a546;Wed Sep 07 00:37:53 EDT 2005;Committer;ocean;3;25;19;44;0
757c6fa4c95a3a8b15878bf5932d81b5608a700a;Tue Sep 06 23:35:31 EDT 2005;Committer;nobu;4;78;3;81;0
f6892cba239b44f37171b3cbf1296943b767d090;Tue Sep 06 23:23:04 EDT 2005;Committer;nobu;7;23;14;37;0
d302364b50c54c1a425abe7313bb032769618fb6;Tue Sep 06 23:22:57 EDT 2005;Committer;nobu;1;3;3;6;0
d5a2954d5eb71e0c97789ede40755a858d9afa5d;Tue Sep 06 06:18:41 EDT 2005;Committer;akr;1;0;1;1;0
535b2911cfc354144e51ee3f4b99d148eea5718f;Tue Sep 06 06:17:56 EDT 2005;Committer;akr;1;20;0;20;0
e27c6fdd7ef51485be823425a401171931bba017;Mon Sep 05 15:02:12 EDT 2005;Committer;akr;1;3;3;6;0
fe13de2096c5a93096cff2cf671ce58620fbfd3c;Mon Sep 05 15:02:10 EDT 2005;Committer;akr;1;21;2;23;0
768e6c1328a77295d1c5b6c53175b511ec073ee6;Mon Sep 05 13:29:01 EDT 2005;Committer;nobu;4;44;5;49;0
df27d91fc4de9215d6af58de191b2c105ef88678;Mon Sep 05 08:40:27 EDT 2005;Committer;matz;6;75;19;94;0
48653d5ef0ed47469d64170d70c8c2a9f21f159e;Mon Sep 05 08:29:52 EDT 2005;Committer;matz;4;47;28;75;0
f5ac36f1a3e484464d13a115bd92fa9904215201;Mon Sep 05 07:22:55 EDT 2005;Committer;matz;1;1;1;2;0
d2847d92cd69a335b4904f9891077eed4363af76;Sun Sep 04 22:03:24 EDT 2005;Committer;gotoyuzo;2;6;1;7;0
bc81591be40e9cf48d78e73206cce48ec4280ad8;Sun Sep 04 22:03:19 EDT 2005;Committer;gotoyuzo;1;3;3;6;0
c75ba025666f5149386fad9f8ba120bad3ce2238;Sun Sep 04 06:01:54 EDT 2005;Committer;aamine;1;3;3;6;0
9c16d334dbc046433429329fdf4a30562deba8b7;Sun Sep 04 06:01:51 EDT 2005;Committer;aamine;2;8;3;11;0
ed353ff1bb6df83138ba33b083bc2d258ad75cfe;Sat Sep 03 05:02:13 EDT 2005;Committer;akr;2;35;18;53;0
83cf0b613efc099fe8c90ff0161843b785bdfe4a;Sat Sep 03 05:02:10 EDT 2005;Committer;akr;1;3;3;6;0
cd5c822ac8adaa4af4daf9166c1e5714662c9c9a;Fri Sep 02 14:53:02 EDT 2005;Committer;nobu;15;47;41;88;0
c6cdbda54f2ebb50d8e2040392f62f7485112600;Fri Sep 02 14:51:23 EDT 2005;Committer;nobu;1;3;3;6;0
0c83f23272c9b76aa60208eca38fe5b780616e96;Fri Sep 02 14:51:19 EDT 2005;Committer;nobu;2;23;8;31;0
c3f059226764f98cd30b8a7441b006de16edaa3a;Thu Sep 01 08:13:30 EDT 2005;Committer;matz;2;6;2;8;0
804054e672d8921ecf63095128cc31b8f5709d89;Thu Sep 01 05:15:19 EDT 2005;Committer;nagai;3;31;3;34;0
f1755966cc5a0bab16cdcb528e95f55e397802aa;Thu Sep 01 05:15:16 EDT 2005;Committer;nagai;1;4;4;8;0
7706418a4e6a3c5a57d00b19d93e9ca51eea53d0;Wed Aug 31 05:43:51 EDT 2005;Committer;usa;2;6;4;10;0
76d6f560c9818d4afc13f36bd7b374f9c744cfe6;Wed Aug 31 01:40:56 EDT 2005;Committer;ocean;2;10;7;17;0
8dcf7f931f3879f46a3ac944a3016515a47db7f1;Tue Aug 30 21:59:12 EDT 2005;Committer;nobu;2;5;2;7;0
47bc0b90135ddc3169e35150063371f6f3cae922;Tue Aug 30 15:35:21 EDT 2005;Committer;matz;1;3;3;6;0
69ba229546f9ce43dfa6dd1a6544f7353e0ab847;Tue Aug 30 15:35:18 EDT 2005;Committer;matz;2;66;0;66;0
74433fd300ff90e61086681fd1152d2da0d28171;Tue Aug 30 14:49:51 EDT 2005;Committer;nobu;10;73;32;105;0
87e8b14cc403f13d5c0d3cbd715a2d85c52fcb95;Tue Aug 30 14:26:38 EDT 2005;Committer;nahi;2;4;3;7;0
624842f6a080d3292f66809936c8344b79c50be2;Tue Aug 30 14:21:18 EDT 2005;Committer;nobu;2;26;19;45;0
aae7040cd0c8cdfd0b12b5d0b7a2fc402fc3e452;Tue Aug 30 14:06:55 EDT 2005;Committer;nobu;2;7;3;10;0
3b18462de7a9d3bb14e5bbbc2c375a3e278cdb56;Tue Aug 30 10:43:36 EDT 2005;Committer;gotoyuzo;4;11;1;12;0
d14de3ecc797f94640aa72ce9a0d33fe11b65cf4;Tue Aug 30 07:22:06 EDT 2005;Committer;keiju;2;4;1;5;0
da7d6381c9b15993821fdc9f1019c9b4455353a4;Tue Aug 30 04:38:14 EDT 2005;Committer;ocean;2;1;6;7;0
0bbbb77d1a50c758812e3ef9a82ebc6fed390cac;Tue Aug 30 04:32:50 EDT 2005;Committer;ocean;2;6;1;7;0
fbf6744823238944d02265332c3eeabeaa4da0fb;Tue Aug 30 04:27:44 EDT 2005;Committer;matz;1;3;3;6;0
10ebbcadd905c4b77d2e28c9872e44703b04f2ac;Tue Aug 30 04:27:41 EDT 2005;Committer;matz;5;21;4;25;0
0b7f8eef403f5773dec64919a5628b1d0fbb0c0a;Mon Aug 29 11:07:10 EDT 2005;Committer;ocean;1;1;1;2;0
7c755d4174414e6ab7677736673092ba6f84357c;Mon Aug 29 10:56:05 EDT 2005;Committer;ocean;2;29;15;44;0
6f23ba054a76fe13d2be54ddb86e42bb9f246964;Mon Aug 29 10:00:27 EDT 2005;Committer;keiju;2;14;7;21;0
cd7cc246d2d1d2d14f30b066baa56aff2e0f0fbd;Sun Aug 28 16:45:11 EDT 2005;Committer;akr;2;101;0;101;0
50e604172eb7e95fe1bdadf37faeeb8a97429bae;Sun Aug 28 15:40:28 EDT 2005;Committer;akr;2;34;12;46;0
97fce772a328f992e35b323f6f9196c85e4deed3;Sun Aug 28 15:40:25 EDT 2005;Committer;akr;1;3;3;6;0
fb46cf1d7a40c8412259735e4c9024859261430a;Sat Aug 27 11:21:30 EDT 2005;Committer;ocean;3;53;16;69;0
ca3d6e72bf6057e53eb03f90820be3389cdd407b;Sat Aug 27 11:21:25 EDT 2005;Committer;ocean;1;3;3;6;0
45695650a610420bff11cc7d133c1830f9fa4af3;Fri Aug 26 05:36:25 EDT 2005;Committer;keiju;1;3;3;6;0
317948160bc929cd73a323d0eac33c8df896eb41;Fri Aug 26 05:36:23 EDT 2005;Committer;keiju;2;13;1;14;0
a5df717c8ee7554b0b18d2ad50f49b6b2aadcdd4;Thu Aug 25 06:51:33 EDT 2005;Committer;ocean;2;5;2;7;0
fec37d5036f5e979914926a887e0571fc6db690e;Thu Aug 25 06:51:30 EDT 2005;Committer;ocean;1;3;3;6;0
030e887feda3f4a0de0050949ad9b9594ba8c3e6;Wed Aug 24 05:08:00 EDT 2005;Committer;ryan;7;171;40;211;0
08324a409816329a925859d2d00c6ee0bf0242a6;Wed Aug 24 02:02:16 EDT 2005;Committer;usa;2;8;0;8;0
acbee0bda7e807e88cc3255d4d3e04aa6dca0510;Wed Aug 24 02:02:13 EDT 2005;Committer;usa;1;3;3;6;0
60106097cebdb5561dcef2b0d2d3835a48d4d561;Mon Aug 22 21:14:24 EDT 2005;Committer;gotoyuzo;2;11;0;11;0
bfb1ed598cff466a2b2239204609b4955ffe64c2;Mon Aug 22 21:12:03 EDT 2005;Committer;gotoyuzo;2;13;2;15;0
8a94b1740ad5c1676c8b4574733961fc36b1ad78;Mon Aug 22 20:47:55 EDT 2005;Committer;gotoyuzo;7;144;7;151;0
f19fe6d957766910d8cd6567c36b29a40ecf9b46;Mon Aug 22 16:21:29 EDT 2005;Committer;ocean;1;3;3;6;0
4b30596a888d12b333c2709f26180057abda5fbc;Mon Aug 22 16:21:27 EDT 2005;Committer;ocean;2;6;0;6;0
8ec48cb06417129f46e21851d4580c4e3e4966c8;Mon Aug 22 14:53:51 EDT 2005;Committer;matz;2;6;1;7;0
fa3b1c5166fde3db23b5446dd47c55a9ecb77fa6;Mon Aug 22 11:12:10 EDT 2005;Committer;nobu;2;6;1;7;0
1731ef43ed383008871ab2c97d4f182cc44f2f5a;Mon Aug 22 11:12:07 EDT 2005;Committer;nobu;1;3;3;6;0
bde7125880217dc322cf9b82f9e71906256500d6;Sat Aug 20 15:44:54 EDT 2005;Committer;matz;3;7;2;9;0
c58a4a50326dd56b4cc81fd8379712a6058f3fb3;Sat Aug 20 15:14:35 EDT 2005;Committer;nahi;2;14;2;16;0
38769c7d4aaffb594136c04840344570a73f17f1;Sat Aug 20 15:14:30 EDT 2005;Committer;nahi;1;3;3;6;0
7af5bc50da5ea3aecfd8ac75023826ff1636f1bc;Sat Aug 20 14:20:17 EDT 2005;Committer;matz;1;5;0;5;0
f003069ecd77611b10e24cc0119ad322c003e2b3;Sat Aug 20 13:43:46 EDT 2005;Committer;nahi;3;151;83;234;0
3dec8be26548a46d3ab5833f4248088fa44be846;Sat Aug 20 12:04:02 EDT 2005;Committer;suke;1;7;9;16;0
004ae5d39cfc0a3efeb3a9a5a445c84efd2d5922;Sat Aug 20 07:34:36 EDT 2005;Committer;suke;1;3;3;6;0
ad4ef9cf0ae0caca0c5f2f968b1757300991a84d;Sat Aug 20 07:34:34 EDT 2005;Committer;suke;1;70;0;70;0
c2eda1c4e99be68e7c26ae2bc6c10e67c51d469a;Fri Aug 19 09:17:20 EDT 2005;Committer;akr;2;12;1;13;0
a2f590d1574f7e96dce674dfa688e5dd336bce33;Fri Aug 19 09:17:15 EDT 2005;Committer;akr;1;3;3;6;0
e67d73e0f31782f9d295338a1e0aae1b1b6d0db5;Thu Aug 18 02:07:28 EDT 2005;Committer;usa;2;8;2;10;0
9b76ae61f455aa98964538fd01b44e6ce93c13a4;Thu Aug 18 02:07:24 EDT 2005;Committer;usa;1;3;3;6;0
743d7affda9cea2172d187aafe7dc98b5bd80f64;Wed Aug 17 14:58:47 EDT 2005;Committer;nobu;2;17;11;28;0
311d02a322cf38b85405613e50ce36c3e5eaec6d;Wed Aug 17 12:59:57 EDT 2005;Committer;naruse;2;15;20;35;0
1de10a2395e739395e0bd6141c38e797053bd2f3;Wed Aug 17 12:35:56 EDT 2005;Committer;nobu;1;6;0;6;0
97348a2dad5af9eb914767731ad708e7d84b56d3;Tue Aug 16 15:24:54 EDT 2005;Committer;matz;1;0;1;1;0
89c09199d15bc29e701d704aaf2a901b034469e6;Tue Aug 16 15:24:19 EDT 2005;Committer;matz;1;3;3;6;0
17957e0dfca25957556bdccd3590be9b9dee5923;Tue Aug 16 15:24:15 EDT 2005;Committer;matz;3;59;43;102;0
e6a104131a39fd051c1a5ab7111dc67b266a1851;Tue Aug 16 03:43:46 EDT 2005;Committer;nobu;1;3;3;6;0
3da52c987f081b8d8d37b1ce38d1757fc755ced9;Tue Aug 16 03:43:44 EDT 2005;Committer;nobu;1;21;6;27;0
68655d09a1b123ef28e882960e8bb8f890724e03;Sun Aug 14 22:25:09 EDT 2005;Committer;nobu;3;9;2;11;0
456acb2ec122155f9b58519a5697412566b6b85e;Sun Aug 14 15:39:41 EDT 2005;Committer;nobu;1;3;3;6;0
e1174370057495b8f4dc9856ee58e1b176493da1;Sun Aug 14 15:39:39 EDT 2005;Committer;nobu;3;28;27;55;0
8e5e94d2f318c9b6169259abd3cd6fc729e46823;Sat Aug 13 13:17:23 EDT 2005;Committer;aamine;1;1;1;2;0
8ce9641fb85782e70860fbcd112f6315e7bfad69;Sat Aug 13 13:14:07 EDT 2005;Committer;aamine;2;14;11;25;0
bacd0dddd17645c193392254b2b2dff8471f57b7;Sat Aug 13 13:06:04 EDT 2005;Committer;aamine;2;47;42;89;0
ba30d87a3687c22d7551968d28b2a4c4a252a57c;Sat Aug 13 12:22:12 EDT 2005;Committer;suke;2;268;77;345;0
31c063eac3a674f8d8cdb1aa498e456fa1b6b94c;Sat Aug 13 12:13:20 EDT 2005;Committer;suke;2;75;0;75;0
7932d2f6abefbbef67254f1d2ff872098a2bc635;Sat Aug 13 09:55:14 EDT 2005;Committer;nobu;1;0;5;5;0
3b602c7a743bce3449b9e8441cb3d7bcf1bea70b;Sat Aug 13 09:52:06 EDT 2005;Committer;nobu;2;12;2;14;0
96d7c07e497e7be5296de10511788eb9aa3e114b;Sat Aug 13 09:36:12 EDT 2005;Committer;nobu;2;13;10;23;0
2bf3c6b6315fa8839ff66c502ee5116711d242f1;Fri Aug 12 23:19:58 EDT 2005;Committer;naruse;2;9;56;65;0
2b5bb9ad00ac8205cda18a3a35e6bd906ba5223d;Fri Aug 12 15:53:06 EDT 2005;Committer;akr;3;66;18;84;0
66323da355837efbf7abc31e6770b1ae20753b27;Fri Aug 12 15:53:03 EDT 2005;Committer;akr;1;3;3;6;0
f50c302e77715fca67e96dd44a3ff9d344298271;Fri Aug 12 12:58:47 EDT 2005;Committer;suke;2;81;8;89;0
e439bc27dc5f6814b49309b4ad32b8d3ca54e9a4;Fri Aug 12 08:13:28 EDT 2005;Committer;matz;6;73;40;113;0
ec14c2c9b925f6add71f7f4d25e0a281f8adb252;Fri Aug 12 07:17:36 EDT 2005;Committer;matz;3;53;51;104;0
d3de1ac85bca8d512d2d7ca152dd3aced2fc8867;Fri Aug 12 07:17:23 EDT 2005;Committer;matz;1;3;3;6;0
c06b78ca928f410d97b38a498b197471cd73f27b;Thu Aug 11 14:29:46 EDT 2005;Committer;nobu;2;9;10;19;0
cc88d93a0ef39c3a8a89d2b2cde147f236be360c;Thu Aug 11 04:21:37 EDT 2005;Committer;kou;1;2;0;2;0
c51f645b44a1c22d16ffce69fe596f81a1a78050;Thu Aug 11 04:08:05 EDT 2005;Committer;kou;6;87;13;100;0
fcf9d14561363e9be2ec532be0120994f4da2059;Wed Aug 10 22:57:40 EDT 2005;Committer;nobu;1;3;3;6;0
90ac1484f1408ec9343ebed8dcc2f2b33048d826;Wed Aug 10 22:57:38 EDT 2005;Committer;nobu;1;8;0;8;0
160055b47468d48dc0443bfbbeabf750bcfe8296;Wed Aug 10 01:39:24 EDT 2005;Committer;matz;4;81;42;123;0
5a0361f84c28d38747c066bda30ecf77483877f9;Wed Aug 10 01:32:44 EDT 2005;Committer;nagai;7;84;10;94;0
599a478ad5046374fa7c0809ac3bc67d57da6ce0;Wed Aug 10 01:32:38 EDT 2005;Committer;nagai;1;3;3;6;0
0c624c4bf27198ddf20a25107deaed151a218b84;Tue Aug 09 12:53:38 EDT 2005;Committer;nobu;2;19;8;27;0
c1566b74903da07910103c143cb2a38f4a7c86ba;Tue Aug 09 06:16:29 EDT 2005;Committer;nagai;33;490;38;528;0
09d57b8e0c3bb80d43798d7a2bfc239229126e9a;Mon Aug 08 23:24:29 EDT 2005;Committer;nobu;4;66;8;74;0
81579af43e3ad506e30a81bda710570d78dea021;Mon Aug 08 23:24:25 EDT 2005;Committer;nobu;1;3;3;6;0
e84219391fb1c0e008c154c59083fcf797ea8fc3;Mon Aug 08 16:18:29 EDT 2005;Committer;ocean;1;14;10;24;0
779f4383aa26f6ae5812a723effe27e5387fe2fd;Mon Aug 08 13:14:08 EDT 2005;Committer;nobu;2;17;2;19;0
875d51ffc93f3404f6b37134dd39b5ad698f6472;Mon Aug 08 12:30:12 EDT 2005;Committer;ocean;3;109;191;300;0
f613a10f5e0c9d255ff06ff61251c987429cc9b8;Mon Aug 08 11:43:56 EDT 2005;Committer;nahi;2;46;0;46;0
0b1038f514c4d03527658ef0436ac9441551caa6;Mon Aug 08 01:21:48 EDT 2005;Committer;matz;2;5;1;6;0
ec4671166848ccc203e415ba3227b6f04bf1cc81;Sun Aug 07 20:21:40 EDT 2005;Committer;gotoyuzo;2;31;2;33;0
b1e29f011dd4c275f7a06c073ff7f100f42732d8;Sun Aug 07 20:16:15 EDT 2005;Committer;gotoyuzo;7;19;6;25;0
170c40a5cf999594294c5212fd67e9b008941225;Sun Aug 07 20:16:11 EDT 2005;Committer;gotoyuzo;1;3;3;6;0
873f007ad3e992809694ad73c98d1bb87e7b362d;Sun Aug 07 14:57:19 EDT 2005;Committer;nahi;2;34;0;34;0
0c36fe42a25799eed5a7591c42b03ee48aabee50;Sun Aug 07 14:57:16 EDT 2005;Committer;nahi;1;3;3;6;0
8eb3323a69a57e7f92776bc8dcf33c9c62ca509d;Sat Aug 06 16:27:12 EDT 2005;Committer;ocean;1;78;257;335;0
58d86a203544ebe3ba795867534c93f52b22c2d4;Sat Aug 06 03:44:00 EDT 2005;Committer;ocean;8;230;14;244;0
3c3f54c7a36813a51ceef9db7f79f9a6122455c6;Sat Aug 06 03:43:55 EDT 2005;Committer;ocean;1;3;3;6;0
16457d4b96e3f0f368ca45abb6d1fa0b45a30e02;Fri Aug 05 23:56:02 EDT 2005;Committer;akr;1;6;1;7;0
d9498f743b8a0e361908d62ae429f7719124170a;Fri Aug 05 11:22:51 EDT 2005;Committer;ocean;1;13;52;65;0
993ad912a266f48e165029241375c41918ec6b8a;Fri Aug 05 09:20:13 EDT 2005;Committer;ocean;1;127;248;375;0
a39d6b1f804437610447687f4ed406c2448b8059;Fri Aug 05 08:12:53 EDT 2005;Committer;ocean;1;56;142;198;0
74d91a4c311f0209b1864171a973ea22a1a54632;Fri Aug 05 03:51:50 EDT 2005;Committer;ocean;2;23;40;63;0
107e177cb8a679baba5726cc299ae8b1cb50803c;Fri Aug 05 03:43:34 EDT 2005;Committer;usa;2;16;1;17;0
aa2de9e3e00db4ecffa592cdeb177d13b28d328a;Fri Aug 05 00:50:46 EDT 2005;Committer;matz;2;7;1;8;0
6c8633ab999b13f59b3756f8a319db813c0784cc;Thu Aug 04 15:26:05 EDT 2005;Committer;ocean;2;77;206;283;0
7c2dad9c1f57f94851c9b212d5e1cd53ef07ba88;Thu Aug 04 15:20:10 EDT 2005;Committer;nobu;2;6;3;9;0
710b99a16b9093e2542e8e8a76999fb6b4b6c643;Thu Aug 04 15:18:38 EDT 2005;Committer;nobu;3;19;9;28;0
c9a8baddbc1fb8e87bd82a47bcd5593f595658de;Thu Aug 04 15:09:06 EDT 2005;Committer;nobu;1;3;3;6;0
c83d6db61bccd8a32f1ba523a47e60012c439bda;Thu Aug 04 15:09:03 EDT 2005;Committer;nobu;3;25;15;40;0
4fd5436b328f1662f68614507943ae7eb8acd5a9;Thu Aug 04 11:29:51 EDT 2005;Committer;matz;3;10;4;14;0
c9ec81289744231cb3ca9aa2c2bda3de6a668442;Thu Aug 04 09:41:57 EDT 2005;Committer;nagai;8;258;20;278;0
b08e8d937f0b4f4289dd204e9c08b8a45e469baf;Thu Aug 04 05:19:44 EDT 2005;Committer;akr;1;12;0;12;0
85eadbbf8cc0bf6e366c34b4db939501f406907d;Thu Aug 04 05:04:53 EDT 2005;Committer;ocean;2;0;6;6;0
a6c074a47a1fbd394dfe19159f50711fd2977855;Thu Aug 04 04:54:08 EDT 2005;Committer;ocean;1;28;28;56;0
7b1bdb68e9297ca59b926467b611e1f861644826;Thu Aug 04 04:48:13 EDT 2005;Committer;ocean;20;118;59;177;0
53b4c2b87a9c6832e663cf5773a8aca9a1cf3341;Thu Aug 04 04:31:33 EDT 2005;Committer;matz;4;32;6;38;0
a767a76ad132befbf1cf39619c55c993c854157a;Thu Aug 04 04:16:27 EDT 2005;Committer;ocean;2;155;36;191;0
b7f6c8989af53f4d6c50271e2b29121b637b131a;Wed Aug 03 23:04:16 EDT 2005;Committer;nobu;2;10;2;12;0
a51e80459c2703d1906a4e1646de47def3550a09;Wed Aug 03 15:27:13 EDT 2005;Committer;nobu;7;25;26;51;0
cc3aa18111d076b256b2c100d6b4fa889eb9b89a;Wed Aug 03 15:27:07 EDT 2005;Committer;nobu;1;3;3;6;0
55832e16016615ab1b53d5f7b28a1fa2f1d0b0c9;Wed Aug 03 15:25:17 EDT 2005;Committer;nobu;2;4;2;6;0
5985a2d6c8015fc9a772b12c32f0dc9ba2118167;Wed Aug 03 13:29:08 EDT 2005;Committer;ocean;1;5;5;10;0
af41a0c14673ce3cfcea1cc6509024401f695dbc;Wed Aug 03 13:10:48 EDT 2005;Committer;ocean;3;72;26;98;0
c32b77cee1ead76eafb05604d49b315217c49d49;Wed Aug 03 07:09:48 EDT 2005;Committer;matz;4;91;16;107;0
ce8d9b4a0d2c16ff2d634ce6c4b00a9156cc55f3;Wed Aug 03 01:21:20 EDT 2005;Committer;usa;7;41;0;41;0
378258bd0b5c98d9752fc2a3e259d7f5d6d7a653;Wed Aug 03 01:05:30 EDT 2005;Committer;nobu;4;19;4;23;0
5ddbcc5de450eb457343aab0be101ca0795d18d7;Tue Aug 02 23:25:35 EDT 2005;Committer;matz;2;6;6;12;0
f362749fac583110489d7d2b8add1769438df9c1;Tue Aug 02 22:02:43 EDT 2005;Committer;matz;1;3;3;6;0
2c29b4e755c34256a1df79abd7f666b9d6c73611;Tue Aug 02 22:02:40 EDT 2005;Committer;matz;3;32;7;39;0
28c635fa9a9a0404aa8a99def42cd3d547cfcfdb;Tue Aug 02 21:05:17 EDT 2005;Committer;ocean;3;145;85;230;0
a26cec27e1c0a161d24188d0259d0405b82c8b16;Tue Aug 02 11:49:46 EDT 2005;Committer;ocean;3;14;6;20;0
909e63ac3c9bdd284821cde2b88dcaaea1ae2a04;Tue Aug 02 06:51:26 EDT 2005;Committer;ocean;3;159;8;167;0
91d7a0295919edef160c0dd71e44e0b2f0fba88a;Tue Aug 02 01:25:01 EDT 2005;Committer;ocean;2;123;430;553;0
8ec208b3fb86e2e461ce3417257b03a2758c09e6;Mon Aug 01 16:42:48 EDT 2005;Committer;gotoyuzo;2;6;1;7;0
7fcbf1d86203fadeed9fac5635695bf3feeb0490;Mon Aug 01 16:42:43 EDT 2005;Committer;gotoyuzo;1;3;3;6;0
b73cd9cb5cebbd2b7670234dc276fd71fc06d29c;Mon Aug 01 10:25:51 EDT 2005;Committer;ocean;4;68;10;78;0
87ecfbd7737d68f2533f30213b19f9eeb569d477;Mon Aug 01 10:09:28 EDT 2005;Committer;ocean;2;16;41;57;0
5b9896ea2453ee3e0cdcc3b446bc501406e935d4;Mon Aug 01 09:47:54 EDT 2005;Committer;ocean;2;9;87;96;0
9aab7083a8109b31e23f2a75f37e4b477f352e5d;Mon Aug 01 06:35:15 EDT 2005;Committer;ocean;2;25;2;27;0
6a7659309dc96e09794716d0089e688a65acb297;Mon Aug 01 05:02:38 EDT 2005;Committer;ocean;1;2;2;4;0
80ed1f46d1937faef267056588386d019feacd15;Mon Aug 01 04:57:28 EDT 2005;Committer;ocean;2;59;165;224;0
6763ac5552107c4c713f7e60861e00c14f1d3cdd;Sun Jul 31 16:19:42 EDT 2005;Committer;seki;4;56;16;72;0
832e2b98f9b59c41fa8feea6d6831958623a20b6;Sun Jul 31 16:16:29 EDT 2005;Committer;seki;1;4;4;8;0
d3dce9632fcf4db1347d75669dcf6326f960dcb5;Sat Jul 30 09:51:51 EDT 2005;Committer;suke;1;3;3;6;0
14f0a0d0bd25b02ced6d43c6335ecc9bf68fe605;Sat Jul 30 09:51:48 EDT 2005;Committer;suke;3;169;44;213;0
0bace243b0635dd4eef5be1a855400708f09ac4e;Fri Jul 29 07:18:34 EDT 2005;Committer;keiju;2;19;4;23;0
97335c53e60750da66f72183e82b201202a5a820;Fri Jul 29 01:00:11 EDT 2005;Committer;nobu;1;3;3;6;0
0ee34e24e31a4d374fc30a73b47700c4031b3e52;Fri Jul 29 01:00:07 EDT 2005;Committer;nobu;2;5;1;6;0
396e297f2d4b95cfe1cc70d75d73f6bd5a1be414;Fri Jul 29 00:58:14 EDT 2005;Committer;nobu;3;8;3;11;0
b4fef39a40db7783e639436ca2836cfb90c7bde9;Thu Jul 28 12:49:31 EDT 2005;Committer;nobu;3;21;12;33;0
41d41fbdb9e2448404865310c295dd666ce60d00;Thu Jul 28 09:14:59 EDT 2005;Committer;nagai;9;836;205;1041;0
501fdc09d8fa09adc1e326c87942276102cbd92b;Thu Jul 28 08:25:05 EDT 2005;Committer;matz;2;13;8;21;0
cb8f27017edb3a12fcfff5968187d00c30ca65bb;Thu Jul 28 08:16:34 EDT 2005;Committer;matz;2;5;1;6;0
727e443c4bc52075dbdfae5f8afb0034c4d39e27;Thu Jul 28 07:16:22 EDT 2005;Committer;matz;3;89;24;113;0
92b6cdc499997dd58052acf0a8a62a4f02799c1e;Thu Jul 28 02:33:32 EDT 2005;Committer;matz;1;3;3;6;0
989b0a6d1e327900f20fcd9b898393b9edbd0c2e;Thu Jul 28 02:33:28 EDT 2005;Committer;matz;4;67;33;100;0
bd3404ced0af1a368e070b6c0fde63290a3e54a8;Wed Jul 27 14:30:09 EDT 2005;Committer;matz;4;23;14;37;0
1dbd5e6a3e499c41bc434743b794ce3ddb660756;Wed Jul 27 13:16:32 EDT 2005;Committer;kou;4;5;323;328;0
bff7359065ecc0561ed35a0699d9eec54067685f;Wed Jul 27 10:12:08 EDT 2005;Committer;aamine;2;6;1;7;0
b5e891b1ed96d598b47a3ab33d37ba2f572ec4b7;Wed Jul 27 07:27:22 EDT 2005;Committer;matz;1;3;3;6;0
759a63b6a3355b85e1e52b78810d66fd9ee7b838;Wed Jul 27 07:27:19 EDT 2005;Committer;matz;14;315;144;459;0
2ea2d95e8196b61a43915870fb2e1eefc3fc2554;Wed Jul 27 01:57:14 EDT 2005;Committer;ocean;2;5;1;6;0
57c8f59761c99970e97272580acdbec080db6949;Tue Jul 26 13:42:49 EDT 2005;Committer;aamine;2;52;5;57;0
bf966297118d781933cecdad2ae1b0ac88ff0e53;Tue Jul 26 13:05:31 EDT 2005;Committer;aamine;2;25;42;67;0
36987b005ee6f6c2d80b10fb83bb7399cbcd0a43;Tue Jul 26 11:53:14 EDT 2005;Committer;ocean;1;1;1;2;0
5dab497052d15c575183039c8d0f4a92426ae895;Tue Jul 26 09:16:37 EDT 2005;Committer;matz;2;19;3;22;0
09e5e42d3e9b8d8f0e065ac051d7fc0d4d4d8d10;Tue Jul 26 03:59:39 EDT 2005;Committer;gotoyuzo;2;10;4;14;0
6d956eab9b0b7be773986e54504d2c5ec865b431;Tue Jul 26 03:59:36 EDT 2005;Committer;gotoyuzo;1;3;3;6;0
528f4c66dd42bda2776508b152facb9e16bd5759;Mon Jul 25 14:50:12 EDT 2005;Committer;usa;3;4;21;25;0
9b4ddc1a01535ab94cd3648c811d791ad1341b71;Mon Jul 25 12:31:21 EDT 2005;Committer;nobu;4;8;12;20;0
a6df88f00b8eac543a29c6c8376f3300d3a310bb;Mon Jul 25 12:29:37 EDT 2005;Committer;nobu;5;17;11;28;0
f65273b4191230447bc7aa8feeaa252b9a2fa60c;Mon Jul 25 07:08:14 EDT 2005;Committer;matz;3;17;6;23;0
b535e9b004097dd567a7c6d461a5b224bbf47991;Mon Jul 25 05:11:19 EDT 2005;Committer;nagai;3;12;57;69;0
73efe6b78349f965a7239bc814bc61fb79513d36;Mon Jul 25 05:11:14 EDT 2005;Committer;nagai;1;3;3;6;0
b502b16eb64b7bace9d39cf4f319733023c7c2be;Sat Jul 23 07:50:17 EDT 2005;Committer;gotoyuzo;2;8;1;9;0
80914a2666d44d1f5b112240d22441d3ac0476c2;Sat Jul 23 02:46:41 EDT 2005;Committer;nobu;3;30;3;33;0
6524f34a2688436249d111a3456a097c7111722c;Sat Jul 23 01:02:18 EDT 2005;Committer;nobu;17;200;132;332;0
e6a02b93747266925fd536a30715352bf2c60c07;Sat Jul 23 01:02:13 EDT 2005;Committer;nobu;1;3;3;6;0
b2270e553583533ac7a1ef28b733f3a1bf27184f;Fri Jul 22 06:14:48 EDT 2005;Committer;kou;8;103;31;134;0
be7999fd3dd2868ff382a7611e978aa2f8ac61c2;Fri Jul 22 05:41:33 EDT 2005;Committer;kou;3;64;2;66;0
17743ce0a8a74095e4f111cff4c102d5d99b5a7a;Thu Jul 21 22:05:04 EDT 2005;Committer;nagai;8;222;63;285;0
0580cf2696d440cb29d34501dc4667ec533c508c;Thu Jul 21 16:13:08 EDT 2005;Committer;naruse;4;821;788;1609;0
f4a0cc5101e290e176c027a80fb2025df3423899;Thu Jul 21 16:13:04 EDT 2005;Committer;naruse;1;3;3;6;0
c7bdb0d8b8d4228f4d796777dc6815a3c6162635;Wed Jul 20 10:21:16 EDT 2005;Committer;usa;2;8;4;12;0
df453bab063fb65f7d2bf5088e6107272a1d3e9e;Wed Jul 20 10:08:41 EDT 2005;Committer;akr;1;2;3;5;0
2b2256217eb359a055c394a0bebab94d2e7ac413;Wed Jul 20 09:46:57 EDT 2005;Committer;ocean;2;12;3;15;0
74e1cc9e55eae39b2adcbdec1d4bff0b70bf0c88;Wed Jul 20 09:14:30 EDT 2005;Committer;akr;2;15;0;15;0
2201229b4aebd2ebb08eae05ff197f0adfd4f4e5;Wed Jul 20 01:08:13 EDT 2005;Committer;matz;5;23;11;34;0
81ad8ec09648d1d2a591ef481a3fbb7cade260eb;Tue Jul 19 19:04:46 EDT 2005;Committer;ocean;3;13;1;14;0
aee718d32a0ef6b47a7dc3bd70e61916f5c71be2;Tue Jul 19 18:26:49 EDT 2005;Committer;ocean;1;2;2;4;0
a41331918ff80eefc7d45f823825dba644550902;Tue Jul 19 18:18:51 EDT 2005;Committer;ocean;2;6;5;11;0
97122bdb613851ec43ade6b7fb2d7358fc3299d4;Tue Jul 19 18:18:46 EDT 2005;Committer;ocean;1;3;3;6;0
7af1a11438c2ed51ae5b769da7ad58a8a26a0f7e;Tue Jul 19 14:59:01 EDT 2005;Committer;matz;3;7;7;14;0
30434d40782ebe046b41b722b1d010324549a1a5;Tue Jul 19 13:52:42 EDT 2005;Committer;matz;3;7;2;9;0
20316027872b9a3a70babc884f838f499f1e5746;Tue Jul 19 08:31:04 EDT 2005;Committer;matz;10;50;47;97;0
1fb55b9d7704c4e3df0118fe33890b65538dd06a;Tue Jul 19 06:57:46 EDT 2005;Committer;nagai;1;1;1;2;0
9042a601c8a9f09962ebcf27569ed09494f02d4b;Tue Jul 19 05:12:52 EDT 2005;Committer;ocean;2;18;8;26;0
4826eaecf63398b0806a49248569a80db344c43e;Tue Jul 19 04:24:05 EDT 2005;Committer;nagai;2;7;0;7;0
50d6cae2127b984c6b9665ea2824275c5c24d5a5;Tue Jul 19 04:24:02 EDT 2005;Committer;nagai;1;3;3;6;0
c2eeec8fd40db6b19b7e385108d6fd5e56569a2b;Mon Jul 18 12:41:18 EDT 2005;Committer;ocean;2;6;1;7;0
06f6c2d35546a986fa637e78a6fcd4fceb03871e;Mon Jul 18 05:43:13 EDT 2005;Committer;akr;2;8;1;9;0
5e69b520145f7280ddd3bf6103124007683b9e63;Mon Jul 18 03:23:47 EDT 2005;Committer;nobu;2;24;11;35;0
8c2e1ce91cfd5561028d54e537c8173971f33338;Mon Jul 18 01:00:23 EDT 2005;Committer;akr;3;47;4;51;0
c065b233c6020e9a63e5f941f8254d7f8d2d0c8a;Sun Jul 17 20:03:35 EDT 2005;Committer;naruse;2;34;12;46;0
7d3740d756d5d575a96063c67ad3b2c0391e48d3;Sun Jul 17 20:03:29 EDT 2005;Committer;naruse;1;3;3;6;0
3db45ca3cc7695a5ee277df5098f4c9bbdb65bd9;Sun Jul 17 04:47:38 EDT 2005;Committer;nobu;3;22;1;23;0
c3f7f78a5f44d611e074bebc98136093bd9714a8;Sun Jul 17 04:47:34 EDT 2005;Committer;nobu;1;3;3;6;0
99ce5395afde78317d1d3ea3a6fa6b7ca217c2ce;Sat Jul 16 14:43:34 EDT 2005;Committer;nobu;2;7;2;9;0
c6a782c14eb1967a5a6d0d3aed99ff3d14488072;Sat Jul 16 06:59:05 EDT 2005;Committer;ocean;3;33;31;64;0
5348402af54ee4be5ae9f0ddc5fffe3b62d3bd87;Sat Jul 16 05:14:23 EDT 2005;Committer;ocean;1;3;4;7;0
049295f5cdca50fef3914f0cb1cfa586772aea29;Fri Jul 15 15:02:24 EDT 2005;Committer;nobu;1;3;3;6;0
d97a7eaa3608512945c08080ea76a504f7106249;Fri Jul 15 15:01:37 EDT 2005;Committer;nobu;1;1;0;1;0
2bfa23f0347d172367f77d78265475c3fb73ed31;Fri Jul 15 15:00:11 EDT 2005;Committer;nobu;2;49;15;64;0
fd0f36a4a8e6877ba160f405a9d10f36ee662a4a;Fri Jul 15 14:20:19 EDT 2005;Committer;nobu;2;4;5;9;0
05d8e212b131a57358ce3181c47131651580aa41;Thu Jul 14 23:29:45 EDT 2005;Committer;nobu;1;4;4;8;0
8db529ca2bc2f718ed2b0179ae489342b0d8f01a;Thu Jul 14 22:59:09 EDT 2005;Committer;gotoyuzo;3;16;0;16;0
ad46d47e6ab48d3a19457bd613d2fd8ff84f9a0e;Thu Jul 14 16:18:44 EDT 2005;Committer;nobu;1;0;2;2;0
ce33ffca6126e238e59afc3cfaef43d413825b04;Thu Jul 14 15:33:15 EDT 2005;Committer;nobu;1;1;0;1;0
d725e6666a76ec9d0f5fda7fc24262cb4b498c17;Thu Jul 14 15:15:22 EDT 2005;Committer;nobu;10;484;421;905;0
f1fbedf1a622710984dd9836947214f4ce169772;Thu Jul 14 15:11:53 EDT 2005;Committer;nobu;1;3;3;6;0
3345d742e7fddacfa6f70878ba5a36ee56358cde;Thu Jul 14 09:58:13 EDT 2005;Committer;ocean;1;16;16;32;0
59970fde60c7d43da6ca381d2104d5ce3b51924f;Thu Jul 14 09:33:52 EDT 2005;Committer;ocean;2;27;6;33;0
a216fd757c43ba88159cbe826c62a057e0dac31a;Wed Jul 13 15:46:39 EDT 2005;Committer;nobu;1;3;3;6;0
6fc0148b2724bccfbb3153bda8d1ccd0f8e62105;Wed Jul 13 15:46:37 EDT 2005;Committer;nobu;2;11;4;15;0
032248d337bd683d2b77d972097a2f31688874cb;Wed Jul 13 13:44:21 EDT 2005;Committer;nobu;7;101;40;141;0
1ee65ab7bb4d6cb78bfd28d63858afb02a7a6434;Wed Jul 13 10:43:54 EDT 2005;Committer;ocean;1;1;1;2;0
80b0773d33eed302872bbf6808b338d0760b260c;Wed Jul 13 10:40:06 EDT 2005;Committer;ocean;2;34;23;57;0
4d52e657871f87c1b61636e01bc60e39ad4d6c26;Wed Jul 13 03:47:05 EDT 2005;Committer;nagai;3;24;16;40;0
9e0adac4b4fc1ec38b2a236124fea675d2f23a0a;Wed Jul 13 03:47:02 EDT 2005;Committer;nagai;1;3;3;6;0
d00d9606d123616fd7696c2e9bb26cc640fccc79;Tue Jul 12 14:33:10 EDT 2005;Committer;nobu;2;9;2;11;0
b224f1987b8539a38f82a163ec41edab026381d9;Tue Jul 12 14:33:05 EDT 2005;Committer;nobu;1;3;3;6;0
27ca40e36a1841abec418a5137f8aa43b5e9d0c0;Mon Jul 11 14:50:42 EDT 2005;Committer;nobu;4;172;49;221;0
499c4e6120a0c69a82eb8b8c367a6019d2d219f2;Sun Jul 10 23:32:33 EDT 2005;Committer;nobu;2;8;3;11;0
9222f534cf0f0e91c7b7ca478f932ec25082ea14;Sun Jul 10 20:37:32 EDT 2005;Committer;mneumann;2;49;96;145;0
e3fa33da383638bbe69f5581060dcae18a1dc9f5;Sun Jul 10 17:54:58 EDT 2005;Committer;gotoyuzo;2;8;2;10;0
f41e9c805cf5112bc0a84770e1c860c912d6d61a;Sun Jul 10 15:17:35 EDT 2005;Committer;akr;2;8;2;10;0
2e820ca5e0e6a82e09a98c098eb41092a72ef23a;Sun Jul 10 15:17:30 EDT 2005;Committer;akr;1;3;3;6;0
08eae62935b9ec7ef4f41cd00d8a8fc35125e0bd;Sun Jul 10 03:47:56 EDT 2005;Committer;nobu;2;9;4;13;0
2fc20646c2bf366236042d996a8e64275a69b45d;Sun Jul 10 03:47:52 EDT 2005;Committer;nobu;1;3;3;6;0
47658933ecbf197fc33a485b0e61a1ec2ab146d4;Sat Jul 09 13:03:12 EDT 2005;Committer;suke;1;3;3;6;0
a2ae6182ae3757b98c2902c8ee3bfea50e4ec12b;Sat Jul 09 13:03:10 EDT 2005;Committer;suke;4;24;3;27;0
682d1bb06848766847e505ce7e529f065ba6431b;Fri Jul 08 10:55:29 EDT 2005;Committer;nobu;1;1;5;6;0
cff37c6dcc79e5f47f780946eee8a57fa76ac82d;Fri Jul 08 06:51:21 EDT 2005;Committer;kou;5;30;28;58;0
b402bdf203baba642a5bab9fb94b136f624e8902;Fri Jul 08 06:51:16 EDT 2005;Committer;kou;1;3;3;6;0
7b7c03717949dbe5c41631bbf02652b251d02636;Wed Jul 06 09:47:08 EDT 2005;Committer;matz;4;96;488;584;0
2e0680f22100e8fc46c8efb43ff1a1b875a9e306;Wed Jul 06 02:20:58 EDT 2005;Committer;usa;3;62;26;88;0
04826ff77b2b2ad7fdce4ae76ad7261bdea0b85d;Tue Jul 05 15:25:36 EDT 2005;Committer;naruse;1;1;1;2;0
26f0a39bb33c3bc14f35dca12403cfd3cea089e7;Tue Jul 05 15:19:36 EDT 2005;Committer;naruse;5;1118;19;1137;0
1980223eaa5562ca3ae409b516c30a630aae3f2f;Tue Jul 05 15:19:33 EDT 2005;Committer;naruse;1;3;3;6;0
d93e516f7802500123bdb0d7282eada3413fa29e;Tue Jul 05 14:45:33 EDT 2005;Committer;nobu;2;7;3;10;0
a327eb95d9d82d255be1f2bcb152d5f6b6199767;Tue Jul 05 14:28:00 EDT 2005;Committer;nobu;2;7;2;9;0
11921b18612a92894f33a64e14dc5670c1cff6b4;Tue Jul 05 14:23:38 EDT 2005;Committer;nobu;2;12;7;19;0
5a33a2c74ab3ef790bd90a8220915a858e3b2cfd;Tue Jul 05 06:19:11 EDT 2005;Committer;nagai;2;6;2;8;0
e3849ae9878e78fd089d117f5bd2cb787a62e941;Tue Jul 05 05:56:31 EDT 2005;Committer;nagai;13;375;94;469;0
6556fb4f00f041e06cd53ca4eab20967c02ffee8;Tue Jul 05 05:56:27 EDT 2005;Committer;nagai;1;3;3;6;0
3285c929930205620cc6ab533108a0600c19bffa;Mon Jul 04 10:31:44 EDT 2005;Committer;ocean;2;6;2;8;0
60f2184922eedceb720307d25714bc9eb146b056;Mon Jul 04 02:24:54 EDT 2005;Committer;usa;4;38;1;39;0
507dd0e1b2db570c16c4711fbd86f1fdd9a6fc5a;Sun Jul 03 15:12:33 EDT 2005;Committer;eban;1;3;3;6;0
2fdd278c86ace13424f2eb7f2932dfef16c9b840;Sun Jul 03 14:54:20 EDT 2005;Committer;nahi;1;1;1;2;0
8345e6fdd3d30d3779663fda2e8cc89e11907ec4;Sun Jul 03 14:34:03 EDT 2005;Committer;nahi;2;11;2;13;0
59eaf14cbf3b6529d0bc2939e42402defbc41b94;Sun Jul 03 09:37:49 EDT 2005;Committer;akr;1;6;1;7;0
c798dc23aa012053b049b35adc3cf26bbddab5bb;Sun Jul 03 09:37:42 EDT 2005;Committer;akr;1;3;3;6;0
3d2e699f0e3eda95f121aeeaa09ab4d3d6ae9eb7;Sat Jul 02 16:17:17 EDT 2005;Committer;akr;1;1;1;2;0
04390cb1f318320cb5cb99b9b15442878a4daed4;Sat Jul 02 15:22:11 EDT 2005;Committer;akr;1;2;2;4;0
ddbe529c628b0c02a4e576edb7fae8bde921eb46;Sat Jul 02 13:45:08 EDT 2005;Committer;akr;3;48;25;73;0
bd5487e383bef78f6b5acfae2dc64661bdb57504;Sat Jul 02 08:49:45 EDT 2005;Committer;eban;1;3;3;6;0
ef87757c1025afa1aeeb8692a9f21f5d08e600f4;Sat Jul 02 08:20:25 EDT 2005;Committer;akr;1;1;1;2;0
7215b7236362aef075fb7c7bc957cfc1f767cce3;Sat Jul 02 08:11:24 EDT 2005;Committer;akr;4;27;3;30;0
12bed479ec5777392077ac70c0996bbc44bd5a20;Sat Jul 02 06:22:14 EDT 2005;Committer;akr;3;18;1;19;0
10d3f6a039fb05c309243f8937c36bd3b5a6f724;Fri Jul 01 08:56:09 EDT 2005;Committer;matz;3;11;9;20;0
9e8d096c83d6b5ae25928f6f72806ba04f327cfe;Fri Jul 01 07:15:31 EDT 2005;Committer;usa;1;1;1;2;0
00e35b4f19e4ec1f7d1d3f8bd49573054669f32e;Fri Jul 01 06:52:37 EDT 2005;Committer;usa;3;17;0;17;0
3b53e365dc41fa15854c2f2275ea7ebc05562152;Fri Jul 01 06:37:48 EDT 2005;Committer;matz;3;122;2;124;0
f99971051f31ebc463e005fa8be9d0b0a24a449d;Fri Jul 01 03:49:12 EDT 2005;Committer;akr;2;13;3;16;0
626f1ee196fe06514d66771ff0e3f82d7686af25;Fri Jul 01 03:25:46 EDT 2005;Committer;matz;4;1309;317;1626;0
aa28f4671cf3e25016a8e908050b7dcb260e9fbe;Thu Jun 30 16:47:07 EDT 2005;Committer;eban;1;4;4;8;0
3f9e6adeb4137ae8b12deddef5fc8c797f25525c;Thu Jun 30 16:46:13 EDT 2005;Committer;nobu;2;7;0;7;0
e1ecbe91693f7991a8d2224d4b0231d751f09a59;Thu Jun 30 15:22:00 EDT 2005;Committer;matz;2;14;0;14;0
46a14a29fc67e0a6212d28e60cb39375bfbea089;Thu Jun 30 14:52:21 EDT 2005;Committer;nobu;2;9;1;10;0
1ffb788aaa0eea607812dc2941f96b9510e8e339;Thu Jun 30 10:11:14 EDT 2005;Committer;keiju;2;19;8;27;0
4ffab8713438fafb118776fcc1807b0c01e70be8;Thu Jun 30 08:31:38 EDT 2005;Committer;matz;2;8;2;10;0
5f97451ef98ed12e9793d6d5c54d245ed41e241f;Thu Jun 30 06:27:05 EDT 2005;Committer;akr;1;6;0;6;0
5d637fbba1c9a4ba0760bab1bb67727dfdd046c1;Thu Jun 30 06:21:00 EDT 2005;Committer;matz;1;0;1;1;0
639bd5e78fa7d83b44c892afccb99869a886e533;Thu Jun 30 06:20:09 EDT 2005;Committer;matz;10;104;72;176;0
00433666fd12d7e08c4c7c51593fc30265dd4508;Thu Jun 30 06:13:55 EDT 2005;Committer;eban;1;3;3;6;0
7fb6a090230983f341882bc043f2efcb80e3eff9;Thu Jun 30 05:58:42 EDT 2005;Committer;gotoyuzo;2;19;6;25;0
13212d08f1b6bd78aa1cabcaca60ae82391abf4a;Wed Jun 29 08:08:20 EDT 2005;Committer;eban;1;3;3;6;0
002794959dac1ea5c5763905894f6d67ebc5b8aa;Tue Jun 28 15:06:03 EDT 2005;Committer;ocean;2;15;0;15;0
08133b13443ea261101a54215931b29fe8de7d1d;Tue Jun 28 13:08:32 EDT 2005;Committer;ocean;7;26;20;46;0
4029f29dd75ec52ef0e776b67371dad5c88af6e3;Mon Jun 27 16:56:40 EDT 2005;Committer;eban;1;3;3;6;0
8e70a60da0d3a34cf6c748d81a6fab42a5734e26;Mon Jun 27 16:53:48 EDT 2005;Committer;naruse;4;47;53;100;0
41d2099e9646b4ad0c191083ec9da05461eb006a;Sat Jun 25 08:16:16 EDT 2005;Committer;gotoyuzo;2;7;1;8;0
9480c6b7206cbbddcfac5996b9efd249eb6bb0b4;Sat Jun 25 06:49:25 EDT 2005;Committer;nobu;2;24;17;41;0
66e5af96b2e52e31943e9ecca49809ea342a9d8e;Sat Jun 25 06:22:05 EDT 2005;Committer;ocean;2;21;12;33;0
52a590f0ccd8655ed719e0e01c869508fa3f04a3;Sat Jun 25 05:11:54 EDT 2005;Committer;nobu;1;3;3;6;0
73812eca67f3333cff9445bd0e2d86e24f1a9156;Sat Jun 25 02:50:50 EDT 2005;Committer;naruse;2;212;65;277;0
b1020bf03edfb370a01949d754e1e3061eac2b6f;Fri Jun 24 04:18:16 EDT 2005;Committer;akira;3;24;19;43;0
f07afe1cb55c1df88eb4ec228e4797d8c90fcd4d;Fri Jun 24 03:32:22 EDT 2005;Committer;eban;1;3;3;6;0
2e3404c1bb0a06aa7abb573eabdec98d1548751d;Fri Jun 24 03:29:24 EDT 2005;Committer;nagai;3;61;17;78;0
fc114887e69a26f27a09faeb91ae3b18b620619e;Thu Jun 23 14:56:40 EDT 2005;Committer;nobu;2;11;5;16;0
20484c52b00500b223bbbc2cdec5331171ab5ff2;Thu Jun 23 08:23:23 EDT 2005;Committer;eban;1;3;3;6;0
7e962a73799914e6355267c820283fea16be5804;Thu Jun 23 08:22:44 EDT 2005;Committer;akira;1;2;2;4;0
223798c50efcabab4ffa17e4060a8d89c929f982;Thu Jun 23 07:57:39 EDT 2005;Committer;nagai;5;275;41;316;0
258f9f49d6ca3946a8e08f207eb8ee2b4b51c6b3;Mon Jun 20 10:00:23 EDT 2005;Committer;akr;2;35;11;46;0
b03649bc2a0764fffb969b71f4bf18dcc12fe869;Mon Jun 20 08:17:53 EDT 2005;Committer;usa;9;95;3;98;0
7946d2357af1a142d7490a05f7f33531a3f28e81;Sun Jun 19 17:16:14 EDT 2005;Committer;nobu;2;44;39;83;0
5cea368b61c716c5e6ff38f100ca2385e19a228d;Sun Jun 19 16:29:17 EDT 2005;Committer;gotoyuzo;6;16;5;21;0
846350c22aded6afe0675b558cb18147d568621a;Sun Jun 19 16:02:41 EDT 2005;Committer;eban;1;3;3;6;0
4110c8936ae6121138740e09f81c1ae3ca9ea709;Sun Jun 19 15:47:31 EDT 2005;Committer;mneumann;3;26;4;30;0
716f1d3cbe8cce091ea3ea0b68fcab443ee34a80;Sun Jun 19 05:41:37 EDT 2005;Committer;nobu;1;3;3;6;0
991ee3ab0a96be612fa538e290905e4add23adfb;Sun Jun 19 05:16:36 EDT 2005;Committer;nobu;1;1;1;2;0
c8b7f0cef9e4e78e7c5cddd9b69e2bcd3eac4876;Sun Jun 19 05:09:32 EDT 2005;Committer;nobu;2;15;2;17;0
3adc6a6d3dea7a312881da9431e774079350c9af;Sat Jun 18 15:02:20 EDT 2005;Committer;nobu;1;3;3;6;0
4a3fffdccbfbf348d23d2192c81b81b3fe5b5405;Fri Jun 17 16:18:56 EDT 2005;Committer;shugo;4;45;4;49;0
edf7bc24641f9ba9bc9f2fa58f2012d179cb78f3;Fri Jun 17 04:04:44 EDT 2005;Committer;akr;2;129;25;154;0
539ac33671bff5b8c404611e014888b9c2b844a2;Thu Jun 16 17:27:09 EDT 2005;Committer;eban;1;3;3;6;0
1f15fe8da048575c90d45a1cc48a7a96ea5b4a1d;Thu Jun 16 17:21:57 EDT 2005;Committer;akr;1;21;29;50;0
ffb1f5722bace8f8eb384f8524f2cb8ce01c74a8;Thu Jun 16 09:22:01 EDT 2005;Committer;nagai;3;14;0;14;0
79d206efef783fbe276b37c14930c8e022482aca;Thu Jun 16 06:43:00 EDT 2005;Committer;usa;2;5;1;6;0
4fb012a86a08bea4c25832de68910e96156ccf8f;Thu Jun 16 06:22:19 EDT 2005;Committer;ocean;2;6;1;7;0
8cd944803eee11a00dea64c6257eb6dd030d3920;Thu Jun 16 04:37:07 EDT 2005;Committer;nagai;2;12;1;13;0
37b0e4164b6fd7c9823004a8361f543acdb58a05;Thu Jun 16 04:00:01 EDT 2005;Committer;akr;2;60;4;64;0
e710ced6595f3f91fdb7635434ca7a5860672c41;Wed Jun 15 15:32:46 EDT 2005;Committer;akr;2;31;7;38;0
27e59d7cdd01eb3a5625890d8d231e42dcce49bc;Wed Jun 15 15:20:23 EDT 2005;Committer;eban;1;3;3;6;0
dde30e112ff4a57e0c8444ae4d1f818547cef175;Wed Jun 15 15:02:32 EDT 2005;Committer;nagai;1;1;1;2;0
9b274216b219a409c0e7385ac41bc04dfa1e2534;Wed Jun 15 14:21:12 EDT 2005;Committer;nobu;1;3;3;6;0
082393fe395ed6c4db65be60c536dc43de6f8b75;Wed Jun 15 09:30:54 EDT 2005;Committer;nagai;3;124;1;125;0
9d49297a749fee60f83f4dc262271f4aade40469;Tue Jun 14 11:48:48 EDT 2005;Committer;nagai;1;1;1;2;0
aff3ea1ce0503a811e84f9cae04a625826646a83;Mon Jun 13 17:27:12 EDT 2005;Committer;eban;1;3;3;6;0
ca5d263facaa56db3bad500f3fc4ddc540765d33;Mon Jun 13 17:07:26 EDT 2005;Committer;nagai;3;150;1;151;0
7a986b2871afef840c3930f36394d9c639a98875;Mon Jun 13 04:04:33 EDT 2005;Committer;ocean;2;9;8;17;0
8db3dc39d60870e07cbdfec5e594e0f49b0733c7;Sun Jun 12 16:56:06 EDT 2005;Committer;matz;13;146;170;316;0
4169e76d14556864dca6bdef05d54f89651efc0b;Sun Jun 12 16:30:32 EDT 2005;Committer;eban;1;3;3;6;0
86aeca931cbd697167fbee85aff13d1c3b439a12;Sun Jun 12 16:23:08 EDT 2005;Committer;akr;2;8;2;10;0
0c3c2633acf94e10a94422abe26a58961cbae521;Sat Jun 11 13:48:44 EDT 2005;Committer;eban;1;3;3;6;0
cc5f78419c74463cb8a9e62311587483c042c79a;Sat Jun 11 13:46:39 EDT 2005;Committer;aamine;2;7;2;9;0
dececad56c69e1944a95a10037cdba5fa673f0c2;Fri Jun 10 14:57:37 EDT 2005;Committer;akr;2;13;1;14;0
647330d72351e809145ee2d6359dfea1d4655386;Fri Jun 10 14:39:36 EDT 2005;Committer;nobu;1;3;3;6;0
0a32e9daa454abfdeeda0329f8d665b3147e22cf;Fri Jun 10 13:56:08 EDT 2005;Committer;nobu;2;7;0;7;0
eec9b911bb9acd56e60c1aa0f4ef3afe831f500f;Thu Jun 09 22:47:35 EDT 2005;Committer;ryan;2;637;319;956;0
c1ae0656e6b3e33a6f874519aa3ed8f11e755650;Thu Jun 09 14:59:10 EDT 2005;Committer;nobu;3;12;3;15;0
3f12095fbf552788a2ab0c6e7059527c189aee36;Thu Jun 09 14:36:02 EDT 2005;Committer;nobu;2;8;1;9;0
27c228d6819b125dc3e9277e74a5d2bb30cf75a9;Thu Jun 09 11:18:31 EDT 2005;Committer;akr;3;53;24;77;0
20e269da04e6eae10910552473d61fa684e5523e;Thu Jun 09 09:49:28 EDT 2005;Committer;eban;1;3;3;6;0
914a916a91dcb28fb376012cfab2c6f32d23b38f;Thu Jun 09 09:49:00 EDT 2005;Committer;akr;1;1;0;1;0
48f2d3a72d3cd92eea720a632ad71883779df708;Thu Jun 09 09:34:31 EDT 2005;Committer;akr;4;13;8;21;0
e1885a0079bc61b610842783fe4dd1a2a84d8a81;Wed Jun 08 14:42:06 EDT 2005;Committer;nagai;2;10;1;11;0
c2e1ef22b91caab1167893f67ded18a747c581bb;Wed Jun 08 14:38:02 EDT 2005;Committer;ttate;1;1;1;2;0
8d5e6a0fc68dbea9b7182d8e8dd9ac4a5b65af57;Wed Jun 08 03:30:56 EDT 2005;Committer;matz;5;28;24;52;0
5ef43814a8d1cf3b3905c70555b09255f37cf1e3;Wed Jun 08 02:16:35 EDT 2005;Committer;matz;2;36;15;51;0
17920c7a9e41f8f89f6a413e42fadfa332b5665e;Tue Jun 07 23:33:51 EDT 2005;Committer;nobu;4;118;118;236;0
db128e1b31f3c31e955a9063d027a97dcb938873;Tue Jun 07 16:33:01 EDT 2005;Committer;matz;6;61;7;68;0
3ec9537664b3555609bccd0bdf54fa25040a2aeb;Tue Jun 07 15:08:31 EDT 2005;Committer;eban;1;3;3;6;0
39b30616a54610567217ecce7c597fe59b624d7d;Tue Jun 07 15:02:32 EDT 2005;Committer;matz;3;40;0;40;0
a6e6bb626ca28ece8d6423caab31238a3ce918c2;Tue Jun 07 09:41:17 EDT 2005;Committer;matz;2;89;20;109;0
f36783751b8b12b4fc2976c82c71a8215f65775a;Tue Jun 07 09:30:35 EDT 2005;Committer;nobu;2;15;3;18;0
15dfe8eee69ce3bc065be8f0cc69963c1404202d;Tue Jun 07 09:04:18 EDT 2005;Committer;ocean;3;29;9;38;0
1049fd5f6401a3769aad4fd60ab9dac8350c85bb;Tue Jun 07 08:54:18 EDT 2005;Committer;nobu;1;1;1;2;0
a99cc44c8dbf22d0a38161ab45850389704babc9;Tue Jun 07 08:35:04 EDT 2005;Committer;matz;2;5;2;7;0
549c345cefe03ab3f35b9cca1192a0062f288eca;Tue Jun 07 08:22:42 EDT 2005;Committer;matz;4;38;10;48;0
7eef190796511c58756e58d4e3666f3a78523f5c;Tue Jun 07 05:11:55 EDT 2005;Committer;ocean;3;116;52;168;0
261f8e0f734e7114622508057a291ac410a672a2;Tue Jun 07 02:49:16 EDT 2005;Committer;akr;1;5;2;7;0
b12b406e98f973e9cc11a9b54d350fd25eeba5a5;Tue Jun 07 01:37:24 EDT 2005;Committer;eban;1;3;3;6;0
78e266c241447ba73e590ee1056dec3530682487;Tue Jun 07 01:33:12 EDT 2005;Committer;nagai;2;18;5;23;0
0e7ab28c36fd9524dd6d93363a1e99c270abf752;Mon Jun 06 07:37:07 EDT 2005;Committer;usa;2;5;0;5;0
99645d57db67483c859ff9aaa044a25c9492c4b3;Mon Jun 06 04:54:00 EDT 2005;Committer;eban;1;3;3;6;0
d993088277ef6bae6e64a27bbf1424ef1727a101;Mon Jun 06 04:47:43 EDT 2005;Committer;ocean;2;22;1;23;0
aa91b7bd5d94e2b0e4150734719a21db9afd5ce9;Sun Jun 05 14:07:21 EDT 2005;Committer;eban;1;3;3;6;0
80eef0fd3b39a6622ef47819ca06cd2aed703aea;Sun Jun 05 14:03:41 EDT 2005;Committer;nagai;3;11;0;11;0
8507219097b2ee57bad4b1ad03c7f292ce45ada6;Sun Jun 05 07:04:06 EDT 2005;Committer;akr;1;8;3;11;0
73c5a99b5088461b3b97f345fc4cc7c6c44e1177;Sun Jun 05 01:26:01 EDT 2005;Committer;akr;2;5;8;13;0
cd8d93d0cd252e8dc9f6d241b46deda784e2e132;Sat Jun 04 05:59:16 EDT 2005;Committer;akr;5;1191;1261;2452;0
f27ff52d1e5bbd16447544761e446fe007d3efcf;Sat Jun 04 02:40:40 EDT 2005;Committer;akr;1;28;0;28;0
8a85b8bef1229c3774096c6b804b0210743fb720;Fri Jun 03 20:40:39 EDT 2005;Committer;akr;1;1;1;2;0
a1782f4e6ab412b10b59dc0011252cc3e02b4de5;Fri Jun 03 18:03:52 EDT 2005;Committer;akr;1;3;3;6;0
0ad046218349809de09d0c8d8bddc372ca4fc0e0;Fri Jun 03 17:14:06 EDT 2005;Committer;akr;1;2;2;4;0
ea0a08fddd28fa6220930e13dd0757074a7ca752;Fri Jun 03 16:49:56 EDT 2005;Committer;akr;1;1;0;1;0
49f4ef7d03bfea5eeeeb3b2846f15a1b078ccde7;Fri Jun 03 16:43:39 EDT 2005;Committer;akr;3;520;556;1076;0
6c4d802e143bcc2d1f6295077e31c8f42689dde6;Fri Jun 03 16:17:17 EDT 2005;Committer;eban;1;3;3;6;0
f7298a29eab289884eeab41b7e8fd59c5fbdd612;Fri Jun 03 16:11:40 EDT 2005;Committer;akr;1;26;0;26;0
5794d80d53b3cf6e64a78c92ac3109dea8ad2c66;Fri Jun 03 14:39:15 EDT 2005;Committer;akr;1;23;0;23;0
c9d126aec990acb56dfa87b67e9fc312f82da91d;Fri Jun 03 14:23:17 EDT 2005;Committer;nobu;6;408;105;513;0
f0ede6b31cc81671d231a92db8b3e87127f4eb24;Fri Jun 03 05:19:49 EDT 2005;Committer;eban;1;3;3;6;0
dc5a620aa0857bc5be4bc7bb8a46b14007d37e57;Fri Jun 03 05:08:40 EDT 2005;Committer;nagai;3;7;3;10;0
d2a81a3aa319d7f1c24c32e315dbf2b7c0e099a9;Thu Jun 02 14:43:10 EDT 2005;Committer;nobu;5;28;8;36;0
34adacb036e1aac4b6b914e1515e4a907c30a0b7;Thu Jun 02 07:26:10 EDT 2005;Committer;matz;2;23;2;25;0
f2469dc78a869cac2d1b2264cb9c131ee882cf19;Wed Jun 01 15:11:04 EDT 2005;Committer;eban;1;3;3;6;0
3aa5496c9897b4aa284693da87bfa17e2e75aec8;Wed Jun 01 15:03:09 EDT 2005;Committer;aamine;3;23;2;25;0
a9543d64f12e7003c143dca3084df6decc0485d9;Wed Jun 01 03:13:54 EDT 2005;Committer;eban;1;4;4;8;0
ec983004055224313f3cd08681d1c27ef31baab0;Wed Jun 01 02:35:35 EDT 2005;Committer;ocean;2;9;1;10;0
fe473adee74c644234893a76090a997a51275eeb;Tue May 31 06:56:41 EDT 2005;Committer;eban;1;3;3;6;0
3894044308b4dca842d458c336e3daca49450284;Tue May 31 06:53:58 EDT 2005;Committer;gotoyuzo;2;13;1;14;0
6622dfe58f7b55b09582b626e844e81b235af090;Mon May 30 14:59:30 EDT 2005;Committer;eban;1;3;3;6;0
bd47024ab6b8c4ef5760a767e39900b023592082;Mon May 30 14:53:52 EDT 2005;Committer;nagai;48;327;4;331;0
99cdce85f290c028191931af7e0544a03feb1e56;Sun May 29 05:17:10 EDT 2005;Committer;eban;1;3;3;6;0
89d21d118dbbe75d61c49dc320fd82de8316ce7f;Sun May 29 04:55:56 EDT 2005;Committer;akr;1;2;0;2;0
1e0f2f7ca8053ba209fd3b68a64061b015eb24ba;Sat May 28 07:41:36 EDT 2005;Committer;gotoyuzo;2;33;7;40;0
ca144bc1920c55a508728ed3d0fc662c00403797;Sat May 28 02:14:07 EDT 2005;Committer;eban;1;3;3;6;0
313799a022529e000c8a25e4081d403bd4db7f2e;Fri May 27 20:20:29 EDT 2005;Committer;gotoyuzo;2;12;12;24;0
2530fa50e9d4d0af08245481536d00d884d5766a;Fri May 27 17:16:06 EDT 2005;Committer;gotoyuzo;4;24;5;29;0
aee4253e707542c8c0bf72558849ff2f5375e4f6;Fri May 27 07:49:06 EDT 2005;Committer;eban;2;14;5;19;0
d44aad57152e8640db9c97394cb8bade1db06d21;Thu May 26 12:58:55 EDT 2005;Committer;eban;1;3;3;6;0
98855e4a27408b22b60d26cf0841114a4b6a2785;Thu May 26 11:33:16 EDT 2005;Committer;aamine;3;86;41;127;0
0d5b973720d9ab919113b5502a3b65f5bb1d1986;Wed May 25 23:35:25 EDT 2005;Committer;nobu;4;75;3;78;0
55ec2ad1637d1aa4bbc7c433da8d4d4b7b1f3ecc;Wed May 25 22:41:32 EDT 2005;Committer;aamine;3;599;407;1006;0
87cad12ae84f9ce07f55100f02fd82ae0fdc7884;Wed May 25 21:11:13 EDT 2005;Committer;nagai;2;59;1;60;0
90537dbe3c152388032608f6f63b23f1762235d0;Wed May 25 11:09:59 EDT 2005;Committer;nagai;18;289;108;397;0
ac5925d2ab40061fd30369049105dc38b9039ebf;Wed May 25 10:50:14 EDT 2005;Committer;aamine;2;35;8;43;0
71a80abc7c1de76cc90fda8ad0e0f06437805025;Wed May 25 04:03:20 EDT 2005;Committer;akr;2;6;2;8;0
2ca35a8bfe4c7e64daab5dbecb4fba384069c0fc;Tue May 24 15:25:52 EDT 2005;Committer;eban;1;3;3;6;0
d3a0ec7636402bfe2f9c9d97d2a910fbca8db51a;Tue May 24 15:24:23 EDT 2005;Committer;matz;4;27;1;28;0
6e027698371e590d56b4ed4067bac26ab07923fc;Tue May 24 08:48:41 EDT 2005;Committer;shugo;2;6;1;7;0
f7ca291dd13129968ffc7f4a788406a652f41b2c;Mon May 23 21:46:18 EDT 2005;Committer;nobu;2;6;1;7;0
0162e83dfaf238deeb89ba2f99aa3384e87b3080;Mon May 23 15:45:01 EDT 2005;Committer;eban;1;0;12;12;0
b38dcb30b4284a2ce62746bf51f7a3429a7d41b0;Mon May 23 15:41:59 EDT 2005;Committer;eban;1;15;3;18;0
087ff5d6e715094d7c320c7d1d5aee32188e7b11;Mon May 23 15:40:01 EDT 2005;Committer;nahi;5;39;16;55;0
94aa5943bb09d52580041e77d66b93d2d11b763d;Mon May 23 07:27:08 EDT 2005;Committer;nagai;3;66;13;79;0
34075ed209a0c9c70570deb4aad1766d2415607c;Mon May 23 06:10:32 EDT 2005;Committer;usa;2;6;1;7;0
d7fcba730c5d9432233398bafd7569d2eaf1e426;Mon May 23 04:08:37 EDT 2005;Committer;eban;1;3;3;6;0
d11b15eb8c9f9a5c4bb97a60f4321d19d3a334ea;Mon May 23 03:24:28 EDT 2005;Committer;matz;2;18;12;30;0
eb3f829be932514064a983eb98fa7f840137f985;Sun May 22 13:03:38 EDT 2005;Committer;nahi;211;5977;9358;15335;0
7aea792d3bdf42c349170e710953d7de29de57ab;Sun May 22 10:18:41 EDT 2005;Committer;gotoyuzo;3;23;2;25;0
21393f1b2de63dd6c539774cccd2ce1718c6a138;Sun May 22 03:31:08 EDT 2005;Committer;nobu;3;8;10;18;0
9564678f36ff89ac373ecf084777c7caf8195004;Sat May 21 17:42:53 EDT 2005;Committer;eban;1;3;3;6;0
5eacc550e2e9ce09b9d45200fadbbfd76e8af313;Sat May 21 17:42:08 EDT 2005;Committer;aamine;1;2;1;3;0
57873ba60f3619c38fede8f6e3c73c9660d0c4c8;Sat May 21 17:40:24 EDT 2005;Committer;aamine;2;208;89;297;0
fecc253a1033fa6966ca7432df5f3d908d3929d3;Sat May 21 01:26:02 EDT 2005;Committer;ocean;2;6;1;7;0
37852577fc1b0ce18b0178f6690bd42f28bc203a;Fri May 20 06:57:06 EDT 2005;Committer;shugo;2;9;3;12;0
6362afe60659408ec4441616c6909171cd1ff47e;Thu May 19 17:01:43 EDT 2005;Committer;eban;1;3;3;6;0
327e957c73780d4248770cf2afc4dbcb8ef34418;Thu May 19 16:26:50 EDT 2005;Committer;shugo;3;34;6;40;0
3fd16970f3a6b4d33d6e6397e5570e9ee0e2a368;Thu May 19 14:36:20 EDT 2005;Committer;shugo;5;173;124;297;0
ddec3de32a6d706e3aea4c8954ea7c97c931f18d;Thu May 19 03:28:25 EDT 2005;Committer;eban;1;3;3;6;0
21e8df5c109e4dd4f50bcebdebf8e4c4ce297560;Thu May 19 02:58:11 EDT 2005;Committer;ser;15;1210;866;2076;0
a399253153b1c4e6f09d798973524fa3dc158247;Wed May 18 14:43:03 EDT 2005;Committer;nobu;2;6;1;7;0
dd2d4bc29bc1d5160d76fc3e3e59a85fe110892e;Wed May 18 08:41:50 EDT 2005;Committer;eban;2;6;1;7;0
a70902a5c9888b45cedc235fd913b7ab88e8c9f6;Wed May 18 05:10:09 EDT 2005;Committer;usa;2;5;1;6;0
8e5dee50ead000a3e7fdaaa3a629d947037c91f9;Wed May 18 02:28:52 EDT 2005;Committer;eban;1;3;3;6;0
b272844547c4680b10cdd0a645384f1285e0a597;Wed May 18 02:08:00 EDT 2005;Committer;nobu;4;69;55;124;0
aab01c2bc991c7f887ae5117afa43f4be2f4e7c7;Tue May 17 03:13:12 EDT 2005;Committer;usa;1;1;1;2;0
c902442151ded79933b238cdfecde25333f9b615;Tue May 17 02:53:09 EDT 2005;Committer;usa;1;3;3;6;0
0a6a371abf8d68184a419c2f3160f21483009aac;Tue May 17 02:52:43 EDT 2005;Committer;usa;2;6;1;7;0
a1ce08c5b39b848ed5f87f3cd3f75259bcb6b347;Mon May 16 13:42:59 EDT 2005;Committer;nobu;2;7;7;14;0
6c2bce70a386dfa80d5a81ce591fd09934142009;Mon May 16 13:40:49 EDT 2005;Committer;nobu;2;5;1;6;0
db218799e8bc4217327124d6802a943b739040d4;Mon May 16 13:28:59 EDT 2005;Committer;nobu;2;7;1;8;0
a3c29ec51ac19043859728696f568b095ac739e6;Mon May 16 13:22:09 EDT 2005;Committer;nobu;5;14;3;17;0
208f2f27ca2604b37125f66585933807759dff99;Sun May 15 18:36:56 EDT 2005;Committer;ocean;3;22;18;40;0
a8d293220d997ea105710a806d8bbc8ebd96b08f;Sun May 15 15:41:58 EDT 2005;Committer;eban;1;3;3;6;0
cb025decffb74f95cadddf4ea278d8ad7b7eddf9;Sun May 15 15:32:35 EDT 2005;Committer;akr;2;7;1;8;0
cd836a0cd2b952dc6d44bbfeec7d9ee1bc98f313;Sun May 15 13:28:32 EDT 2005;Committer;seki;2;7;1;8;0
e27aaa177e6d6d374be8af4811ef801a8db6cbea;Sun May 15 09:56:53 EDT 2005;Committer;nobu;3;10;20;30;0
eebb06165f56fc316b03fbd6734a513eb05a96ac;Sun May 15 05:50:45 EDT 2005;Committer;akr;2;8;3;11;0
c23d3e4640e52104bc513136e37a58223bf3da09;Sun May 15 00:57:49 EDT 2005;Committer;nobu;2;8;1;9;0
a7c5e6bcec40e4488f30935b973097ea2fbaf26f;Sat May 14 20:59:07 EDT 2005;Committer;ttate;2;7;0;7;0
36e3983a2720afac6ecba48464e0e6ab9910acc7;Sat May 14 14:59:53 EDT 2005;Committer;nobu;2;9;4;13;0
642ddf7201445c6abd8b7afa6efdaa1e8f1bea67;Sat May 14 14:57:53 EDT 2005;Committer;nobu;11;65;30;95;0
9bbb8406cb1ded73ebdc10d565fdd1fc0f805cb8;Sat May 14 02:48:27 EDT 2005;Committer;nobu;1;3;3;6;0
434e8a379656337f97cff9108c5a4b5b7c220fed;Sat May 14 02:48:07 EDT 2005;Committer;nobu;4;209;14;223;0
2cf330ad771450f9285cb0f0c88d6a1dc17a64d2;Sat May 14 02:23:45 EDT 2005;Committer;ocean;1;3;2;5;0
2c716f2b4716372ccf3f591bb0201b73d03dc117;Fri May 13 14:44:59 EDT 2005;Committer;nobu;6;23;6;29;0
8726077bc11e717d971fb1c18a59576b15879c1b;Fri May 13 14:33:02 EDT 2005;Committer;nobu;2;6;2;8;0
74eab43d49ec23a1a3dc0a01fc18dcac9b298d72;Fri May 13 08:56:40 EDT 2005;Committer;ocean;2;12;6;18;0
6bbd130b4d50fd0b8db27ea802ad948640e32225;Fri May 13 06:20:06 EDT 2005;Committer;ocean;1;8;3;11;0
49a84b08672f6023a4fdf3045ef0cc03244f1255;Fri May 13 05:24:19 EDT 2005;Committer;ocean;1;10;0;10;0
3d240686f3c80d97ee3e8d1bd6c0e2f345180717;Fri May 13 05:18:33 EDT 2005;Committer;eban;1;3;3;6;0
e1c5d1978b282324297e444600fcea79111bd692;Fri May 13 04:50:14 EDT 2005;Committer;ocean;1;14;0;14;0
40fd465e821e08cd2a1d58c0fc490ff9e8abb095;Thu May 12 09:04:49 EDT 2005;Committer;akr;1;45;0;45;0
cddaecb1ae11b2d1d4e19a449497f53a93c08a0e;Thu May 12 08:42:36 EDT 2005;Committer;naruse;2;22;11;33;0
d806a4daa718095b3b3f8ecf02ed97a940dfc20e;Thu May 12 07:53:39 EDT 2005;Committer;ocean;2;15;4;19;0
bf4eb618198d3e9ff0bf439a5521bcda663bf101;Thu May 12 07:00:37 EDT 2005;Committer;ocean;2;16;0;16;0
72a6794070964789beaaec190dff8f7aab7875ea;Thu May 12 02:24:41 EDT 2005;Committer;ocean;1;3;3;6;0
42de5af133bdbd0c466b902b86ffde45634b6c31;Thu May 12 00:54:36 EDT 2005;Committer;nobu;2;5;0;5;0
dd9d1e580c29042f0f7dc30fd802796e7d2e80ce;Wed May 11 16:28:22 EDT 2005;Committer;eban;1;3;3;6;0
058df1f632b3d2bfaf223fdb0902bb38d5858002;Wed May 11 16:25:24 EDT 2005;Committer;nobu;2;17;2;19;0
6fcad7f1c55d4e93226084cc4aaa8ad45e6ff584;Wed May 11 07:00:32 EDT 2005;Committer;matz;5;15;4;19;0
edc4823184ab9c0c5254c71f64d72a0e66042fbb;Wed May 11 01:46:31 EDT 2005;Committer;ocean;2;6;2;8;0
b7c3cb31f0374d98f7a3ea5ab80fd25857a1b847;Wed May 11 00:05:52 EDT 2005;Committer;nobu;1;3;3;6;0
c3aa92a9213e95807ec5720eb4954a49849d266a;Tue May 10 16:04:52 EDT 2005;Committer;nobu;2;7;2;9;0
91e758c9d755a4fc0deb4701ebe46247a8a6dd2e;Tue May 10 01:48:34 EDT 2005;Committer;eban;1;3;3;6;0
3d8229b1267b9ad319ac8e2036b01ba8514fc4a3;Tue May 10 01:29:03 EDT 2005;Committer;nagai;2;6;2;8;0
e2a0e0faae52e96c8f19d5bb79b2db5dd02a6ccd;Mon May 09 14:43:50 EDT 2005;Committer;ttate;1;6;0;6;0
597a64146fe0268f4a71f78cdeebdf9823e6d045;Mon May 09 14:38:44 EDT 2005;Committer;ttate;1;6;7;13;0
4c2929e1521d5dc0bc1e9036139f6bff74582796;Mon May 09 02:11:37 EDT 2005;Committer;eban;1;3;3;6;0
4187afceca216df5bc8b0f400f6a1aeb4abd6b17;Sun May 08 18:56:23 EDT 2005;Committer;ttate;1;2;2;4;0
357ce6cfe465e21ec6c6ba330adce3a46fec1a4f;Sun May 08 14:21:31 EDT 2005;Committer;nagai;11;29;21;50;0
8f1f1183f5b7c7fdf445eabe2813594346fe8de9;Sun May 08 12:23:51 EDT 2005;Committer;ocean;2;5;72;77;0
ff185d9e089e58351e20984b94b1e96484b62686;Sun May 08 08:20:27 EDT 2005;Committer;eban;1;3;3;6;0
4c72dfd39f9f3a854863a7c79ac2f63690156c56;Sun May 08 07:54:20 EDT 2005;Committer;ocean;2;34;29;63;0
ce3785458a46a5c5029607ee55c9513847692c32;Sat May 07 15:05:49 EDT 2005;Committer;nobu;1;3;3;6;0
d88a67866c2805f7e0fa71d038e7726ddb34c541;Sat May 07 13:58:26 EDT 2005;Committer;nobu;2;4;2;6;0
633fe04dddf457eb0979e397273138b8bb4059cf;Thu May 05 23:25:58 EDT 2005;Committer;nobu;1;3;3;6;0
98c50b0b9355d315246b0bbb69171bdb50ba725a;Thu May 05 23:08:47 EDT 2005;Committer;nobu;3;9;1;10;0
833c2375aa22756256a58ef05ad0860d2e80617a;Sun May 01 00:59:08 EDT 2005;Committer;nobu;1;4;4;8;0
1ec656e349a1173fd95dd40e152f770c22de2602;Sun May 01 00:15:25 EDT 2005;Committer;nobu;3;20;13;33;0
fa1855c6d4c9af369c4837051ee2d592375fb603;Sun May 01 00:13:48 EDT 2005;Committer;nobu;2;39;11;50;0
dd5e79bacec9429c46b6c29a5d17616d2f559118;Sat Apr 30 13:00:16 EDT 2005;Committer;nobu;1;2;2;4;0
f64e6fed21f070d7d994c7c65464ca7e88144fdd;Sat Apr 30 12:50:34 EDT 2005;Committer;nobu;1;1;1;2;0
15741e262eeb78546daf6555da07141d2cc7aaa6;Sat Apr 30 04:11:33 EDT 2005;Committer;nobu;1;2;3;5;0
15b12588ab7b4ade469a8838a63411a2cc9d31d5;Sat Apr 30 03:00:22 EDT 2005;Committer;nobu;1;3;3;6;0
27a9df2a6ba505846f25aa9cd4cb2627e753e6de;Sat Apr 30 02:59:44 EDT 2005;Committer;nobu;8;75;32;107;0
6d69a240b86c10f128347a681c731c5cda972e22;Fri Apr 29 22:10:56 EDT 2005;Committer;gotoyuzo;5;41;16;57;0
0e3af10d5ef375f69ba8792fa5355e635b54421b;Wed Apr 27 23:25:13 EDT 2005;Committer;nobu;1;3;3;6;0
0dd5e501ad2fb96e001bb4dd30ea46530e3f8479;Wed Apr 27 23:21:58 EDT 2005;Committer;nobu;2;49;10;59;0
35379dc7b78fe94dc7b0759e2da63baed1309181;Wed Apr 27 14:43:54 EDT 2005;Committer;nobu;1;3;3;6;0
6329fa50b69c3982488ed6b4ca593c8177ddaf40;Wed Apr 27 14:43:06 EDT 2005;Committer;nobu;3;12;3;15;0
be2020554745ea4f09ec54ad78e247e868c79cb5;Tue Apr 26 14:49:36 EDT 2005;Committer;nobu;1;3;3;6;0
6fc7b39b62d20a2d6f0a88cd3da072c8ea1026af;Tue Apr 26 14:00:20 EDT 2005;Committer;nagai;2;66;16;82;0
64c156e07395882539f2e24b2472322c66807472;Mon Apr 25 05:09:08 EDT 2005;Committer;ocean;3;27;22;49;0
0214d35d79b74bc52442b9337bbf74d35102bf59;Sun Apr 24 16:28:04 EDT 2005;Committer;eban;1;3;3;6;0
0fe7df5c2f94550a9505176c4e3ec48d2a394a3a;Sun Apr 24 16:23:15 EDT 2005;Committer;akr;3;8;3;11;0
1a0261296361397650c5665869a782a0f6b8b8e8;Sat Apr 23 11:05:23 EDT 2005;Committer;ocean;2;2;2;4;0
4e9a14b715815cec855ab19432581a5a80fc6a1c;Sat Apr 23 11:04:00 EDT 2005;Committer;ocean;2;8;2;10;0
a08123a5de4cc29bb956a3812e54e3fec9b59648;Sat Apr 23 02:46:57 EDT 2005;Committer;nobu;1;3;3;6;0
7b81c9d7a3d1b1ce27c1853d8c0d6a622d57951d;Sat Apr 23 02:45:38 EDT 2005;Committer;nobu;2;23;8;31;0
d8cd7516c5d0ff56842ad4dbd676aca2b0e9f137;Fri Apr 22 08:36:00 EDT 2005;Committer;ocean;1;1;1;2;0
c5dd07925a08f74ab3c85faa0a4a82f78613e572;Fri Apr 22 08:17:50 EDT 2005;Committer;eban;1;3;3;6;0
a7473661024891abf422f8ffa0ea84022b154304;Fri Apr 22 07:57:26 EDT 2005;Committer;ocean;2;8;1;9;0
dbbfbc5a21dec443bd0234f89d739129cff4d0a5;Wed Apr 20 21:45:43 EDT 2005;Committer;nobu;6;44;2;46;0
756a1c457e8b5243c6fb09fa0aa8c71f5ca78646;Wed Apr 20 21:44:20 EDT 2005;Committer;nobu;2;42;6;48;0
3ff0189a1f8a9639c0f8a67e4bb2c880d5c38f7b;Wed Apr 20 16:56:14 EDT 2005;Committer;eban;1;3;3;6;0
b6b8750a29313a817c34cad5cdf0eaeb66fee2a4;Wed Apr 20 16:53:27 EDT 2005;Committer;aamine;2;52;13;65;0
514df9097eaca61ba9cddf1da6692af8be51ac2a;Wed Apr 20 15:08:36 EDT 2005;Committer;nobu;5;30;1;31;0
5c6e6441966c41135a1d08c32b177748d9c15e2d;Wed Apr 20 14:25:34 EDT 2005;Committer;nobu;8;32;4;36;0
9031084686439d54fe1bf88db7d96372f255ac16;Wed Apr 20 14:02:15 EDT 2005;Committer;nobu;2;6;0;6;0
9d0758b3b0f85a0a3ca26e1e83b4a6f04c460873;Wed Apr 20 13:55:26 EDT 2005;Committer;aamine;3;75;7;82;0
75cff6289c53155bfa73e7cc98bad0b12fab317f;Wed Apr 20 02:04:05 EDT 2005;Committer;eban;2;6;1;7;0
4c4e6b60d16d710342d887a8a172e56da40359f4;Wed Apr 20 01:30:02 EDT 2005;Committer;eban;1;3;3;6;0
7f530ef4e1dd29e2259f8bff0a6b901eaa5c01d3;Tue Apr 19 22:28:28 EDT 2005;Committer;nobu;7;62;2;64;0
98cc039220de33cf426b771d264d485f7ecf60cb;Tue Apr 19 14:49:43 EDT 2005;Committer;eban;2;35;22;57;0
e313b6a9f1448bd2255ca12586068ddee6b7c3e0;Tue Apr 19 14:02:48 EDT 2005;Committer;nobu;3;9;2;11;0
07eead80713acee91fbca1c0c3bc33b5284eea31;Mon Apr 18 23:38:16 EDT 2005;Committer;nobu;2;6;1;7;0
b56724550db45600ce90507faaf05cf6a1ec9130;Mon Apr 18 15:03:05 EDT 2005;Committer;eban;1;3;3;6;0
81217389431297d209fdad76a5d7efc66a428b76;Mon Apr 18 15:01:21 EDT 2005;Committer;nobu;4;48;21;69;0
ce3eb0b20417dd304f27618ed5db0693b2c9563a;Mon Apr 18 06:38:30 EDT 2005;Committer;matz;5;14;7;21;0
925cb98fe832a25734420c8bd5b6eabceb985180;Mon Apr 18 02:40:30 EDT 2005;Committer;eban;1;3;3;6;0
4605d6bc417b0fcbcc29e8f5a35f127c404aa938;Mon Apr 18 02:34:20 EDT 2005;Committer;ocean;2;9;0;9;0
3403d175d9150734055c8f576c54e0fdad42d5ad;Sun Apr 17 14:58:16 EDT 2005;Committer;nobu;2;6;2;8;0
7906fe4b639939ed7767360b0c64010b548eb849;Sun Apr 17 14:48:55 EDT 2005;Committer;nobu;1;3;3;6;0
b567351affbe7f6279038db8d45da73f13f5ea77;Sun Apr 17 13:57:52 EDT 2005;Committer;nobu;2;10;4;14;0
4afc07a66637ab4df52f1b4672adf51b56b6c1eb;Sat Apr 16 08:04:50 EDT 2005;Committer;kou;2;15;9;24;0
b51cd234cf7840c80cc9a78e487ee884af0c67d4;Sat Apr 16 06:27:43 EDT 2005;Committer;nobu;3;19;7;26;0
dc404f009a1def233c7cdbc8e870a316b366669c;Sat Apr 16 05:05:58 EDT 2005;Committer;eban;1;3;3;6;0
18c5d91bb39f4674c7d04c39b4a8370484b1cb7d;Sat Apr 16 01:40:34 EDT 2005;Committer;ocean;2;7;2;9;0
385d24afa5cf8c417110235aa1d8f46326a89249;Fri Apr 15 19:16:18 EDT 2005;Committer;gotoyuzo;3;11;0;11;0
9f6d8980ff21139fa45ae58ce67a8ece8cb33563;Fri Apr 15 13:43:32 EDT 2005;Committer;suke;3;24;2;26;0
6a63e942ba20b6a2bb4d7fb3ef784cc89f0e5ae7;Fri Apr 15 13:05:01 EDT 2005;Committer;suke;2;45;3;48;0
dd82fb6393e8a4b5bc5b9fa6abfa0730c29e60c2;Thu Apr 14 10:05:29 EDT 2005;Committer;aamine;3;10;3;13;0
af759b81a1ed2fb2c932b7d10b31f6e8d7397f5b;Thu Apr 14 10:00:52 EDT 2005;Committer;aamine;3;62;21;83;0
ce7c263fb621099b1aaed1018e56fd7dd7dee258;Thu Apr 14 09:58:18 EDT 2005;Committer;keiju;5;28;6;34;0
2ac523a89143f5d39239382e9e60f7d6e63657a0;Thu Apr 14 06:16:08 EDT 2005;Committer;keiju;4;11;6;17;0
ff958cd44ea40ddd83f3ac4566ad5517c70b996b;Wed Apr 13 20:45:54 EDT 2005;Committer;keiju;3;13;4;17;0
8e8cd649be669910e360e0be43eb9a9f4d6edd58;Wed Apr 13 15:30:15 EDT 2005;Committer;keiju;3;313;0;313;0
914c81e98b4038845fea56f8b88fd9744911ce8b;Wed Apr 13 15:29:51 EDT 2005;Committer;eban;1;3;3;6;0
622b522047ea7bdb716ec87131d08400ba41e8b7;Wed Apr 13 15:27:09 EDT 2005;Committer;keiju;33;446;319;765;0
c56355fbdcaac7a55319f63416fcc19fbad89670;Wed Apr 13 14:48:00 EDT 2005;Committer;kou;3;15;4;19;0
abdb27bf16d9938299ba9724cc2655c924f0dcbc;Wed Apr 13 13:24:59 EDT 2005;Committer;nobu;1;0;2;2;0
4eede6b4a1aa7e6eea390c9ce82c0a5edd34fc9c;Wed Apr 13 13:12:24 EDT 2005;Committer;nobu;2;15;4;19;0
c7151a3f5e8fbcba2927cd382e8f4083c9b445c7;Wed Apr 13 12:24:40 EDT 2005;Committer;eban;2;6;2;8;0
7b8fe2bcc7147f10e4e1b881fd7b80d2384cef35;Wed Apr 13 11:05:30 EDT 2005;Committer;eban;1;3;3;6;0
f091f360356f942cf829ae741bd7dcc7c189c991;Wed Apr 13 10:25:41 EDT 2005;Committer;nobu;4;90;11;101;0
bea190a1fce429ebf080d59faa637f796227dc50;Tue Apr 12 10:30:45 EDT 2005;Committer;nobu;2;59;12;71;0
c594a95a57345d2edb68b74546d5953d61d81972;Tue Apr 12 06:37:10 EDT 2005;Committer;nagai;2;37;12;49;0
b346101b25b6678d89503e152366eae5b85c92e0;Tue Apr 12 03:39:50 EDT 2005;Committer;nagai;2;20;9;29;0
f5af2022620d823dfd7390298679434450115bd0;Mon Apr 11 17:32:39 EDT 2005;Committer;eban;1;3;3;6;0
7f2298504819c17bdb7bbb29db274203ed84d505;Mon Apr 11 17:29:51 EDT 2005;Committer;nagai;2;21;3;24;0
d822ffdc04e125d19daeeef71bc100377cf54e0b;Mon Apr 11 14:48:50 EDT 2005;Committer;seki;3;35;5;40;0
4f6e8bade5afe7d71ea6db73089f7634124aeec3;Mon Apr 11 13:30:10 EDT 2005;Committer;eban;3;8;4;12;0
e3d946f2503d01f6758911d458a9b9ef50e8080c;Mon Apr 11 11:14:33 EDT 2005;Committer;nagai;2;9;4;13;0
07f61642e49d48ca2551f533573832dbcfc7b486;Mon Apr 11 06:26:49 EDT 2005;Committer;usa;2;5;1;6;0
fbe5252b144d401c79d72a3281459a08c1d75c1e;Mon Apr 11 01:28:36 EDT 2005;Committer;eban;1;3;3;6;0
d7ff98037597614e1ff629fd416077271dd73f2b;Sun Apr 10 23:05:52 EDT 2005;Committer;ttate;1;1;1;2;0
53d7b3df7d108593def13abc91888c92c04298de;Sun Apr 10 05:46:55 EDT 2005;Committer;ocean;1;1;5;6;0
2d3b81755dcec7a55e4183a7d22ebd41def42ffe;Sat Apr 09 17:22:10 EDT 2005;Committer;eban;1;3;3;6;0
47bd6a4f37cb14701458233479caaaf3a25397b3;Sat Apr 09 17:03:32 EDT 2005;Committer;ser;9;98;114;212;0
ff866f0a8f99cd9ea94157e73c57200baadea15c;Sat Apr 09 16:33:26 EDT 2005;Committer;ocean;2;5;1;6;0
9e985d3e58ab381d56e8d995ce5021f28b5c3cb2;Sat Apr 09 09:27:54 EDT 2005;Committer;nagai;51;1882;27;1909;0
98d168ffc7331938a2aaaf761768de28f012dc24;Sat Apr 09 05:47:33 EDT 2005;Committer;kou;4;73;0;73;0
58f1ea99d711f94f11d8792a043a9ef8c5c74cef;Sat Apr 09 05:28:19 EDT 2005;Committer;ocean;2;7;10;17;0
458547da6add387906a00fe93bc8cdf3412e4958;Sat Apr 09 04:38:00 EDT 2005;Committer;ocean;1;2;2;4;0
e1510f334d3cd0a64e332605d12ecbbce16439aa;Sat Apr 09 04:09:09 EDT 2005;Committer;ocean;3;10;5;15;0
f965e55355ffb5bd7f474dad8a172b7d602375bc;Fri Apr 08 15:21:43 EDT 2005;Committer;eban;1;3;3;6;0
d43e5b18129e630a04f8bfbd59cbde5e461d9223;Fri Apr 08 15:08:45 EDT 2005;Committer;ocean;2;5;1;6;0
6143edbbe07b97d7359c98428525544bf45e2c71;Fri Apr 08 14:30:20 EDT 2005;Committer;ocean;2;6;1;7;0
ee0460d5a1752fd14dde13a8c275763ab3474492;Fri Apr 08 12:44:19 EDT 2005;Committer;ocean;2;12;11;23;0
06c1a64ebb88474da466caae1ddfa0e72e9da284;Fri Apr 08 11:18:17 EDT 2005;Committer;nobu;3;11;2;13;0
514abcc1014f5fda80bcb5111fcb42fc99a7ee26;Fri Apr 08 08:54:32 EDT 2005;Committer;ocean;3;41;21;62;0
10b0ee18654751f8fefad6c12e70a907e9ac5671;Fri Apr 08 03:24:15 EDT 2005;Committer;ocean;4;15;6;21;0
e82a3d23c7e26839491c87fae854771d6cf3a8af;Thu Apr 07 18:02:18 EDT 2005;Committer;ocean;2;13;4;17;0
45b5c311a70ac2044f2b276ebbba8f2fc2f753a9;Thu Apr 07 17:17:00 EDT 2005;Committer;ocean;1;1;1;2;0
2f7e67f3588da9c3a27b8e961fd1d494f4076e49;Thu Apr 07 17:02:46 EDT 2005;Committer;ocean;2;10;7;17;0
231e7ac939453e6e2daac2cc7beaaf946dbd995d;Thu Apr 07 16:53:56 EDT 2005;Committer;ocean;7;92;24;116;0
051399c46fac8cc7ed9cb5f3cc6a063ee96ea6f8;Thu Apr 07 15:23:13 EDT 2005;Committer;eban;1;3;3;6;0
69af75c28f450283ee7e3c87c217fac5447133d7;Thu Apr 07 15:21:04 EDT 2005;Committer;nobu;1;1;1;2;0
9ea857d7ee2ee9ccb8527751c27422f6dbc9a87b;Thu Apr 07 14:59:24 EDT 2005;Committer;nobu;3;31;15;46;0
138b4c427c2c8761eae0e63e01fc05768a7a9a2a;Thu Apr 07 14:55:55 EDT 2005;Committer;ocean;11;110;76;186;0
9961c29c25b54088569a7025ff80c8f7cd58a32d;Thu Apr 07 08:38:05 EDT 2005;Committer;shugo;3;60;42;102;0
d8c66e05467c70fa3ee4a0e90bfce6f42f853fde;Thu Apr 07 05:42:56 EDT 2005;Committer;kou;2;25;0;25;0
f382841107f1151351127de9276c866102489978;Thu Apr 07 03:32:02 EDT 2005;Committer;eban;1;3;3;6;0
c3410fc1e1d4085bf8f7531a9061818cfaf7b34c;Thu Apr 07 02:55:48 EDT 2005;Committer;kou;4;81;7;88;0
f1587ee5a095e12ff3a747ffceaa53be737ede96;Wed Apr 06 12:36:47 EDT 2005;Committer;mneumann;1;2;0;2;0
69bed7f7cf9ead0e39242df9685a1d48e1b5c95a;Wed Apr 06 07:48:23 EDT 2005;Committer;eban;1;3;3;6;0
17167ece8a66339c4008e773858a17a2d7d64703;Wed Apr 06 07:19:54 EDT 2005;Committer;ocean;2;14;9;23;0
5f3a36794a578eabbc67b401e818b3711051b7ad;Tue Apr 05 07:03:43 EDT 2005;Committer;kou;12;147;141;288;0
56ce2994de24b14905f0b23ec35aeb0e3b4ff563;Tue Apr 05 06:59:59 EDT 2005;Committer;eban;1;3;3;6;0
21e257b26bccacd2c6780810e5d1836924edd190;Tue Apr 05 06:52:16 EDT 2005;Committer;kou;2;42;11;53;0
d12dff187a86d0f21ad1628472cd797505ddeabe;Tue Apr 05 06:42:03 EDT 2005;Committer;kou;12;438;98;536;0
5ddcd35cf12613969b27c06cf3ca1b57ce68a3f0;Mon Apr 04 14:21:24 EDT 2005;Committer;ocean;3;22;13;35;0
1d580ecda2597a842379ac012eb80ec3361b7d10;Mon Apr 04 03:23:30 EDT 2005;Committer;eban;1;3;3;6;0
cd7d0af1c1b0f5243266aa9fc4f11be1d4cbebd4;Mon Apr 04 01:37:19 EDT 2005;Committer;ocean;6;132;129;261;0
df9cf4fc6785ce97738bde56102de4cfef6edac0;Sat Apr 02 14:39:38 EST 2005;Committer;nobu;2;8;4;12;0
b54682b7ea51556535b6bbe1733576cbc24f66b8;Sat Apr 02 13:35:02 EST 2005;Committer;nobu;4;111;63;174;0
fb707a77043f9afebf90ab1fca8c89ab841d6753;Sat Apr 02 13:30:49 EST 2005;Committer;nobu;3;17;10;27;0
2aa633b2688e96f502ffabd080adbf4df3e945bd;Sat Apr 02 08:05:08 EST 2005;Committer;eban;1;3;3;6;0
21df665098bb29493a7b5196eb8fd1c48995314c;Sat Apr 02 08:02:39 EST 2005;Committer;nagai;9;126;23;149;0
373282f6656d3d3d989d261e7a95f8e81b5c9712;Sat Apr 02 04:23:56 EST 2005;Committer;ocean;2;17;3;20;0
4f8df7dcc42119a11c568a12b3e50f01553f4e4c;Fri Apr 01 17:22:02 EST 2005;Committer;nagai;8;230;114;344;0
011527f455eab7e7be7e3fd90d0f6d801eeccfde;Fri Apr 01 07:42:37 EST 2005;Committer;nagai;2;22;2;24;0
ad755116ee051c4b9b67ef2c9cc2fb274dc6732c;Fri Apr 01 03:51:17 EST 2005;Committer;usa;1;4;4;8;0
a8123f8f7e65381e57ef20195b353db99efd3bb4;Fri Apr 01 03:48:26 EST 2005;Committer;nagai;3;2387;79;2466;0
4b7cc65b81f23a2191f53f9836074a9b686b1639;Thu Mar 31 14:55:37 EST 2005;Committer;ocean;3;15;4;19;0
0f52655b0685e67ad1b4292b52f3194870e804fa;Thu Mar 31 13:24:27 EST 2005;Committer;nobu;4;124;3;127;0
78711606b3c5e3eec4906ccc9992d7bf72cfe14e;Thu Mar 31 05:55:35 EST 2005;Committer;nagai;5;63;10;73;0
0a57886cca5ebc2743ba15ba7d1299e7a04174ec;Thu Mar 31 05:09:24 EST 2005;Committer;gotoyuzo;2;11;2;13;0
b7891928a33f7f6452f5e51858144e822e11a9cb;Thu Mar 31 02:10:18 EST 2005;Committer;kou;10;46;25;71;0
f8c33000697574d405e822b1bb04430a34784907;Thu Mar 31 02:03:05 EST 2005;Committer;kou;2;8;2;10;0
ba269b1976f75cd03551ec88266583b452d4c5dc;Wed Mar 30 23:26:00 EST 2005;Committer;nobu;2;18;6;24;0
fc3e402ddedc3b7d643ba25363b22f102e9ede3c;Wed Mar 30 21:01:04 EST 2005;Committer;gotoyuzo;2;7;1;8;0
7f6e93fd624cfe1a5078dc556c12ccf3e1ca298f;Wed Mar 30 15:43:42 EST 2005;Committer;nagai;2;9;4;13;0
59fd11fb3565a953d1820bf0a0e79bb633b3b567;Wed Mar 30 15:42:41 EST 2005;Committer;eban;1;3;3;6;0
9919ef7212caee693871d4fb5193e7068f46e33c;Wed Mar 30 15:40:29 EST 2005;Committer;ocean;1;0;1;1;0
188493e4251fc3fc5e148fb617d4d59e5483aa05;Wed Mar 30 08:58:08 EST 2005;Committer;eban;1;3;3;6;0
11974f26b347c59c4cea15f3631cc632481dd4c3;Wed Mar 30 08:44:19 EST 2005;Committer;nagai;17;588;418;1006;0
a07bc1123aeb0bd3a1548338053d44047d20b509;Tue Mar 29 13:21:59 EST 2005;Committer;seki;2;9;4;13;0
ef049291d4225bf6ba0a8a505f59bd74a3dff4c8;Tue Mar 29 10:34:40 EST 2005;Committer;eban;1;3;3;6;0
10fa84d750eced2f5c8fcfb5630d2d04e3a04cb5;Tue Mar 29 10:27:32 EST 2005;Committer;nagai;9;537;48;585;0
42959f502945d18c8ce793b1840d4140b1eb7278;Mon Mar 28 15:06:10 EST 2005;Committer;seki;3;141;33;174;0
5c47cc1f0ab1617762a7f05167a84e0ef636f4bd;Mon Mar 28 11:53:52 EST 2005;Committer;nobu;2;13;3;16;0
6a096e49add687349d8b24074de31b9a7405585b;Mon Mar 28 07:29:17 EST 2005;Committer;ocean;2;6;2;8;0
3fe1e7e89dd49a25b8de1b04964eb858ec8fdd2a;Mon Mar 28 00:16:38 EST 2005;Committer;usa;1;3;3;6;0
b2b2a3285160c3178a564e124f8cf3960c692885;Sun Mar 27 23:40:32 EST 2005;Committer;nobu;2;20;12;32;0
9d02461a6e9d85f025b920810bd5886b81b4a051;Sun Mar 27 13:37:23 EST 2005;Committer;ocean;3;0;0;0;0
71e43b51bd9440d19ebe87e0aa75161fe7b54f2b;Sun Mar 27 13:23:54 EST 2005;Committer;ocean;3;0;0;0;0
8c2e036589f7fa00adb4d1167e9363045509daeb;Sat Mar 26 16:01:57 EST 2005;Committer;eban;1;3;3;6;0
5bd2b12dae1737581edb9f53b505d6ec481adb95;Sat Mar 26 15:57:16 EST 2005;Committer;aamine;2;12;18;30;0
4dd2dd2f211de95c50dbf1201f700e096bf0fa7e;Sat Mar 26 14:11:24 EST 2005;Committer;eban;1;3;3;6;0
334325f72a08589acaeca6d9ef5171af42dfbe60;Sat Mar 26 13:58:11 EST 2005;Committer;nagai;95;5897;208;6105;0
e3c98febde12ce153bd07d29a9d7118d7ba8c58b;Fri Mar 25 02:02:54 EST 2005;Committer;eban;2;2;2;4;0
3eeeabf586a2e2c174f6e34455a1c04989d48869;Fri Mar 25 01:58:30 EST 2005;Committer;eban;1;5;0;5;0
4e0703bca84320e8ca41131f0165a4702ad77376;Fri Mar 25 01:56:03 EST 2005;Committer;eban;1;3;3;6;0
54ba9c60da108154b43175c79bf345da92a463a2;Thu Mar 24 14:14:19 EST 2005;Committer;eban;1;3;3;6;0
15df6bd4f7344f783cc3317d8033a3ba1c17a946;Thu Mar 24 14:11:27 EST 2005;Committer;nobu;2;20;6;26;0
3b6992be6712b7ec1a58f030b08ab53940db33ae;Wed Mar 23 10:09:07 EST 2005;Committer;gotoyuzo;3;20;2;22;0
28199eeae85647c68fd03682c464221be3b88dbe;Wed Mar 23 07:16:42 EST 2005;Committer;eban;1;3;3;6;0
142922368680cbd6038fc2837daf2df7e7109720;Wed Mar 23 07:15:49 EST 2005;Committer;shugo;3;12;8;20;0
93c746f8282ec59b8ac59b2ac2f884aadf3e384b;Tue Mar 22 15:43:27 EST 2005;Committer;shugo;2;116;12;128;0
59120ecccc84b3eb5060cbdf89056fa112641d6f;Sun Mar 20 13:53:19 EST 2005;Committer;nobu;1;3;3;6;0
25012d5420ae34399744379fd596c7bda249a814;Sun Mar 20 13:51:48 EST 2005;Committer;nobu;2;6;1;7;0
116b9027ea18cf3ada8361159bb892668cc9ba52;Sat Mar 19 14:50:05 EST 2005;Committer;nobu;1;3;3;6;0
f870f12334334ec3bbd0f346702da177cdce9d56;Sat Mar 19 14:48:35 EST 2005;Committer;nobu;2;10;5;15;0
58bc7420de33ca276e5ab455754d1b1798d518de;Fri Mar 18 15:43:42 EST 2005;Committer;nagai;5;1632;772;2404;0
7ffe69662b7c4a61e9487ed5801aaeb048a7161b;Fri Mar 18 03:17:31 EST 2005;Committer;eban;1;3;3;6;0
cd205708037f1adfc91efd46970a08aef7cf7e06;Fri Mar 18 03:17:27 EST 2005;Committer;eban;1;1;1;2;0
56b9f4da439078b606d87f1be53ee079b914918d;Thu Mar 17 08:56:36 EST 2005;Committer;matz;3;26;16;42;0
b547538e680a9bc8988fea059db6a637758d228c;Wed Mar 16 16:23:12 EST 2005;Committer;nagai;2;32;27;59;0
f1f87b2613b075c831b466a53f20264ec3c71464;Wed Mar 16 15:20:11 EST 2005;Committer;eban;1;3;3;6;0
c2de94e6c8f0d6fec0425fbd7351467daa705a62;Wed Mar 16 15:18:02 EST 2005;Committer;shugo;1;1;1;2;0
6697b0a7282b7439ade532e4a340c62c68d716cc;Wed Mar 16 14:47:30 EST 2005;Committer;shugo;2;15;9;24;0
9606ff514f4563969023254652a32c7c22b82d4b;Wed Mar 16 14:02:21 EST 2005;Committer;shugo;3;32;15;47;0
1aeb9b93c2446b07eb20b9ac4518014b1276911a;Wed Mar 16 13:05:46 EST 2005;Committer;shugo;5;192;35;227;0
feda16cbd48c1c60b304218e41985cd378382190;Wed Mar 16 09:25:45 EST 2005;Committer;matz;6;51;33;84;0
4007644d8378c85c0e90ddd9d29e90e3713546af;Wed Mar 16 09:12:16 EST 2005;Committer;nagai;3;257;87;344;0
ff11efeea7bf9f9c269d6710124ce7d6ee261a38;Tue Mar 15 15:43:29 EST 2005;Committer;nobu;1;16;16;32;0
d3d9bcf46025877c3562b0d963b15c57313f5341;Tue Mar 15 15:43:25 EST 2005;Committer;eban;1;3;3;6;0
739595c99e2f608c760cc1f73d954404849a9141;Tue Mar 15 15:41:41 EST 2005;Committer;nagai;1;2;2;4;0
f109834b8c9ec8af723a7c1b4343eeeacac84226;Tue Mar 15 14:53:17 EST 2005;Committer;nobu;1;6;1;7;0
52fcd892e7c7eb553fd94c124f4ba59c90b73cb5;Tue Mar 15 14:52:59 EST 2005;Committer;nobu;1;3;3;6;0
04284b7663e40098e688c15b5b206a47760588dc;Tue Mar 15 14:52:59 EST 2005;Committer;nobu;1;284;0;284;0
7881775f3b80e6c678f92773830a39d21afdc423;Tue Mar 15 14:50:08 EST 2005;Committer;nobu;2;41;43;84;0
b1d94ab54a39f91d1b6ee9f118c11b8aae9f3ff2;Tue Mar 15 14:12:53 EST 2005;Committer;nobu;2;9;4;13;0
3173befe84d53d660533905eb51f86f69a4cd6b2;Tue Mar 15 08:22:09 EST 2005;Committer;nagai;3;1522;0;1522;0
09c90d12657483a01d223a6efc256e64c9451aa3;Tue Mar 15 08:21:32 EST 2005;Committer;eban;1;3;3;6;0
17805a51d1df4d4290ef78e003a77f29b00d036f;Tue Mar 15 07:41:09 EST 2005;Committer;nagai;2;11;2;13;0
289b6bb21b4b6fca598c05c595669701d657d923;Mon Mar 14 10:42:46 EST 2005;Committer;nagai;3;89;0;89;0
e58c2dc6a8624c8f9e213e757b7a74337b82652f;Mon Mar 14 03:23:01 EST 2005;Committer;nagai;3;13;1;14;0
a00bc63ac303f0047c5ed5811dfeaeffa41dea9b;Sun Mar 13 15:21:16 EST 2005;Committer;eban;1;3;3;6;0
cde3bdf26f4fcccf15d69fd41f84403e2c1a12f4;Sun Mar 13 15:19:16 EST 2005;Committer;nagai;9;187;49;236;0
28b1db091d53824322c157120b20e52b002f7c41;Sun Mar 13 13:19:28 EST 2005;Committer;nobu;2;18;8;26;0
2bc0405d1c8cff5f7ade1fbac67667c8b5d0392f;Sun Mar 13 01:10:24 EST 2005;Committer;seki;2;4;10;14;0
7ff4c7c70a4c97b8460cb1e8b75a243cc4a9d986;Sat Mar 12 17:38:37 EST 2005;Committer;gotoyuzo;2;7;2;9;0
a59c198a12be281c21a02117fe2392cada50da62;Sat Mar 12 17:17:07 EST 2005;Committer;eban;1;3;3;6;0
0d23cc25c2bd3250c78e99bd39eb55827a89b28e;Sat Mar 12 17:15:29 EST 2005;Committer;gotoyuzo;3;12;4;16;0
726624affd1a79b7768040ad70d1b928cdbd73ab;Thu Mar 10 14:15:50 EST 2005;Committer;eban;1;3;3;6;0
d2a9e77748684e786af9525e258aee98c8ff2a8d;Thu Mar 10 10:13:30 EST 2005;Committer;nagai;35;550;292;842;0
7935361d36fdfd372002c276baede34bb39f89a2;Wed Mar 09 14:56:16 EST 2005;Committer;akr;2;19;10;29;0
827a62edd7f92e32ea2d953944401d7d647c5389;Wed Mar 09 13:57:59 EST 2005;Committer;nagai;4;8;8;16;0
55054497934bb9759aa400ef47042f33b34d0b9a;Wed Mar 09 10:45:42 EST 2005;Committer;gotoyuzo;9;304;230;534;0
f43cae2b057622e6812e370f2c7cb3efa06f6665;Wed Mar 09 09:29:52 EST 2005;Committer;matz;8;261;33;294;0
9ef561b6e09a6d5768617e20db4d985ca34260e9;Wed Mar 09 06:08:33 EST 2005;Committer;nagai;1;64;2;66;0
8e5362a66603a3ded8f2a77fd6f9a55c67952488;Wed Mar 09 05:47:21 EST 2005;Committer;eban;1;3;3;6;0
9150a8278f3fdef883e5769d9c1e4e122ca7b8b1;Wed Mar 09 04:39:25 EST 2005;Committer;nagai;2;84;27;111;0
6080121d55ca8e3dba46369d2011c3a8f47543a0;Tue Mar 08 11:31:20 EST 2005;Committer;ttate;2;37;7;44;0
215cd35df9cca5e3003106bf6a85a65a5e72d5a9;Tue Mar 08 10:50:23 EST 2005;Committer;ttate;1;1;1;2;0
6f70f54e1df721ed7b6cdc5d04b34077bfc583bb;Tue Mar 08 09:48:46 EST 2005;Committer;nagai;1;10;2;12;0
746268fa1b24eb29e6834bf21a748b907276b605;Tue Mar 08 09:19:03 EST 2005;Committer;nagai;2;469;0;469;0
6f345fb2c478f1a4aeab627a0c1b32cb90f47bde;Tue Mar 08 05:09:00 EST 2005;Committer;ocean;1;7;7;14;0
e2c31e461459a5ba838ec5b00728c3cb2ec66af8;Tue Mar 08 04:41:51 EST 2005;Committer;usa;2;8;0;8;0
1c3769c67d0fdcf8532a33e3d58cca84c7a2fc1f;Tue Mar 08 01:52:15 EST 2005;Committer;usa;2;8;3;11;0
2f2cc0ddfc8785ef5cc030159fba6b040836be13;Tue Mar 08 01:46:33 EST 2005;Committer;matz;4;27;3;30;0
2a91610f3a32fa075b77d445b87dccbc4d85bd1d;Mon Mar 07 16:25:25 EST 2005;Committer;eban;1;3;3;6;0
afb7b3e1f8fd426342a77aa4439cc0ce080c72e9;Mon Mar 07 16:22:18 EST 2005;Committer;naruse;2;7;1;8;0
813d4b5dd792342a479995d0295f4feef1b4e32a;Mon Mar 07 12:34:20 EST 2005;Committer;gotoyuzo;2;5;2;7;0
d0f6f9fb7a2045426756795366233f64fd9c6332;Mon Mar 07 12:32:07 EST 2005;Committer;gotoyuzo;2;29;12;41;0
562185ff5cc2196cb80ea71ecaecf8e7f5c79eb3;Mon Mar 07 12:01:46 EST 2005;Committer;nobu;2;9;4;13;0
39d35c11307e31434cc71f0412b6ec34c7e3ee69;Mon Mar 07 09:30:06 EST 2005;Committer;usa;1;1;1;2;0
82849c97dd42961521fce3a084cb53dfdf94c6df;Mon Mar 07 07:47:40 EST 2005;Committer;usa;2;14;3;17;0
9f19f36ed5be8025ea4a900bb93b03aa30e4a03b;Mon Mar 07 05:13:54 EST 2005;Committer;gotoyuzo;2;11;10;21;0
6645b928266cf7f8139f58b6b260e82f291d8446;Mon Mar 07 02:05:08 EST 2005;Committer;matz;8;95;42;137;0
57b3ed4cda8882429590f761f9d545eee88823a3;Sun Mar 06 16:23:47 EST 2005;Committer;nagai;2;6;57;63;0
40671c1c5d5fb6d79f55985bd0330f61b90d7502;Sun Mar 06 15:08:15 EST 2005;Committer;eban;1;3;3;6;0
9c7c117d505704f20846ee7c7f2edb7e595366dc;Sun Mar 06 15:03:02 EST 2005;Committer;nagai;2;5;0;5;0
5a4f8179fe31ca75141277f4d320bf9c9663b192;Sun Mar 06 12:20:30 EST 2005;Committer;zsombor;3;206;0;206;0
31f4cddb6971e5035658a3746749efa25dd8d246;Sun Mar 06 03:15:36 EST 2005;Committer;eban;1;3;3;6;0
22d8da0c272c1c72daf0f3055d489e66032a77aa;Sun Mar 06 03:02:52 EST 2005;Committer;akr;1;0;13;13;0
d6c5652cbdf4e21ed88c50f3b542bd676722f371;Sun Mar 06 02:56:46 EST 2005;Committer;akr;1;1;1;2;0
1b178621c2c7b11628a7640ecf134b39d5f78eba;Sun Mar 06 02:55:16 EST 2005;Committer;akr;2;122;149;271;0
25d8e7a119d3a96f8e782a87be8ba1ac557fa28d;Sun Mar 06 02:41:15 EST 2005;Committer;akr;2;14;4;18;0
771a610bfac7f44652edc39167ec476eae31bfc3;Sun Mar 06 00:50:07 EST 2005;Committer;nagai;1;65;57;122;0
a9fb0817a15469f0572cd3b8637243daecfe168e;Sat Mar 05 21:36:11 EST 2005;Committer;gotoyuzo;6;461;61;522;0
4b0f7cecc41ec1ae015eed42bd0b82538e8b9408;Sat Mar 05 09:30:24 EST 2005;Committer;ocean;3;9;11;20;0
1ff45719130e7224b07e9625963248f9c408bdd7;Sat Mar 05 07:53:14 EST 2005;Committer;naruse;2;21;7;28;0
a09556f064195cefc088d18320797598c2a99ebb;Sat Mar 05 07:46:44 EST 2005;Committer;nagai;2;6;0;6;0
854f86e8ba65bed226ae3fbb8f385f68c51a6260;Sat Mar 05 07:35:41 EST 2005;Committer;nagai;20;550;63;613;0
47839448767f922a88956a7d4a30c77c36a53304;Sat Mar 05 03:52:21 EST 2005;Committer;nobu;4;10;4;14;0
1117412bccea71a2a4b2a94db2d112cac2640a01;Fri Mar 04 17:43:29 EST 2005;Committer;usa;1;3;3;6;0
302b8ff05519b9b9387b56bf1e3fdc41834716a4;Fri Mar 04 17:42:55 EST 2005;Committer;usa;3;13;0;13;0
49af08e1887326f74cabef7b92dfd814ad7c144b;Fri Mar 04 10:40:09 EST 2005;Committer;nobu;4;239;225;464;0
0992f6c4728112c50520e7506f4e75e1cac62206;Fri Mar 04 07:15:12 EST 2005;Committer;usa;4;12;27;39;0
70bbad3cfd5a692c8e78ccf750eed3f1c7f186db;Fri Mar 04 06:47:45 EST 2005;Committer;matz;73;1312;920;2232;0
d29f9e080bc6e578df495c56c4fbee29260273d2;Fri Mar 04 00:39:04 EST 2005;Committer;usa;2;8;1;9;0
b1e84d4c94afcb33c72055018263467f0ca4dd46;Fri Mar 04 00:16:09 EST 2005;Committer;usa;1;3;3;6;0
076d6dfc8a674ac1edfac90078c5d44661d64c1b;Thu Mar 03 22:12:03 EST 2005;Committer;naruse;2;12;1;13;0
e5d5c0d8fcc309fe84fc9f3b9ad9945ef74b06fb;Thu Mar 03 14:27:17 EST 2005;Committer;naruse;2;240;137;377;0
31d9032ae2354a3eeeb1e03d886809e7cc02f50c;Thu Mar 03 09:48:30 EST 2005;Committer;eban;1;3;3;6;0
90bdc3367715550049175aec44dd6f072039f9f4;Thu Mar 03 09:47:30 EST 2005;Committer;nobu;2;6;3;9;0
4a4ff7fac1c33ab1a880010965619f0cc1d998c9;Thu Mar 03 09:44:33 EST 2005;Committer;nobu;5;53;5;58;0
a48c63f36b48bdad1cfea978b58410fc70fada7a;Thu Mar 03 09:38:40 EST 2005;Committer;nobu;6;110;20;130;0
813a901a5e01675e548a2fd3ede472f9a2572bc3;Thu Mar 03 02:52:55 EST 2005;Committer;kou;2;52;18;70;0
6f3016a9695376bc24660abbe5edf3b1c62a3816;Wed Mar 02 12:38:23 EST 2005;Committer;akr;1;1;1;2;0
b9304586665444e32ee7e1e6cdc859fc617912fe;Wed Mar 02 10:53:53 EST 2005;Committer;nobu;2;8;3;11;0
ca014268676d4924549a4da8814d8f868d9b2b2c;Wed Mar 02 08:18:06 EST 2005;Committer;nagai;2;5;1;6;0
9815949157a76bb32dd516638f0f17549a15081c;Wed Mar 02 08:11:28 EST 2005;Committer;nagai;4;60;10;70;0
3124427ccbf02a5bd20f169ad6a328286e05c262;Wed Mar 02 07:06:52 EST 2005;Committer;nagai;24;7696;707;8403;0
16771ba23c0d1adaa4c2a51d5ab8096b56a7858d;Wed Mar 02 03:23:26 EST 2005;Committer;nobu;1;3;3;6;0
6c0cc67bb22435d3c8233777258fe917f72c842a;Wed Mar 02 03:21:31 EST 2005;Committer;nobu;4;52;3;55;0
eaf373d6026c20a7b6c5e263fc9f0e8ca81d3b8c;Tue Mar 01 12:23:17 EST 2005;Committer;kosako;2;6;2;8;0
7f08f0d51126de193a9bd87804718a57e06b24fa;Mon Feb 28 15:56:10 EST 2005;Committer;eban;1;4;4;8;0
6fca4ecdd1576d61e12f99f24248f5160a1bff33;Mon Feb 28 15:41:14 EST 2005;Committer;seki;3;54;17;71;0
8687b8ffe8d3454b9a03b4b16916e1b555bf4f59;Mon Feb 28 14:18:41 EST 2005;Committer;ocean;3;16;7;23;0
f4900ea772c7dff3c6cf3b0f9c38315681e7d4fe;Mon Feb 28 13:04:28 EST 2005;Committer;kosako;2;14;13;27;0
4200ee6e69b41ecc508f9cf68db506ec74058d50;Mon Feb 28 06:42:12 EST 2005;Committer;eban;1;3;3;6;0
845cfb281bbd5e6a9b597cc9a0b291c02ad9a8ce;Mon Feb 28 06:29:52 EST 2005;Committer;ocean;4;279;450;729;0
ff5186ea4e97ad142e982c90ebe716188fb9b9b7;Sun Feb 27 04:14:59 EST 2005;Committer;eban;1;3;3;6;0
1f5721d854f939a7fb112233bdd7c7df34327176;Sat Feb 26 21:08:24 EST 2005;Committer;aamine;2;10;6;16;0
ae55e1429f80b1be0de74d34d9786e9ffebd067f;Sat Feb 26 10:56:00 EST 2005;Committer;kosako;1;3;3;6;0
41d96dbd357ac485b3e79d29328170fa069f55d7;Sat Feb 26 08:05:06 EST 2005;Committer;kosako;7;31;134;165;0
2499da40f9a899969532998d0df1d4fe4ea5ab26;Wed Feb 23 13:10:45 EST 2005;Committer;ksaito;3;14;9;23;0
be587c77ef27f30112bb64459f1da83c0ad1deaa;Wed Feb 23 12:47:23 EST 2005;Committer;ksaito;8;214;172;386;0
f052429aa5a7ba0dfb41e5704ea3de4c970c97da;Wed Feb 23 12:41:49 EST 2005;Committer;ksaito;6;106;94;200;0
c36a0f0ec0a77c47f5378118913250ea983266c2;Wed Feb 23 06:08:29 EST 2005;Committer;akira;3;22;9;31;0
de26996f0aad3346498a93df8b8c97a78d7eff0d;Tue Feb 22 22:34:15 EST 2005;Committer;nobu;1;3;3;6;0
ec2e637cb4539bfa735303d6f39728aa7158df02;Tue Feb 22 16:55:31 EST 2005;Committer;shugo;2;11;5;16;0
6b68105ab26cce76c2f2e3dd876e2551715f4570;Tue Feb 22 15:39:40 EST 2005;Committer;kou;2;6;2;8;0
9001cbdfadbc8d797dbca764211775e098bb9068;Tue Feb 22 14:57:43 EST 2005;Committer;nobu;2;18;7;25;0
984f9a0df167c8f68832388b10c0d395a099d7a9;Tue Feb 22 14:52:59 EST 2005;Committer;nobu;7;72;20;92;0
21189400d60904d34ba756839c9129a731709c3c;Tue Feb 22 14:51:53 EST 2005;Committer;nobu;2;6;0;6;0
6f6b9a9b54fe87cc85fc548c339e3a48b476f04a;Tue Feb 22 14:50:33 EST 2005;Committer;nobu;2;17;2;19;0
6b80542ead851d85235b7718f99894d57b4fa1d4;Tue Feb 22 09:15:30 EST 2005;Committer;akr;1;1;1;2;0
b6bd8677f70b79aa079144dc8702040dfc5c977d;Tue Feb 22 03:54:43 EST 2005;Committer;eban;1;3;3;6;0
8c18a183c9eea6bbb4ae9255d835c8f7f9011f5e;Mon Feb 21 22:25:28 EST 2005;Committer;nobu;2;11;6;17;0
7e70ac99dee1fc4d5988cc8f3e05480ab6d8fd8c;Mon Feb 21 09:33:34 EST 2005;Committer;nagai;3;97;4;101;0
cc1e41d9bf82090c9f22c6cebc07a19789d023b4;Sat Feb 19 16:06:29 EST 2005;Committer;eban;1;3;3;6;0
b36f9a090d68687b66ea32193c5948291e2d4602;Sat Feb 19 15:53:43 EST 2005;Committer;akr;2;39;4;43;0
5c293c10e105a9a9e2a1515e362a937d15a18474;Sat Feb 19 10:00:33 EST 2005;Committer;seki;3;14;2;16;0
614b7a2d32da5a82843af3c3459d317899ae1950;Sat Feb 19 04:55:16 EST 2005;Committer;akr;2;11;1;12;0
74240f58c34c3f34e6028c6cf3810544023f1d2e;Sat Feb 19 04:31:36 EST 2005;Committer;nobu;2;6;1;7;0
04f8cbbe78a67d1762fb715c1d7ea2b7c212560d;Sat Feb 19 02:22:57 EST 2005;Committer;nobu;1;3;3;6;0
9648e68d88236f844ad927a636793ff7b73b9fa6;Sat Feb 19 01:43:58 EST 2005;Committer;nobu;3;43;24;67;0
c1ed63a4c4044fcf1c59fc3788bab233371f1e76;Fri Feb 18 17:31:14 EST 2005;Committer;ocean;4;10;42;52;0
64fbfe54fb3cea4f2fea23e00f6df17b0363b15f;Fri Feb 18 16:46:09 EST 2005;Committer;ocean;1;1;1;2;0
ce5140ad2ab2bb35a5d4fd98881f12b0ccf3c99e;Fri Feb 18 16:42:43 EST 2005;Committer;ocean;3;9;3;12;0
1034d1407e433b3fa7fe163c87e0b81e9b3f5787;Thu Feb 17 14:43:38 EST 2005;Committer;kosako;7;124;359;483;0
02b8414d98c0cc66b7b3870c26a59dd8c5600cf4;Thu Feb 17 14:29:20 EST 2005;Committer;nobu;2;8;1;9;0
52dca163848ad38fd2c078e4099d657b2670f591;Thu Feb 17 11:16:57 EST 2005;Committer;ocean;3;91;60;151;0
f2d29b01cb8d47b9689af62ec4d67059277580d9;Thu Feb 17 04:50:49 EST 2005;Committer;ntalbott;5;29;12;41;0
966332ebed8ae32009e7f54ffcfe6bbaada8080a;Thu Feb 17 00:01:11 EST 2005;Committer;akr;1;5;5;10;0
580b57cbf926c34c5de83d0b722ed79e478d468a;Wed Feb 16 15:34:59 EST 2005;Committer;eban;1;3;3;6;0
8fd62dccb239887cf889e6ac1ef19c6c5c646efb;Wed Feb 16 15:30:52 EST 2005;Committer;seki;3;10;3;13;0
482abfc851b86fa70482e70c828c56453677c58f;Wed Feb 16 14:58:25 EST 2005;Committer;nobu;1;1;2;3;0
1fdf66ad676cdeebf0b9a2e24d828c8643475ee0;Wed Feb 16 14:54:22 EST 2005;Committer;nobu;2;6;1;7;0
2048950e16974f14159f9945fa8be576b6022b2a;Wed Feb 16 06:14:25 EST 2005;Committer;gotoyuzo;2;7;1;8;0
ee51586edaf1b1c2d1035c880d8818e444ea41d6;Wed Feb 16 00:45:27 EST 2005;Committer;usa;1;3;3;6;0
a579d8bf6818cd979efc441f9bcec849b2d37b3e;Tue Feb 15 17:50:47 EST 2005;Committer;gotoyuzo;4;31;2;33;0
e65affb360af11decb81be8b19dde7fc25ff9672;Mon Feb 14 15:01:05 EST 2005;Committer;kou;2;7;1;8;0
1883e41c1b5f2f8d087cb63ba9efe47cdc450972;Mon Feb 14 04:14:39 EST 2005;Committer;gotoyuzo;3;80;0;80;0
610131d7b9044857ba552eceec4884772be7ecff;Sun Feb 13 15:37:31 EST 2005;Committer;eban;1;3;3;6;0
2681be1eed16ad862b3dd2d1a317e154b80f1148;Sun Feb 13 15:13:54 EST 2005;Committer;seki;5;65;9;74;0
1a22e46d60bd43bd19a089bd52fe4ee36518fe2c;Sun Feb 13 14:21:21 EST 2005;Committer;kou;7;26;0;26;0
8b8973761ceb969c5ff95adab132b26f2c045eea;Sun Feb 13 14:12:55 EST 2005;Committer;nobu;2;6;2;8;0
9c560ca864c7cfb2d7d78fea6b2970cb7fefab8f;Sun Feb 13 08:00:35 EST 2005;Committer;gotoyuzo;2;9;1;10;0
08e340fb75e05da908154e5ae97d6618849a73b4;Sun Feb 13 03:57:37 EST 2005;Committer;eban;1;3;3;6;0
ad24e235482e7733a1948b8a761f4ce7ae34c74d;Sun Feb 13 02:58:58 EST 2005;Committer;ksaito;2;7;2;9;0
7049aeb893d9bc9b7205e2f70581760cb54091ab;Sun Feb 13 01:54:52 EST 2005;Committer;ksaito;4;43;7;50;0
2e3d3bb91681a9f916f862a05ebc9736a15e3dda;Sun Feb 13 01:39:06 EST 2005;Committer;ksaito;1;8;0;8;0
d1d0c52a1ee0a9fbdb2472027cfa82c3da0ca0a8;Sat Feb 12 16:34:45 EST 2005;Committer;seki;2;8;0;8;0
a46bb48bcb62a4171194d5b21bdf6b34e2b5952a;Sat Feb 12 13:17:18 EST 2005;Committer;nobu;2;220;32;252;0
4c1d7f6d8ff3744be0ac79148f59578aa9d2d39f;Sat Feb 12 08:40:23 EST 2005;Committer;akr;2;12;1;13;0
4413bd95c674202365316622fc7abf38bb264efc;Sat Feb 12 06:07:47 EST 2005;Committer;nobu;2;6;2;8;0
1aacb7a948a593db7b2584198318eb0aba3b3712;Sat Feb 12 05:45:27 EST 2005;Committer;eban;1;3;3;6;0
f1bd353b58411c3a24e428076c0aa671d46b2303;Sat Feb 12 05:38:44 EST 2005;Committer;akr;1;9;8;17;0
203b7c50f2ff251feb184b941424f5ac2c19b573;Sat Feb 12 05:12:56 EST 2005;Committer;akr;2;8;0;8;0
c34e899e4f189fb7b76b5dcb095573bad7685306;Sat Feb 12 05:01:18 EST 2005;Committer;akr;2;88;72;160;0
ac0478b274b7b55d1515aa1fd099be02ee76fdbf;Fri Feb 11 09:36:21 EST 2005;Committer;eban;1;3;3;6;0
6bfc1f3900b20164d6ff35ab01c5ff03c7457143;Fri Feb 11 08:42:57 EST 2005;Committer;gotoyuzo;2;17;0;17;0
db6d5b15be94735ef08ba844561f9ef9f320ae19;Fri Feb 11 02:47:11 EST 2005;Committer;akr;2;22;2;24;0
6ef3fe63497fb57a1550517d441d712d6300e5df;Thu Feb 10 12:18:16 EST 2005;Committer;nobu;1;1;1;2;0
a32bc08d36360adf59806908ebe790ff03f689a2;Thu Feb 10 04:55:34 EST 2005;Committer;usa;6;22;20;42;0
0de28773260c8c47dec6a39711765c27acc646de;Thu Feb 10 03:58:50 EST 2005;Committer;usa;1;1;1;2;0
bd1541667c663cbedceebb89acb91d006d0f7503;Thu Feb 10 03:24:03 EST 2005;Committer;nobu;1;3;3;6;0
0bb45af1031aab51b05fecd4dff00b9f42359a81;Thu Feb 10 03:09:27 EST 2005;Committer;nobu;2;13;6;19;0
80f43309730056cffbf29fd4e11a24643900f55e;Thu Feb 10 03:07:24 EST 2005;Committer;nobu;5;40;5;45;0
6400a671b8775096f3c312cf04e413c3307b2edb;Thu Feb 10 03:06:43 EST 2005;Committer;nobu;2;26;0;26;0
8c5bd041b6ddca4a6b403624bedc5554f3474cbd;Wed Feb 09 09:42:40 EST 2005;Committer;ttate;2;4;4;8;0
816fa8d14d416d1a767a0fc762c48f215a8af4ed;Wed Feb 09 07:34:56 EST 2005;Committer;usa;2;8;1;9;0
bc983c9f3e06e8602d452d699c76da93a6ec4087;Wed Feb 09 05:49:31 EST 2005;Committer;usa;2;5;1;6;0
ce74e5836695a0908c22dbd4caf9005589326b5e;Wed Feb 09 01:04:43 EST 2005;Committer;usa;1;3;3;6;0
b0a71179ea80ec54153bd0c6896a6627f053e313;Wed Feb 09 01:03:41 EST 2005;Committer;usa;4;10;45;55;0
3d7177422d1c67632a4590abd1e1ad7449462d84;Tue Feb 08 14:51:06 EST 2005;Committer;seki;2;6;1;7;0
2c685f16816c0f33afa2665b6f21e7e3a884df28;Tue Feb 08 14:05:06 EST 2005;Committer;akr;1;1;1;2;0
891c4aa199bb1d815afa6add6d7ab653f9cc964f;Tue Feb 08 13:39:47 EST 2005;Committer;nobu;4;40;50;90;0
c1f29da23d4f9e31f81a7d37ce9f36394ee903c4;Tue Feb 08 09:18:16 EST 2005;Committer;ttate;3;19;36;55;0
84075c004b53559e7f096f1053e70fe232ce6128;Tue Feb 08 03:06:37 EST 2005;Committer;akr;1;53;47;100;0
3977dbc57674bc2aab0beb33b84195c23e1d6a04;Mon Feb 07 23:08:26 EST 2005;Committer;ttate;2;13;13;26;0
c47ca1f02f514ecf765877414bfacceb1402d011;Mon Feb 07 16:11:14 EST 2005;Committer;akr;1;7;0;7;0
501a409e5ef4fcc5b6d39cbc6425cade1d6a8bed;Mon Feb 07 15:47:05 EST 2005;Committer;eban;1;3;3;6;0
9bdb4b4b0817151ba4ee98d857ac50d6b841b51a;Mon Feb 07 15:24:09 EST 2005;Committer;akr;2;37;0;37;0
b8f04a8bcba7a059d1ccd95f4ba5dfb01e8e2c67;Mon Feb 07 14:40:22 EST 2005;Committer;akr;1;7;2;9;0
d486686eb768619714328bff86be8e7711c2e967;Mon Feb 07 14:18:41 EST 2005;Committer;akr;3;15;7;22;0
f605a6fcb788af156d79339d2a0b140ddac8846e;Mon Feb 07 12:13:46 EST 2005;Committer;ttate;1;1;1;2;0
7bcc13550437e1c4198fbf6212abc8e7672e1adb;Mon Feb 07 09:45:02 EST 2005;Committer;ttate;5;98;45;143;0
48a86f5ffafb2744fac609714fee74f1872df84b;Mon Feb 07 04:00:58 EST 2005;Committer;eban;1;2;2;4;0
dca41072d39248093c84fb29c823c9b06a30724c;Sun Feb 06 18:07:10 EST 2005;Committer;ttate;4;18;8;26;0
1f0125e4aafceca63b4ce353dbb58e66c1052bd8;Sun Feb 06 17:12:31 EST 2005;Committer;usa;2;10;2;12;0
765c659f759d655247f25c7474dc5d47618c9756;Sun Feb 06 16:23:25 EST 2005;Committer;nobu;1;3;3;6;0
ef8f1ff3dffa4392c4663a56d528ba06d0fd859b;Sun Feb 06 16:23:03 EST 2005;Committer;nobu;2;10;7;17;0
7a07ffe479d8a791ebfc5e57268f15993b622741;Sun Feb 06 14:51:44 EST 2005;Committer;nobu;5;301;309;610;0
983de47edc0aeaa08846f9c29f1d58323cff6a9a;Sun Feb 06 10:21:48 EST 2005;Committer;usa;2;6;1;7;0
93711e5bd35203e6622f89fe72b38b13478b9313;Sun Feb 06 06:54:12 EST 2005;Committer;ttate;3;50;0;50;0
b393a2bc5fe07abef59656a6358f7ee7113bbe8b;Sun Feb 06 05:05:18 EST 2005;Committer;tadf;3;47;9;56;0
a9639c22ef3588882cd2554dba419063f72c921b;Sun Feb 06 02:32:40 EST 2005;Committer;akr;2;8;3;11;0
c4e6638ce0e2489fd0ad4830321858387e354233;Sat Feb 05 20:22:43 EST 2005;Committer;usa;1;3;3;6;0
8971dafa8d4698b3c45efff63a4ed129e8ad284c;Sat Feb 05 18:31:20 EST 2005;Committer;akr;2;34;6;40;0
7adb25643e0301042218df648cc5f175fa44c2ea;Sat Feb 05 14:13:47 EST 2005;Committer;akr;1;2;2;4;0
1731084302c2eb310dd4ec2c062e86ed2bcc0b9b;Fri Feb 04 17:33:39 EST 2005;Committer;eban;1;3;3;6;0
828c5ec400ccac53fec11f6d00e9ac6edec65685;Fri Feb 04 17:25:09 EST 2005;Committer;aamine;2;13;9;22;0
41cd3d868de66ff407dd6f3c9a4126ac1692575f;Fri Feb 04 14:01:22 EST 2005;Committer;ttate;6;733;0;733;0
bda37095ca990568069aaf07dc6b3fa8ceebc327;Fri Feb 04 13:35:37 EST 2005;Committer;ttate;17;2555;0;2555;0
4ae9132605dc7b0297bcda408ca7a2ad7de39d2f;Fri Feb 04 13:29:49 EST 2005;Committer;ttate;30;0;6260;6260;0
889ca023e33ae35c259d02912187ac31be4f5362;Fri Feb 04 09:46:18 EST 2005;Committer;aamine;2;13;4;17;0
6a24d7ed9b5cbe0d7caa74869aa83cd8a412394d;Fri Feb 04 05:33:53 EST 2005;Committer;aamine;2;9;4;13;0
73a9963ddffe4108b67918df7647a1f05914a2f9;Thu Feb 03 15:31:57 EST 2005;Committer;kou;13;626;9;635;0
58d0a3de500e1896a843a11dc398d3824298dc85;Thu Feb 03 15:29:49 EST 2005;Committer;eban;1;3;3;6;0
0a1cd99af2b121855f8d7231f5bbebd5ece4551e;Thu Feb 03 14:43:07 EST 2005;Committer;nobu;2;41;30;71;0
e849cce8a00b70141ad10fbd0e1e2f549767fda7;Thu Feb 03 14:38:31 EST 2005;Committer;ttate;1;2;2;4;0
f281abc9d11c1a4dfef72090e1b6a3aae3bb2bc5;Thu Feb 03 00:36:35 EST 2005;Committer;usa;1;3;3;6;0
0535b8dd08cfb4ff29f8a0785f3433c0021e8048;Wed Feb 02 18:39:44 EST 2005;Committer;naruse;1;8;0;8;0
621f6c0b6ff3810ae6b214bf1e7c94cc73fd8b78;Wed Feb 02 18:36:51 EST 2005;Committer;naruse;1;4213;2240;6453;0
c298b3fe143c62ecc0997f16a33f95833aa4d966;Wed Feb 02 18:36:18 EST 2005;Committer;naruse;1;3;0;3;0
cf84cf931a640a322582a9e2d340ba3f3c8f9b24;Wed Feb 02 18:31:20 EST 2005;Committer;naruse;1;313;48;361;0
729249159e34d20c8c9bf7529ef645fa8ca9de79;Wed Feb 02 14:53:36 EST 2005;Committer;nobu;2;12;3;15;0
9b6581dc4771a77195a2f294ce89d249fc819733;Wed Feb 02 13:02:34 EST 2005;Committer;kou;1;2;0;2;0
bd4fd26fda94d3a0d75a130a025ea5b7b85a4f55;Wed Feb 02 13:00:31 EST 2005;Committer;kou;6;86;66;152;0
ab2b03033ad19b0c936cff6387700e46c3fac0be;Wed Feb 02 01:41:36 EST 2005;Committer;eban;1;3;3;6;0
dee374059771bf9d7e9551c906414b446c719b4a;Tue Feb 01 18:32:40 EST 2005;Committer;aamine;5;248;65;313;0
2388b9c79bfd5879da9fd895e7636f8f39a2d2a3;Tue Feb 01 12:57:03 EST 2005;Committer;seki;2;16;1;17;0
81c44c9d3c7ad9138709467745bea160e8efbc36;Mon Jan 31 15:37:51 EST 2005;Committer;eban;1;4;4;8;0
ac3499a0fa7f986628a65a299f8690bf0f96a3f0;Mon Jan 31 15:20:59 EST 2005;Committer;nobu;2;6;5;11;0
420a708098527c816ab0437f58e111ecae9c2211;Mon Jan 31 15:19:27 EST 2005;Committer;nobu;5;19;5;24;0
a1f5d730fd1ac4187ceeba048d886ab1343cb6ef;Mon Jan 31 07:01:38 EST 2005;Committer;usa;1;3;3;6;0
dbe83e69d8e05ba1f82f68102da0eb7bd6136761;Mon Jan 31 04:17:23 EST 2005;Committer;nagai;9;1460;1435;2895;0
75b202c933760176519ac1ed9f1e04e5dacb0b52;Mon Jan 31 04:14:50 EST 2005;Committer;nagai;5;122;69;191;0
02d0c9e75c54d8187e6570be13fa768e098b6e9c;Sat Jan 29 05:22:35 EST 2005;Committer;akr;1;4;4;8;0
a0b39cf64f05c4864e63310a9a1364b02dc31b93;Sat Jan 29 05:14:11 EST 2005;Committer;akr;2;63;0;63;0
962af989ec513944b558a2b52c1e5e0d967d6feb;Fri Jan 28 15:31:55 EST 2005;Committer;eban;1;3;3;6;0
a19d6b33d7419ed3724ee6646fa9303d9542b5e5;Fri Jan 28 15:21:48 EST 2005;Committer;ksaito;12;4237;446;4683;0
7d765e5203d8c909c1956276ead32b1f3d8c351f;Fri Jan 28 15:02:36 EST 2005;Committer;ksaito;8;22;28;50;0
6da8e73567a8c8c237c9fa1bd8fd509b605b40f2;Fri Jan 28 15:02:34 EST 2005;Committer;ksaito;1;8;0;8;0
4c9e47c749809749da8468ff91cab8abd8bf7d41;Fri Jan 28 10:04:28 EST 2005;Committer;eban;1;3;3;6;0
68f5e2361a81493297869d5a06aae8841dcefd49;Fri Jan 28 08:18:59 EST 2005;Committer;akr;2;19;0;19;0
ba492a05a5e3a47f1daa3659b3d88de4223f84f3;Thu Jan 27 08:16:11 EST 2005;Committer;usa;2;7;2;9;0
6c6dbbe011589c4043d3e083071060c35428909c;Wed Jan 26 15:17:57 EST 2005;Committer;eban;1;3;3;6;0
ad5830c4d07d25b4be90b07ea5003f00bb459ffb;Wed Jan 26 15:13:03 EST 2005;Committer;aamine;2;7;2;9;0
2d042f539b2a281b203875e890e9cf92b199cf7f;Wed Jan 26 15:05:42 EST 2005;Committer;aamine;1;0;1;1;0
19b9567c8421eee4755701763ef00f4c9f7ffe41;Wed Jan 26 15:03:37 EST 2005;Committer;aamine;3;22;13;35;0
4b62150e0be909f703746abfb5b87d6ffae899b9;Wed Jan 26 05:15:02 EST 2005;Committer;usa;7;10;12;22;0
e7d56fde5f0a55cc7d0da6196626f90e70cadc1a;Wed Jan 26 03:49:26 EST 2005;Committer;usa;2;26;12;38;0
d635cd73a5ace8cca7524be84f7d27179e29e16c;Wed Jan 26 01:53:38 EST 2005;Committer;usa;1;3;3;6;0
66d39f93b40b9af5b4eb626cd65df904cba0f8bc;Wed Jan 26 01:51:06 EST 2005;Committer;usa;2;7;0;7;0
4116b8b0f5e04347782dfbce5b1ee35134e2a31a;Tue Jan 25 14:31:45 EST 2005;Committer;nagai;46;9992;9918;19910;0
5ff5e1c91d436e44b6ecd2a8c74c191252af2ed6;Tue Jan 25 08:10:33 EST 2005;Committer;usa;2;7;2;9;0
17e40d68e09563188e7edc49a24c55b853e61d11;Tue Jan 25 05:42:49 EST 2005;Committer;nagai;3;72;67;139;0
ead5e7c7f744ee0f7e3b35f1c2b2f966b5f75346;Tue Jan 25 05:29:30 EST 2005;Committer;ocean;1;3;3;6;0
10484e5c95d649554fc353012626c3696edd2eac;Tue Jan 25 05:09:22 EST 2005;Committer;nagai;31;639;105;744;0
586d308ecf23a88d18413bd2ce9d1373e556c34f;Tue Jan 25 04:03:02 EST 2005;Committer;akr;1;10;11;21;0
66739f720d095b3ad7659666d905255f7e2057bb;Mon Jan 24 11:43:12 EST 2005;Committer;akr;1;13;5;18;0
0a310d08da7d721a9912c0bd3b6ca5547d2a0c9e;Mon Jan 24 07:53:52 EST 2005;Committer;eban;1;3;3;6;0
50700c367bdb6929bb4dc449dad27102e38cd13e;Mon Jan 24 07:12:45 EST 2005;Committer;naruse;1;5;0;5;0
3eac37990667658f90329619743dfad429b54bd5;Mon Jan 24 07:10:44 EST 2005;Committer;naruse;1;1;1;2;0
c52611a3203bb0b6a8e4ee4270c355f4fd1def49;Sun Jan 23 04:33:14 EST 2005;Committer;eban;1;3;3;6;0
69026d2f7335b81f958f33552fa610eaf3be370e;Sun Jan 23 03:42:36 EST 2005;Committer;nahi;2;15;0;15;0
8d8c9f6cd1d1b501f76250aa8e2e335d7018c9ca;Sat Jan 22 20:28:02 EST 2005;Committer;gotoyuzo;2;6;1;7;0
4f61ea58647e203a79eefd48e55e8d1143425049;Sat Jan 22 14:18:23 EST 2005;Committer;eban;1;3;3;6;0
0805616b06da98448c8810272ac542939670a223;Sat Jan 22 14:10:36 EST 2005;Committer;seki;2;9;0;9;0
b0b6e67394926bc6346184cf52767476859699b8;Sat Jan 22 13:37:37 EST 2005;Committer;seki;2;5;0;5;0
78f31c7be6ceb0b64309cd6162aaf23d9511d776;Fri Jan 21 11:11:44 EST 2005;Committer;akr;2;6;3;9;0
e073692159aa4dca9df96bef6755b8cc238b46da;Fri Jan 21 08:25:44 EST 2005;Committer;shugo;1;1;1;2;0
90ad5e369977eb45ecbe13c2411d0caf2540f1d5;Fri Jan 21 08:15:56 EST 2005;Committer;shugo;3;24;121;145;0
d3125e3e43d39d847c766f0f56e6a1e9501694ea;Fri Jan 21 05:02:16 EST 2005;Committer;shugo;2;5;1;6;0
93ea81670a04f3f525b4fc65ff749fcfbf8bf8ff;Thu Jan 20 15:42:44 EST 2005;Committer;eban;1;3;3;6;0
38e0c89c35a4b359b53973d96f499f073676c9b0;Thu Jan 20 15:39:22 EST 2005;Committer;ocean;2;7;2;9;0
d85815fbca1efe4d00fe33bfc916895f884bf52f;Wed Jan 19 09:14:42 EST 2005;Committer;usa;1;1;0;1;0
2512210f8e7f69248cb048f419ec06ec33aa66af;Wed Jan 19 09:05:50 EST 2005;Committer;usa;2;9;1;10;0
30b6cf55302848d98c7cf099d1e85543a60b54e9;Tue Jan 18 16:32:19 EST 2005;Committer;eban;1;3;3;6;0
01c6a1f8ff91d25318742ee09ce620e2142088d1;Tue Jan 18 16:29:23 EST 2005;Committer;akr;2;8;0;8;0
0cf40469d84d2d7a61df8e55f8a31dbbf8f512c3;Mon Jan 17 14:34:09 EST 2005;Committer;nobu;2;5;1;6;0
4d2f38b7778cd51cdf1e877d61dbb1ad2b028557;Sun Jan 16 22:09:29 EST 2005;Committer;nobu;7;39;24;63;0
e84ce31a9e6e82bc1980ac34eb2b8f246caf77c0;Sun Jan 16 15:25:44 EST 2005;Committer;eban;1;1;1;2;0
d8f43c5084f96c3711a09ce839daa0c6c9b54b6a;Sun Jan 16 15:12:19 EST 2005;Committer;eban;1;3;3;6;0
e17432809713f72db574e6252e0569377278031d;Sun Jan 16 15:12:02 EST 2005;Committer;eban;2;5;1;6;0
74252bf1354211954f7263c281470063d3d8f9f8;Sat Jan 15 05:59:19 EST 2005;Committer;nobu;1;3;3;6;0
378f74227ea752dbfcf58a4a45782979589c9a13;Sat Jan 15 05:58:02 EST 2005;Committer;nobu;2;19;3;22;0
e1e5eda547ef256076d0c6276af4284cfd8081fd;Sat Jan 15 04:46:20 EST 2005;Committer;kou;5;114;50;164;0
c853ea40c336098f3fec97b25efab0d62148ec73;Tue Jan 11 15:38:35 EST 2005;Committer;nobu;1;3;3;6;0
b4114b4dc783fb53812334136cc4c3890715c6c3;Tue Jan 11 15:36:52 EST 2005;Committer;nobu;2;8;0;8;0
54198fca16edef9ec2828edad7b9dd82693d19c8;Tue Jan 11 11:59:00 EST 2005;Committer;nobu;2;12;3;15;0
0be6a1f5c873e6e2074ebbe47ca83863890ecceb;Tue Jan 11 00:50:15 EST 2005;Committer;usa;1;3;3;6;0
ff57fbf2a69dbd8af929e747d0f7262803b78b1d;Tue Jan 11 00:46:35 EST 2005;Committer;ocean;2;8;0;8;0
60e9c4e62ae0ae46671789c97decf7be7d2af7f7;Mon Jan 10 14:07:53 EST 2005;Committer;nobu;2;6;0;6;0
083475a1f3a683bc9378c19555fe0cde99d60bc6;Mon Jan 10 07:58:55 EST 2005;Committer;gotoyuzo;1;4;1;5;0
3a1ee90cbe0161629b123eb5d0ea0ffab8840380;Mon Jan 10 07:30:32 EST 2005;Committer;eban;1;3;3;6;0
a9a02401a849958b5d654cf60d4cda927c7e33b4;Mon Jan 10 06:29:58 EST 2005;Committer;gotoyuzo;7;100;6;106;0
c744d6f62dcb536e58ded4a79eec1987880bc23c;Sun Jan 09 05:12:29 EST 2005;Committer;nobu;2;9;5;14;0
7011bf152338c065f653996af7f2513f8f64de6b;Sat Jan 08 19:09:12 EST 2005;Committer;gotoyuzo;2;5;2;7;0
1630a8294aad6b65f297195a7fadf0b3e15d5151;Sat Jan 08 18:24:54 EST 2005;Committer;eban;1;3;3;6;0
b2625d914e0b003495f6dd9a06a7c69d063e589c;Sat Jan 08 18:23:24 EST 2005;Committer;aamine;2;7;2;9;0
16b5ba2707a711be7a7e0cbb5f8dc1b4f4f41c13;Sat Jan 08 18:18:36 EST 2005;Committer;akr;2;8;6;14;0
563a79c756cc0d0594929badc2c45bf9c13dfc98;Sat Jan 08 07:40:41 EST 2005;Committer;akr;1;1;1;2;0
39f2da68962916ff21fa3aa6c3f585b63e3fb6c7;Sat Jan 08 05:08:12 EST 2005;Committer;eban;1;3;3;6;0
b237383984e1797682c23d702b51588df1337df1;Fri Jan 07 19:38:21 EST 2005;Committer;why;2;6;1;7;0
8d03779d75331a3bbcdd4c11cf81780d850d5d3e;Fri Jan 07 14:04:53 EST 2005;Committer;akr;1;1;0;1;0
ea06d92507abd09c03ad79c77c8a2edc86f5cce6;Fri Jan 07 14:04:30 EST 2005;Committer;akr;2;6;2;8;0
36c839f233cf77d4992bedc2a26f35b5529eb389;Fri Jan 07 11:05:22 EST 2005;Committer;gotoyuzo;14;895;34;929;0
fe1019c6659b5f628c751d289e73456e1da2313f;Fri Jan 07 09:25:33 EST 2005;Committer;nobu;1;3;3;6;0
db4cb5545b0d56dd022e07bf45a4bdfc84ea69ed;Fri Jan 07 09:08:19 EST 2005;Committer;akr;2;9;2;11;0
d35f41076143f440e59a2d99aca16f88ac75cb67;Thu Jan 06 11:29:58 EST 2005;Committer;usa;2;5;1;6;0
753f4e97a272d1d0ea9a38425266539815b6dd96;Thu Jan 06 11:19:38 EST 2005;Committer;ocean;1;1;0;1;0
160bfa5befa7de9a8675afe4efb05882e5020301;Thu Jan 06 11:05:31 EST 2005;Committer;ocean;2;22;1;23;0
8531657741a5d8fb3443ccfe54f62d551dfa0aca;Thu Jan 06 08:24:04 EST 2005;Committer;ocean;2;9;1;10;0
a12ac9b17de142cecd8672fc1107c4c5fdcc406d;Thu Jan 06 04:48:31 EST 2005;Committer;akr;2;32;4;36;0
2c32f0f918ab3959dbe1c5644edb7a4723699834;Wed Jan 05 23:02:50 EST 2005;Committer;dave;2;6;1;7;0
e5c787463e6a07fb650b34be06966899d3177a77;Wed Jan 05 15:08:54 EST 2005;Committer;eban;1;3;3;6;0
1125ba5fd405741060e04a8c323ffc948df1c33f;Wed Jan 05 15:03:04 EST 2005;Committer;seki;2;126;7;133;0
8728b3fde4a6ffdfd77462193680565fea5d5b34;Wed Jan 05 11:31:41 EST 2005;Committer;akr;2;26;15;41;0
09736c1621ad5cb67ac1b4b21ce2ea6f3761539b;Wed Jan 05 08:00:50 EST 2005;Committer;ocean;4;16;2;18;0
5e51e94304a30446108752829639247da23873ca;Wed Jan 05 03:50:04 EST 2005;Committer;nobu;2;20;4;24;0
3be3c95ca0611e906c2aa5a23f067c646fa044a1;Tue Jan 04 17:48:00 EST 2005;Committer;eban;1;3;3;6;0
943e67ef97de210495426bc79718942698cb2768;Tue Jan 04 17:38:39 EST 2005;Committer;akr;3;353;37;390;0
e8bab0762a594b577bc4328aa38043759eb4eb7b;Tue Jan 04 12:35:09 EST 2005;Committer;eban;1;3;3;6;0
940aa83194eca6a88c82286e04fe216685e3c6ac;Tue Jan 04 12:25:45 EST 2005;Committer;seki;4;8;26;34;0
1b27958bfb62041721d010c42ee6670bcdd76341;Mon Jan 03 05:13:18 EST 2005;Committer;akr;2;20;3;23;0
f0041381daa8554597cfc9b98e443bd92615be07;Mon Jan 03 02:55:45 EST 2005;Committer;nobu;1;3;3;6;0
e5abd52ab205ffa58f5756342df5b8fa91c02def;Mon Jan 03 02:41:03 EST 2005;Committer;akr;2;24;1;25;0
5ef141e3e93376827be8af1762973a846e6623ca;Mon Jan 03 02:07:37 EST 2005;Committer;seki;4;34;9;43;0
239d44a19c2758339a356bc07a411fdbfdd07974;Sun Jan 02 22:48:59 EST 2005;Committer;gotoyuzo;1;2;2;4;0
97102f6596e490ea98f0300e34c47061f1e97f85;Sun Jan 02 22:31:13 EST 2005;Committer;gotoyuzo;6;134;8;142;0
a8c92267b133b6717ff3fd66d9de74d2b071c7c1;Sun Jan 02 06:46:38 EST 2005;Committer;seki;1;2;0;2;0
60f289bf2639cb5df895f8aec58af5ab1e2ea319;Sun Jan 02 06:46:37 EST 2005;Committer;seki;3;15;9;24;0
3ba5337dfa1e358484074db1ed575e44acb643ce;Sat Jan 01 16:34:02 EST 2005;Committer;eban;1;3;3;6;0
b7e70f049729cc6a7f55f409618d9c3f169a1cb8;Sat Jan 01 16:20:35 EST 2005;Committer;seki;4;29;16;45;0
571aa4db39067f319ab5a8d7554f6d0985133a11;Sat Jan 01 11:25:43 EST 2005;Committer;akr;2;111;49;160;0
8af8ebfb92324f10b2fa62175594f66feb70b0d1;Sat Jan 01 08:59:48 EST 2005;Committer;aamine;2;3;3;6;0
94402f983fbfacaf989c9f5d5d97fa5b4b6d1934;Sat Jan 01 08:45:50 EST 2005;Committer;aamine;3;16;1;17;0
6a95ae2a79f26d8efbfa4d9340fde6c10241606d;Sat Jan 01 07:32:15 EST 2005;Committer;aamine;1;2;0;2;0
0a4a9dbaea37782ffe47210b26f2462f42ebff16;Sat Jan 01 07:22:04 EST 2005;Committer;aamine;3;136;42;178;0
41257b6d93728a6fa4ab5a4bf17e7ad20da1d880;Sat Jan 01 04:52:23 EST 2005;Committer;eban;1;5;5;10;0
72f2ca11179d1ebcc96fcb289ff458442dfe0aac;Fri Dec 31 19:24:11 EST 2004;Committer;gotoyuzo;2;8;3;11;0
0eaf4872a6b30640dfc244d3dba70d467077a10b;Fri Dec 31 05:12:37 EST 2004;Committer;dave;3;37;9;46;0
07ca1240f2d3b5891be05dd1ac8735f276490ce6;Thu Dec 30 15:54:19 EST 2004;Committer;eban;1;3;3;6;0
b25095f6e4e491dbea0c30aa0e4930e68225ca7c;Thu Dec 30 15:09:42 EST 2004;Committer;akr;2;4;14;18;0
3b2de91dcff9e794281917fd2f4f5f19fad7f348;Thu Dec 30 13:49:56 EST 2004;Committer;akr;3;36;13;49;0
b4466a1084ae89dd4dd96031048ca6d99f4c5bc6;Thu Dec 30 09:57:06 EST 2004;Committer;eban;1;3;3;6;0
77a0c515453c64a03fcc60f63637970d09adb9d0;Wed Dec 29 20:41:04 EST 2004;Committer;aamine;2;59;36;95;0
4d81be859b3f6211e89ef4f08ffb4fe35dd540f5;Wed Dec 29 14:38:43 EST 2004;Committer;eban;1;3;3;6;0
0730057b53f04946d8ac437a9cc67bcd69229e5f;Wed Dec 29 14:38:32 EST 2004;Committer;eban;1;0;1;1;0
7eeb5cac7257660fcd81d9dfa080b6cc77a13b22;Wed Dec 29 13:47:43 EST 2004;Committer;akr;1;7;7;14;0
a35058f9f984d0563439ddba0a7aa001f7c51a08;Wed Dec 29 02:16:33 EST 2004;Committer;dave;3;35;15;50;0
afd7aea8577988d77cd7faed3524a92f29640e2b;Tue Dec 28 13:32:28 EST 2004;Committer;nobu;2;6;1;7;0
ecb09c186e8decb94f10b54e07a6d424b596abbd;Tue Dec 28 08:27:25 EST 2004;Committer;usa;1;1;0;1;0
b19d1e1d981e94942eee17df0309edf8b6cc68e6;Tue Dec 28 08:22:37 EST 2004;Committer;usa;2;7;0;7;0
32c09c25311bff2324d22978e888f3da56205b39;Tue Dec 28 06:49:04 EST 2004;Committer;nobu;1;16;0;16;0
70a1eecdb95978a193c0dd6abd936e68fe1d84fd;Tue Dec 28 06:42:33 EST 2004;Committer;nobu;2;12;3;15;0
1b9d66dfebb17ae1e7c3dc7b4ce729e6e3e9b3cd;Tue Dec 28 06:26:34 EST 2004;Committer;nobu;3;85;4;89;0
ccc05de1e5f755a22ccdcac7f506460488e56f99;Tue Dec 28 04:47:51 EST 2004;Committer;nobu;1;3;3;6;0
83ef3cd8a6709dd71901e408a0c46673a16f6682;Tue Dec 28 04:36:21 EST 2004;Committer;nobu;2;52;26;78;0
53c584d35db576377c4aa803c8f5a28c2d52eede;Mon Dec 27 11:04:21 EST 2004;Committer;nagai;4;59;27;86;0
8768030bb6b217de19158f54421dfd34d0dfaa80;Mon Dec 27 07:55:56 EST 2004;Committer;gotoyuzo;2;7;1;8;0
3cf02cc03ebfd6be299c7ad08066df33dfbbc202;Mon Dec 27 06:29:34 EST 2004;Committer;aamine;2;19;3;22;0
ea12b3eb5387145e9445137e4528a563e9004435;Mon Dec 27 06:15:32 EST 2004;Committer;aamine;2;39;12;51;0
46df1a4c8019d0b54756237cc099acb8d5b94261;Mon Dec 27 05:39:50 EST 2004;Committer;usa;1;3;3;6;0
13388ff2642e8a1b88f248c4b09a2fb8aa814a19;Mon Dec 27 05:39:27 EST 2004;Committer;usa;2;8;5;13;0
85cd4d9c5d1ab9c1f20b72aa554198ff4342ea0d;Sun Dec 26 14:27:51 EST 2004;Committer;eban;1;3;3;6;0
4394e19fddbfafb762fc6bd427e68370d41a0cee;Sun Dec 26 07:26:15 EST 2004;Committer;shugo;2;22;0;22;0
0634c0761033d05e20dbc2d2dd56819b60b73fbc;Fri Dec 24 14:30:14 EST 2004;Committer;nagai;2;6;2;8;0
0ebc7c2bc96cbcbf6fa4315cbe66f49ce6abf875;Thu Dec 23 18:06:19 EST 2004;Committer;nobu;2;40;26;66;0
a892f803ef6066a2bf9b51bee2d530d4a4266ec3;Thu Dec 23 17:53:58 EST 2004;Committer;nobu;2;39;28;67;0
4bdc2a662da439999f9e5157af067b4f9832612f;Thu Dec 23 17:23:02 EST 2004;Committer;nobu;2;231;211;442;0
ca5b499241d28ed82df319c4613f6acb14a435cd;Thu Dec 23 17:10:29 EST 2004;Committer;eban;1;3;3;6;0
532e34fcd243eaa906880c5c5a9fb77f19e0b7c1;Thu Dec 23 16:23:30 EST 2004;Committer;nagai;37;5819;6;5825;0
d34a65bc40ce303f8070bc043b490eee5881ebf1;Thu Dec 23 14:44:38 EST 2004;Committer;nobu;1;3;3;6;0
a68e68b22759657ef267cc8eb70f7ae99e13e4b4;Thu Dec 23 14:43:30 EST 2004;Committer;nobu;2;24;24;48;0
4155f97bb0bc857c5fec8b71cd0bc33e19e11107;Thu Dec 23 14:36:53 EST 2004;Committer;nobu;2;6;1;7;0
4ff1561a8c3a0b1eb682feb7a03e2d1300e4abfa;Thu Dec 23 10:12:35 EST 2004;Committer;akr;4;24;15;39;0
13fde676feb8c1280f674cb7537fb680bb86eef7;Thu Dec 23 04:17:03 EST 2004;Committer;nagai;5;101;0;101;0
7d6f48ccd22e93b6213514962a6ded168cad2966;Wed Dec 22 15:16:55 EST 2004;Committer;nobu;2;10;9;19;0
f68ab9c2d9a2208a5f8039db6bc35a9fa5c707ee;Wed Dec 22 02:15:35 EST 2004;Committer;nobu;2;10;1;11;0
bf48e2286965c53e1d083113c7d2b4d4eb9a0f13;Tue Dec 21 23:35:11 EST 2004;Committer;nobu;2;7;1;8;0
e537aaba91ac5ad8a554b155afbcc2d0efb50f66;Tue Dec 21 16:23:33 EST 2004;Committer;mneumann;4;32;21;53;0
d1be7e2cd30dafd729674c1578a2796f766d4b31;Tue Dec 21 15:10:31 EST 2004;Committer;nahi;1;3;3;6;0
e426b93e84e74ca8e7dbbd12eb86ab1e54681d04;Tue Dec 21 15:08:56 EST 2004;Committer;nahi;12;116;129;245;0
8180c1bd50d84563900bfe81dfa45d0ea4c1fa0f;Tue Dec 21 13:09:26 EST 2004;Committer;gotoyuzo;2;20;9;29;0
21d42dc45b9f2830294fc0c2d6b1facf0a9fd451;Tue Dec 21 03:44:17 EST 2004;Committer;gotoyuzo;3;207;3;210;0
97c701fb4116e13f47a44df911bc0eb2ce90c9f2;Tue Dec 21 03:17:14 EST 2004;Committer;usa;1;3;3;6;0
30197588570d15f61f5103f0cd4c6b54d5949c3d;Tue Dec 21 03:12:40 EST 2004;Committer;nagai;2;14;1;15;0
d7f6ed827fdfcabcd1e5a0d4419f5ea06f90ebaf;Mon Dec 20 14:00:21 EST 2004;Committer;nahi;12;171;2;173;0
9ee320461dd0f4c6897ae2c34443d343e0df9335;Mon Dec 20 13:58:50 EST 2004;Committer;akr;1;5;0;5;0
a198987f0b44ec861cf72d56762da79f03315e9c;Mon Dec 20 13:55:00 EST 2004;Committer;akr;1;2;0;2;0
e5a3aba50e2bd7e0327aacd8fe1ab7963fc4a007;Mon Dec 20 13:50:15 EST 2004;Committer;nahi;82;2977;1145;4122;0
643dc132113489749c333a6bda14730d9b175ed1;Mon Dec 20 05:46:45 EST 2004;Committer;gotoyuzo;3;7;8;15;0
5cd1282f21ad79859230978ac4eaf73f0853b0b4;Mon Dec 20 05:10:59 EST 2004;Committer;nagai;5;154;19;173;0
9a6c901fc431c58c0c607483ca2b41a20ceb4a4d;Mon Dec 20 01:52:06 EST 2004;Committer;nobu;2;7;1;8;0
ce1fce4a4cefb095d2c65be7511608de9a6e4f4a;Mon Dec 20 01:30:27 EST 2004;Committer;eban;1;3;3;6;0
a0f7b7ec928ec295280dac28aa05190739a66671;Sun Dec 19 18:31:04 EST 2004;Committer;nobu;2;7;1;8;0
d81899716ffdc562f928ef3e902f2942b96d47a2;Sun Dec 19 17:10:46 EST 2004;Committer;nobu;1;3;3;6;0
ee6e23caf6d041d3056ded5884152756f00158b4;Sun Dec 19 15:19:43 EST 2004;Committer;kou;2;6;1;7;0
64592fbc10bc301ca8764c2396995328163d3850;Sun Dec 19 08:29:13 EST 2004;Committer;nobu;1;1;1;2;0
a965236490c2f9ff98d5f1b073e3b989a351c1fa;Sun Dec 19 08:25:36 EST 2004;Committer;nobu;2;31;23;54;0
8c299e6e264c7a3366f11b0b73c80ce49ca3be9b;Sun Dec 19 02:01:59 EST 2004;Committer;nobu;5;37;16;53;0
3cf7c1758f887429762c208bdc3c1d85a55f1c00;Sat Dec 18 07:38:33 EST 2004;Committer;nobu;1;3;3;6;0
9c016c18fcf65332f8d6be099826df79ac12ebc0;Sat Dec 18 07:37:01 EST 2004;Committer;nobu;2;10;4;14;0
93ed2c7b1e0370287228c967c9973c9f2344fc54;Sat Dec 18 06:17:33 EST 2004;Committer;nahi;4;9;5;14;0
7614d647251da818f5f8d851528de52c6c601611;Fri Dec 17 08:47:11 EST 2004;Committer;akr;2;7;0;7;0
cb2349d653e70e77e189ae6ef8b11b26c50b4261;Fri Dec 17 07:31:51 EST 2004;Committer;nagai;10;188;39;227;0
3da93dd84287874fdefe439384efcc3d56d1c07f;Fri Dec 17 04:34:39 EST 2004;Committer;nobu;2;10;6;16;0
0b2d95aafdf2c41aac34524234fd0727cebf5856;Fri Dec 17 02:46:48 EST 2004;Committer;eban;1;3;3;6;0
9534e73ff49fc59f3c061f80604dc37f6661c76a;Thu Dec 16 15:06:58 EST 2004;Committer;nobu;1;6;0;6;0
7910c3fd56c9811aaa642af2570ed3b1b19b6533;Thu Dec 16 15:01:49 EST 2004;Committer;nobu;3;103;59;162;0
326ebac3dbb4649464e38936f6850765302d77d6;Thu Dec 16 14:31:21 EST 2004;Committer;nobu;2;8;2;10;0
c09dc0f7257c40d5ee2f5eb90a0f7cdf8fb134a9;Thu Dec 16 13:38:15 EST 2004;Committer;seki;2;5;4;9;0
67f4a393ba15b8dff5a0d442670a3c9b6b921931;Thu Dec 16 09:39:54 EST 2004;Committer;gotoyuzo;2;6;1;7;0
a247c7715db3ee30bb030eeafc08cedf9c43cf15;Thu Dec 16 07:32:01 EST 2004;Committer;nagai;2;9;4;13;0
cd4ce67e501a097757fde775fba489bfb0788164;Thu Dec 16 07:14:49 EST 2004;Committer;nagai;1;30;0;30;0
9e51ec666b367a8bca102d8f858173cc7ed56e12;Thu Dec 16 07:13:14 EST 2004;Committer;nagai;24;187;100;287;0
c89c302d3ff426d3f8a21da16cc8c2c8e42613a2;Thu Dec 16 00:40:23 EST 2004;Committer;usa;1;3;3;6;0
0ce6372dc1b24ae821689d0999a058978484a487;Wed Dec 15 19:02:42 EST 2004;Committer;aamine;2;9;2;11;0
64b5b2b1a249b4901396692cea5ccd4239e219ed;Wed Dec 15 18:27:44 EST 2004;Committer;aamine;2;5;1;6;0
e0ddacfc36bfeeecb0fcf37d3dc21eece522d3b9;Wed Dec 15 16:01:11 EST 2004;Committer;matz;4;25;7;32;0
8a92fc97092161be3fc44e58a84976f782fcba98;Wed Dec 15 15:46:53 EST 2004;Committer;seki;3;37;4;41;0
52d91fa4027cd0d988d89a1d2e95253fbbabf894;Wed Dec 15 08:47:49 EST 2004;Committer;gotoyuzo;5;47;13;60;0
2edbb9d0f802bab53153979c59125dd0afaafccf;Wed Dec 15 06:35:55 EST 2004;Committer;matz;23;184;146;330;0
772396882f02ec3738242a4e83a34e4fc32597bb;Wed Dec 15 05:33:10 EST 2004;Committer;usa;1;3;3;6;0
f598caf62157148856aec37d3b8d6c2c9086695a;Wed Dec 15 05:32:53 EST 2004;Committer;usa;2;10;1;11;0
6982d10a7e69bbc22ecc3d6658d4adbc1a91a94d;Tue Dec 14 13:04:28 EST 2004;Committer;matz;1;11;0;11;0
ba2fce15075685e92d5d8be13df4df69dc56f63b;Tue Dec 14 12:42:42 EST 2004;Committer;ttate;3;56;48;104;0
2f35e1e146592806dce5701ed853c516283399f1;Tue Dec 14 08:10:32 EST 2004;Committer;usa;2;5;0;5;0
2235b8c36d2ef508cf132a3c2079d2e2dc2d32ae;Tue Dec 14 05:05:17 EST 2004;Committer;gotoyuzo;2;8;3;11;0
a87ff1d339aa88c52b812bb63d0edac694519eb6;Tue Dec 14 01:40:56 EST 2004;Committer;eban;1;3;3;6;0
21ae9c745ad435cad08ac394326dee7b77d8e66c;Mon Dec 13 23:55:04 EST 2004;Committer;matz;3;16;55;71;0
96439f2a4a09c0994883991226966b79701968db;Mon Dec 13 11:50:13 EST 2004;Committer;ser;2;5;5;10;0
4497af1591dd5936545297a6933d67b0204bc354;Mon Dec 13 09:57:41 EST 2004;Committer;akr;2;22;10;32;0
ad36c25be8094095209212e8529295ad68c1cc62;Mon Dec 13 04:11:46 EST 2004;Committer;eban;1;3;3;6;0
562ddea6ba128fb4513bf2d88fc57d547c85391c;Sun Dec 12 17:47:53 EST 2004;Committer;shugo;2;15;6;21;0
4627c5a19bca043c2e35aa84df68e133e0009530;Sun Dec 12 16:04:31 EST 2004;Committer;akr;2;10;2;12;0
329c2cd72371c1a41b3eb547f3136df6fce8d7af;Sun Dec 12 13:47:06 EST 2004;Committer;eban;1;3;3;6;0
b6aba9ad547003dd57f0a6a830ca2be7ef166db0;Sun Dec 12 12:32:21 EST 2004;Committer;nobu;2;6;1;7;0
5f87cfb94ca437bcd1fec2a5f5f2051ebe48e459;Sun Dec 12 01:36:57 EST 2004;Committer;dave;2;10;0;10;0
05b5e64ac3a33930dcfdd6ace3ff549d3813d8e7;Sun Dec 12 01:16:19 EST 2004;Committer;dave;2;10;4;14;0
a402acbbb6e366a21554e8e9f74b05c4a4116621;Sat Dec 11 12:12:17 EST 2004;Committer;seki;4;48;4;52;0
d4b0bf031d38e6af65f3055601f7a10ce150d5b6;Sat Dec 11 05:38:10 EST 2004;Committer;usa;1;3;3;6;0
0e01d2883bfffd8335c8d3391e3d5a79c24aeb13;Sat Dec 11 04:09:07 EST 2004;Committer;nobu;2;24;0;24;0
12790683f360ac66a5726859fc06d8d4a7a2fb28;Fri Dec 10 00:08:19 EST 2004;Committer;usa;1;3;3;6;0
bb59e412e1a37124d8ba14c4ab19caea75f54233;Thu Dec 09 23:39:57 EST 2004;Committer;nobu;3;22;1;23;0
d9a56b4feedb4d85b5b867e537a3e94acacd42e1;Thu Dec 09 07:31:22 EST 2004;Committer;usa;2;5;1;6;0
3f06be1b9d5904514811bdbf53742d7ec528bf8f;Thu Dec 09 07:22:45 EST 2004;Committer;gotoyuzo;3;24;10;34;0
e326946b35c0e1eb022e381206c2df292d9c2761;Thu Dec 09 05:38:59 EST 2004;Committer;nobu;2;16;3;19;0
b9c6120e079075e0bb2b4acde395d25e592c3fe2;Thu Dec 09 03:34:47 EST 2004;Committer;eban;2;6;1;7;0
3d66cc4c6b9585227b6489497d66dbc065c6f6a6;Thu Dec 09 02:19:50 EST 2004;Committer;matz;5;140;160;300;0
32481c4126c09a659dd240a44fe27a2af513dd52;Thu Dec 09 01:19:30 EST 2004;Committer;nobu;3;59;11;70;0
bfb31fdd22e3d5680d87d926704caff374b77f3c;Thu Dec 09 00:09:55 EST 2004;Committer;usa;1;3;3;6;0
3e75f9b513bbe651505847738bd1d562c1c7b4bd;Wed Dec 08 18:19:53 EST 2004;Committer;nagai;1;22;0;22;0
b9bdee95f10922c0f4adbb51d2496c63d7d1ecdc;Wed Dec 08 18:14:15 EST 2004;Committer;nagai;25;689;119;808;0
642e10156c3554e2f1c922f0b3f6e0f8bd26ec16;Wed Dec 08 14:56:55 EST 2004;Committer;dave;2;7;2;9;0
78f7b7036bb6c950a3533a5eb0f2fc9741511efa;Wed Dec 08 13:26:27 EST 2004;Committer;akr;6;95;100;195;0
19f57ce1443f309c726aef8e5316efde1dfece8e;Wed Dec 08 11:14:53 EST 2004;Committer;eban;3;14;3;17;0
3f5646312944b77463f7576c275702e9896abb93;Wed Dec 08 08:38:59 EST 2004;Committer;usa;2;6;3;9;0
a0b3060708a3422d2aa4046c0f6595cd94728ba9;Wed Dec 08 05:32:26 EST 2004;Committer;matz;2;5;0;5;0
87a77c71748c1b97e16f141709e9679f37efc441;Wed Dec 08 04:56:07 EST 2004;Committer;usa;2;9;11;20;0
bc4088d768c081b15949d06f2dfb6b88c33e3eef;Wed Dec 08 02:54:24 EST 2004;Committer;usa;2;9;0;9;0
e41a1c0f10db58206394bbef056a0613c353ab92;Wed Dec 08 02:46:39 EST 2004;Committer;nobu;3;10;1;11;0
ec8d7f3672e379700d90d8ed0deab767584e5e76;Tue Dec 07 23:35:18 EST 2004;Committer;nobu;1;3;9;12;0
25a637eff54787ecc2f40b33fca38c34773fd4e4;Tue Dec 07 18:34:29 EST 2004;Committer;gotoyuzo;2;21;3;24;0
bebc2eb8c74f9fd90eab3a254ede62f569b26690;Tue Dec 07 18:26:46 EST 2004;Committer;nobu;2;12;3;15;0
807a93be080e97dafb31f4d975b6eaa991070961;Tue Dec 07 18:26:12 EST 2004;Committer;nobu;3;30;5;35;0
d5b434088ada94b3df3fe87ea42c98c3e6e9ee16;Tue Dec 07 16:36:29 EST 2004;Committer;usa;2;10;6;16;0
44dc05e55fbb351106c2ded1980b6bcc2d0b272b;Tue Dec 07 15:48:40 EST 2004;Committer;eban;1;3;3;6;0
c3ce319d7d9ea2bbde36aa65baf6fecebc9f101a;Tue Dec 07 15:47:59 EST 2004;Committer;usa;4;188;74;262;0
6100eced2ed54b75c059e7fac4b69182798cfa75;Tue Dec 07 15:27:01 EST 2004;Committer;kou;2;14;0;14;0
a435e522598e97005ef3d9d8bcdaa8262d9905a7;Tue Dec 07 06:44:42 EST 2004;Committer;akr;5;24;98;122;0
638bbb19460b26f7be79c3780c9887bbee7f0d4a;Tue Dec 07 04:47:59 EST 2004;Committer;usa;1;2;1;3;0
571e1361b656b9949724bf64a14d665cf9d662f8;Tue Dec 07 04:45:46 EST 2004;Committer;usa;4;55;5;60;0
69b64a7d5f1e6b711f0cfac87997b1abe193ca5d;Tue Dec 07 01:51:27 EST 2004;Committer;eban;1;3;3;6;0
29cbbc5b38449e256107297b0c7d5da2b6935caf;Mon Dec 06 23:02:17 EST 2004;Committer;nobu;1;4;5;9;0
aa92750f27e519c225d9bb50e59ed063857e0c04;Mon Dec 06 15:31:26 EST 2004;Committer;matz;10;184;54;238;0
2cefbe9fb2297147c034086ff3b1b2dd9a9f5545;Mon Dec 06 14:09:33 EST 2004;Committer;akr;2;6;0;6;0
ee40e2386472d6cd05dd64a036a0395473f38554;Mon Dec 06 14:04:05 EST 2004;Committer;eban;4;14;2;16;0
9e31b97465f7c837456350904833bc425f53cdb2;Mon Dec 06 12:20:29 EST 2004;Committer;usa;2;12;6;18;0
699a1cab5d83a9be0087444731dbac9bebac872d;Mon Dec 06 12:07:24 EST 2004;Committer;usa;1;2;2;4;0
1acf7e6b018031df7d1413ae4d67e230034d0e20;Mon Dec 06 11:19:27 EST 2004;Committer;usa;4;71;39;110;0
3bd61a71a07d5ca96aaf3c34860a61e5527a6e78;Mon Dec 06 10:42:49 EST 2004;Committer;eban;2;6;4;10;0
710bab848043a44c782677fefb11a694a146f0a2;Mon Dec 06 09:17:42 EST 2004;Committer;akr;1;1;1;2;0
f6a2a9b7433e8c74d29e3a9204f3abc6054524fa;Mon Dec 06 08:50:11 EST 2004;Committer;usa;2;5;0;5;0
04f36c2bba797225f0ab8f2bd83de86e1203ac47;Mon Dec 06 08:40:30 EST 2004;Committer;akr;12;539;621;1160;0
35091fdda5bb3aa55d49c1c6bf20964a7a920bee;Mon Dec 06 08:15:56 EST 2004;Committer;nobu;4;90;0;90;0
b0efbcfb9ea3d888af17a8ee2b04f78de597bee4;Sun Dec 05 16:39:48 EST 2004;Committer;eban;1;3;3;6;0
dd92742ce1e27971c268c0b433884733014448ab;Sun Dec 05 16:36:26 EST 2004;Committer;gotoyuzo;3;92;26;118;0
af3da7d124e67a195e761d2b8e82f80320f57387;Sun Dec 05 10:39:58 EST 2004;Committer;nobu;3;23;20;43;0
174052749c836c59dcdb13a38c181bb3374b66e6;Sat Dec 04 15:57:58 EST 2004;Committer;eban;1;3;3;6;0
a54f1be716f696b199bc26fe4b257852812e050c;Sat Dec 04 15:56:34 EST 2004;Committer;eban;2;9;1;10;0
95a5b4e9a406e01cf89709bd843914f7a730b910;Sat Dec 04 12:29:55 EST 2004;Committer;aamine;3;25;30;55;0
7c0370dcafee76642ea40d1a3488078f744910b4;Sat Dec 04 11:46:24 EST 2004;Committer;aamine;3;152;9;161;0
500bd1f033c8c0f2e7bbe8d864334681be1ce0b5;Sat Dec 04 09:55:29 EST 2004;Committer;kou;2;6;1;7;0
636e37fcb940f845c2323e055f063cd4aec5f7d4;Sat Dec 04 09:53:01 EST 2004;Committer;kou;4;40;8;48;0
5262bd8a2c445534408d947bd5d96c4da488e8c9;Sat Dec 04 05:41:01 EST 2004;Committer;eban;1;3;3;6;0
5d8d9754340ae05e596310a951ec3f6f74bb4a07;Sat Dec 04 05:38:17 EST 2004;Committer;dave;4;53;5;58;0
405a50a5948fecb6ba44efb250a86052f4a406c8;Fri Dec 03 04:56:25 EST 2004;Committer;matz;4;63;28;91;0
da4884e2d4ea78b39cfdea0a747f2b700ccedfbc;Fri Dec 03 03:25:29 EST 2004;Committer;nobu;3;14;3;17;0
e582317a4e06e051696ac20e3abf08003cef2393;Thu Dec 02 17:03:59 EST 2004;Committer;eban;1;3;3;6;0
697908d0d4237db41a48f7f89ed62ba91b3fccf9;Thu Dec 02 16:59:02 EST 2004;Committer;nagai;7;89;5;94;0
4c10b035ef46165c1b9a42183c7744988a38138a;Thu Dec 02 15:22:23 EST 2004;Committer;mneumann;7;279;11;290;0
5847fadf7b173479fca0521b2301e6ff89cbd09a;Thu Dec 02 15:17:35 EST 2004;Committer;matz;4;34;10;44;0
dd1510eddcfda423b8871271f36590c458b1cc39;Thu Dec 02 07:41:50 EST 2004;Committer;nobu;2;37;23;60;0
c22f22bd400c79166f8add21d4ab108cb213f417;Thu Dec 02 02:44:08 EST 2004;Committer;eban;1;3;3;6;0
c741090753c4002f2130258364db50daa8810ee9;Thu Dec 02 01:54:13 EST 2004;Committer;shugo;2;22;11;33;0
fc0fcec74e5a9817e6d1e2b100fdb0e78b71e9b9;Thu Dec 02 00:31:17 EST 2004;Committer;nobu;2;11;0;11;0
aa997fca3e0ebde50ea9121c14eeb5c82d749a53;Thu Dec 02 00:27:27 EST 2004;Committer;matz;2;5;1;6;0
c1b036033b813973a8b175f86ab5585795192573;Wed Dec 01 22:44:46 EST 2004;Committer;naruse;1;10;0;10;0
32e79507bbded78aa8fff92121bb78755a3f7c41;Wed Dec 01 21:12:10 EST 2004;Committer;naruse;1;30;20;50;0
3cf6e46e62f3add4febc6dacb498e91010f57701;Wed Dec 01 21:09:02 EST 2004;Committer;naruse;1;4;4;8;0
6efefe35b3dc32ece5de669dab18007512ab86c3;Wed Dec 01 21:07:22 EST 2004;Committer;naruse;1;2;2;4;0
d8a85fe9deca4fa0175f622db53f398ab49c16a2;Wed Dec 01 01:08:16 EST 2004;Committer;eban;1;4;4;8;0
1b4f379ba34bb48aa2144ff5a14b07ae4f4bc57e;Tue Nov 30 17:28:17 EST 2004;Committer;matz;3;7;2;9;0
6f1b13de9904e3c26ebf14e4b5633e4b9f4a01ff;Tue Nov 30 14:49:18 EST 2004;Committer;nobu;2;7;0;7;0
e6e84eab64ae594f78d21dbd07ba1d2de57168e3;Tue Nov 30 09:36:39 EST 2004;Committer;matz;2;8;8;16;0
ee6869c8d63643f2f3b198fa4ad8ed52a2744145;Tue Nov 30 09:33:50 EST 2004;Committer;matz;2;12;1;13;0
c079ee2bce1f2540680718e0ab81fc8317f383c0;Tue Nov 30 06:10:53 EST 2004;Committer;matz;2;3;0;3;0
9556d9333aabe3328259e41404b706571026b399;Tue Nov 30 06:01:58 EST 2004;Committer;eban;2;5;1;6;0
38ada9fe878c649e80bf8c1ae835bc855240192c;Tue Nov 30 04:01:17 EST 2004;Committer;matz;3;7;2;9;0
afae182fe26c355d5eb9827ee99a66c80ec32639;Tue Nov 30 03:09:40 EST 2004;Committer;eban;1;3;3;6;0
c0acb3ce179ff038ee24f608a3615069645a7799;Mon Nov 29 15:58:18 EST 2004;Committer;matz;3;24;9;33;0
cb32ebe81c0d02a430d016cbdfd93960ec0b259d;Mon Nov 29 15:16:20 EST 2004;Committer;ksaito;2;24;4;28;0
af7418e5c42ff7b399e644ce281a3d57b46740dc;Mon Nov 29 07:06:21 EST 2004;Committer;nobu;3;16;1;17;0
37eb7502dbc5dbbcdeb4f0099dd484e8de48ece1;Mon Nov 29 06:22:42 EST 2004;Committer;nobu;2;11;3;14;0
83cb605d69f20be5fe842a913e51d017f61cdc44;Mon Nov 29 06:09:40 EST 2004;Committer;matz;9;104;42;146;0
6e221605373ff89fd52d08d5df86cfb0bd805de7;Mon Nov 29 05:21:47 EST 2004;Committer;nobu;1;7;3;10;0
e73b5c9bfcd0563496a7bfbd113f505edb4d2c81;Mon Nov 29 05:00:46 EST 2004;Committer;nobu;1;22;0;22;0
fa69f28eb5cdca123bddc46029e63584daaf7897;Mon Nov 29 04:38:08 EST 2004;Committer;nobu;2;21;9;30;0
0412ddfd24f806b8d1dd88a367f21684b30e5fd0;Mon Nov 29 04:17:05 EST 2004;Committer;usa;2;6;1;7;0
9c926fb4010bb801c30ca1de48b4bd66ba40944d;Mon Nov 29 00:24:01 EST 2004;Committer;usa;1;3;3;6;0
a8f25ded9c8e8ccb867112d8092ac903af9e9a8d;Sun Nov 28 17:02:14 EST 2004;Committer;akr;2;3;7;10;0
da9166cc19b2fd9a825d9089307b1e992f35aa08;Sun Nov 28 16:46:04 EST 2004;Committer;akr;1;1;0;1;0
06646d1b4ebf73e54b444bee43df76f3ff490f31;Sun Nov 28 16:31:12 EST 2004;Committer;akr;2;9;3;12;0
44b9ca66968f7d683d0356c8cec123100c27345a;Sun Nov 28 07:02:36 EST 2004;Committer;kou;1;1;1;2;0
0c616db7ff406d8f3454807aa0e3310629d53ee3;Sun Nov 28 06:59:34 EST 2004;Committer;kou;6;22;14;36;0
b684f87574166a42d3305c005896bf2aa7cd37b3;Sun Nov 28 06:53:41 EST 2004;Committer;kou;10;255;193;448;0
49d454ea2e2dc1d447b2dc290b6ea361ad18f979;Sun Nov 28 04:08:22 EST 2004;Committer;eban;1;3;3;6;0
aa01c7368935835509e9db1c79fdb588c5d5f12b;Sun Nov 28 03:16:16 EST 2004;Committer;ksaito;2;15;10;25;0
09542e3269f5b915b45eb5c03fcb8c61452d751e;Sun Nov 28 03:09:13 EST 2004;Committer;ksaito;3;26;11;37;0
5fb312bd18a09ac50e8c7d707cb87893609ce9fc;Sun Nov 28 03:07:48 EST 2004;Committer;ksaito;3;10;1;11;0
7eac88ecd5ee9ecf63ff7a3192c3d73fd5c0063f;Sun Nov 28 03:06:39 EST 2004;Committer;ksaito;3;21;87;108;0
39eac7ded8512e4f9c78f1bdab2b143f8190009f;Sat Nov 27 14:08:45 EST 2004;Committer;akr;1;1;1;2;0
5eec9fe63c0cd627bfa8b1ffbcfeec8b4bb57490;Sat Nov 27 13:33:34 EST 2004;Committer;akr;1;1;1;2;0
0abc28742a0673602483793b57796869e88ce5b8;Sat Nov 27 13:08:11 EST 2004;Committer;akr;1;1;1;2;0
b70e88a123a5a291665d70ce0c59bafa5cebebfc;Sat Nov 27 13:05:46 EST 2004;Committer;akr;2;57;17;74;0
2572d5e20efb42599759f97b1ec0cc66c15fb14a;Sat Nov 27 08:47:28 EST 2004;Committer;kou;12;1066;14;1080;0
0a93165e167a4d1d6b0f8a2dc0479524f49855d4;Sat Nov 27 08:43:18 EST 2004;Committer;kou;4;41;25;66;0
b325d73c13d683352e2917b4c00bb1593982c3c9;Sat Nov 27 08:41:32 EST 2004;Committer;kou;3;120;114;234;0
5e5fe659fab94c09a322992149c2ff794fe18451;Sat Nov 27 02:25:54 EST 2004;Committer;eban;1;3;3;6;0
65445b53ca3dc9417f2e6fa49d4b5a73b637d53d;Sat Nov 27 02:21:53 EST 2004;Committer;matz;2;29;10;39;0
27c24b0f3bdd63459ea2d1de4366d0b38a4aef5d;Fri Nov 26 09:07:25 EST 2004;Committer;nagai;10;67;15;82;0
6d0f22ebc6cf0c3ad5d542bf5bfd140a0f7c98cf;Fri Nov 26 06:27:45 EST 2004;Committer;matz;2;15;17;32;0
c97c3590530f9742ca0e49d36b3c953763d0224a;Fri Nov 26 05:30:45 EST 2004;Committer;matz;2;14;10;24;0
9e5c4cde2f219f9b37c3885a71faa05531305576;Fri Nov 26 04:50:36 EST 2004;Committer;matz;3;18;6;24;0
a052ef75abbf7cc6035083a8af05cf4051ca0110;Fri Nov 26 04:32:11 EST 2004;Committer;dave;3;7;3;10;0
41cb9a59f59a29c86e3d661ba259a45b9c226ec3;Thu Nov 25 15:59:14 EST 2004;Committer;eban;1;3;3;6;0
84bd21465eae308efa6ef531f75f02f340ad6c41;Thu Nov 25 15:23:19 EST 2004;Committer;matz;3;370;16;386;0
0247fbae3d9b41cac9bc86b74e6a5dbd4ea20444;Thu Nov 25 11:15:33 EST 2004;Committer;nobu;2;13;5;18;0
3e37ee5af18889fb3ad78194b7094ff46447f4c4;Thu Nov 25 09:11:48 EST 2004;Committer;akr;1;1;0;1;0
db306518e4d77dc50c503c0908c4e9ca2e2afb18;Thu Nov 25 09:09:26 EST 2004;Committer;akr;2;8;1;9;0
f7884c6beb479950cb8863a556df38ec29806b9f;Thu Nov 25 08:39:31 EST 2004;Committer;ttate;3;21;13;34;0
f7a5ee56d72e4badc825d60af0d8efc36d3d95d1;Thu Nov 25 08:15:29 EST 2004;Committer;ttate;3;6;6;12;0
058c1d1620218ef0a8304516007479922a1a4523;Thu Nov 25 02:24:02 EST 2004;Committer;nobu;1;6;3;9;0
51c48c29d8d89c729075f611e7c25abf92f7aa41;Thu Nov 25 01:58:31 EST 2004;Committer;matz;4;17;4;21;0
624f62c515edeca8e6b9fdc01bfea736ecd7dbe2;Thu Nov 25 01:46:00 EST 2004;Committer;usa;1;2;1;3;0
5632cf0d191734766c3ad7c13f8aff8bc15b23e7;Thu Nov 25 01:19:24 EST 2004;Committer;usa;1;3;3;6;0
733a3adc796907415f642a92510d6ccd050dc4a9;Wed Nov 24 16:38:38 EST 2004;Committer;ttate;3;128;67;195;0
0f2fdc6978fb05e0149473a79d6083a1dd63e743;Tue Nov 23 17:37:51 EST 2004;Committer;matz;3;55;61;116;0
140a9e7be3d0fb44b1266b6aece93310d9f41e88;Tue Nov 23 16:49:53 EST 2004;Committer;eban;1;3;3;6;0
e66752a0ed87b1bd3127032f27289fe897c643cd;Tue Nov 23 16:04:16 EST 2004;Committer;matz;2;12;6;18;0
d852a4e317e163c920b0b69aff59cb5edea08a18;Mon Nov 22 23:12:37 EST 2004;Committer;nagai;2;45;18;63;0
941d1359043bbb52e14eba9cfcc90292b4ddaa4b;Mon Nov 22 17:02:45 EST 2004;Committer;matz;2;5;1;6;0
041ede07f5857fd64b60186805f3523543c8f157;Mon Nov 22 15:37:28 EST 2004;Committer;usa;1;3;3;6;0
f50136a311942aff1928739821add73b1c490266;Mon Nov 22 15:26:02 EST 2004;Committer;matz;4;32;10;42;0
d9d5c88cf3259b793724c5cfe70146cc69e0066b;Mon Nov 22 13:37:39 EST 2004;Committer;dave;2;9;4;13;0
f1f0ca312f88e44372c6550a4d425bbf061c551a;Sun Nov 21 15:38:05 EST 2004;Committer;eban;1;3;3;6;0
fec64f7fe2ace6ffc56685b0666504000d855468;Sun Nov 21 15:33:56 EST 2004;Committer;matz;2;15;2;17;0
5809c72125504680921cd91046b7d84a222d69b9;Sat Nov 20 17:33:18 EST 2004;Committer;aamine;1;2;0;2;0
72a6f92f4e32d44c2cd74696355afedc75c2241e;Sat Nov 20 17:29:18 EST 2004;Committer;aamine;1;27;0;27;0
688c69b1f7ed0949673dc8932de2e9fb54a5a9e7;Sat Nov 20 15:18:35 EST 2004;Committer;matz;3;15;2;17;0
fc4a280c75e23e71fa1e84a69c8ce3123e1533bb;Sat Nov 20 15:05:19 EST 2004;Committer;eban;1;3;3;6;0
a80ba17d67141a51459bb89b1fb51e8b0a4ff2de;Sat Nov 20 15:02:57 EST 2004;Committer;dave;7;484;325;809;0
aafc487d6a461d0a729432f919af0ee9645fcf14;Sat Nov 20 14:26:23 EST 2004;Committer;aamine;2;12;4;16;0
a0b500ac088667ae82b1fcd2ee0e5e51eb7f3f50;Sat Nov 20 13:58:20 EST 2004;Committer;eban;2;7;1;8;0
919992f5b8bac22566a1f896fbe7886859a529f6;Sat Nov 20 13:23:57 EST 2004;Committer;aamine;1;2;0;2;0
e62aac94241e9551ad2d7195f92e0c2ebfdb4826;Sat Nov 20 12:18:16 EST 2004;Committer;eban;1;3;0;3;0
9ad74dd3772d784851a1556694d227d89540c054;Sat Nov 20 11:44:02 EST 2004;Committer;aamine;2;5;1;6;0
9b25eee46e5acba4a651bf1d1fde2de1153178f7;Sat Nov 20 08:49:16 EST 2004;Committer;eban;2;9;3;12;0
643ac551dc5d58fbf63a1ae253dbdbe941778abd;Fri Nov 19 20:46:13 EST 2004;Committer;naruse;1;6;0;6;0
6caa49e45fb60c5ef4c450ff98b5d60c2cdce42e;Fri Nov 19 20:38:24 EST 2004;Committer;naruse;2;412;82;494;0
77a23fba355e5303da1182255bef800ee6acc468;Fri Nov 19 16:59:11 EST 2004;Committer;matz;7;41;8;49;0
a6610efee851bb8cd6dd2a312062c372abaef765;Fri Nov 19 16:48:37 EST 2004;Committer;eban;1;3;3;6;0
86761931c8879108e35ed9af3d53280dcf76f0e6;Fri Nov 19 16:48:05 EST 2004;Committer;eban;2;6;1;7;0
5913c969f14d27807e785c119eb484830f7bb697;Fri Nov 19 15:09:13 EST 2004;Committer;eban;1;1;1;2;0
ab55ad1afd52340619eb79d554293fb44196d353;Fri Nov 19 15:01:20 EST 2004;Committer;eban;1;2;1;3;0
0fe17f5d812d5d1a065e7d472df9be3376a90920;Fri Nov 19 13:45:46 EST 2004;Committer;eban;2;5;0;5;0
b37319295dd921fe3d679f7221fda6a151da626b;Fri Nov 19 08:49:05 EST 2004;Committer;kou;3;11;39;50;0
9be1ed43c888249563f32a3df394a9841e4f9601;Fri Nov 19 08:25:25 EST 2004;Committer;kou;27;1801;576;2377;0
1c453c06081222e9b75dac428b08ffd26f1ca2a7;Fri Nov 19 02:26:23 EST 2004;Committer;eban;2;4;1;5;0
e6a0f42c9462e8f7d1a70b94c2428657d5cb9874;Fri Nov 19 02:22:57 EST 2004;Committer;eban;3;11;4;15;0
964171ebfaf84e79f61ef45f2f11e9cd7b22d2a5;Fri Nov 19 01:38:38 EST 2004;Committer;shugo;3;23;4;27;0
2bf189db24db4d328063637c456d2792c0cd47e6;Fri Nov 19 00:07:12 EST 2004;Committer;usa;1;3;3;6;0
5e2c8a40c37651725b4ae08cccf2771592d8d604;Thu Nov 18 16:02:08 EST 2004;Committer;matz;3;58;0;58;0
5e2fdf0163a4b9f9297dad5c8484aa4201d56696;Thu Nov 18 14:42:54 EST 2004;Committer;aamine;2;7;3;10;0
fce2bb5ea8b804d31c673df9a6c8200ae73ea268;Thu Nov 18 11:52:46 EST 2004;Committer;usa;3;24;1;25;0
5141d3ea7986da8d0dcf51e6b34c99308210bf14;Thu Nov 18 08:11:12 EST 2004;Committer;matz;5;48;17;65;0
fc20fdcbc8c76961151a26c6fdba97821826dc40;Thu Nov 18 08:06:09 EST 2004;Committer;nobu;3;74;1;75;0
1e6cdc00e7bb33571016ce8a48a93a586b6ba6a8;Thu Nov 18 06:12:12 EST 2004;Committer;shugo;3;113;15;128;0
ac5eac4066f968963d34c4e5c4c62872c6fc5593;Thu Nov 18 03:55:04 EST 2004;Committer;usa;1;3;3;6;0
b28b7933a832bed1426852d67fe5e6ace8eb8bef;Thu Nov 18 03:45:23 EST 2004;Committer;matz;4;67;52;119;0
76fd9b85d9ee675c179e1460b27ff978f0ed9158;Thu Nov 18 02:27:00 EST 2004;Committer;nobu;1;5;0;5;0
27e4aa4a937c032073ee265aa0e71c430bf5774f;Thu Nov 18 01:11:01 EST 2004;Committer;nobu;4;21;11;32;0
e766a04a573d5d878678db553d9b539322f734a6;Wed Nov 17 14:48:35 EST 2004;Committer;nahi;2;30;0;30;0
eabc1fc65855301bbfc867cae1918de745af5fda;Wed Nov 17 11:51:08 EST 2004;Committer;mneumann;3;12;5;17;0
6c8ffdbf32121f49766dca934ae6be20d65d9ba6;Wed Nov 17 10:12:19 EST 2004;Committer;akr;2;9;0;9;0
3691ea5cf42b333a8607df1d2f6d9e22d747d5a1;Wed Nov 17 08:04:19 EST 2004;Committer;gotoyuzo;3;39;38;77;0
9c1e33fc452bfc545eac51a8579d4f3a7f7872b8;Wed Nov 17 04:05:18 EST 2004;Committer;nobu;2;13;4;17;0
46a9555860f4dba985ed9839b8f249376bf0bed4;Wed Nov 17 02:29:02 EST 2004;Committer;eban;1;3;3;6;0
288ceaeec2077d06df3ba46bca97960f76f283e1;Wed Nov 17 02:27:38 EST 2004;Committer;matz;9;49;32;81;0
3ad741f132133bb542a84a01d8e7644fc4b51e4c;Tue Nov 16 21:25:50 EST 2004;Committer;mneumann;2;6;1;7;0
02f848f9a48129aca2b372a06a85da0e6c687923;Tue Nov 16 14:51:38 EST 2004;Committer;matz;3;14;4;18;0
a74375b05f1e0b6b7ff5ab14b230b0818b4f76f2;Tue Nov 16 14:36:35 EST 2004;Committer;mneumann;1;26;0;26;0
f6c1872354a8566077c553063e2e9f2e5e290be2;Tue Nov 16 14:12:53 EST 2004;Committer;mneumann;2;301;0;301;0
597e0c74ba024b59ecc326b5399d06c2b63ac03b;Tue Nov 16 14:07:15 EST 2004;Committer;mneumann;2;128;0;128;0
790a05a3b92180b9d6e4c4cc11acf6ee106aaee3;Tue Nov 16 13:35:45 EST 2004;Committer;mneumann;1;5;5;10;0
f5c2af51db6f330337f47a5bdbd95dfb72df4844;Tue Nov 16 10:55:47 EST 2004;Committer;mneumann;4;15;22;37;0
befb362acf53b3ef725ead23d55edd24a0010cc4;Tue Nov 16 08:37:59 EST 2004;Committer;usa;3;3;3;6;0
15de1b79f07f9b3ef9e1b2957a9c214db670e163;Tue Nov 16 07:30:42 EST 2004;Committer;usa;4;8;0;8;0
2d28e9d55b124b895d34fe41dbe6d362c2a88327;Tue Nov 16 07:21:21 EST 2004;Committer;nobu;2;6;1;7;0
b93479b8d9b8f0f95844d8e53ad954445177af00;Tue Nov 16 04:55:14 EST 2004;Committer;matz;6;38;22;60;0
c2b7884076865795a309a93eda6589a66150e968;Tue Nov 16 04:39:22 EST 2004;Committer;usa;3;18;2;20;0
6116dd832cdd42fb8631bd90db3657fc9c1bb7ef;Tue Nov 16 02:19:44 EST 2004;Committer;nobu;2;7;2;9;0
8b38f8c03e28f12c4c92a47a903558b55f350c9d;Tue Nov 16 01:11:49 EST 2004;Committer;mneumann;4;54;20;74;0
0cf2581ec1ced929beaa04d154faaf8e41d0afeb;Tue Nov 16 00:48:02 EST 2004;Committer;usa;1;3;3;6;0
396b1f27ca1581aa676c235a5d021828eef6257f;Mon Nov 15 23:26:20 EST 2004;Committer;mneumann;18;475;31;506;0
67d54f209d28019cc5d8b332706dd9950b56bdc7;Mon Nov 15 16:45:03 EST 2004;Committer;matz;5;30;16;46;0
30b3ce3445f5cbf94080a8408b83eaafaa264baa;Mon Nov 15 10:05:17 EST 2004;Committer;akr;2;34;6;40;0
e77fc758024989891f1852f27575eaed9d3053c2;Mon Nov 15 02:51:10 EST 2004;Committer;nobu;2;15;5;20;0
7320e53be18278a2121bbfc1f7911cd5b2fd411d;Mon Nov 15 01:52:45 EST 2004;Committer;matz;2;14;4;18;0
9d4144af0942821bd6fbb752d734e8e26b91792b;Sun Nov 14 16:00:36 EST 2004;Committer;matz;3;34;27;61;0
eeb6612e72a1e2ed96bcbc9c32c3d25d7b3bd0bc;Sun Nov 14 15:45:15 EST 2004;Committer;eban;1;3;3;6;0
0f36ecebe0d0e89dd96d66dba96119824ae055a0;Sun Nov 14 15:41:40 EST 2004;Committer;matz;8;81;46;127;0
8f1c92af4f90b4817eebcaa7c1e75747a90cfb50;Sun Nov 14 10:06:16 EST 2004;Committer;akr;4;168;2;170;0
5d581bc314e2017c8357c7dfd88ea6f69a29afaf;Sun Nov 14 04:27:39 EST 2004;Committer;nobu;2;8;1;9;0
8f1e1664991d9197b30ee1eb18eeabcebb37a392;Sun Nov 14 04:24:31 EST 2004;Committer;eban;1;3;3;6;0
12c788d061c6039fb0ae9512f50ee90bbeec5a80;Sat Nov 13 23:50:46 EST 2004;Committer;nahi;2;14;2;16;0
d51f21cee00312a4581623e6b5481174d333ba74;Fri Nov 12 08:33:17 EST 2004;Committer;usa;3;7;2;9;0
6069640f88a2f71dd2a3b538a45915bd930902ff;Fri Nov 12 06:16:03 EST 2004;Committer;usa;1;3;3;6;0
c4ce79084f4a09fc8ee78df409a863257c7d53ea;Fri Nov 12 06:15:40 EST 2004;Committer;usa;4;19;13;32;0
47fa2caf2ec0ea135050d299d452331dd0d1a75d;Fri Nov 12 05:09:37 EST 2004;Committer;nagai;3;18;14;32;0
9f3d5e71720dc450731ba6e50d589fd5c3c65757;Thu Nov 11 08:59:20 EST 2004;Committer;matz;3;10;5;15;0
0935d9536957260d33db5546145c4397912c717e;Thu Nov 11 07:56:38 EST 2004;Committer;usa;2;8;3;11;0
f6f53011791183b461d748e3fec283f52a9c5394;Thu Nov 11 01:38:51 EST 2004;Committer;eban;1;3;3;6;0
20beabcb68e0b94f2f4509ca101948abc894bb6a;Wed Nov 10 16:53:26 EST 2004;Committer;nobu;2;6;1;7;0
7eaf299bf2434d3005ef83f7d374117bb9b233e3;Wed Nov 10 13:52:08 EST 2004;Committer;matz;2;15;8;23;0
765c6a80e60df2f4dedfe055cb06534c4a62c9d3;Wed Nov 10 10:48:01 EST 2004;Committer;nobu;2;6;2;8;0
683400f4278fe0db00592c06522979be845bcc45;Wed Nov 10 07:17:53 EST 2004;Committer;matz;9;126;86;212;0
63b9174a64ab16045924d5ec053303b81e91dc16;Wed Nov 10 03:31:55 EST 2004;Committer;nobu;2;5;2;7;0
cd84994255d9f33172021b1f74621fd93ff0c57a;Tue Nov 09 18:35:52 EST 2004;Committer;nagai;4;22;0;22;0
3df602c018cabf965ebaaefd53ca0a9665428493;Tue Nov 09 16:45:14 EST 2004;Committer;eban;1;3;3;6;0
877d48c8ae1d7d217453dff3c9b8208f9955e864;Tue Nov 09 16:40:34 EST 2004;Committer;naruse;1;8;0;8;0
4849f57d7ba0af0fd50e7d9c3bbc623c9e9cd063;Tue Nov 09 13:34:43 EST 2004;Committer;naruse;1;2;2;4;0
7b791b208a18853a6a85b748edbd368ce9e96385;Tue Nov 09 13:25:54 EST 2004;Committer;naruse;1;246;135;381;0
cf943041cc2229cbe91bd036525c47e741219730;Tue Nov 09 13:24:07 EST 2004;Committer;naruse;1;12;9;21;0
f441603f2aa42694056de947ab5b1a9e5103e6c4;Tue Nov 09 13:23:05 EST 2004;Committer;naruse;1;98;86;184;0
4c718c753e4fa121c76fa5d73055f2d92c0fce8f;Tue Nov 09 05:27:58 EST 2004;Committer;nobu;3;83;45;128;0
7c5c394f097819c30bb7955704a0f5030d0b1743;Mon Nov 08 15:57:31 EST 2004;Committer;eban;1;3;3;6;0
79c4db675a5c523f5d6c780dffe30f3ff51ad567;Mon Nov 08 15:55:23 EST 2004;Committer;dave;3;7;12;19;0
8b9422f5023e300ef03a4f606dc9f747d07a700e;Mon Nov 08 15:45:31 EST 2004;Committer;seki;3;10;2;12;0
37abc5eaa3303c83f790c6727f3af2860ebdf2fd;Mon Nov 08 13:25:26 EST 2004;Committer;dave;2;8;1;9;0
d9bde4fcbec4232ec6e90e2b056ca55b839f9fdb;Sun Nov 07 15:19:36 EST 2004;Committer;eban;1;3;3;6;0
495358834c9a8c98c8c866a639ef37df6486aeca;Sun Nov 07 15:16:27 EST 2004;Committer;eban;2;10;0;10;0
c2ac862f1a3a1d387f65d4cd6342b4a836b03893;Sun Nov 07 14:53:02 EST 2004;Committer;nagai;10;98;74;172;0
4cbaddcf8c61f411d54c2e7799e234972dd382ed;Sat Nov 06 11:42:35 EST 2004;Committer;suke;3;22;6;28;0
e015d893529064c414d1f27c058dfc0f882dbb68;Sat Nov 06 03:44:44 EST 2004;Committer;eban;1;3;3;6;0
033709e5e4ccc65b0943e3fdcce23dbbbaf67de9;Sat Nov 06 02:24:35 EST 2004;Committer;tadf;2;11;3;14;0
e527b8d876e87111ec9ddead686ef63f6331e670;Fri Nov 05 13:34:26 EST 2004;Committer;eban;1;3;3;6;0
eac79e135c19db06f20c6bf0d13d231bd004c37e;Fri Nov 05 10:09:53 EST 2004;Committer;naruse;1;4;0;4;0
8b60d65bcb516df0dc0a5f0de695fc5de8231f06;Fri Nov 05 10:07:16 EST 2004;Committer;naruse;2;131;19;150;0
27425a52ba53d99551b2fd0d8dae672f3f423e64;Fri Nov 05 09:15:18 EST 2004;Committer;nagai;4;38;17;55;0
ff814d4c375e19d246b29ce738c69fca9c3fdbe3;Fri Nov 05 07:07:39 EST 2004;Committer;nagai;2;10;2;12;0
4286469353c57c5a57133e27e3db01431b4f5b0f;Fri Nov 05 04:24:03 EST 2004;Committer;nagai;2;5;1;6;0
91192d19a9c76de20dd5e48bfcf30fa39799c0ef;Fri Nov 05 04:19:16 EST 2004;Committer;nagai;2;6;2;8;0
28d67a0bfebaeeb61f436a6d1f38909f823061c7;Thu Nov 04 23:43:40 EST 2004;Committer;matz;4;12;2;14;0
47548dd33e4cb2cd747f746262a4777bd214e485;Thu Nov 04 14:57:11 EST 2004;Committer;ksaito;4;7;37;44;0
82cb9eaa3bb49a77df4452cfdff18f817ecf63a6;Thu Nov 04 14:43:08 EST 2004;Committer;ksaito;9;1884;1286;3170;0
5e853c811ce1d6d6edc187e580a14133667e1058;Thu Nov 04 14:31:26 EST 2004;Committer;ksaito;9;1203;498;1701;0
67ae0fb9aced8cf56de10a1fd400a236bd753b60;Thu Nov 04 12:27:57 EST 2004;Committer;matz;3;17;11;28;0
e4a65e442737a45016db4a36ffcf3b41df01c707;Thu Nov 04 12:12:59 EST 2004;Committer;suke;2;41;5;46;0
e42cec58db09dc222c5d145fa4636a4f2da39e1c;Thu Nov 04 06:03:53 EST 2004;Committer;nagai;2;12;0;12;0
cc0da70929d7fe0092f78d32011c8bc4343976e5;Thu Nov 04 03:33:04 EST 2004;Committer;eban;1;3;3;6;0
27715649f4de175dc19e29c5bea6c323abb4b0d2;Thu Nov 04 00:53:21 EST 2004;Committer;matz;4;21;3;24;0
77d3f40c90ca3c28c8fa2ad3456f49c07a535267;Wed Nov 03 13:29:42 EST 2004;Committer;gotoyuzo;2;7;2;9;0
cfc8755fafda7339ed48aba960f01e7fb9c1e560;Wed Nov 03 11:35:27 EST 2004;Committer;suke;1;371;68;439;0
3be03e9294e208bb0f158a1dd91c31e93dcd96fd;Wed Nov 03 11:34:57 EST 2004;Committer;matz;5;26;14;40;0
39c871c925cd76c2e61d2741fdc920869da3356b;Wed Nov 03 08:09:55 EST 2004;Committer;nagai;15;105;47;152;0
1ae00aafd10e5ba76b86d346abba9ce9f3478a1b;Wed Nov 03 07:05:29 EST 2004;Committer;eban;1;3;3;6;0
d5b6a7b16947aaf4821d6b76c7de153866fb30c0;Wed Nov 03 06:43:18 EST 2004;Committer;kou;25;146;84;230;0
0b4597eccfb5ee078e546c910f2f3cee31d3274b;Tue Nov 02 07:38:21 EST 2004;Committer;matz;2;10;8;18;0
7b45f992889e20ff28efa8bbc5c2b000704c6b59;Tue Nov 02 05:54:45 EST 2004;Committer;usa;2;7;0;7;0
4727632f01cb1aea1fd5fe7adf29803380ed2b26;Tue Nov 02 05:33:11 EST 2004;Committer;matz;2;28;27;55;0
b3a1381e9b46ddae13af0a31b0410bcc992e7375;Tue Nov 02 01:48:41 EST 2004;Committer;eban;1;3;3;6;0
1d1b8102bcb38b982855395e97067139190de1d8;Mon Nov 01 23:49:16 EST 2004;Committer;matz;6;47;61;108;0
c2d8185ba63818aee5457b178aa2e85a9e81b053;Mon Nov 01 13:30:08 EST 2004;Committer;kou;4;61;18;79;0
0aeea1ad38b6e033fd18ed1594c4fa4404710e53;Mon Nov 01 10:41:08 EST 2004;Committer;eban;3;18;58;76;0
49fb289ea1a328c5b680fe718589a3532183b747;Mon Nov 01 10:13:52 EST 2004;Committer;eban;34;2;2166;2168;0
a39967d06218736fe8a6e366f1dfc6e1f2dfdb06;Mon Nov 01 05:04:04 EST 2004;Committer;eban;5;15;3;18;0
aa23bfaf08fb8eafa9c48fc0c3d79afc21ad3bf9;Mon Nov 01 02:55:29 EST 2004;Committer;usa;2;7;3;10;0
d84edcfd73b3779657a5b142882559ce1174338b;Mon Nov 01 02:49:06 EST 2004;Committer;eban;2;5;1;6;0
74f50ab6888834b5e02743c5a7fab75b8d59cec3;Mon Nov 01 02:46:09 EST 2004;Committer;eban;1;4;4;8;0
4fc4f5215bbbd24dfd744348fd3aff2baedf075e;Mon Nov 01 00:43:47 EST 2004;Committer;kou;3;38;0;38;0
8db864c99979a0e97d39c47f4345e440f8617a63;Sun Oct 31 17:37:52 EST 2004;Committer;matz;6;73;70;143;0
b7e13d867771826578450651558bc5233bbd040c;Sun Oct 31 15:04:15 EST 2004;Committer;naruse;1;4;0;4;0
a8966861e81e8df30ee683b5ba050c1fd3f82ecc;Sun Oct 31 14:37:08 EST 2004;Committer;naruse;1;5;0;5;0
ac0fc7798dcf1044e40c978a2e40c213ffd239ad;Sun Oct 31 14:24:29 EST 2004;Committer;eban;1;1;1;2;0
b16206503c8623109ca58d39fc3f8be44a56f82f;Sun Oct 31 14:21:11 EST 2004;Committer;eban;1;16;0;16;0
d58d59b0a4fa6859a3d3efd1a9d40832c3007ecf;Sun Oct 31 14:14:21 EST 2004;Committer;kou;21;2673;3;2676;0
c6cf2e24fe9895b84308374017100cb77900d6db;Sun Oct 31 07:59:58 EST 2004;Committer;suke;3;109;6;115;0
6d63dce6cb1a228182eeb6cc8f8c76afec5cfc49;Sun Oct 31 05:37:09 EST 2004;Committer;eban;2;8;3;11;0
97d9e12e079a0e4e81d4d85fe99d96d0eefb0456;Sun Oct 31 05:33:15 EST 2004;Committer;eban;1;3;3;6;0
cf49a01eaebda0dd89e927f11c15cc8ce03fcadf;Sun Oct 31 05:22:58 EST 2004;Committer;aamine;2;53;60;113;0
1c0b6e5829d3f4afcddba8fe50bb5eb874c1ec9a;Sat Oct 30 08:17:40 EDT 2004;Committer;eban;1;1;0;1;0
1263b697626c7870e163d2f64d33c92033363448;Sat Oct 30 08:16:19 EDT 2004;Committer;eban;1;3;3;6;0
3e9e2bd4ed14de63e8e18e779a5e8c1060ea5bcf;Sat Oct 30 06:56:18 EDT 2004;Committer;matz;17;116;89;205;0
ad2c05f1c0947cbcc5dd86b00dda06bf4c391692;Sat Oct 30 06:25:00 EDT 2004;Committer;suke;6;972;190;1162;0
7dc3169658a6c89aebabd02a3244ce3e3d29ad45;Fri Oct 29 23:22:57 EDT 2004;Committer;akr;1;5;1;6;0
1bc4363c5e75dbe5b544a03b9cb2b115b26c9536;Fri Oct 29 22:45:13 EDT 2004;Committer;akr;2;8;0;8;0
9f5f676d82fbf68e81c7d592a4f45fab7dd425bc;Fri Oct 29 12:28:32 EDT 2004;Committer;nobu;4;19;2;21;0
b99f22f19681191a4014579d69c870145cc3ee7a;Fri Oct 29 10:59:34 EDT 2004;Committer;naruse;1;0;1900;1900;0
bf31fe3ed0429f5d4f5cb0604932aab29e6ff222;Fri Oct 29 10:11:22 EDT 2004;Committer;naruse;1;4;0;4;0
6b8e5b303f8692a61e7197a714d4b3d608880eaf;Fri Oct 29 08:43:10 EDT 2004;Committer;nobu;1;25;25;50;0
61edd31bf661cde8296de5db15796d7d4b2d1330;Fri Oct 29 08:19:50 EDT 2004;Committer;usa;3;11;2;13;0
7c04db1d3cd29185ab7047527e4c7d4e44b75e08;Fri Oct 29 08:08:16 EDT 2004;Committer;matz;3;24;4;28;0
6d25a97ca06276ca76dfe248ba76b7417e034657;Fri Oct 29 06:55:08 EDT 2004;Committer;naruse;3;9424;0;9424;0
35b917f3ee63fc2251e3d4fc063a48f2d91bb96c;Fri Oct 29 06:51:33 EDT 2004;Committer;naruse;4;782;148;930;0
640fad68cc5061b1fef782a842f1e4f038107883;Fri Oct 29 06:51:33 EDT 2004;Committer;naruse;1;1;1;2;0
1b66559c660a307598c58a1d37439baa916ab97c;Fri Oct 29 02:35:11 EDT 2004;Committer;nobu;2;11;4;15;0
e954bfb6ef6f0fd050c8e3035ec6edf3d25b70d6;Fri Oct 29 02:13:36 EDT 2004;Committer;eban;1;3;3;6;0
b0dee8f90d4ffe30cff0047df263b6098ffaed51;Fri Oct 29 01:06:37 EDT 2004;Committer;matz;5;17;6;23;0
80e9b8f29556a7ec50504cc289d38d593b523d1f;Wed Oct 27 16:42:43 EDT 2004;Committer;eban;1;3;3;6;0
4fabf1184087e7d50d8f5a466ab10d74d006a02d;Wed Oct 27 15:23:16 EDT 2004;Committer;nobu;1;1;1;2;0
018837b84f26adf1dd43ff0f41b211a41f5289e8;Wed Oct 27 09:29:26 EDT 2004;Committer;matz;18;149;80;229;0
6ffdbac5edcdeb0a9c916735cab125674c5a693d;Wed Oct 27 00:19:40 EDT 2004;Committer;nobu;1;3;3;6;0
ee51d0f9fd224695cbdb2b0b36ddb00bbdf69eaf;Wed Oct 27 00:18:08 EDT 2004;Committer;nobu;2;36;29;65;0
c7b31b00480fe6d363fe372e58a02fcfda05db85;Tue Oct 26 14:59:41 EDT 2004;Committer;eban;1;3;3;6;0
3ecf38f376ff520e0e1d49f3c6a601af69cfac9b;Tue Oct 26 14:33:17 EDT 2004;Committer;dave;2;7;1;8;0
b088595db7298ce80bc33e982450d97ec6d1ef62;Mon Oct 25 09:40:55 EDT 2004;Committer;eban;2;9;2;11;0
cdb66dc2483f62bc28f1fe8892d04f645b07b0b4;Mon Oct 25 00:03:22 EDT 2004;Committer;nobu;1;3;3;6;0
da1265564a0406050ee14dc25f0f4377ea930ae1;Sun Oct 24 23:04:04 EDT 2004;Committer;nobu;2;5;1;6;0
9f196e03cb90483dda162d8bf0ed6f3b3b6f8b2d;Sun Oct 24 13:13:12 EDT 2004;Committer;nagai;2;5;1;6;0
eba5641496f6d9afe2008de449016f52207119be;Sat Oct 23 15:43:25 EDT 2004;Committer;eban;1;3;3;6;0
d0c2e3c7c95302c70a19b3d1d34bcb67da9f982f;Sat Oct 23 15:41:17 EDT 2004;Committer;nobu;3;20;3;23;0
9c65d88c0e0bf5c148f6f591edd7f440bc4e4bf6;Sat Oct 23 06:53:11 EDT 2004;Committer;matz;3;26;12;38;0
a0f6bcf93ff3922f44ba73d61e735b2256d54912;Sat Oct 23 06:21:26 EDT 2004;Committer;eban;1;3;3;6;0
0748ee8b900a80228b4eb83152ba4d84f76b3366;Sat Oct 23 06:05:15 EDT 2004;Committer;ttate;1;2;2;4;0
3377aebed4fafbc40e873a4923af39d96c249fe7;Fri Oct 22 15:28:13 EDT 2004;Committer;matz;2;8;9;17;0
1419b789ab827452d1c91c552ec0c121b93b9b0e;Fri Oct 22 03:05:10 EDT 2004;Committer;matz;2;11;4;15;0
e7a1207dcddfd839b1162de4553f8e33ee56b325;Fri Oct 22 01:38:42 EDT 2004;Committer;gotoyuzo;2;6;1;7;0
d9d60e8c1258bda8f730a91c78458622034909a5;Thu Oct 21 16:13:32 EDT 2004;Committer;matz;4;20;1;21;0
9cd654ea2645598d088eb6e54c6957084bb2966d;Thu Oct 21 15:23:57 EDT 2004;Committer;eban;1;3;3;6;0
0f3decb07100e63ccfa9f7a986c80f643a9bef1a;Thu Oct 21 15:21:08 EDT 2004;Committer;nobu;2;7;9;16;0
9ec1f6d27eb7eced0c91cf121ca6af5682276dc4;Thu Oct 21 15:10:06 EDT 2004;Committer;suke;5;17;2;19;0
b8f68de2be55082cb7b7478d7fa1f5a34db0dd06;Thu Oct 21 10:10:52 EDT 2004;Committer;gotoyuzo;2;24;16;40;0
2870c4d1a65e17e05fead85d526765306f44ac93;Thu Oct 21 04:16:40 EDT 2004;Committer;eban;2;7;3;10;0
e84d895ad40b41496229206b9c1d46140134dea4;Wed Oct 20 16:10:42 EDT 2004;Committer;eban;1;3;3;6;0
7d7d82463df6f5b163507e2ff7eb5916866cdc88;Wed Oct 20 15:44:06 EDT 2004;Committer;matz;4;17;0;17;0
93931a0d9394fce698d2821a02ecd4305ae9195d;Wed Oct 20 10:40:26 EDT 2004;Committer;nobu;1;5;0;5;0
fbdc2bf5f70aa594eac63d27079708ae739a0481;Wed Oct 20 06:53:42 EDT 2004;Committer;matz;4;13;4;17;0
30544883773f979b123ac9d00776cfcdf9c5c82c;Wed Oct 20 03:42:53 EDT 2004;Committer;nobu;1;1;1;2;0
e447cd5add7e3357c6e8e117e48cb5d1d1c2d1a8;Wed Oct 20 01:39:17 EDT 2004;Committer;eban;1;3;3;6;0
db318b86b99d7d690460aea82bbe731a54b66656;Wed Oct 20 01:39:04 EDT 2004;Committer;eban;1;1;0;1;0
3f075b9ac9063a037456a2828a9478cc323fdb2e;Wed Oct 20 01:38:04 EDT 2004;Committer;nobu;3;13;0;13;0
c1c101e752f483d4956f66fd567ec86d0274899a;Wed Oct 20 00:52:42 EDT 2004;Committer;nobu;1;16;0;16;0
39ecad1339f5c41eff1ca54155c0dea4c566e13c;Tue Oct 19 19:49:49 EDT 2004;Committer;matz;3;9;0;9;0
9f6b3edcd65e2f62f38106495f03f986f6dc9673;Tue Oct 19 19:17:33 EDT 2004;Committer;matz;6;78;21;99;0
b9ec9b69a92432c5566f7a7981945dfe1c2c6d18;Tue Oct 19 16:21:50 EDT 2004;Committer;dave;1;5;0;5;0
60a7b3a935ebb02703a80f4aa8888d3ac3fcfc98;Tue Oct 19 15:25:49 EDT 2004;Committer;nobu;2;6;5;11;0
db00c782f4d477e04217b8da9782d9fe3c515675;Tue Oct 19 14:59:52 EDT 2004;Committer;nobu;2;13;8;21;0
d43b40dbddde5d5bdb9efbf63978507d4f08d762;Tue Oct 19 13:46:05 EDT 2004;Committer;dave;2;7;1;8;0
05a43e2367ca8961e733d5434b474da14126d68b;Tue Oct 19 11:40:33 EDT 2004;Committer;suke;2;13;6;19;0
1057902ac7bc51a9d6c852e6cd778498acbed869;Tue Oct 19 10:25:23 EDT 2004;Committer;matz;19;126;124;250;0
c0700eba8dd91c3f2c070670cc448ba704effd78;Tue Oct 19 00:07:23 EDT 2004;Committer;nobu;1;3;3;6;0
9bd744a09284411b8cd7817c762187174199d734;Tue Oct 19 00:03:01 EDT 2004;Committer;nobu;1;38;38;76;0
39324f819fbdf6edd27624b6aa8eb1d3c9d135cc;Mon Oct 18 23:47:32 EDT 2004;Committer;nobu;3;64;56;120;0
f2549e0bf7e73a85f2ddd24c813331110a47fd9d;Mon Oct 18 14:37:42 EDT 2004;Committer;nobu;2;6;1;7;0
79e68a49d9831a3ab224ad4ebb881772e6636191;Mon Oct 18 02:40:13 EDT 2004;Committer;eban;1;1;0;1;0
0fdb2ae104d9a4a2ef4885d19860b2dff09cc42a;Mon Oct 18 02:29:43 EDT 2004;Committer;nobu;3;11;2;13;0
6a6773b969b67af6395e022c64c1424372bf324c;Sun Oct 17 22:28:29 EDT 2004;Committer;nobu;1;3;3;6;0
2cb2ef977cfec135ae81e251c565b037c6208bc2;Sun Oct 17 22:26:58 EDT 2004;Committer;nobu;2;10;1;11;0
96bd1643a073c83b17e0e62229e7bdc1a6ba6390;Sun Oct 17 16:57:44 EDT 2004;Committer;gotoyuzo;2;9;2;11;0
6fb00e8a1ff95de610143e7076209c58c19f5f59;Sun Oct 17 14:05:19 EDT 2004;Committer;nagai;2;15;5;20;0
fa420ca48a6e1f651e2f8539d6762ca6d03a01d3;Sun Oct 17 09:26:15 EDT 2004;Committer;usa;1;3;3;6;0
deaed319749127c09e90ed4930e0b228778c082d;Sun Oct 17 04:02:16 EDT 2004;Committer;suke;3;30;14;44;0
42dc25803157b11ed566874d0126e8faff9bfaa6;Sat Oct 16 05:47:17 EDT 2004;Committer;kou;2;5;1;6;0
891ad83098840851fb16f7ec4a664fc664792df0;Sat Oct 16 04:51:15 EDT 2004;Committer;kou;27;4275;4269;8544;0
0ebac90b0ebb07ad2aa99080c8509559a7ddc74d;Sat Oct 16 04:39:58 EDT 2004;Committer;kou;8;210;154;364;0
64422ae4941480634fbc2788d73ec3ba44c70b4b;Sat Oct 16 02:13:54 EDT 2004;Committer;nagai;3;118;0;118;0
af6061e50b56806cb62c72ce305fde0eb3834c6b;Sat Oct 16 01:59:44 EDT 2004;Committer;eban;1;3;3;6;0
740b2d99ce1998317f8db74b6a7a69f936a94575;Sat Oct 16 01:56:44 EDT 2004;Committer;nobu;2;7;3;10;0
f282f05fbca84d6b72a82279508992785f21dd29;Fri Oct 15 14:49:44 EDT 2004;Committer;suke;1;1;0;1;0
4e5c3ea0dc679d25d7565d7e986ece01d64eb984;Fri Oct 15 14:43:39 EDT 2004;Committer;suke;1;1;0;1;0
52d096987b657ea49a6723d6e3ac1d034e2882b1;Fri Oct 15 09:24:29 EDT 2004;Committer;eban;1;3;3;6;0
8c1b803ed4435edda2c47cc1a559af4bdb88b7d9;Fri Oct 15 09:16:19 EDT 2004;Committer;gotoyuzo;3;72;3;75;0
bb4e34110bcd2b50a256877c3c26d1765baf74e6;Fri Oct 15 09:06:52 EDT 2004;Committer;nagai;2;42;14;56;0
5677755baedd9d9e7271316276abd7afe798bfda;Fri Oct 15 03:54:02 EDT 2004;Committer;akr;2;6;1;7;0
8069e3f8e77d160c08bee614964dc499a131e90f;Thu Oct 14 04:42:47 EDT 2004;Committer;eban;1;3;3;6;0
56d7198e55338b0373e63213fd57762be22e3679;Thu Oct 14 04:36:35 EDT 2004;Committer;kou;2;5;0;5;0
385edf1e5c6dd5465067bae293844e640e9887a2;Tue Oct 12 12:26:39 EDT 2004;Committer;gotoyuzo;6;165;31;196;0
90b337ce3702db3bf12a9bc13bd36c39ccef9c7e;Tue Oct 12 06:07:42 EDT 2004;Committer;eban;1;3;3;6;0
1d81baaf36860e0638f3d4691442e6974c5bb835;Tue Oct 12 06:07:01 EDT 2004;Committer;eban;2;6;2;8;0
6c2684ab953fdf01ca8a8986e410c630c4f2fc43;Mon Oct 11 07:39:51 EDT 2004;Committer;eban;1;3;3;6;0
3514110b89bee5c37e308b4ca887e66dfe841456;Mon Oct 11 04:51:21 EDT 2004;Committer;nagai;296;13911;13878;27789;0
05f5928c9d0f094d1e7e21a9bd9d8a8fc2f1a805;Sun Oct 10 05:56:09 EDT 2004;Committer;eban;1;3;3;6;0
f5666a648d0424e0b58ad636f3db762a3eedfa17;Sun Oct 10 03:35:51 EDT 2004;Committer;dave;3;13;1;14;0
1344cfba26ac2ecbb206ddbb13e1a31dafceaba3;Sat Oct 09 18:20:46 EDT 2004;Committer;aamine;1;40;14;54;0
493bcc9b6475f5e2abc5548474bfac50f0fe4294;Sat Oct 09 17:49:41 EDT 2004;Committer;aamine;2;8;2;10;0
580a9e70e2a35d1c5de6632d7d434c206173e1fe;Sat Oct 09 17:45:20 EDT 2004;Committer;aamine;2;5;0;5;0
3f5c0f4f6ff6a34189d578ed7f6bfbb240400109;Sat Oct 09 12:30:52 EDT 2004;Committer;kou;3;16;8;24;0
abc8e89324000d16aefd5c04c7920f60b0707b6a;Sat Oct 09 11:57:51 EDT 2004;Committer;eban;1;3;3;6;0
126cd9d01ecea6d268ba73abda88e7fd0022ea0b;Sat Oct 09 11:53:16 EDT 2004;Committer;akr;2;12;0;12;0
225f22cd9a2cc135652393570a32723d53e0e7e0;Sat Oct 09 10:51:11 EDT 2004;Committer;nobu;2;8;3;11;0
e9f4ad970a876fa65d3476df9a85c2a28a8137c5;Fri Oct 08 12:37:19 EDT 2004;Committer;aamine;2;11;3;14;0
1f1d15f8994206f52d04c5dc55820eef02bee900;Fri Oct 08 04:08:06 EDT 2004;Committer;eban;1;3;3;6;0
5de7917c8e3014dfea6fa3efa88fc17049aff273;Fri Oct 08 03:36:54 EDT 2004;Committer;matz;2;8;0;8;0
d2eea09f4a1f67faccac9c99bb1e54e49f3e507d;Thu Oct 07 16:14:29 EDT 2004;Committer;nagai;2;38;21;59;0
c2f8cec766967673fe59f30c8bd3cf2d5d011250;Thu Oct 07 14:50:59 EDT 2004;Committer;nagai;2;17;2;19;0
046d4e7ee113eac1c6a9ab848adb978c07b06aae;Thu Oct 07 08:38:03 EDT 2004;Committer;nagai;2;15;1;16;0
607314595a4b9a69b21b06ce2593a9031c98c0c8;Thu Oct 07 05:54:28 EDT 2004;Committer;matz;2;4;1;5;0
6299619da97a74a4f0e303d069ab5fd1d781a79e;Thu Oct 07 04:06:41 EDT 2004;Committer;matz;3;10;2;12;0
2ed1cdbb0da44d346fc57a4f583392a8636bfd6b;Thu Oct 07 02:33:37 EDT 2004;Committer;akr;1;2;2;4;0
790fa9041acff067083ba3315be5ee944ace8fb2;Wed Oct 06 17:57:19 EDT 2004;Committer;nobu;2;8;5;13;0
cb5a59ebd58fbdf28154b597c59fda1ca4c5f9c3;Wed Oct 06 16:11:52 EDT 2004;Committer;eban;1;3;3;6;0
fd6f4e20cca447022fa931ebde362341645cb0a6;Wed Oct 06 16:08:45 EDT 2004;Committer;nagai;5;22;2;24;0
7f5cf7a100555ddf4deee2a6dfe776ffb3ed6334;Wed Oct 06 15:10:43 EDT 2004;Committer;matz;2;13;6;19;0
1af24252b8d6b7e8ea56d150978d3a5ac352c5b5;Wed Oct 06 08:04:23 EDT 2004;Committer;eban;1;3;3;6;0
9a2c853b971fc4220bfe45f23ef8077dd6604ea1;Wed Oct 06 08:02:34 EDT 2004;Committer;eban;1;1;1;2;0
fbb88b011aab36a5d3bed8be3098b9d4d439cee1;Wed Oct 06 07:40:06 EDT 2004;Committer;matz;13;90;89;179;0
3d17082a50358d83da7f65e923b5559dd8b20ca5;Tue Oct 05 09:13:49 EDT 2004;Committer;eban;1;1;1;2;0
ef8cfca7f9a2cd18bb3e78ad04159af3f93448c4;Tue Oct 05 02:31:42 EDT 2004;Committer;eban;1;3;3;6;0
c800d0b75d23e2ac8c10674ff41cc25b0c793ddd;Tue Oct 05 01:37:46 EDT 2004;Committer;matz;7;133;87;220;0
889a620b769145a7c20c7ce78aff62d80e485496;Mon Oct 04 05:04:22 EDT 2004;Committer;nobu;2;17;9;26;0
2547b0c073030b2058957e63e1fa7db3f6985c2c;Mon Oct 04 04:01:47 EDT 2004;Committer;eban;1;3;3;6;0
581ca6097ea061e7b348ed098ca56f809aba4499;Mon Oct 04 03:56:00 EDT 2004;Committer;nagai;6;90;1;91;0
6e8ae612bac85ad5bb421170d62b41c4533d8165;Sun Oct 03 12:21:35 EDT 2004;Committer;shugo;2;12;3;15;0
92578ab007d3b2faff4398c69f2f64b72ea2abea;Sun Oct 03 06:20:55 EDT 2004;Committer;eban;1;3;3;6;0
97ad41b50bdba3113d9ba39dfb9587a2c7ea5a5e;Sun Oct 03 06:20:40 EDT 2004;Committer;eban;1;1;0;1;0
2bd403488dc63afcd76f1bd724260a6c41a778ed;Sun Oct 03 06:09:54 EDT 2004;Committer;akr;1;1;1;2;0
129c02057e50ab1c4b016ac352af65f853668986;Sun Oct 03 06:02:55 EDT 2004;Committer;akr;1;19;0;19;0
3e7c55fb005f1860ffdd31fdaed719f9818f00ba;Sat Oct 02 11:34:13 EDT 2004;Committer;nobu;3;106;55;161;0
77636d0364d5df961834b64bff1a3bc8f50ce259;Sat Oct 02 11:30:40 EDT 2004;Committer;matz;3;8;2;10;0
779f3d6d11146c5c4e6acfff3c1c05f404387cf0;Sat Oct 02 07:57:32 EDT 2004;Committer;matz;3;24;16;40;0
9d923be60446cd599094d12f259b7fee173ec875;Sat Oct 02 03:49:15 EDT 2004;Committer;matz;2;7;4;11;0
7665754a5a6cb8903d4892e3d00e709d5de7f0b6;Fri Oct 01 16:03:06 EDT 2004;Committer;eban;1;4;4;8;0
1b4d97ddba6b3190a4aecad2c6159e6ecd63604e;Fri Oct 01 15:56:05 EDT 2004;Committer;matz;9;84;39;123;0
8e292f628567bad4b7e67d0fea28138785775651;Fri Oct 01 02:27:03 EDT 2004;Committer;nagai;4;14;3;17;0
c6655d70685d1c15c6dad853069101b37838e63d;Thu Sep 30 01:56:09 EDT 2004;Committer;eban;1;3;3;6;0
83185f9ff097beb2946a5abf41c2b180db152f17;Wed Sep 29 15:54:32 EDT 2004;Committer;nagai;8;133;10;143;0
30116ff8c286c91090722f4d6aada2cc47fcae7e;Wed Sep 29 05:15:33 EDT 2004;Committer;matz;8;132;76;208;0
c0e71a8a97b907ab934d02d3cc4d9e55538a2e5f;Wed Sep 29 02:13:08 EDT 2004;Committer;eban;1;3;3;6;0
3615015df08416dbc83393d4bf8f4906ae4c7242;Wed Sep 29 01:58:43 EDT 2004;Committer;nobu;2;6;0;6;0
cf729ce62bdc8f645c22aebc502a81e5ff0dc949;Mon Sep 27 12:32:05 EDT 2004;Committer;nobu;1;1;1;2;0
6f42276d057e947c1c675da089512383adc85e52;Mon Sep 27 12:25:21 EDT 2004;Committer;nobu;4;75;42;117;0
2352c318ca7e5e4d049ffc640bf49ddf3344f9a1;Mon Sep 27 10:45:56 EDT 2004;Committer;eban;1;3;3;6;0
18c4d3543140874af79b3e78863a456f7922bc6f;Mon Sep 27 06:02:27 EDT 2004;Committer;aamine;2;5;1;6;0
0bedb2e07f50044ef9625c6d71d1e73f4d9fc977;Mon Sep 27 04:46:54 EDT 2004;Committer;nobu;4;28;25;53;0
ddd5b50d1271cb7a910d67ceeb0be25c6c256673;Sun Sep 26 02:53:28 EDT 2004;Committer;eban;1;3;3;6;0
c26e86fd1bb18d3842c95f61e2cfcf15072d76f4;Sat Sep 25 23:10:36 EDT 2004;Committer;tadf;3;81;32;113;0
7e827e66944e4a04c64eb72dde794e81e9d0d1b0;Fri Sep 24 19:05:07 EDT 2004;Committer;nobu;2;24;19;43;0
08f84dcf44711d4ae397e01f1e402386622395a2;Fri Sep 24 16:58:51 EDT 2004;Committer;matz;3;36;6;42;0
7c29bcfb039de815d393299b05cb7b349f2301e7;Fri Sep 24 06:00:57 EDT 2004;Committer;eban;1;3;3;6;0
c0a998d027eac8e9dc6d85b4b56c5e5bc87024a0;Fri Sep 24 05:53:43 EDT 2004;Committer;matz;11;196;155;351;0
0c9d76889af8e00a946dbe8de33568fc87bdd983;Thu Sep 23 10:49:11 EDT 2004;Committer;aamine;14;1424;1411;2835;0
bf189b88d34f23b1f4e7709fd6c9b947cd5073e7;Thu Sep 23 00:53:21 EDT 2004;Committer;matz;1;0;1;1;0
959176599c7ec65637287cf43b9f85d0324d4f9a;Thu Sep 23 00:52:23 EDT 2004;Committer;matz;1;0;3;3;0
f1f0f39e036daa8940996d2957f8756d4db08cdb;Thu Sep 23 00:51:32 EDT 2004;Committer;matz;7;76;48;124;0
2c179216717d75837de7a6ff092fd773670f4d11;Wed Sep 22 05:22:50 EDT 2004;Committer;aamine;14;379;287;666;0
61d1dce5a226d3bf8393fd10777db09b046f68e6;Wed Sep 22 04:52:17 EDT 2004;Committer;matz;2;7;4;11;0
0c97c8e33584e6203bb09c08f92b63bd2cca8ae7;Wed Sep 22 04:48:52 EDT 2004;Committer;matz;6;103;49;152;0
56173249ef486db321c8aa01a680966f921f5201;Wed Sep 22 04:05:11 EDT 2004;Committer;usa;2;5;1;6;0
6904429af3edf6b2cff8a87abf65f8cc09788318;Wed Sep 22 01:37:10 EDT 2004;Committer;usa;1;3;3;6;0
136b284b5959a6e71abf46da41b00dce102a0c59;Wed Sep 22 00:19:15 EDT 2004;Committer;matz;8;94;74;168;0
141dae12c51031159bb0fe59be42e3507423d21a;Tue Sep 21 15:13:53 EDT 2004;Committer;dave;2;16;1;17;0
f427cf935299a86fafc4091cd2eb2191ac98fbeb;Tue Sep 21 12:47:48 EDT 2004;Committer;ttate;1;2;2;4;0
bfabc05a4375b84fa128af89337b1195248bd6da;Tue Sep 21 03:08:33 EDT 2004;Committer;matz;11;232;93;325;0
90ae99b0f0505f66a6fc1dfb7d7c631bf4bf76cc;Mon Sep 20 08:47:32 EDT 2004;Committer;aamine;2;4;1;5;0
2c750e368d28af3a14a4e2ab1f7cb20244a41838;Mon Sep 20 08:42:00 EDT 2004;Committer;aamine;3;64;10;74;0
b2a700f13eb406145983ff2f2308ce0f6b1ebbe5;Mon Sep 20 07:59:30 EDT 2004;Committer;aamine;3;44;56;100;0
273d0344a8c25e2f14129d78df4cc7242762f507;Mon Sep 20 07:16:33 EDT 2004;Committer;eban;1;1;0;1;0
d781183f420b9fd144d877994cd4d4851fb520fd;Mon Sep 20 06:18:28 EDT 2004;Committer;aamine;2;39;0;39;0
b1e943f465193fe4d834ba4b8e0e8dc142cfcaef;Mon Sep 20 06:14:09 EDT 2004;Committer;aamine;2;63;19;82;0
3ad7a18275b55449fc1165441dc106651add72f4;Mon Sep 20 05:51:13 EDT 2004;Committer;aamine;2;8;4;12;0
144339d4bce9a8e91d44ee9942dc31d7fd27c239;Mon Sep 20 05:40:23 EDT 2004;Committer;aamine;7;107;57;164;0
9f18c235727fc3875b4423bd1ad7eba69f9520e9;Mon Sep 20 04:23:18 EDT 2004;Committer;aamine;2;8;26;34;0
f2d01d14785e48b78be98fd805fef2c1334d2a71;Mon Sep 20 03:03:12 EDT 2004;Committer;aamine;3;87;130;217;0
917f067885810d3639eee3b12f879fd1e86e9052;Mon Sep 20 02:02:58 EDT 2004;Committer;aamine;2;22;2;24;0
67bb2004b113e6e44bc12aca2795f4cb0ba6d223;Sun Sep 19 19:52:49 EDT 2004;Committer;aamine;1;3;3;6;0
c2c7f4c186d682444b0c02a5fb4befbb54e8be4f;Sun Sep 19 19:49:56 EDT 2004;Committer;aamine;4;260;221;481;0
f43e22190c355fc41fd97c70cbf96436d29fefd1;Sun Sep 19 19:13:19 EDT 2004;Committer;aamine;2;27;30;57;0
0ad4ae91ea6c9c489946a390b231e90c1bf9eedd;Sun Sep 19 18:48:29 EDT 2004;Committer;aamine;6;26;3;29;0
44abd808658570a65df2adca678c746aa0356960;Sun Sep 19 18:42:32 EDT 2004;Committer;akr;4;124;13;137;0
0a4e53a5c5e6ab3093397826cb4ccc2f1ef1a9aa;Fri Sep 17 11:38:49 EDT 2004;Committer;usa;6;19;4;23;0
e77ddaf0d1d421da2f655832a45f237558e23115;Fri Sep 17 09:24:13 EDT 2004;Committer;matz;12;569;587;1156;0
7b66963f61609fe8edea2380cba43289381a43d7;Fri Sep 17 07:09:28 EDT 2004;Committer;nagai;2;71;55;126;0
bdd1ba494be6d02e308b210b14760c529d5d1ef4;Fri Sep 17 06:09:29 EDT 2004;Committer;eban;1;3;3;6;0
27859754890e5562b33ffbb4b89e9f3c9c68df97;Fri Sep 17 06:05:33 EDT 2004;Committer;nagai;7;587;208;795;0
2ce5bb2594fbd6250b60fc9dd49d7735668fa8fa;Thu Sep 16 15:22:20 EDT 2004;Committer;ttate;1;3;2;5;0
5278fa5b48c23254c5351b0524a3e92af396356e;Thu Sep 16 10:04:58 EDT 2004;Committer;eban;1;3;3;6;0
b10696b56840ac6c6eaa5d85f1cf85b6f7cc8a0b;Thu Sep 16 09:14:27 EDT 2004;Committer;gotoyuzo;3;11;1;12;0
4fbcbeb06f208a650116b4a687ab9765404ae781;Wed Sep 15 13:12:15 EDT 2004;Committer;ocean;1;3;3;6;0
3c3785918674ffab7fb3c66fbeec26bd721c6a4f;Wed Sep 15 11:24:22 EDT 2004;Committer;nagai;2;8;3;11;0
011a8516963e68a348d695064d686b80fb93b9fa;Tue Sep 14 14:59:04 EDT 2004;Committer;nagai;3;49;16;65;0
0964c4781652bcdfcf940017722164d2effc69ee;Tue Sep 14 14:49:19 EDT 2004;Committer;dave;3;76;15;91;0
d4e341c43d435c42a9da85beb1c999b721c9dffb;Tue Sep 14 13:11:29 EDT 2004;Committer;aamine;2;55;0;55;0
d3bce8cb5a9c44eb4413aca819bfa4dfeceda221;Tue Sep 14 11:27:36 EDT 2004;Committer;aamine;11;157;185;342;0
26a828a605a6738db2388b6487c6ddef4a48088a;Tue Sep 14 08:23:57 EDT 2004;Committer;eban;1;3;3;6;0
1130f2cbfa9fd9fcaf6e274d63e39d08f6da759c;Tue Sep 14 08:01:55 EDT 2004;Committer;nagai;6;262;116;378;0
07f245da375d80612bf3abd987cf51e69cee6bf2;Mon Sep 13 12:35:25 EDT 2004;Committer;gotoyuzo;4;232;5;237;0
f3721195a939a36457d0fbbe1991b4b9e93f199a;Mon Sep 13 10:20:36 EDT 2004;Committer;eban;2;22;17;39;0
7945cd59785dadaf910346c9f5ce3731d1c86885;Mon Sep 13 07:25:02 EDT 2004;Committer;nagai;3;81;21;102;0
977eb1bae737419eafd3b0cc7ac932c8770e909f;Mon Sep 13 01:50:32 EDT 2004;Committer;usa;2;6;5;11;0
1a1724229e7ed7faa2f066a16ff86f45a3f5908d;Mon Sep 13 01:22:31 EDT 2004;Committer;usa;1;4;0;4;0
03f75020c94533778c395b28a2443e67b55c870b;Mon Sep 13 01:22:16 EDT 2004;Committer;usa;1;1;1;2;0
3f5c91786052ca505a4f148649ccc1751178bbf6;Mon Sep 13 00:30:47 EDT 2004;Committer;aamine;2;8;2;10;0
98258515dd70c65174cb19b09fb93c217957daab;Sun Sep 12 21:44:13 EDT 2004;Committer;aamine;3;26;34;60;0
5cdf9a0a199c1b380140de09ac467c3aa9bdaa69;Sun Sep 12 17:42:49 EDT 2004;Committer;aamine;7;20;0;20;0
c971589817150d1850b06a49e11d11edfc489bbf;Sun Sep 12 17:34:30 EDT 2004;Committer;aamine;25;3911;0;3911;0
5bea219a9d95e58a1b2ad77637776a8e0cade1bf;Sun Sep 12 16:05:59 EDT 2004;Committer;nagai;3;216;44;260;0
a472f971f0e39f16949975b09ca6c7346de3f99b;Sun Sep 12 15:26:19 EDT 2004;Committer;eban;1;3;3;6;0
fcbdda36d920ec280423de30c6eae1da7f3285dc;Sun Sep 12 15:23:41 EDT 2004;Committer;aamine;2;7;3;10;0
b86ccb79738a3aaf41629599a065e434dd81d47d;Sun Sep 12 15:21:49 EDT 2004;Committer;aamine;4;2714;113;2827;0
d7da08aadd3b9768296db3c8744f58dd5e9697e8;Sun Sep 12 14:55:22 EDT 2004;Committer;ocean;2;12;2;14;0
4ad01cad0105baceebea3b5e5afed09abdab48ee;Sun Sep 12 05:27:40 EDT 2004;Committer;eban;1;3;3;6;0
82ba5974c4c1d9ddd6b7374a1efdcd4d4cf7eff6;Sat Sep 11 17:45:53 EDT 2004;Committer;nagai;8;1036;199;1235;0
3e9b083f34aa6fcc2dc9a669fdb26ae7da918613;Sat Sep 11 07:12:51 EDT 2004;Committer;eban;1;3;3;6;0
61503bbf3be79ea46a4147fb135032e2dacee95c;Sat Sep 11 07:11:46 EDT 2004;Committer;dave;3;11;1;12;0
b22110e517bbde446a0f7bd02c78b68c0b46ad33;Fri Sep 10 11:22:31 EDT 2004;Committer;ocean;2;6;1;7;0
6302bcf0227d237a49af37862c335891222af339;Fri Sep 10 10:24:08 EDT 2004;Committer;ocean;4;15;3;18;0
ed1a776ae06b9b11ae7fe86c94f3a76dae969b41;Fri Sep 10 06:56:20 EDT 2004;Committer;aamine;3;16;1;17;0
54876834a680d1e57b2176e9f9f3e460b46ea24c;Fri Sep 10 02:18:26 EDT 2004;Committer;eban;1;3;3;6;0
a7a1ac81daa685757203f2dde746a375bd6ebeb5;Thu Sep 09 17:46:05 EDT 2004;Committer;dave;2;11;1;12;0
d782aad77de15ca3beb8999ed0f829d0db76aa46;Thu Sep 09 05:03:21 EDT 2004;Committer;nagai;3;43;2;45;0
a8fc3fb8b03867cac3b10a71b8c2a06cbcefda10;Thu Sep 09 04:59:04 EDT 2004;Committer;eban;1;3;3;6;0
156ea41fa2169ef730924799e11ec35ed30c2420;Thu Sep 09 02:48:32 EDT 2004;Committer;dave;2;7;2;9;0
a838eb5c65cd937c36c8e0653ecde78913d47d78;Wed Sep 08 09:44:46 EDT 2004;Committer;nobu;3;15;8;23;0
3d8690ebdbb8bec5d828d36fb558c63ae6f4e220;Wed Sep 08 06:52:20 EDT 2004;Committer;eban;1;3;3;6;0
38bbb9673fc0fb69f890e8675d910eea646350f7;Wed Sep 08 06:23:41 EDT 2004;Committer;nagai;5;277;65;342;0
23a48713683a2f03bc8bb619f1fa62765658f6b7;Tue Sep 07 07:11:06 EDT 2004;Committer;akr;1;6;12;18;0
1ae2ac92d2afc114de6f595d3dfdfc4f228c7acc;Tue Sep 07 07:03:51 EDT 2004;Committer;akr;1;12;7;19;0
08907d87e01ba0181b90603e27ec83cd9c285ad8;Tue Sep 07 05:32:26 EDT 2004;Committer;akr;5;110;4;114;0
eb136f8643857119206ccb360e6b85a951a72e5a;Tue Sep 07 03:52:52 EDT 2004;Committer;usa;1;3;3;6;0
f4d60b5f6370651978316dcecf8160781190f91f;Tue Sep 07 03:52:15 EDT 2004;Committer;usa;7;107;9;116;0
70f8c054b2dad9f7f5af7444fa98bfac541b216b;Mon Sep 06 02:03:02 EDT 2004;Committer;ocean;2;5;1;6;0
7818f988b943c2793670c7ecc23d7e8d3c9b9cec;Mon Sep 06 00:50:19 EDT 2004;Committer;usa;1;3;3;6;0
d58885977b5ea50cb177aee491f92386042ae0f5;Mon Sep 06 00:48:03 EDT 2004;Committer;matz;2;10;2;12;0
6faa93ff25dc1c868810910bec9d27a51a68da3d;Sat Sep 04 02:00:51 EDT 2004;Committer;eban;1;3;3;6;0
bf22dff8ea5f3ac94ab1a354abea48fd7c3f272c;Fri Sep 03 17:41:27 EDT 2004;Committer;matz;3;8;23;31;0
880d7af47a66f021712eac17adffac2686d08aad;Fri Sep 03 09:00:52 EDT 2004;Committer;matz;5;43;35;78;0
7cf8256075020e1dd80800807e3d92f3350511e6;Fri Sep 03 02:33:08 EDT 2004;Committer;nagai;2;19;2;21;0
0a054a5fd8f0b9d3a8c711990953988565593f49;Thu Sep 02 17:17:20 EDT 2004;Committer;nagai;8;207;44;251;0
abcd179a2bed3f837384fa14b610ff0d96384826;Thu Sep 02 17:06:58 EDT 2004;Committer;eban;1;3;3;6;0
a7ec244cc7f875936042ea4872c4d4d89eb86d29;Thu Sep 02 16:54:35 EDT 2004;Committer;nobu;2;15;2;17;0
1e1054f3d852ff02612908ded87450d86c5ece0c;Wed Sep 01 12:32:44 EDT 2004;Committer;ocean;1;4;4;8;0
9e73d16db2d4f6215e962c1efa8715acd6e6be1a;Wed Sep 01 12:27:43 EDT 2004;Committer;ocean;2;5;1;6;0
c0a2f6effe65a3d771201b0f532d2beeda1232e6;Wed Sep 01 10:28:45 EDT 2004;Committer;nobu;2;5;2;7;0
3fb0d33b197b41b399740941b295e5271f62ea06;Tue Aug 31 09:24:36 EDT 2004;Committer;ocean;2;7;2;9;0
24053adc1e766d1041c355b070907fe9ac5f5dfe;Tue Aug 31 07:09:49 EDT 2004;Committer;nagai;2;6;0;6;0
b064a106d53441a5caa5283168a9e558f4fedce1;Tue Aug 31 03:49:53 EDT 2004;Committer;eban;1;3;3;6;0
ec76306b0a0f568eaad143e13c094d66cc05ecaa;Tue Aug 31 03:32:33 EDT 2004;Committer;nagai;2;10;1;11;0
f7b90183903672bc8fc77aaa676a34aa6f6a9e07;Mon Aug 30 14:23:19 EDT 2004;Committer;dave;2;32;3;35;0
8e94bb29ae5c33d988cba29f130ba0d0a7276b00;Mon Aug 30 14:22:26 EDT 2004;Committer;dave;9;92;25;117;0
e80e14c7882d3955eb88d078f43822af030a1bf4;Mon Aug 30 13:42:19 EDT 2004;Committer;nagai;2;23;6;29;0
6cd1907c58a14351413f99cfde078b19dcf9c756;Mon Aug 30 06:16:34 EDT 2004;Committer;eban;1;3;3;6;0
2ebfc7e32819f1a1bc79852f5e3905c13432c299;Mon Aug 30 06:16:29 EDT 2004;Committer;eban;2;9;13;22;0
2ca3c51719daafae497d689c48dd06187529cb4c;Sun Aug 29 11:02:42 EDT 2004;Committer;eban;1;3;3;6;0
1cf49eb9f39ac128bdbb0c99527a903d6fe71130;Sun Aug 29 05:12:00 EDT 2004;Committer;nagai;3;10;2;12;0
a1dd800235214569f88d7008d4ede60b1e2b247a;Sat Aug 28 14:19:52 EDT 2004;Committer;eban;1;3;3;6;0
88ba175ab0c87882e446a5290ddc84880310d6d3;Sat Aug 28 14:14:11 EDT 2004;Committer;matz;7;80;16;96;0
55bf54a9c062b30492b328345ab3c68449e3f676;Fri Aug 27 03:15:44 EDT 2004;Committer;akr;2;6;0;6;0
fc8cbe79bf1cb3543005f8dae0c06d0e057b3173;Fri Aug 27 01:22:49 EDT 2004;Committer;nobu;1;3;3;6;0
e8d486e119ac254cf2438d2b5bd9de2ec5af8ebc;Fri Aug 27 01:14:30 EDT 2004;Committer;nobu;3;44;9;53;0
9b6bafef387de68aa9a31f39470e660b6524443d;Thu Aug 26 14:30:36 EDT 2004;Committer;nobu;1;3;3;6;0
ad7564a02a3288f807f1e6dd0ad9a42dc931bcdd;Wed Aug 25 19:44:46 EDT 2004;Committer;dave;1;1;1;2;0
4441ea370bbdcc7fa5c90654f714d056f6ac8845;Wed Aug 25 19:41:31 EDT 2004;Committer;dave;3;7;3;10;0
ee0bdcd6289257af4d11402b49a8daea0be7a7a3;Wed Aug 25 06:40:49 EDT 2004;Committer;eban;1;3;3;6;0
0d6b190e9f27b49fc28e0256b1d4a8bbc28f50ff;Wed Aug 25 06:19:01 EDT 2004;Committer;nobu;2;6;2;8;0
73a6f9af6c26d9adcbc6c46e0f2f3793891faa6a;Tue Aug 24 07:59:50 EDT 2004;Committer;shugo;3;17;17;34;0
b9b4a769f11a95ed7fca70d5f2d0620923b36001;Tue Aug 24 05:35:12 EDT 2004;Committer;shugo;2;6;1;7;0
99439f54eac0ee297cc6b9649968bb5c113f9b5b;Tue Aug 24 00:41:55 EDT 2004;Committer;usa;1;3;3;6;0
ef5ce7029d1cc25ca9026f55bcc5d37253dd6480;Mon Aug 23 23:59:44 EDT 2004;Committer;gotoyuzo;4;16;6;22;0
b1ba6aebf9abbed4afa04c7d884ca5a4d112c413;Mon Aug 23 03:45:12 EDT 2004;Committer;usa;1;3;3;6;0
30c0611f97b61d2fb0e3d7778f24d44a59fa5961;Mon Aug 23 03:44:32 EDT 2004;Committer;usa;2;6;1;7;0
7b505316a49875bd3ae5ee15a91a392cf55565e9;Sun Aug 22 07:28:45 EDT 2004;Committer;gotoyuzo;3;43;23;66;0
b21ef0f47abd3b1d89f9d313cdd347a87a9138f8;Sat Aug 21 16:21:32 EDT 2004;Committer;eban;1;3;3;6;0
0263ace6fb5cc96c687a3cf09e950b7b430e9aa5;Sat Aug 21 16:16:18 EDT 2004;Committer;gotoyuzo;2;8;0;8;0
e5602e48dc3db4a056d67c4e98da8000192952f3;Sat Aug 21 09:33:47 EDT 2004;Committer;eban;1;3;3;6;0
7e28ad63fff06ab146debe63df0645ce2b451ea0;Fri Aug 20 21:42:21 EDT 2004;Committer;nobu;3;29;8;37;0
34fff376ffbbf8e1fcff501869f043003f88edd5;Fri Aug 20 08:30:43 EDT 2004;Committer;usa;2;6;1;7;0
6a04a2c7d84e68f4720174272e41039881066d85;Fri Aug 20 03:50:39 EDT 2004;Committer;eban;1;3;3;6;0
47778e27f9cfa2dc0c9e321cf89bd2a1a177567d;Fri Aug 20 03:19:09 EDT 2004;Committer;katsu;2;24;17;41;0
c59f1e6c900233cc3a970c9dc0bd630f33cd0463;Thu Aug 19 07:43:54 EDT 2004;Committer;nagai;3;13;2;15;0
d73fa69935a2d6657e13bfe2d3fa266fef55614d;Thu Aug 19 07:33:15 EDT 2004;Committer;matz;5;87;9;96;0
4c57b2b49905d652fb500249c34303d8c0571155;Thu Aug 19 00:34:54 EDT 2004;Committer;usa;2;4;1;5;0
66b6366e1c60aaa58d2d9aa4eba22ad0e77cd832;Thu Aug 19 00:24:43 EDT 2004;Committer;usa;3;7;2;9;0
6c5ba93713c6c672372637c09fa06ca9a2d98b2c;Thu Aug 19 00:11:12 EDT 2004;Committer;usa;1;3;3;6;0
8c7a37f643343db88633f9890759771f6afc3e6f;Wed Aug 18 20:44:54 EDT 2004;Committer;why;1;0;1;1;0
5e07e55204aede8b5f80e7d01b464f08c6bd611e;Wed Aug 18 20:42:09 EDT 2004;Committer;why;4;39;21;60;0
b79d77197f17778a9a63a9b048bd22194418007b;Wed Aug 18 14:44:41 EDT 2004;Committer;aamine;2;8;4;12;0
1d1ad956cb33755c80f3d112408044faef047d3e;Wed Aug 18 08:14:54 EDT 2004;Committer;eban;2;14;2;16;0
8d906bd08ece1ce1924e39d60c0b615c7be81c88;Wed Aug 18 04:06:22 EDT 2004;Committer;eban;1;3;3;6;0
4937f8cf34d10ece4aa515e8b5e5259df095ca08;Wed Aug 18 03:53:50 EDT 2004;Committer;nobu;2;6;8;14;0
c41cefd4929b73536789f3dc7a9e093fcedec29d;Wed Aug 18 02:22:59 EDT 2004;Committer;nobu;2;67;15;82;0
67232b21511423f82ab18db04f941e6925338a7b;Tue Aug 17 09:02:40 EDT 2004;Committer;matz;6;66;8;74;0
4af25f5813cd98baa93c459c49718ef62882913a;Tue Aug 17 01:42:32 EDT 2004;Committer;ocean;1;3;3;6;0
00b363cd9492febe9f73b6a783a57de72cf4884a;Tue Aug 17 01:39:25 EDT 2004;Committer;ocean;1;1;1;2;0
86e8e8a2f5ae3947a61088d150c9b12eca9b9f09;Mon Aug 16 16:41:21 EDT 2004;Committer;dave;4;22;8;30;0
4339612a1462d4707f76e72d57a54a9cf9e27976;Mon Aug 16 05:07:49 EDT 2004;Committer;akr;1;4;5;9;0
e2e305605df3b79e1af040b7bad33641ba29e9e8;Mon Aug 16 05:01:26 EDT 2004;Committer;akr;1;5;1;6;0
65a2518a1edafec9ddc60549e4402416286c0195;Sun Aug 15 10:07:12 EDT 2004;Committer;eban;1;3;3;6;0
8460e4adee01fe5d419a7a679455dae668723b70;Sun Aug 15 10:07:08 EDT 2004;Committer;eban;1;1;1;2;0
5667fa237cb1051fb05732f7a91a4125ddc74ec2;Sat Aug 14 04:00:48 EDT 2004;Committer;ocean;1;3;3;6;0
dbc98560679d4b4044d46853f4f1ae2128cc88c8;Fri Aug 13 18:43:21 EDT 2004;Committer;dave;1;14;30;44;0
3319ea129ea921cde08aa1033abb3084069d6100;Fri Aug 13 17:52:52 EDT 2004;Committer;dave;4;14;5;19;0
690face91a21878fc96bf31b63b5288054186809;Fri Aug 13 17:50:11 EDT 2004;Committer;dave;1;220;0;220;0
6bf86382c0f2cf890a4a777c52b1c49ebd2f5322;Fri Aug 13 16:14:23 EDT 2004;Committer;why;4;3828;1973;5801;0
c6a58f872518bcc14fae7a267fa31c6779b2b427;Fri Aug 13 05:11:57 EDT 2004;Committer;eban;1;3;3;6;0
abca1cb92e5f7ca31775b134acc5d6485b575499;Fri Aug 13 04:15:27 EDT 2004;Committer;gotoyuzo;1;11;0;11;0
d85b9c8925b54589636566decc1141653765243a;Fri Aug 13 04:11:30 EDT 2004;Committer;gotoyuzo;3;8;4;12;0
a7b6d90e48478613150f12389e24c8a1b5cddd72;Thu Aug 12 14:17:58 EDT 2004;Committer;eban;1;1;0;1;0
8783ed5ab06602da1c30c4624eba446191266d32;Thu Aug 12 01:56:47 EDT 2004;Committer;usa;1;3;3;6;0
564538541e80ce1870bdd52de563cc6d6cc0c3f6;Thu Aug 12 01:56:25 EDT 2004;Committer;usa;3;28;30;58;0
0e104131b8bbc50a8c2c5d336a07a39bc3833d5b;Wed Aug 11 16:59:31 EDT 2004;Committer;akr;1;69;0;69;0
8f8de7782e93aab8e09c0727140fd1ff02d8ca6f;Wed Aug 11 16:57:14 EDT 2004;Committer;akr;2;142;21;163;0
9492165db232bb3bee4c13ac03bf96eb0e76d6ad;Wed Aug 11 08:22:14 EDT 2004;Committer;eban;1;3;3;6;0
39516ae717ee95963e003425e059b6a7049ee390;Wed Aug 11 08:21:39 EDT 2004;Committer;eban;2;5;2;7;0
1a79a3139a0ef0f693d4807c42f201ffa8a74cf6;Mon Aug 09 14:00:58 EDT 2004;Committer;ocean;1;11;11;22;0
18e9500afcea51b6d0e8c6adc94f3c17eeb3cd1e;Mon Aug 09 09:10:25 EDT 2004;Committer;ocean;1;4;3;7;0
461bbe2f45478b779f172838ceeabb5dcaf1be5c;Mon Aug 09 06:04:59 EDT 2004;Committer;gotoyuzo;2;8;1;9;0
541d9d3536027fc86effc7677450f913d30950ee;Mon Aug 09 03:54:15 EDT 2004;Committer;dave;2;82;6;88;0
072985c0f844e7c831402fb893c4b3cbe923b55d;Mon Aug 09 02:34:02 EDT 2004;Committer;ocean;1;12;11;23;0
d47f2458adcdf30c8562a5d78ecbe385fef129fd;Mon Aug 09 02:27:45 EDT 2004;Committer;ocean;1;3;3;6;0
18c0a86cc680929bbd8c48f4f45a197e3e68c70a;Sun Aug 08 21:35:11 EDT 2004;Committer;aamine;4;263;79;342;0
ab8f2ed967389c70fc9e841ca26635dc45148c14;Sun Aug 08 06:53:04 EDT 2004;Committer;ocean;1;3;2;5;0
ee102ea19207b1f8316ba862b38042dd7f14df92;Sun Aug 08 06:43:53 EDT 2004;Committer;ocean;1;7;8;15;0
8364780988f0cf02bb0836202d9239c6e062fa97;Sun Aug 08 02:33:31 EDT 2004;Committer;ocean;1;3;3;6;0
e3619768b1273cd532c87ca5948b85475a147f54;Sat Aug 07 15:34:39 EDT 2004;Committer;why;5;1385;2944;4329;0
5190564b682d8bfe6f71f7bbd07d897a354b3712;Fri Aug 06 16:32:16 EDT 2004;Committer;eban;1;3;3;6;0
a3a55eb5508957ab4cf7f85ff1a8d80b8e3aa758;Fri Aug 06 16:01:02 EDT 2004;Committer;akr;3;16;1;17;0
b15e66669f680606232ed6a0ab6e88c96a95f7d7;Thu Aug 05 01:20:00 EDT 2004;Committer;ocean;1;6;0;6;0
06c0305e1b129c5b0f24317dab7410faab7ae0e2;Tue Aug 03 05:11:20 EDT 2004;Committer;eban;1;3;3;6;0
7fc53294f27a325b15cf0dc81caa40bebb28b080;Tue Aug 03 04:49:20 EDT 2004;Committer;nagai;2;30;10;40;0
84fddcff2ff32077f0f90620494f68d3f3c0eb8f;Mon Aug 02 14:35:06 EDT 2004;Committer;ocean;2;108;0;108;0
b259fddba810a4ae2d18f99dfbc414898b426821;Mon Aug 02 09:06:18 EDT 2004;Committer;nagai;2;30;12;42;0
c267d34070370603078b900c5628eb62d2103475;Mon Aug 02 08:52:53 EDT 2004;Committer;matz;2;18;1;19;0
82c39d5579b893d5fb5c8729f9a971e317102d95;Mon Aug 02 03:02:27 EDT 2004;Committer;usa;1;4;4;8;0
ee580a5a92c8f1091ff0e1dd9aebaa449c33ca54;Mon Aug 02 02:59:17 EDT 2004;Committer;dave;3;15;4;19;0
fd404f03cbdf9dec1dfc9a85ed8bafaf1477689a;Sat Jul 31 14:13:30 EDT 2004;Committer;matz;2;7;2;9;0
cd110140db1a0ef1f057580860ded9c39944e288;Sat Jul 31 08:40:24 EDT 2004;Committer;nobu;2;17;11;28;0
021b336535e0db9c807abe9cb5c04f558bee1d5c;Sat Jul 31 04:40:11 EDT 2004;Committer;matz;2;15;9;24;0
45942bdbc6a7dba1caa36c160b734c359881fd25;Fri Jul 30 20:31:09 EDT 2004;Committer;why;3;975;1154;2129;0
4bcb334a5c831c59b1d3de3dde6339a77978489c;Fri Jul 30 16:40:14 EDT 2004;Committer;eban;1;3;3;6;0
d21727bdc52f74440e4ae44a0239dfbb72bfc455;Fri Jul 30 16:38:03 EDT 2004;Committer;matz;2;15;5;20;0
b079f859b965394aac97f024435390b54d0d6ccc;Fri Jul 30 09:05:39 EDT 2004;Committer;ocean;1;3;3;6;0
bfab0945123e20061de6094f5b6dcfc017351167;Fri Jul 30 07:13:55 EDT 2004;Committer;nagai;3;32;4;36;0
30de361409c1599763d71522d646a686015884f2;Thu Jul 29 06:27:53 EDT 2004;Committer;usa;1;3;3;6;0
73472b4b7b743cba7eb9cd832175bcd88e795234;Thu Jul 29 03:09:38 EDT 2004;Committer;nagai;1;64;9;73;0
3a43b8429fabfceaa2eba2ea734c09ff121e8ad5;Wed Jul 28 13:15:47 EDT 2004;Committer;matz;2;12;28;40;0
51c61416d7740ea1baf67dd612debc2c3f2b60fa;Wed Jul 28 11:03:35 EDT 2004;Committer;akr;1;1;1;2;0
1bd47bf0bc2051affae12a3a420abf2b44660389;Wed Jul 28 09:05:08 EDT 2004;Committer;matz;7;21;12;33;0
3f1f17c8c5f3e30e33e904b3c77502bfa5718a5b;Wed Jul 28 08:29:53 EDT 2004;Committer;nagai;7;241;10;251;0
92e7fccf4111e98e8e9229c5eda086d85500b53d;Wed Jul 28 05:58:49 EDT 2004;Committer;nagai;1;5;0;5;0
6d83f3afbdeaeccf661e73027cf6214f4534f899;Wed Jul 28 02:15:22 EDT 2004;Committer;eban;1;3;3;6;0
9531aef9eba120e3c75f6ade0931f97c92c7a43b;Wed Jul 28 01:22:49 EDT 2004;Committer;matz;6;43;86;129;0
7b5b448a1e675015bd341e1303590d154557490c;Tue Jul 27 08:34:28 EDT 2004;Committer;matz;1;1;1;2;0
457bc261c5e3980eb967a55c297f39cae6e74f8e;Tue Jul 27 08:14:58 EDT 2004;Committer;eban;1;3;3;6;0
bc667633d0f8f1a3a7f2cee99642e61bd824ac5c;Tue Jul 27 08:11:36 EDT 2004;Committer;matz;4;33;7;40;0
ae7d870923677fc63ae2db09e6ce33269ed56bcf;Mon Jul 26 02:53:14 EDT 2004;Committer;eban;1;3;3;6;0
36adf323b6a765405899dc7cd1fc08feff1ac65d;Mon Jul 26 02:50:18 EDT 2004;Committer;gotoyuzo;2;6;1;7;0
18789d6b5d3554270d9955b437d74f1c84858f27;Sun Jul 25 02:55:02 EDT 2004;Committer;eban;1;3;3;6;0
9d07076beffe22495ec496c60a09edd6c390e8cd;Sun Jul 25 02:25:25 EDT 2004;Committer;ocean;4;72;3;75;0
9a983e5150dc673c38c0269dd1b4da5e18a7f88d;Sat Jul 24 12:33:55 EDT 2004;Committer;eban;1;5;0;5;0
48071a32c28db4c6b25171c95d11cd75493c428a;Sat Jul 24 09:50:46 EDT 2004;Committer;eban;1;3;3;6;0
280d014d6d72deac20d4ac3d180718125d5bd56e;Sat Jul 24 09:48:21 EDT 2004;Committer;matz;5;12;10;22;0
ca14017bb65ee6316bfd400ac3efd6abe3ab70ed;Fri Jul 23 07:52:38 EDT 2004;Committer;matz;10;37;20;57;0
a32c01d85a5adb0fa4357db00eb98be5ad2240a6;Fri Jul 23 06:31:57 EDT 2004;Committer;nagai;5;106;14;120;0
0caca522a909b2268b6495e2f00b6ec1e10eb5e3;Fri Jul 23 01:54:30 EDT 2004;Committer;eban;1;3;3;6;0
26b9cd878a91a5ab495762fc168b4bb7b74c4d62;Thu Jul 22 23:52:11 EDT 2004;Committer;shugo;2;9;0;9;0
2f8bc7be98bdfe9c904f57f53a297fcd445cc77f;Wed Jul 21 04:27:43 EDT 2004;Committer;ocean;1;3;3;6;0
1ebcad550f1c300b6b525c53f74e32626c9d943f;Tue Jul 20 18:22:03 EDT 2004;Committer;ttate;1;1;1;2;0
433920226600a38b8d2287a5c78aa711bd9acd1b;Sun Jul 18 15:59:02 EDT 2004;Committer;gotoyuzo;2;10;1;11;0
f4991ab79520659d2a4ca585c41fa22141e3f6d8;Sun Jul 18 14:40:04 EDT 2004;Committer;gotoyuzo;1;4;0;4;0
94e117da620b122dd28f6c1e52ac452459a50cc5;Sun Jul 18 14:04:03 EDT 2004;Committer;ser;5;28;15;43;0
b841a6fce553dd5440a86c7ad9dcabfe7c06f826;Sun Jul 18 07:26:44 EDT 2004;Committer;nagai;2;7;1;8;0
6d27ddd2895562b6a951851cd1d89d3bfd15e0e1;Sat Jul 17 23:14:52 EDT 2004;Committer;nobu;2;17;13;30;0
e6401638f48180978488de810ac22b15695646ea;Sat Jul 17 18:25:18 EDT 2004;Committer;knu;1;3;3;6;0
5b42ef645e4487cb16b0091d933db97362291a2c;Sat Jul 17 18:20:57 EDT 2004;Committer;knu;2;7;3;10;0
73e0d386b81191c2d838b05c8d095dff0945797e;Sat Jul 17 17:35:53 EDT 2004;Committer;shugo;2;18;2;20;0
b9db231cbda6bfb90a20f55c9c70b38db24c8268;Sat Jul 17 15:06:17 EDT 2004;Committer;shugo;2;1339;1306;2645;0
de804fe2350e2c3a1f6c9f92dad0e63f8495aa23;Sat Jul 17 14:57:33 EDT 2004;Committer;nagai;2;6;1;7;0
02771a7aede0f9e3485d947ba542cdef4852caf7;Sat Jul 17 13:14:35 EDT 2004;Committer;akira;4;12;7;19;0
95439d074129ee930d360666f0549be3f413ca61;Sat Jul 17 09:29:59 EDT 2004;Committer;nobu;2;4;1;5;0
83fa0928d735f7076a7b755ff150cdec741a32ed;Sat Jul 17 08:02:20 EDT 2004;Committer;matz;3;21;5;26;0
eabd490119df3f6c15be62d26ed1f4d523a65f17;Sat Jul 17 06:28:10 EDT 2004;Committer;matz;4;61;31;92;0
545bbcf272208f0a286d0614e653492a54a007d8;Sat Jul 17 05:09:32 EDT 2004;Committer;eban;1;3;3;6;0
15ba9f85cf264143de586c962fe86faeebbd2d98;Sat Jul 17 02:23:52 EDT 2004;Committer;matz;4;94;8;102;0
9c54f61a5098c33d68ea1090e7ad7ef345c6767f;Fri Jul 16 20:28:43 EDT 2004;Committer;dave;2;10;5;15;0
9c376bc5e8af993fa3141111fed2d74fb898c236;Fri Jul 16 13:58:43 EDT 2004;Committer;nagai;15;324;324;648;0
97094af3ca9cae3d8b388d24e624ba9116b1da09;Fri Jul 16 05:56:44 EDT 2004;Committer;gotoyuzo;2;2;9;11;0
449ca256cc6ddc7a697376e938bd86c3bffa4196;Fri Jul 16 04:48:03 EDT 2004;Committer;eban;1;3;3;6;0
428228fe22b87b783531613c3d661c09cbeb4273;Fri Jul 16 02:17:59 EDT 2004;Committer;nobu;2;45;9;54;0
108db34fa3b3bb167c17d750c5f122f79f9efed9;Fri Jul 16 02:12:58 EDT 2004;Committer;nagai;1;1;0;1;0
4a56a0ef5d096b9440c1221bcfb734b4607077de;Thu Jul 15 14:54:01 EDT 2004;Committer;nobu;2;13;8;21;0
068b58b5e8c978669bb8586b26dccb2b9e90ebd9;Thu Jul 15 14:04:09 EDT 2004;Committer;shugo;2;8;0;8;0
acd44f6e1e96ec14a98bc6d30d70080f994ff68c;Thu Jul 15 13:01:06 EDT 2004;Committer;nobu;1;31;31;62;0
5a54353598c56b83ebb08d628a675785e3e20fd4;Thu Jul 15 11:49:45 EDT 2004;Committer;ocean;1;2;1;3;0
5d67732de3747604c29e90a08fa7c5571de2449e;Thu Jul 15 11:46:00 EDT 2004;Committer;ocean;2;9;5;14;0
3ac79892be7f3473d79ed0868f8413804e279f40;Thu Jul 15 05:04:49 EDT 2004;Committer;why;6;673;356;1029;0
13d4e3b5cdd1b64913446cc42825db3da4ec424a;Thu Jul 15 04:49:01 EDT 2004;Committer;nagai;4;149;4;153;0
07aef3a89c7e38ac1148d75a665d1673db143495;Thu Jul 15 02:18:43 EDT 2004;Committer;eban;1;3;3;6;0
ce1b23b7a5a496f4b6d3ad4627a161b1dc6945fe;Thu Jul 15 01:18:57 EDT 2004;Committer;nagai;133;5635;184;5819;0
6c6a24826c5fda68e04e71ac17620b0e70bca265;Wed Jul 14 14:51:42 EDT 2004;Committer;matz;7;113;25;138;0
1a760a6f76e5b2fad343fce10ebf831fe22286b4;Wed Jul 14 09:09:36 EDT 2004;Committer;gotoyuzo;3;11;1;12;0
b9bfdbb13eebe43e9610092ab0de6117e745d85e;Wed Jul 14 03:32:20 EDT 2004;Committer;ocean;3;40;9;49;0
b956b4a45048365fb96caf86a53271ccbe1e1bad;Tue Jul 13 16:21:23 EDT 2004;Committer;ocean;2;173;168;341;0
038ed182ddd8858fd05c9d90d6cec3e0c9b9e925;Tue Jul 13 15:51:54 EDT 2004;Committer;eban;1;3;3;6;0
208b771b480f65bb12bd70bb66edddbee7c57899;Tue Jul 13 15:34:34 EDT 2004;Committer;ocean;2;117;110;227;0
30f357661075faf7865843f18357ad272fdc30a3;Tue Jul 13 12:37:40 EDT 2004;Committer;dave;1;1;1;2;0
f461a6b8e532826e52fcbae8dcfdaecd55f3fc48;Tue Jul 13 10:50:26 EDT 2004;Committer;akira;3;47;6;53;0
db850b21fd6550f102fb5e7a322774788be96757;Tue Jul 13 06:54:01 EDT 2004;Committer;knu;2;10;3;13;0
b34c2101280e34cff949e1999711542d2f069660;Tue Jul 13 03:01:52 EDT 2004;Committer;eban;1;3;3;6;0
a2b021fb45e7c09c9679e1a709a86ea7f40688e1;Tue Jul 13 03:01:45 EDT 2004;Committer;eban;1;1;1;2;0
1811324f30e564181bd543e0df3d1085edc86d42;Mon Jul 12 17:21:21 EDT 2004;Committer;dave;1;1;1;2;0
e191fde02eb684c27b5b1678738ee0f835e4e095;Mon Jul 12 16:03:11 EDT 2004;Committer;dave;1;1;1;2;0
68b5d42563b8656eab5c1781ca4cf7e4e0394370;Mon Jul 12 15:54:25 EDT 2004;Committer;dave;1;0;1;1;0
dcfe4ecff8ab21e14b5f8e39d2587ebcac49bc5b;Mon Jul 12 15:52:35 EDT 2004;Committer;dave;3;19;0;19;0
9f519d661cae9d1150b88f8433963e025dcfc30c;Mon Jul 12 14:57:03 EDT 2004;Committer;eban;1;3;3;6;0
67eb47394242cbe98f169a127dbdaad762b2f182;Mon Jul 12 12:20:51 EDT 2004;Committer;dave;3;11;3;14;0
c868c85dc49df33d7297d5b9261147d9bcdf9866;Sat Jul 10 00:36:22 EDT 2004;Committer;nahi;1;3;3;6;0
519531dd9afc3c90c9c8b5355887b8af4f91571f;Sat Jul 10 00:35:02 EDT 2004;Committer;nahi;2;8;3;11;0
e55330c9c415f673ca5565a9dbd0b84775d53419;Fri Jul 09 19:29:29 EDT 2004;Committer;nagai;45;1162;20;1182;0
29c3cb6d2061d2d476ef50066b44a5596dd51d99;Fri Jul 09 13:38:34 EDT 2004;Committer;ocean;5;11;3;14;0
704d798615c5190510b036a4db8d32a0f9783df2;Fri Jul 09 10:33:25 EDT 2004;Committer;akr;2;11;0;11;0
fea3684d5e3dbc04ca8f7b15d06eecbd1b02a061;Fri Jul 09 05:29:45 EDT 2004;Committer;nobu;2;34;13;47;0
eb8cee076e13334ba0d1d957a18209976f07aba0;Fri Jul 09 01:51:40 EDT 2004;Committer;eban;1;3;3;6;0
b3f8249babbd19152100f5cc79b8d6aafe316194;Thu Jul 08 16:59:56 EDT 2004;Committer;nagai;1;41;0;41;0
afcfca607e147260b424563306a8d2c9ad9853eb;Thu Jul 08 16:50:07 EDT 2004;Committer;nagai;64;2429;110;2539;0
aa4878589c57acdee9f189b67f1dc55c1283fa16;Thu Jul 08 10:27:23 EDT 2004;Committer;nobu;3;34;4;38;0
4e7110d4355e9236467a1f63cfe4b625394b3043;Wed Jul 07 17:12:27 EDT 2004;Committer;eban;1;3;3;6;0
dbc7ba14a0087214fbaa4df3cddb3890fa155f61;Wed Jul 07 15:18:00 EDT 2004;Committer;akira;2;11;1;12;0
10b0f97ae9cbca50d01476a7dff184dcef058b9b;Wed Jul 07 14:02:54 EDT 2004;Committer;eban;1;3;0;3;0
0fcc88d07c3e1523be994f1f67bf3eaef1e74e07;Wed Jul 07 13:21:39 EDT 2004;Committer;ser;3;720;0;720;0
77e092c31c933c243b85b6d228e93e5de239bde1;Wed Jul 07 02:15:17 EDT 2004;Committer;dave;1;24;0;24;0
e289fcf81a22f1dc6ebcb87861877b463af04b7c;Tue Jul 06 17:43:05 EDT 2004;Committer;kou;9;440;107;547;0
9800838ff02369fa9e393b70f40b6083af0ce595;Tue Jul 06 15:52:37 EDT 2004;Committer;eban;1;3;3;6;0
012c7afa27b9b2694b5f05092315ccc90f9076b0;Tue Jul 06 15:52:18 EDT 2004;Committer;eban;3;7;2;9;0
806560ae4c8472fcb0153fc4546b2527a3983c1d;Tue Jul 06 10:34:45 EDT 2004;Committer;eban;1;3;3;6;0
d8465ff9abf63545262b7d8f88b069522ae82823;Tue Jul 06 09:42:12 EDT 2004;Committer;nagai;138;8458;427;8885;0
3d8fa5556164f3aa2f6f1733ffe4a96fc4f33ed8;Mon Jul 05 15:15:04 EDT 2004;Committer;kou;6;60;36;96;0
b750470064fec81ed3d2027e986c56c11ff54be6;Mon Jul 05 14:06:10 EDT 2004;Committer;akr;3;21;0;21;0
1e610842fb88f3a34f6100a3a843b7ddf4155cf7;Mon Jul 05 00:22:55 EDT 2004;Committer;nobu;1;3;3;6;0
b46e9297b3f12be4aad7535c9392622673e150bf;Mon Jul 05 00:21:38 EDT 2004;Committer;ocean;1;1;0;1;0
4f46d8a69a58486de19d5a8aadbb8b994a1b866b;Mon Jul 05 00:03:50 EDT 2004;Committer;nobu;2;8;3;11;0
bc9d396610b7882573d1a5ab257e19a296825d1d;Sun Jul 04 16:29:03 EDT 2004;Committer;ocean;2;12;4;16;0
7255981a4d663dc77850ee46a60f657db613ca75;Sun Jul 04 15:26:07 EDT 2004;Committer;ser;5;23;14;37;0
038103a0ce70d8083cfe3e83c4ffc0a0c479165a;Sun Jul 04 03:44:29 EDT 2004;Committer;eban;1;3;3;6;0
e2bd7aebeb2d77b555e0aee1d1b95e2cb721afc7;Sun Jul 04 03:26:23 EDT 2004;Committer;kou;2;10;1;11;0
b7aacc5b694ede490c5f38a4b0eabbc52a463565;Sat Jul 03 13:37:31 EDT 2004;Committer;eban;1;90;16;106;0
df731e37a1953755edfedd1462995fa824ca22bf;Sat Jul 03 13:33:20 EDT 2004;Committer;nahi;116;7273;2956;10229;0
0d6fa996d9e842fe435308cef68df06bc3596a76;Sat Jul 03 08:50:57 EDT 2004;Committer;eban;1;3;3;6;0
5b84fe46eb9a57c52ddee936c4037529d13d8c5e;Sat Jul 03 08:28:05 EDT 2004;Committer;eban;2;8;4;12;0
ffcedd79505ea2e99f859c7cea2fb2221c948d4c;Thu Jul 01 09:38:48 EDT 2004;Committer;nagai;199;14116;572;14688;0
73cf1d02bac2dbdd5d7f673a33d81444a00c865e;Thu Jul 01 09:31:37 EDT 2004;Committer;nobu;2;10;8;18;0
7662d794fed79e87d30962cac4b50a3843d390d3;Thu Jul 01 04:50:33 EDT 2004;Committer;gotoyuzo;2;1;4;5;0
0b6d266dae4deb1244eb33f4b150397e29eed643;Thu Jul 01 02:21:43 EDT 2004;Committer;eban;1;4;4;8;0
0dc43217b1898c6087474a8cbfe53eb27dde1322;Wed Jun 30 15:45:41 EDT 2004;Committer;gotoyuzo;2;88;75;163;0
22ab58c03c6beee7c0b6e508a97c07f77334423b;Wed Jun 30 10:48:43 EDT 2004;Committer;gotoyuzo;11;316;65;381;0
ba0756ca01443f13e1122499719f300c4e92acae;Wed Jun 30 08:02:42 EDT 2004;Committer;ocean;2;83;0;83;0
d1ffc6ae5385e8684e7e885d9155b9eefc5286cd;Wed Jun 30 02:39:38 EDT 2004;Committer;nobu;2;8;1;9;0
77411b3577ee04014479c0dcbc26342c2637e118;Wed Jun 30 02:05:48 EDT 2004;Committer;eban;1;3;3;6;0
24d2835e27f1c0a0ef09b5399888e455c975fb34;Tue Jun 29 17:34:08 EDT 2004;Committer;why;2;9;5;14;0
1b17df7bc1ee372420101c9845013cc01c1725af;Tue Jun 29 03:37:39 EDT 2004;Committer;eban;1;3;3;6;0
ac3c46901c3d1f75e5b66505056a1d1fa50e5343;Tue Jun 29 01:31:37 EDT 2004;Committer;nobu;5;59;29;88;0
63dedc7de4877eb4d7fba2716a2eeedb31efa794;Tue Jun 29 01:17:39 EDT 2004;Committer;nobu;2;378;368;746;0
c7558580f67c81dd03b1a7f1672545adf9d6ce9a;Mon Jun 28 14:08:03 EDT 2004;Committer;nobu;1;1;1;2;0
6f9195ec91a6d769dd2ae42171e146d778091246;Mon Jun 28 05:58:13 EDT 2004;Committer;nobu;3;7;2;9;0
711b9f9b4c2879bbfe923e4a2cba6aba8437362e;Sun Jun 27 15:43:28 EDT 2004;Committer;eban;1;3;3;6;0
a1162d2bf8fda567f67006ea063c033daca0860a;Sun Jun 27 15:36:32 EDT 2004;Committer;seki;12;17;20;37;0
0131ff249ae19e1decc7817a53ca7c523293e72a;Sun Jun 27 15:29:12 EDT 2004;Committer;nobu;1;3;3;6;0
ea88f84a777fb54f9148b326d2577e66c15c21a2;Sun Jun 27 13:40:47 EDT 2004;Committer;kou;2;8;2;10;0
3d41f06e109be3c3da97cd473f56c7761afa4a55;Sat Jun 26 06:39:32 EDT 2004;Committer;nobu;1;3;3;6;0
d4ae6052404886fd0ee60ecca23af1e8f914b571;Sat Jun 26 06:17:20 EDT 2004;Committer;nobu;2;9;9;18;0
11fa3bf8c7396d7789d5b6435e9d37b888225055;Sat Jun 26 06:10:52 EDT 2004;Committer;nobu;1;1;1;2;0
95084622ffbf27f6461a11a376cb2ae63b67ff2b;Sat Jun 26 03:47:10 EDT 2004;Committer;nobu;1;1;0;1;0
1f16f35849cddc27028dda5fd6b482c4194eb80d;Sat Jun 26 03:43:26 EDT 2004;Committer;nobu;2;3;3;6;0
4cf1e8654d8f7372d6244054dedfd22d3df3dd88;Sat Jun 26 02:07:30 EDT 2004;Committer;nobu;2;8;6;14;0
89b572762d271b570e98ec91709934c77c8e6ece;Sat Jun 26 02:05:54 EDT 2004;Committer;nobu;2;10;2;12;0
500cd0d57d84ab57e9b6e631e4c489291bf88f7a;Fri Jun 25 22:59:01 EDT 2004;Committer;akr;1;1;0;1;0
620cbfd46681582c003b8c5103b5135ee80c38a6;Fri Jun 25 15:13:16 EDT 2004;Committer;nobu;2;8;3;11;0
60d938063bbb3ba60650f4f3200b0cd4ff004ffe;Fri Jun 25 09:08:55 EDT 2004;Committer;michal;2;9;0;9;0
9aa6a033d20be72e3b04c0a0ab8b999b50166ee8;Fri Jun 25 06:33:11 EDT 2004;Committer;nobu;2;6;2;8;0
be9dc49f1e4cd2a0ce1728651781d416fdc1b2d6;Fri Jun 25 02:11:08 EDT 2004;Committer;eban;1;1;0;1;0
2c7c9e82df0293da4b55ae6886b0870727c8178f;Thu Jun 24 23:10:55 EDT 2004;Committer;matz;5;40;8;48;0
0f1db9d8a4706cff9909252ef5dc9ba61ffc220f;Thu Jun 24 17:05:27 EDT 2004;Committer;usa;1;3;3;6;0
9effc74508ee3836f4b78b3f6bbb9370e2ca4672;Thu Jun 24 17:02:11 EDT 2004;Committer;usa;3;4;4;8;0
2183b2380312fad426471f4805a37b85f7a430c6;Thu Jun 24 16:59:05 EDT 2004;Committer;usa;2;6;1;7;0
2f978ec25a49e35d5b20427ec151b9dbd3cbd165;Thu Jun 24 05:23:44 EDT 2004;Committer;nobu;2;8;4;12;0
d7861f7446eee48fda0733c778b0276385619e2e;Thu Jun 24 01:38:24 EDT 2004;Committer;eban;1;3;3;6;0
97ebe521bfdb6ef8fa172b7cb02c3595fe749de6;Wed Jun 23 16:29:16 EDT 2004;Committer;shugo;2;9;0;9;0
ac0ba927f3914353b8bac6da9b93753a169fb4ef;Wed Jun 23 13:23:55 EDT 2004;Committer;dave;2;11;1;12;0
3e1c383e455ec9fb938e6d85b353f648d516a0de;Wed Jun 23 13:18:32 EDT 2004;Committer;michal;2;12;4;16;0
cdf40ecbd88c9ef9f758d3bd6376668f2e4722b3;Wed Jun 23 12:59:01 EDT 2004;Committer;michal;4;278;283;561;0
5199bf7529853c496f300502f42ae87904afdf7e;Wed Jun 23 09:19:14 EDT 2004;Committer;matz;1;1;1;2;0
77574f0fa2ce5cbc1558cec1ac4368cedbe8ec6a;Wed Jun 23 08:38:15 EDT 2004;Committer;shugo;2;14;4;18;0
417f9ec4aa93958452059b84f33dbee8423139c6;Tue Jun 22 16:47:31 EDT 2004;Committer;dave;2;6;0;6;0
8aa7a962381e9dc1baa4ef5f16e0c3bb18174d0a;Tue Jun 22 15:23:14 EDT 2004;Committer;eban;1;3;3;6;0
42f00af5e303eae62bf88fd36628da89728c67d7;Tue Jun 22 15:21:03 EDT 2004;Committer;ocean;2;11;3;14;0
65e0e64656f24488e1a17cd91a3a3de02ee27a78;Tue Jun 22 15:00:36 EDT 2004;Committer;nobu;2;4;1;5;0
e99c018d87163c099ea9ca5dc31127552ce160c3;Tue Jun 22 14:59:25 EDT 2004;Committer;nobu;2;7;2;9;0
a28006f959e36e11e6d7ca1cd82220c1d58b753b;Tue Jun 22 14:38:21 EDT 2004;Committer;usa;3;95;3;98;0
29904b93f4e001150e63a77f08cac8574d2c0307;Tue Jun 22 12:22:01 EDT 2004;Committer;suke;2;18;9;27;0
ba5b04cd1b94a9d83bbac0bec430fd6066258cb0;Tue Jun 22 10:28:12 EDT 2004;Committer;usa;2;41;0;41;0
03f3e5e99408acd7fc47b7cb752072a808dc871c;Tue Jun 22 06:30:41 EDT 2004;Committer;michal;2;5;6;11;0
3469fd5a35278138b214a9346a276c5fa518fcf7;Tue Jun 22 04:24:48 EDT 2004;Committer;eban;1;3;3;6;0
17cb00b6e505d5b0fe22165a0084b72111b8d547;Mon Jun 21 16:36:19 EDT 2004;Committer;gotoyuzo;4;57;9;66;0
c89a62cd98e97ddbfeb602d4e17ebce6e0a9681e;Mon Jun 21 00:34:19 EDT 2004;Committer;usa;1;3;3;6;0
f43b8e20c0f6c53030ed23e41363fc74a3f871cb;Mon Jun 21 00:27:39 EDT 2004;Committer;usa;2;6;0;6;0
f9bdcf54952717b79e2ae274bfc4f2b14187c726;Sun Jun 20 15:57:40 EDT 2004;Committer;gotoyuzo;2;24;17;41;0
86d21234a41ed2a126ae8fd6ed85325f344491d9;Sun Jun 20 12:51:55 EDT 2004;Committer;eban;1;3;3;6;0
036219fbfbfbee172ae3e9a19bdc6f00a008a79e;Sun Jun 20 12:34:18 EDT 2004;Committer;shugo;1;4;0;4;0
9e9fdc15927023c745671bd1e6f172557bfabaa2;Sun Jun 20 12:15:07 EDT 2004;Committer;shugo;1;83;59;142;0
33b85912480abe4dbf28bdbd596d84f5efc3245d;Sat Jun 19 04:27:08 EDT 2004;Committer;nobu;3;42;3;45;0
934064ba5ac136bcfeb1b32c76bd064044156dfc;Sat Jun 19 04:24:34 EDT 2004;Committer;nobu;2;9;4;13;0
eba13dbc0499292ada162629a63b5655ecaf3f76;Sat Jun 19 04:00:11 EDT 2004;Committer;eban;1;3;3;6;0
d9f9245ad30cf0bb493be07cc05bb7ed5d672a3f;Fri Jun 18 16:13:01 EDT 2004;Committer;kou;2;136;39;175;0
960d79099f8b5f027c7a7ee590571694fcfca65b;Fri Jun 18 14:52:07 EDT 2004;Committer;nobu;1;5;5;10;0
658d8ea405dfa3ff57c39b2bd320a4fdf6859e76;Fri Jun 18 14:16:32 EDT 2004;Committer;nobu;1;3;3;6;0
31764d62ce2429077f85259e1c54910f851811f9;Fri Jun 18 14:12:42 EDT 2004;Committer;nobu;2;13;1;14;0
afa8c5c272ad13359b947b0724cce06e52b29a57;Thu Jun 17 08:20:30 EDT 2004;Committer;eban;1;3;3;6;0
9d1f9bd56ba2f47b7b964f261fc39a1a00c9e697;Wed Jun 16 14:21:34 EDT 2004;Committer;matz;5;27;11;38;0
1135c41a5bfece4b4db3bba472c30d31c5891fe1;Wed Jun 16 12:52:59 EDT 2004;Committer;nobu;1;4;3;7;0
7a28fb146ff00e995c4476beb36e7adb354910c8;Wed Jun 16 11:01:15 EDT 2004;Committer;michal;2;33;0;33;0
07a45c21c0a3f4f26f82c4479b2896de0ad61b11;Wed Jun 16 09:20:36 EDT 2004;Committer;nobu;1;49;49;98;0
5c6442068327a17bf1dc0b9e1e40212b8754c426;Wed Jun 16 07:05:37 EDT 2004;Committer;eban;1;3;3;6;0
856658ca9cbdc0bd8f0619cd2985a6cf05290868;Wed Jun 16 07:05:24 EDT 2004;Committer;nobu;2;129;55;184;0
6a5e63a71557428a68a576a0890e784a6dd12a25;Wed Jun 16 07:04:05 EDT 2004;Committer;nobu;2;10;0;10;0
83c917df38d6edbcbe7a220d21ed2e8d3a97b1d6;Wed Jun 16 07:01:32 EDT 2004;Committer;nobu;2;14;5;19;0
f895f94cce55af4df0c5dfb9ee59bd71ede40be6;Tue Jun 15 03:12:40 EDT 2004;Committer;nagai;2;12;1;13;0
60ed1ef3c0bb22171991dbc72977dd7f33f0e3eb;Mon Jun 14 13:39:22 EDT 2004;Committer;eban;1;3;3;6;0
3676a70e7b0fcee8a956c6ac8922744a82860876;Mon Jun 14 09:25:06 EDT 2004;Committer;nagai;2;51;20;71;0
db71ceb9c09d555015f9c632dd04b6b2bcaf4914;Sat Jun 12 15:40:29 EDT 2004;Committer;eban;1;3;3;6;0
c0271cadd7c49f2c3304e93f6190da0b8623c1f3;Sat Jun 12 15:25:49 EDT 2004;Committer;nagai;18;724;177;901;0
82593c058f0a61d8d4bcf7279fed496022330246;Sat Jun 12 05:18:23 EDT 2004;Committer;ocean;2;7;0;7;0
53529eba90db3818b6bbf96fa4a6342543ba8c2b;Sat Jun 12 02:45:56 EDT 2004;Committer;eban;1;3;3;6;0
4fb0b08ffdff6931d10123b396099a9e49d09875;Sat Jun 12 02:17:24 EDT 2004;Committer;eban;2;5;1;6;0
21606c6ec56bf11be012f391e43974132ae5646f;Fri Jun 11 13:33:47 EDT 2004;Committer;matz;6;65;238;303;0
6ea8b5094649cb28b5cf1ea7e1c9bed32cf5c31f;Thu Jun 10 13:48:46 EDT 2004;Committer;eban;1;3;3;6;0
c04dffe04961b6e75d53a0a644d8f9f98e499f20;Thu Jun 10 13:39:52 EDT 2004;Committer;matz;2;7;4;11;0
bef1521876fe0e96853b28b0775839148b412056;Thu Jun 10 02:09:37 EDT 2004;Committer;ser;3;90;0;90;0
3289dfc78b4c5051b0079217a193ce50d5349506;Thu Jun 10 02:01:04 EDT 2004;Committer;ser;13;244;121;365;0
f2b75020ba193b6d20788c800fde583ca8e900d5;Wed Jun 09 07:15:56 EDT 2004;Committer;akira;3;54;19;73;0
d918f9f34fd189cb0adc947a16792389104de623;Wed Jun 09 06:41:08 EDT 2004;Committer;knu;2;8;2;10;0
505d19848ee7a6325d201d81706ad0449e95026a;Wed Jun 09 06:10:59 EDT 2004;Committer;knu;3;239;110;349;0
b1469c134c0b42883a98542b9966f4e14348c033;Wed Jun 09 03:47:08 EDT 2004;Committer;usa;1;50;62;112;0
768c36c93addc7b84d1b2cd9877ff04eee2764b7;Wed Jun 09 02:21:45 EDT 2004;Committer;usa;1;3;3;6;0
595ed9f7fd5e08b497363902584a7efaa54061ed;Wed Jun 09 02:21:21 EDT 2004;Committer;usa;1;4;0;4;0
4b33ed994b02c486aaf43a78e11e01fc6e936b10;Sat Jun 05 02:33:01 EDT 2004;Committer;matz;2;7;3;10;0
dfb79bf51e257c832ec7e431b861d78c39cde698;Fri Jun 04 12:56:21 EDT 2004;Committer;eban;1;4;4;8;0
4f127ee34b7eabf7c5816e973448ea5fe11c3310;Fri Jun 04 09:56:25 EDT 2004;Committer;matz;5;10;6;16;0
14fa51aa0b8d8c6e8ab7210584ce254ec5ea2d50;Fri May 28 02:55:14 EDT 2004;Committer;eban;1;3;3;6;0
e3308c527274b8075bbf7a7ba672e5d6b861409c;Fri May 28 02:20:34 EDT 2004;Committer;nobu;2;8;5;13;0
d8cf22793bf09fd73b2a69703ed1c89ae7aa46af;Thu May 27 12:41:10 EDT 2004;Committer;akr;2;14;1;15;0
94e5d6ba19ffd14e5c97fa2f428296def9f03ae5;Thu May 27 11:22:30 EDT 2004;Committer;ocean;2;6;2;8;0
979de48915cd1c0d903eeed0fcec181ab80ef1ae;Thu May 27 07:43:38 EDT 2004;Committer;matz;5;50;80;130;0
87fb7bb66daa35dcf1750e2f764da0167ac79938;Thu May 27 06:56:23 EDT 2004;Committer;shugo;2;6;1;7;0
b6299328631a41846dcaff170257a9254536b464;Thu May 27 06:17:05 EDT 2004;Committer;eban;2;4;2;6;0
ec6cb67d037eb9f25f0e78215a07e4c6285f5739;Thu May 27 05:58:32 EDT 2004;Committer;eban;2;11;2;13;0
decac03616d833b5e1ff02328e444ac658ebe9f2;Thu May 27 03:00:32 EDT 2004;Committer;nahi;1;3;3;6;0
015e218d6cbf21e72e1496d64f79da715739ceb7;Thu May 27 02:26:15 EDT 2004;Committer;nahi;2;5;1;6;0
61949eefde17da5497fe28cbbe311e459073296f;Wed May 26 18:14:27 EDT 2004;Committer;gotoyuzo;3;264;0;264;0
fde5c3ff928fb42d30595f7e2a75bf7e123e5973;Wed May 26 18:11:29 EDT 2004;Committer;gotoyuzo;3;19;8;27;0
6dee0fab9b72b9c185fa742685f6486de9373243;Wed May 26 14:30:30 EDT 2004;Committer;nahi;3;144;92;236;0
74ab20eb3756f0061c89c2acda5ac972bd9cf69e;Wed May 26 05:19:50 EDT 2004;Committer;nobu;2;10;4;14;0
00fe662f6faa276e7573656b375ab5dea406d00d;Wed May 26 05:12:32 EDT 2004;Committer;eban;1;3;3;6;0
129313378fbefab34fe4d8cf8d47df9f5fc714bc;Wed May 26 05:02:55 EDT 2004;Committer;dave;4;34;10;44;0
13ebee7a9e4c38d7f89b0cbed9036b2692ff3c42;Wed May 26 04:15:02 EDT 2004;Committer;nobu;2;6;0;6;0
b216b65ce90978d164860513b27d249ef43e7ee2;Wed May 26 04:01:55 EDT 2004;Committer;nobu;1;1;1;2;0
ca1dca02b029a7d6b8c9a3a5cc21221346f792bc;Tue May 25 14:57:25 EDT 2004;Committer;why;5;24;25;49;0
82572952ecf82aad6bc47a51e3d63d7b52858b2d;Tue May 25 02:54:22 EDT 2004;Committer;nobu;5;186;28;214;0
1efe963c7afdc9efc2d8a5f37600812f07f5e638;Tue May 25 01:39:57 EDT 2004;Committer;eban;1;3;3;6;0
5059c5a53b290b3772767ff8ab5f0c0d2db7e08d;Mon May 24 16:57:44 EDT 2004;Committer;gotoyuzo;2;25;8;33;0
3216cb5839b0e61aedd505cff1d783e15b306e90;Mon May 24 16:50:59 EDT 2004;Committer;gotoyuzo;2;37;8;45;0
614537d5fa13f72e8c1eaf55a322697a7aadb898;Mon May 24 11:56:50 EDT 2004;Committer;akr;1;12;1;13;0
61397f6b134ef6d7b3c96259e5e9846a325cc7ae;Mon May 24 08:39:57 EDT 2004;Committer;eban;1;3;3;6;0
0427ff47360c2d169d95f8430bfb9d61a2f29950;Mon May 24 08:33:45 EDT 2004;Committer;nagai;2;144;33;177;0
c951f2f28e005d23214aba3f9a89998541ad7eb0;Mon May 24 01:48:37 EDT 2004;Committer;dave;3;8;3;11;0
8897b01d40b7b253e78f09562409b058c23ca3ad;Sun May 23 08:16:55 EDT 2004;Committer;eban;1;3;3;6;0
c863d62b6f38f24bc2d61602e0a650e4710868cc;Sun May 23 08:11:36 EDT 2004;Committer;ttate;6;70;49;119;0
b04bb4fb26776f7e8558803ffd1cde67f9de637e;Sat May 22 07:42:27 EDT 2004;Committer;eban;1;3;3;6;0
961d66abc26f9e491d5c622664f8e49b717ebbf1;Sat May 22 05:22:09 EDT 2004;Committer;nagai;1;10;10;20;0
edf9c3da4b680da9d6ac89a82212d943fab11804;Sat May 22 02:54:16 EDT 2004;Committer;nobu;3;12;0;12;0
c93c500910bc184afdde27c0a65d0d1ddd2fc441;Sat May 22 02:23:59 EDT 2004;Committer;nagai;2;54;1;55;0
56761e29f655407aa7bbbf27072f9ff6bf055757;Fri May 21 20:45:27 EDT 2004;Committer;nagai;18;562;43;605;0
11784c2c4b735f77a503c2e7149ba069caf1cf56;Fri May 21 18:25:25 EDT 2004;Committer;gotoyuzo;3;145;0;145;0
495ff23436d632b21ee103ad0aab392254e55c5e;Fri May 21 12:38:31 EDT 2004;Committer;eban;1;1;1;2;0
13e0f77bf44769c58f5799e60abe6f69c174d824;Fri May 21 00:23:34 EDT 2004;Committer;dave;2;6;0;6;0
406f506d59510743469db2421ecdf6460aace6af;Thu May 20 17:24:04 EDT 2004;Committer;nahi;4;251;86;337;0
fc04396ea31c74a85bb34ea4d2bbebd13e8f87f9;Thu May 20 08:02:11 EDT 2004;Committer;nobu;2;10;3;13;0
2ef79516bc53dee1a6c21beae717e9f530ecc202;Thu May 20 06:04:39 EDT 2004;Committer;akr;2;27;9;36;0
09053e137f6b168847d410d98757053f2823d075;Thu May 20 04:38:53 EDT 2004;Committer;matz;1;0;1;1;0
a6a8847190d9075b742e6247a769c2b8c6ab5f0c;Thu May 20 04:34:14 EDT 2004;Committer;matz;8;44;28;72;0
5345d52ff66b5970c488719749154d53eacc4eb0;Thu May 20 03:38:11 EDT 2004;Committer;eban;1;3;3;6;0
cc7c48ff6a52df248e9df1abc7c85db4063eb7af;Thu May 20 03:36:43 EDT 2004;Committer;dave;2;13;1;14;0
41e4c5de36fc9005a65320c39ce07c74b747222c;Thu May 20 03:22:20 EDT 2004;Committer;nobu;2;8;2;10;0
6988d86035f8063bd3c1228573523ed700405cf5;Wed May 19 18:30:52 EDT 2004;Committer;gotoyuzo;4;35;7;42;0
d3ba99c15f6e787957c24dedd8796b68e60739c2;Wed May 19 14:45:49 EDT 2004;Committer;nobu;2;7;3;10;0
9272ca4d2b181842b7d322fe90a38bd5d2974cb8;Wed May 19 09:48:10 EDT 2004;Committer;nobu;1;5;5;10;0
c504ca6776df526032be9e1296932d9069b9dcfe;Wed May 19 09:00:48 EDT 2004;Committer;nobu;2;15;8;23;0
3ac7b642fa2e73f6af7911dccef33d91af0e38cd;Wed May 19 05:26:51 EDT 2004;Committer;eban;1;3;3;6;0
3011f45158a7b8bb9d0a4b4af44a010f0bb30e45;Wed May 19 02:10:02 EDT 2004;Committer;nagai;2;6;1;7;0
36d86893c47c005d9f3d350236afce12100b25d6;Tue May 18 17:29:55 EDT 2004;Committer;aamine;2;16;0;16;0
b3e53ed154822eeb0aca1fd5bd900dffb510c495;Tue May 18 17:23:22 EDT 2004;Committer;aamine;2;9;5;14;0
34a553da2ee21e96999c150f80b7231d474a48d3;Tue May 18 12:34:33 EDT 2004;Committer;nahi;3;463;611;1074;0
75db654808404ad6f7ec79c3f9ae6fda8a3c827e;Tue May 18 06:10:45 EDT 2004;Committer;why;1;58;18;76;0
62289f13673c5af189d4314bf509f0ffbb342766;Tue May 18 05:17:46 EDT 2004;Committer;why;2;125;8;133;0
06ec03900534450824896d6fb0bb7eadad2a4ba2;Tue May 18 05:00:58 EDT 2004;Committer;nobu;3;8;1;9;0
3375c0bf6a50d148d8d8ead725f1f557b8a14feb;Tue May 18 01:41:25 EDT 2004;Committer;eban;1;3;3;6;0
e0e8ee0ac8eb04e44060218af4dc207f3e59eeed;Tue May 18 00:32:30 EDT 2004;Committer;matz;2;10;0;10;0
bd0cd7f92b7d7856b315bbc0342de8b3e0ad3b5a;Mon May 17 20:23:28 EDT 2004;Committer;gotoyuzo;6;804;0;804;0
22ee7f04fe89e878098c9e16db73fb86566ac5e6;Mon May 17 07:27:04 EDT 2004;Committer;ocean;1;2;0;2;0
0cc83a9c3baaf77e8245099ef63d467759088219;Mon May 17 07:25:36 EDT 2004;Committer;eban;1;1;1;2;0
6eaba4acec99d4acaaa7c199c6ac6fda1fe6ab16;Mon May 17 07:18:29 EDT 2004;Committer;matz;3;26;8;34;0
a655b0d8e1bf5ef406caa3c0d5edf68a2b411443;Mon May 17 07:14:45 EDT 2004;Committer;ocean;2;19;11;30;0
14b693c1b38af1ef5eb26a303a4ba48476353112;Sun May 16 21:43:37 EDT 2004;Committer;nagai;3;406;0;406;0
ad68e2035143b2a0fde18156ee99ebb5e3ce591e;Sun May 16 19:18:58 EDT 2004;Committer;ser;2;7;4;11;0
0d04057aad88b17c6189caa2443cd4b79ba96b13;Sun May 16 18:42:58 EDT 2004;Committer;ser;4;6;6;12;0
fcc9c6eab39a535efb827e5fd556dc043bdff6e6;Sun May 16 17:35:51 EDT 2004;Committer;ser;2;19;9;28;0
620549da3f87717471248b09467d0b59b6844238;Sun May 16 15:29:30 EDT 2004;Committer;why;2;120;115;235;0
246b33d1081f090671352abd520c5290222204a7;Sun May 16 15:23:12 EDT 2004;Committer;eban;1;3;3;6;0
36c32728b2824d4989d24b1fa66c9a156c7a1a3f;Sun May 16 15:20:47 EDT 2004;Committer;ser;1;2;0;2;0
ac4bee6fc338dc1533233c5f9467a0ce94ae91ab;Sun May 16 15:19:22 EDT 2004;Committer;ser;2;167;0;167;0
8fd29e2019077205a9997308cf3bc05202a83ad1;Sun May 16 15:17:31 EDT 2004;Committer;ser;8;1001;956;1957;0
ac1d9e7c2dfceb06a9b6ee22e2fc0593c9ddce29;Sun May 16 15:09:52 EDT 2004;Committer;gsinclair;2;11;7;18;0
eeb5c7e18e91e43502cf30d6f395364543fbf109;Sun May 16 12:03:23 EDT 2004;Committer;akr;4;74;14;88;0
a694dea2d8d4778bdfdfb6018647c6b022e0d9e5;Sat May 15 08:54:23 EDT 2004;Committer;ocean;2;8;0;8;0
18e3d54e929c29b0282da6ec09cc04313ab444e5;Sat May 15 05:29:30 EDT 2004;Committer;eban;1;1;1;2;0
bbfad2ba7c198f9f0956ee2d6b6464a655ce85f2;Sat May 15 05:22:54 EDT 2004;Committer;eban;2;16;10;26;0
79133371e8abb1a7cbdd24b3c62ce04d7227c4b0;Sat May 15 04:38:39 EDT 2004;Committer;nobu;5;47;21;68;0
36de1f6acbb66fba5bbe37fb119530e48060b7d6;Sat May 15 03:31:55 EDT 2004;Committer;eban;1;3;3;6;0
c474911e5b78749c5a85db39256240db5fb9e3be;Sat May 15 03:11:28 EDT 2004;Committer;why;11;369;347;716;0
094290e68fd4dfed851e8f7254d60a1301fe97e2;Fri May 14 16:45:40 EDT 2004;Committer;matz;2;6;0;6;0
6a60393280046a4991da8a415a77c60c7be240b5;Fri May 14 16:39:15 EDT 2004;Committer;matz;8;54;48;102;0
35ae7c90450157e1d8d415be819da40c9c1289a6;Fri May 14 14:13:24 EDT 2004;Committer;eban;1;2;2;4;0
d3a8f9b361470dc928e7804f14638366367f8362;Fri May 14 09:41:59 EDT 2004;Committer;nagai;4;99;116;215;0
dca0de41913ee3de07da76aca9d096b07e685870;Fri May 14 04:34:07 EDT 2004;Committer;ocean;2;6;0;6;0
bc8fe41ccaece5b0ec2fe2ef667052572b4876aa;Fri May 14 03:32:34 EDT 2004;Committer;eban;1;3;3;6;0
91da320a9ba6800b7a7ee7933036062c51657630;Fri May 14 03:17:50 EDT 2004;Committer;ocean;2;11;8;19;0
793b2e87956a04eb639fa202c7478f0dccde03c9;Thu May 13 07:02:18 EDT 2004;Committer;akira;2;13;4;17;0
25aa9e696969bc9f68bec0e8fabed7c1f2b835bb;Thu May 13 05:15:54 EDT 2004;Committer;why;2;6;1;7;0
63719ed2e891e2fc840a52f94f76b9c205647198;Thu May 13 02:05:00 EDT 2004;Committer;eban;1;3;3;6;0
67ffc9d9e1722f4878d9e9ff76418b060649a214;Thu May 13 02:04:20 EDT 2004;Committer;nobu;2;19;11;30;0
93472ba0ed10c2f8f17f648b8814b3731fca5c70;Wed May 12 10:59:52 EDT 2004;Committer;nobu;2;10;5;15;0
fbb8f1964a5c642ad2f520a3d3712b47feba9a14;Wed May 12 08:44:11 EDT 2004;Committer;akr;2;97;35;132;0
10b01eddac30f7c65b43bd5f874c0a16e0c3cf98;Wed May 12 05:38:20 EDT 2004;Committer;gotoyuzo;2;6;0;6;0
6e0085b137fd9f67ca94862b19e2bc6ae4b1fa4f;Wed May 12 04:24:55 EDT 2004;Committer;nagai;3;308;18;326;0
3b3b85666933562a2c07e53608dbb34a61e79c80;Wed May 12 02:54:32 EDT 2004;Committer;eban;1;3;3;6;0
227ec51ff288659f022dae00b839195b0c92e732;Wed May 12 02:51:54 EDT 2004;Committer;dave;2;6;0;6;0
f55d6c9298a37f7954cac446ea3c55dbe8d142b3;Tue May 11 14:30:05 EDT 2004;Committer;shigek;1;1;1;2;0
373747ab109d80b74535d13e38c83cb31be45472;Mon May 10 13:28:26 EDT 2004;Committer;aamine;2;4;1;5;0
58ec532ac9d6bc8913bc681d922a34d2d9ecf4b0;Mon May 10 12:46:18 EDT 2004;Committer;dave;2;17;4;21;0
ae3241dcfe7ffd81766e179bb306b00c8764a312;Mon May 10 08:23:13 EDT 2004;Committer;matz;4;16;5;21;0
4b9e46d95d76b96fa9dd9fa093c81dc079a8b714;Mon May 10 03:48:10 EDT 2004;Committer;eban;1;3;3;6;0
9b7b6016ce83eb1b160be0787a52f9130c89daf8;Mon May 10 03:14:35 EDT 2004;Committer;dave;2;13;0;13;0
c9d3f3dd8a61344d6d1871d4316fc51d64a51fa3;Sun May 09 16:19:35 EDT 2004;Committer;aamine;2;9;1;10;0
d9c41de9ccd3a1f262b22ddb0c705038c97beef5;Sun May 09 14:42:43 EDT 2004;Committer;gsinclair;6;520;478;998;0
0603e040b232e019fcf7b6491586f696915819ef;Sun May 09 14:38:11 EDT 2004;Committer;nahi;2;16;0;16;0
9c61c44fbae1616d5be762aab7b1ddbe5b0552df;Sun May 09 04:25:15 EDT 2004;Committer;eban;2;6;1;7;0
f0a523c45aeb6044c58af0e8813b9d664f9113b7;Sun May 09 03:40:21 EDT 2004;Committer;eban;1;3;3;6;0
2026c934a6fb9ee2e20c310b71546a8b714b8655;Sun May 09 03:40:18 EDT 2004;Committer;eban;1;0;1;1;0
8e65234086a15f90585bc09cce82dbad2aa647d7;Sun May 09 03:37:53 EDT 2004;Committer;ksaito;2;4;26;30;0
2c247e3d6bf178c4b19c87b6c55635467624864f;Sat May 08 08:12:08 EDT 2004;Committer;matz;6;17;14;31;0
8d7d25a0545296a1b9df506a8ab9fe930929ab6a;Sat May 08 05:33:38 EDT 2004;Committer;eban;1;3;3;6;0
3a8d8654f70017e7ca658b654cdfc8714f2a457c;Sat May 08 03:54:51 EDT 2004;Committer;suke;1;183;61;244;0
ac5f6e0a60ed62a8754e11d6adc4f32a610e72b9;Fri May 07 23:22:28 EDT 2004;Committer;akr;1;4;0;4;0
97391920d35fdfb83c29a301f4240aba2cca3048;Fri May 07 13:08:12 EDT 2004;Committer;aamine;2;111;66;177;0
6bb2e55d0cbf8ac9e6e5d1289ad409b62aaf4822;Fri May 07 12:51:18 EDT 2004;Committer;dave;2;13;4;17;0
876aa19435d43da902ccfe6768342a613b72851a;Fri May 07 12:04:19 EDT 2004;Committer;aamine;3;26;1;27;0
58860e0d64fa67081a122e80c0004bdd345dc45e;Fri May 07 10:05:05 EDT 2004;Committer;eban;1;3;3;6;0
d92f10ac061b38952747aff06225019e7a6d37de;Fri May 07 09:39:12 EDT 2004;Committer;akr;4;40;1;41;0
1b0f90ca333ddbf7ed57eba28465fbb922daa957;Fri May 07 08:44:24 EDT 2004;Committer;matz;22;270;109;379;0
c4216a26e2c9b3754abc3225de1732c50803433b;Fri May 07 02:26:19 EDT 2004;Committer;ocean;2;26;27;53;0
175f3b2d7aa6426bb36943cbf13fb1bf40d017bb;Thu May 06 13:28:23 EDT 2004;Committer;seki;2;10;5;15;0
fb019df11e175e350cfd8f108da0be427e205eb5;Thu May 06 13:12:12 EDT 2004;Committer;nagai;2;5;1;6;0
c4bb9c030863f1950020062af97eedbfeba68f46;Thu May 06 07:29:46 EDT 2004;Committer;eban;1;3;3;6;0
acfe0a70068037797ffc79d97f3d8190c5b566ae;Thu May 06 07:27:18 EDT 2004;Committer;eban;1;1;0;1;0
2fa9a0b08c7d2c672d2ae2ac8b76a66cfc1c5082;Thu May 06 06:29:56 EDT 2004;Committer;why;14;456;311;767;0
f77db2ed9ca3f9c404594787b456b1cabee351c7;Thu May 06 05:42:48 EDT 2004;Committer;ocean;2;10;6;16;0
b21aa86d5c34128e4acdc9d9dc975d548919f1cd;Thu May 06 04:32:49 EDT 2004;Committer;nobu;2;7;2;9;0
7cb6dfb8fcdb73058775b978b9f3b5c55d13f718;Thu May 06 02:47:37 EDT 2004;Committer;shugo;2;33;8;41;0
3d33a14369dd65001b840a9fe0e77ed3d3508fec;Wed May 05 17:02:47 EDT 2004;Committer;dave;4;18;0;18;0
6776688a2d08cf129a331f4ca6750279a4cba8b0;Tue May 04 18:53:26 EDT 2004;Committer;seki;2;5;1;6;0
898a1e71970ea6858c9eed7efe9f0223d92d6b90;Tue May 04 15:42:39 EDT 2004;Committer;gsinclair;3;112;2;114;0
fb0878b31074df726cb023f396fadbb4872663d0;Mon May 03 00:49:33 EDT 2004;Committer;dave;2;7;0;7;0
bd4dc9f6716184b443a6a29993fa851ef5fb3829;Sun May 02 12:57:31 EDT 2004;Committer;aamine;2;23;0;23;0
a9e658faf0e92df97a2332381f2f0106c57a5acd;Sun May 02 12:54:12 EDT 2004;Committer;eban;1;4;4;8;0
4c4631c2daaf7b2418c1f0e39292c8ee27a64813;Sat May 01 16:09:54 EDT 2004;Committer;nagai;260;28620;12545;41165;0
ce23680755e4e9ab0eed9dc6adb091ef7f1c58cb;Fri Apr 30 11:11:04 EDT 2004;Committer;eban;1;3;3;6;0
76546b54897069aaddd2e4cf56e62909f450d5f0;Fri Apr 30 11:10:51 EDT 2004;Committer;eban;2;6;0;6;0
ce4078d5bdbcafc6b5f4b72292cab6bad1c4f6a0;Tue Apr 27 16:37:56 EDT 2004;Committer;ksaito;3;9;2;11;0
803279135ce8585f31047a9b39200057622f935d;Tue Apr 27 16:20:02 EDT 2004;Committer;ksaito;3;44;25;69;0
4e85c0322aa3f9843a42ac1955004854dd501df5;Tue Apr 27 16:18:06 EDT 2004;Committer;ksaito;3;14;189;203;0
aa1fe3248fca7cf758c8ea034a0fdaab1e20d145;Tue Apr 27 16:04:30 EDT 2004;Committer;ksaito;3;25;44;69;0
653fbad62809d98e01a9bf70e7c6f69fbbc5b524;Tue Apr 27 15:53:16 EDT 2004;Committer;ksaito;3;73;41;114;0
315b3e19061212fa96e98d291ad7f2b5fc090446;Tue Apr 27 05:43:36 EDT 2004;Committer;nobu;2;6;1;7;0
912254c29ce68ba5be12bab82e195abd6752fc42;Tue Apr 27 01:40:19 EDT 2004;Committer;usa;1;3;3;6;0
a7524e343c1db6c3d336e0223029a1392fa080e2;Mon Apr 26 23:24:46 EDT 2004;Committer;why;8;432;312;744;0
10b598499b61d2c95a417f145e4cc70d96aeee71;Mon Apr 26 16:27:57 EDT 2004;Committer;akr;1;27;0;27;0
f63ff3acd5f2113c325e56796aee7ecac07f2140;Mon Apr 26 15:15:40 EDT 2004;Committer;nobu;1;3;3;6;0
aeae3aa4bbe179d3ef71353e3bdab64b133866de;Mon Apr 26 14:56:58 EDT 2004;Committer;nobu;3;7;2;9;0
04aa9a8f7df6577b710015f7dc78ccbc97e1e836;Mon Apr 26 12:42:01 EDT 2004;Committer;dave;2;11;1;12;0
269d1e9f0d305a6d7e750b2a8dd2657cb0e08501;Sun Apr 25 09:28:13 EDT 2004;Committer;eban;1;3;3;6;0
6075e128e6fe87bc15b3af925e4e496baf6993e9;Sun Apr 25 09:28:07 EDT 2004;Committer;eban;2;5;0;5;0
fa659c14490d24277b56d14127b547a2a758796e;Sat Apr 24 05:34:54 EDT 2004;Committer;ksaito;2;13;7;20;0
eb93c7431490c3f2a54895d50a297fb0823ff305;Sat Apr 24 03:21:19 EDT 2004;Committer;eban;1;3;3;6;0
8e47df7b6c9d6629de1e7984316fe686a24d13e9;Sat Apr 24 01:39:45 EDT 2004;Committer;dave;2;6;1;7;0
d15f41b0eb0f284cb15ee814c691e556ae20d8b1;Fri Apr 23 15:44:30 EDT 2004;Committer;ser;7;49;27;76;0
7792d9026a592ffc9714bec34d9b911b226036e7;Fri Apr 23 14:24:51 EDT 2004;Committer;nobu;2;11;3;14;0
cd322e0403ed15cdf836b44f9dcb1b514c20fbd0;Fri Apr 23 07:40:50 EDT 2004;Committer;akr;2;38;1;39;0
a6ed135520268c1dc0c0cc33188a241f93f736f3;Fri Apr 23 05:52:18 EDT 2004;Committer;nobu;2;11;2;13;0
d834d3a763e7aecc168bc87c9ca26d4835694db3;Fri Apr 23 05:25:16 EDT 2004;Committer;eban;1;3;3;6;0
f2f93023c82c14df33c016350e1fa4648bf4702a;Fri Apr 23 05:22:25 EDT 2004;Committer;akr;2;11;5;16;0
7b9431d98d37f57813fbcb1b72bd312f47f439a9;Thu Apr 22 09:25:16 EDT 2004;Committer;nobu;3;10;5;15;0
074852e54071117d3fec0672154e33124e635730;Thu Apr 22 01:10:07 EDT 2004;Committer;usa;1;3;3;6;0
8d9587fb819c19c0c43dcdc26d4972ffcbd0d02f;Thu Apr 22 01:08:23 EDT 2004;Committer;usa;4;7;3;10;0
39cac947b18894650fc166fb33ea66fe79c1d1a8;Wed Apr 21 19:18:02 EDT 2004;Committer;nobu;2;4;2;6;0
c94f8ab926a524a633a739e8a2e69016e18354d2;Wed Apr 21 19:16:40 EDT 2004;Committer;nobu;2;7;1;8;0
fb3c76a225a314a3583250ae6e92f41fce0e371f;Wed Apr 21 14:05:40 EDT 2004;Committer;seki;3;32;24;56;0
317547dc5d2ec69412b7b2e769f67598285c7fe3;Wed Apr 21 11:11:40 EDT 2004;Committer;akr;2;19;5;24;0
51ef45c6f31d320ba9173e41ce7d98a755d0f276;Wed Apr 21 09:40:48 EDT 2004;Committer;aamine;2;158;18;176;0
ef36d754724af7f271fc686928447f8406fd7061;Wed Apr 21 09:23:56 EDT 2004;Committer;aamine;2;31;28;59;0
6562d8732d1d2892c6e06ddfaa9ac2e29c4b2fe6;Wed Apr 21 09:02:04 EDT 2004;Committer;aamine;2;65;40;105;0
d4f7c8ccef0d0af20fd188a1a1bd6da9331162d4;Wed Apr 21 08:26:33 EDT 2004;Committer;aamine;2;41;35;76;0
97a557bdf92580ac1458e7da639040fd11c8eaec;Wed Apr 21 06:56:48 EDT 2004;Committer;nobu;2;7;1;8;0
45c445941b834b420c92773a01c460b34de4234e;Wed Apr 21 02:50:15 EDT 2004;Committer;ocean;2;158;154;312;0
c46c88c4a61154ca622bd2f71a88fcd7548c87c3;Wed Apr 21 01:47:52 EDT 2004;Committer;eban;1;3;3;6;0
1f4513af45cfb1620bc44c60be859bd4a9c65c3c;Wed Apr 21 01:28:19 EDT 2004;Committer;ocean;2;162;157;319;0
51ab50efd30d941b0f018f39c7a03f83b4a2a447;Mon Apr 19 11:59:33 EDT 2004;Committer;ocean;2;3;2;5;0
589cdd4d78fc1df82209727ef6cf92a85f7290b9;Mon Apr 19 10:09:45 EDT 2004;Committer;eban;1;3;3;6;0
c2642b2c3f21fc5f358cf3bc6806b8094a2b9017;Mon Apr 19 09:31:39 EDT 2004;Committer;ocean;2;35;25;60;0
92f0be2037b5f51861e8b7fdf763a343bb564c10;Sun Apr 18 23:19:47 EDT 2004;Committer;nobu;31;79;67;146;0
e5eb4590894ced3bb4c676538e1b52af9c0daf11;Sun Apr 18 23:15:30 EDT 2004;Committer;dave;2;17;4;21;0
902c0e2c5792bdca74799168f54f4575e410a130;Sat Apr 17 03:23:10 EDT 2004;Committer;dave;2;27;18;45;0
03f06115a6653d05fd5c20d9eedc5088ffdcdd0e;Fri Apr 16 03:38:53 EDT 2004;Committer;nobu;3;15;4;19;0
729aa8e1f40be5cdf78df5e357108ea68f41a06a;Fri Apr 16 02:08:11 EDT 2004;Committer;eban;1;3;3;6;0
6bfa557f8eda83379150164424f6b036e2c726e2;Thu Apr 15 23:27:12 EDT 2004;Committer;nobu;2;7;2;9;0
d0f38773d1c38d0a2f8449d66d5041dc64c6b025;Thu Apr 15 15:02:12 EDT 2004;Committer;nobu;1;1;0;1;0
5d73f8f7334241c3819fbe074930627d3601e787;Thu Apr 15 13:16:48 EDT 2004;Committer;ocean;1;2;0;2;0
a3dc7b771e08f43c149687c0e70dd4bbdaa71329;Thu Apr 15 10:57:16 EDT 2004;Committer;nobu;2;12;7;19;0
b3db09df79386f602b513e064f4e886f5ac6672d;Thu Apr 15 10:53:12 EDT 2004;Committer;nobu;2;26;1;27;0
7ab8be45db300d17245dba9bb38d71e1b885a422;Thu Apr 15 10:35:15 EDT 2004;Committer;eban;1;3;3;6;0
da2ace5c40567136b6bbed7eb6ed9c24a063a11d;Thu Apr 15 10:32:09 EDT 2004;Committer;ocean;2;47;71;118;0
f32d6dcb87632faf6075ad2c66b704d6f8f0e7d8;Thu Apr 15 09:40:40 EDT 2004;Committer;akr;1;1;0;1;0
ec2f9136703a674582eb923d4613b4f832f680e6;Thu Apr 15 09:39:39 EDT 2004;Committer;akr;1;33;0;33;0
c7629cdd28904438e5fbe8ff36be9c7010210485;Thu Apr 15 08:15:27 EDT 2004;Committer;akr;2;30;16;46;0
d952e330032662b0adba77f20a13715a1bc0f16e;Wed Apr 14 04:06:52 EDT 2004;Committer;nobu;12;24;19;43;0
b88dfa10b5be5147c7204dee44ed39880254fd88;Wed Apr 14 02:32:15 EDT 2004;Committer;eban;2;8;0;8;0
13dbddbdceb2af94eec96d896115ff0e0c0ea5b3;Wed Apr 14 02:10:45 EDT 2004;Committer;eban;1;3;3;6;0
11dad50e0dc3d628816b39b8f54ea979c8aa3d92;Wed Apr 14 02:03:41 EDT 2004;Committer;ocean;2;9;1;10;0
dae0bfcf376fa0fb32fdde10587a8fb255cf1d00;Tue Apr 13 14:06:50 EDT 2004;Committer;seki;3;12;2;14;0
e022b74520978ad11e4db30aece8403099199e94;Tue Apr 13 12:51:01 EDT 2004;Committer;nobu;2;7;0;7;0
a4e80a024dfb453b7d642a4d5263f3170e2a0490;Tue Apr 13 08:55:55 EDT 2004;Committer;aamine;2;8;3;11;0
500e181e2013c87e449ffef49f34415d433d1f63;Tue Apr 13 07:48:14 EDT 2004;Committer;aamine;2;129;17;146;0
14680a516df415d388d231cabf8294f87c691961;Tue Apr 13 01:36:08 EDT 2004;Committer;eban;1;3;3;6;0
64cdea9fae741b1b94ceaf9e6bc9c81621f4ffd3;Mon Apr 12 17:57:40 EDT 2004;Committer;ksaito;2;8;4;12;0
15d2b80c8a8495c996561e9fd68cae5dfdddde16;Mon Apr 12 10:17:46 EDT 2004;Committer;akr;1;1;1;2;0
795405fe3a982d8d42039065b6f000b2162f1cf6;Mon Apr 12 10:11:34 EDT 2004;Committer;nobu;2;5;1;6;0
a70b33bac9377fd5b96c821a2d6928a3dbbf0fcc;Mon Apr 12 09:53:14 EDT 2004;Committer;gotoyuzo;2;7;1;8;0
8ec111cae935c3f712321926f590b097d4ceaca3;Mon Apr 12 01:48:57 EDT 2004;Committer;eban;1;3;3;6;0
4c4d155e3d8861d2e85078d0d21305a26ee69a18;Mon Apr 12 01:45:27 EDT 2004;Committer;ocean;2;27;11;38;0
ac419876d5740a1887c1d481a3554552db11f100;Sun Apr 11 10:14:46 EDT 2004;Committer;nobu;1;1;1;2;0
aa144505ac9f91117f26791cfb2217cae44e778f;Sun Apr 11 10:13:20 EDT 2004;Committer;nobu;1;3;3;6;0
42fa4e83cd82e05dab64684d8c7d9595568ee347;Sun Apr 11 10:10:18 EDT 2004;Committer;nobu;2;11;3;14;0
7e9f3d2934ffdaf1bc98654ef216a5e39f4b7d3c;Sun Apr 11 01:49:10 EDT 2004;Committer;dave;2;8;2;10;0
da8a0fa4748164a46da482f498c00860bb335d49;Sat Apr 10 14:58:40 EDT 2004;Committer;eban;1;3;3;6;0
5d716f9303c5d46ddb507241a4c75d5421bc5e36;Sat Apr 10 14:51:58 EDT 2004;Committer;dave;3;8;3;11;0
1f3819adc85fd76761ec6ccb0cc37b54ef67fcc2;Fri Apr 09 15:01:53 EDT 2004;Committer;dave;3;13;16;29;0
bf02c31e869c4151b65177d53ca9d93c4f8fa2fb;Fri Apr 09 13:20:23 EDT 2004;Committer;eban;1;3;3;6;0
ae9512fcf604787a76dcb7b05e1ade5b7138e049;Fri Apr 09 08:06:01 EDT 2004;Committer;ocean;2;65;20;85;0
d9420d05689c43fcc7f8c31fbe774891c55aa6b7;Thu Apr 08 11:37:25 EDT 2004;Committer;nobu;1;0;3;3;0
fb8c9a2c79a02561111dfc8304b517b439c4c79d;Thu Apr 08 11:31:17 EDT 2004;Committer;nobu;1;1;1;2;0
eb1fa257b5f08aafe440a84a064bf9d93652dabe;Thu Apr 08 11:25:24 EDT 2004;Committer;nobu;3;19;6;25;0
fa7a5d5477dd8015b9bc0be9dc7ef2bf583e46d8;Thu Apr 08 10:45:21 EDT 2004;Committer;nobu;9;40;16;56;0
4732bf25f5a965ebee61971184af3a64c0cf90d3;Thu Apr 08 10:03:38 EDT 2004;Committer;nobu;2;5;1;6;0
65e7842b099d3e7efde95a469d4992079cbaafa6;Thu Apr 08 09:38:02 EDT 2004;Committer;eban;1;3;3;6;0
51c8d62bff1c86990f6a705df45b8335864ce311;Thu Apr 08 09:22:04 EDT 2004;Committer;nobu;2;19;3;22;0
8586deca95eea4634ebb2cdc18487b0197d4b070;Wed Apr 07 14:14:46 EDT 2004;Committer;ser;2;21;25;46;0
df84c64be98e362068524a2bbe7db6bcefe2ca7c;Wed Apr 07 06:30:15 EDT 2004;Committer;matz;10;63;52;115;0
66d03898953b6245eefdfccd41ac6aca6bfe9495;Wed Apr 07 06:01:25 EDT 2004;Committer;akr;1;1;0;1;0
ae8dfe8626c5835556b340e377b0b49a434d0cd8;Wed Apr 07 05:33:19 EDT 2004;Committer;akr;1;1;1;2;0
b2a4f270e8dde1cb0e2ea7e7afcf7367207ed7dd;Wed Apr 07 05:06:34 EDT 2004;Committer;akr;1;6;1;7;0
23376aae5305755924d4996a218da898cab3de8c;Wed Apr 07 04:07:11 EDT 2004;Committer;eban;1;3;3;6;0
8dfa6fb0a80d633d71987f06462823ca13b67be8;Wed Apr 07 03:36:38 EDT 2004;Committer;kou;9;84;38;122;0
4ded52b623ebd1b3de12db82f8b54cc156c1fd28;Wed Apr 07 02:51:05 EDT 2004;Committer;matz;17;221;110;331;0
43db576e61cc70fc7d8280183b71985e5ab18651;Wed Apr 07 01:43:27 EDT 2004;Committer;nobu;6;23;5;28;0
3d359cecd815f6d6cd9eeb55e14f38de75ab03ee;Tue Apr 06 15:26:25 EDT 2004;Committer;seki;4;63;11;74;0
383964bc30a9e0b9f8f8a17dbf0ecd9450bfb90e;Tue Apr 06 07:48:38 EDT 2004;Committer;akr;3;63;62;125;0
3f56949401549b639cc1db62d7e8d24807d504d7;Tue Apr 06 04:13:24 EDT 2004;Committer;usa;2;9;3;12;0
e4d66f4d6edea8ef331d29c17fd90c8d82bc8f7e;Tue Apr 06 03:03:23 EDT 2004;Committer;eban;1;3;3;6;0
6daf30d0d78d656b475960db2b95bf599b7b34ee;Tue Apr 06 03:02:57 EDT 2004;Committer;eban;1;1;0;1;0
dc252a75a251772f5d2bd9df442d9e6df74638cf;Tue Apr 06 02:59:13 EDT 2004;Committer;akr;1;9;4;13;0
ce44928d2b4d32b41f9a19097fb7bd7b2c13c4bd;Mon Apr 05 15:55:09 EDT 2004;Committer;matz;8;34;18;52;0
cded3d5c93f0964fc504a4344146e3624a9875a1;Mon Apr 05 15:14:20 EDT 2004;Committer;seki;2;5;0;5;0
22757fbaba39cfe9eecdd1604c6d95702dd04708;Mon Apr 05 14:59:33 EDT 2004;Committer;akr;1;1;7;8;0
2f8c9ce629bff3ada0b367d1e4cd4c12f5bd7198;Mon Apr 05 13:27:45 EDT 2004;Committer;akr;2;21;0;21;0
e5af80c69779c10e237a20d1b04daf2453d5dc0c;Mon Apr 05 13:16:40 EDT 2004;Committer;aamine;2;19;3;22;0
d0dec9337b76267676bf8e62cf7cd189e2dff14e;Mon Apr 05 10:44:44 EDT 2004;Committer;ksaito;1;4;0;4;0
62a7fde33b7c6055f2da8654b67a0993e9a96013;Mon Apr 05 10:40:54 EDT 2004;Committer;ksaito;3;117;90;207;0
14b890313732c681c76c4ea13fd291954b779956;Mon Apr 05 10:38:01 EDT 2004;Committer;ksaito;1;1;0;1;0
5acb4437c780b452619424944dc6697dce7db2ec;Mon Apr 05 03:14:05 EDT 2004;Committer;usa;2;9;2;11;0
2ca96a332b6f3bebdbc5654e6321a4da65cca414;Mon Apr 05 01:33:45 EDT 2004;Committer;akr;1;1;1;2;0
496a2ac02cdfa6ec4fde7f31d478032b0176bf19;Mon Apr 05 01:18:11 EDT 2004;Committer;eban;1;3;3;6;0
f02159637a70d53336dcd503bf918b5c7de2d0db;Sun Apr 04 23:19:58 EDT 2004;Committer;dave;3;7;2;9;0
5e59422f414ad385754c9e4f7ce525c8638e2c2c;Sun Apr 04 07:57:39 EDT 2004;Committer;akr;1;3;3;6;0
8b912a07d0abe099a7bc7ac5738751afc3adfa61;Sun Apr 04 05:08:18 EDT 2004;Committer;eban;1;3;3;6;0
440c26186cf2fe90b9170429f1e33c63c324f4c3;Sun Apr 04 05:03:00 EDT 2004;Committer;dave;3;14;3;17;0
45edb83b9a375eeefb1fc1f13e93a302fc35e8e0;Sat Apr 03 02:33:54 EST 2004;Committer;eban;1;3;3;6;0
d1a2925eee6a1d79f01c459024359bdfacb33de4;Sat Apr 03 02:22:38 EST 2004;Committer;ser;2;18;12;30;0
08cd3453b246e3c968d56ef1e7a4505378621db5;Sat Apr 03 00:35:06 EST 2004;Committer;why;2;5;1;6;0
28b79f39570641caeea3b9464e0ac081580a91fe;Fri Apr 02 23:31:14 EST 2004;Committer;why;4;354;310;664;0
6ebad07ea1c03d8b9b988d0f3be18ba37e1cb42b;Fri Apr 02 10:28:53 EST 2004;Committer;nobu;2;7;1;8;0
5c51ccc35c78651cfa98546fae06901db76c3265;Fri Apr 02 09:00:12 EST 2004;Committer;nobu;3;43;13;56;0
c0ab40c785d71c5b2b41c69731b61fe4ba9f8c0f;Fri Apr 02 08:35:32 EST 2004;Committer;matz;4;24;12;36;0
6c70639e7b2e49ff4491219c83333e8749baa56e;Fri Apr 02 05:38:07 EST 2004;Committer;matz;2;6;0;6;0
c7138f165658f3fee5083a74efb538a2ecc518a8;Fri Apr 02 03:53:58 EST 2004;Committer;ser;4;12;7;19;0
7bc6f498d585257ec93b4d64b55087ac96af62a4;Fri Apr 02 02:39:48 EST 2004;Committer;aamine;1;3;3;6;0
6dcbfbc5259a6ebfdf7ac68a69574ca270111da7;Fri Apr 02 02:36:48 EST 2004;Committer;aamine;4;11;9;20;0
b7552a5535f72bf850fd96040ab76bd04d5f4587;Fri Apr 02 02:15:25 EST 2004;Committer;matz;2;68;15;83;0
695fe49de9a52cb76e97fbff94ffe55c062a76ee;Fri Apr 02 01:20:59 EST 2004;Committer;dave;1;0;9;9;0
ef38efca9f4835ee2306f9b56eb26a2eaa14dc7a;Fri Apr 02 01:20:58 EST 2004;Committer;dave;5;66;26;92;0
64ec09d45675fa8a12594c00b8b4acccf9960fce;Thu Apr 01 23:13:39 EST 2004;Committer;matz;3;202;267;469;0
b9e7165e78f0da5632736ce503170067330d4710;Thu Apr 01 11:41:21 EST 2004;Committer;nahi;1;4;4;8;0
ad47c057c950e2a3dfb7949b1d9fc255cd2ecfab;Thu Apr 01 11:32:17 EST 2004;Committer;akr;1;6;0;6;0
b37f4923e5f63a0e4988f82dce8f48fbb2b6f184;Thu Apr 01 10:58:17 EST 2004;Committer;nahi;3;26;2;28;0
9db6fb5ce56ee2e911944377edb02cb493e428b1;Thu Apr 01 01:53:32 EST 2004;Committer;akr;1;11;0;11;0
b3009ced333c57456d7d1534b5ecd90b85f15b8e;Wed Mar 31 11:08:16 EST 2004;Committer;akr;1;2;0;2;0
5c9d45e6e75c02884d13dc197ab9e7c94c98bc11;Wed Mar 31 10:40:22 EST 2004;Committer;akr;1;14;4;18;0
9bf44e389ece8f91f517532a61a588f7fdedc8b1;Wed Mar 31 10:27:58 EST 2004;Committer;akr;2;95;8;103;0
b4a2460981606453e928129b9afd566a7506480d;Wed Mar 31 03:05:48 EST 2004;Committer;nobu;1;3;3;6;0
111d2ad8c5c80733e46dabc59e76622ff78885a6;Wed Mar 31 03:05:22 EST 2004;Committer;nobu;3;10;6;16;0
189febdf243244c963d5a370601eabd4423ac2f7;Wed Mar 31 02:59:57 EST 2004;Committer;matz;4;32;8;40;0
d3bb9ea1128c1f98b3aede3228f77a4d79241382;Wed Mar 31 02:52:44 EST 2004;Committer;nobu;2;12;7;19;0
dd889fac191adcf34103443d6ea563d54dda0fb7;Wed Mar 31 02:35:34 EST 2004;Committer;akr;1;29;5;34;0
a66ee49d2cb9a6503ff900fcfe8409396b2ca1e1;Tue Mar 30 11:53:00 EST 2004;Committer;akr;1;2;1;3;0
85000ef0be234071572be1e8b962ebbbc4c3141a;Tue Mar 30 11:41:39 EST 2004;Committer;akr;1;1;1;2;0
7bb7e17675846bd0caa7b3ad0ff1815cd313ed4f;Tue Mar 30 11:31:44 EST 2004;Committer;akr;3;24;0;24;0
7c34ed846fc29d34638857e4372e7b98c4f4fbe0;Tue Mar 30 09:20:04 EST 2004;Committer;nobu;1;3;3;6;0
058fd1101939461788e402600e6762c2acda8d8e;Tue Mar 30 09:19:06 EST 2004;Committer;nobu;2;6;2;8;0
846f087a07dd148c07f111ac0483454dc9e756df;Mon Mar 29 11:17:21 EST 2004;Committer;nobu;2;80;22;102;0
712de4408cfeece6ffedc3d411ff0b6daef4174e;Mon Mar 29 08:26:33 EST 2004;Committer;eban;1;3;3;6;0
919f456de88e9e1011db8f6e4e484e1b25e77af4;Mon Mar 29 07:54:38 EST 2004;Committer;matz;39;127;124;251;0
6a738f22656ffe247bcd02cf354c12a5370818ec;Sun Mar 28 22:36:15 EST 2004;Committer;ser;6;43;21;64;0
adb4439f85466a58378ba37a426e5f87a115a74e;Sun Mar 28 14:10:39 EST 2004;Committer;akr;3;4;4;8;0
7307dd069f05b5d9092da21bb37147249ac3ce8c;Sun Mar 28 12:12:31 EST 2004;Committer;nobu;1;3;3;6;0
47f86aae0a89c95a0093e5cac1df30c487a54db7;Sun Mar 28 07:25:42 EST 2004;Committer;nobu;3;17;3;20;0
b81df5d837ac72bee85cde0624d747a7250f20ab;Sun Mar 28 05:23:13 EST 2004;Committer;aamine;2;47;44;91;0
0cf429ce8248956912dfb127eb33cab353511351;Sun Mar 28 05:17:13 EST 2004;Committer;aamine;1;2;2;4;0
277839dc81807da0376602eaf24a6585d4e8c8a7;Sun Mar 28 05:13:12 EST 2004;Committer;aamine;1;6;26;32;0
111b11703d196e093d8f33ce17c1d309fbd0fa9a;Sun Mar 28 05:09:26 EST 2004;Committer;aamine;2;31;6;37;0
c451c56b10be59e905667c93b167f05bb9e4f50b;Sat Mar 27 12:43:02 EST 2004;Committer;akr;2;7;2;9;0
4d664a098d92c34a2720d04f1624103aa245254c;Sat Mar 27 01:46:05 EST 2004;Committer;akr;3;51;39;90;0
395256493671911414f25798fdc3c7963f383c27;Fri Mar 26 16:48:13 EST 2004;Committer;nahi;1;3;3;6;0
223d1cb77b595b2eb4b2653fd9a54af44118b7e0;Fri Mar 26 16:47:16 EST 2004;Committer;nahi;4;21;13;34;0
d6dc168b22e59de4802bbcbe60ea265f11259de3;Thu Mar 25 14:19:23 EST 2004;Committer;dave;1;1;1;2;0
4cdf253e4d129d35f49c8fb77fde90b72c5ae577;Thu Mar 25 14:19:22 EST 2004;Committer;dave;2;21;3;24;0
aa9d57c8736cc154dde612cad4ced7d4d9fde478;Thu Mar 25 12:50:21 EST 2004;Committer;shigek;1;6;0;6;0
c9d5d2554c210fec9b75aa86cdf8dc08400f5f17;Thu Mar 25 12:45:07 EST 2004;Committer;shigek;1;8;25;33;0
ec37ab2efeb67b23dcaf2a9891aad2e70d29e4bc;Thu Mar 25 12:01:41 EST 2004;Committer;nobu;5;20;8;28;0
384df36250d273583b7dba5f45934bd0b96268e1;Thu Mar 25 10:40:11 EST 2004;Committer;nobu;3;0;133;133;0
b47d4160468872c096fe1e3841b7c67c1ea6bad9;Thu Mar 25 10:37:39 EST 2004;Committer;nobu;2;11;3;14;0
3b79d34d990e285521e23e4f792f91b4cb815460;Thu Mar 25 05:01:15 EST 2004;Committer;nobu;7;23;12;35;0
d01fac5573dea2168abdfa546190b8c9a2111c88;Thu Mar 25 02:01:38 EST 2004;Committer;eban;1;3;3;6;0
e147632bffc50fd33f5b5d6f5716e3627985c0d1;Wed Mar 24 19:17:42 EST 2004;Committer;dave;7;75;8;83;0
16040850af57472ad0ec20fb9f86277c9527458d;Wed Mar 24 18:59:27 EST 2004;Committer;dave;2;7;0;7;0
154c29be3aa52e5bb014491918ca3fcd3a6c6c73;Wed Mar 24 17:01:11 EST 2004;Committer;dave;2;12;1;13;0
9d84c894643aec9df11417edd4ecc9e21219dd7b;Wed Mar 24 16:52:49 EST 2004;Committer;dave;1;16;15;31;0
42ad5216ec57a5890eb20230efb09e1aa53ed528;Wed Mar 24 11:53:31 EST 2004;Committer;gsinclair;9;979;985;1964;0
5e23ff603f53c99ac45e331e24498bfa124b4d72;Wed Mar 24 09:48:09 EST 2004;Committer;nobu;2;21;8;29;0
d5158a0833e631a4728bf0d70552cd16c8bc25db;Wed Mar 24 09:27:15 EST 2004;Committer;matz;1;1;2;3;0
91faa496b3d1864fc3c8de34c5cbb0712791686c;Wed Mar 24 03:35:24 EST 2004;Committer;dave;3;17;4;21;0
fdef713db1724873dc994f4203f866d796cd3274;Wed Mar 24 02:14:19 EST 2004;Committer;dave;1;0;1;1;0
124a20d3d2f469a7836029eb5bfa083f66683bd0;Wed Mar 24 02:14:18 EST 2004;Committer;dave;2;13;3;16;0
a43eeaef7529f979eb17276cd04bd87fabb25968;Wed Mar 24 01:08:20 EST 2004;Committer;matz;2;12;4;16;0
9de96e572ce62ab00fc379ebb3585ca3006c1cc7;Tue Mar 23 22:33:47 EST 2004;Committer;nobu;1;3;3;6;0
4f0ef242ccf453a72e092dba86ca2f8e7a7b0045;Tue Mar 23 19:14:16 EST 2004;Committer;matz;4;72;2;74;0
38c173aa6011df22a9839ed337d0c5fd8175f1ec;Tue Mar 23 05:54:55 EST 2004;Committer;nobu;1;3;3;6;0
8b7dbcf4b77cbdb94276f45f674da328bfd3b0e1;Tue Mar 23 05:49:10 EST 2004;Committer;nobu;2;2;3;5;0
9356e8d17780036ffe32f25f8f1245db5a94c477;Tue Mar 23 05:46:14 EST 2004;Committer;nobu;2;4;2;6;0
52a67fe60d08eb982586695b8bd6b1ceb32b30da;Tue Mar 23 05:32:01 EST 2004;Committer;nobu;11;87;44;131;0
69d80a31202da7ab038f3ced858fc064e75d43f6;Mon Mar 22 02:32:48 EST 2004;Committer;usa;1;3;3;6;0
71f46f07245023e55a44b6c04100b72cd1bd8777;Sun Mar 21 23:21:31 EST 2004;Committer;nobu;11;598;1288;1886;0
48dde6f3e6b3faf336a8734a21a7124115ed500f;Sun Mar 21 13:17:24 EST 2004;Committer;gotoyuzo;2;17;2;19;0
06d1cbb92691638db23984b32a8011c6dd602fdb;Sun Mar 21 12:21:11 EST 2004;Committer;keiju;4;20;9;29;0
b9c8bcafdce125d9e1dea00f77bc9e15e9510d8b;Sun Mar 21 12:08:02 EST 2004;Committer;eban;2;5;1;6;0
7515ca9a0623ac6e4af6b087835941be8c4e9a67;Sun Mar 21 10:08:44 EST 2004;Committer;eban;1;4;2;6;0
abe876ed4e69d08868373051bebee6ab7e303954;Sun Mar 21 10:03:17 EST 2004;Committer;kou;13;1080;1053;2133;0
cfbe158faea79c6c61f04e99d1309e26bf9f1e54;Sun Mar 21 09:54:07 EST 2004;Committer;kou;4;42;4;46;0
7ead69e5b3a2b09878037f11a7dda59ae402ccbf;Sun Mar 21 09:20:47 EST 2004;Committer;kou;15;385;85;470;0
2639d6dc809a3f78c96543c839d72d05e6e90ca7;Sat Mar 20 16:59:47 EST 2004;Committer;eban;1;3;3;6;0
aab1ba1365e1132717cbd8ae8a92014b1bba0854;Sat Mar 20 16:45:41 EST 2004;Committer;matz;6;59;22;81;0
38fc76574a85aa1fbb117fa9d9c5f8c69d76b5e6;Sat Mar 20 12:22:48 EST 2004;Committer;eban;2;5;1;6;0
a42fb7a811659d3091ed3fec55e479832de5f6b3;Sat Mar 20 06:26:57 EST 2004;Committer;dave;2;6;0;6;0
a4e25c6b23c804ed0ca6969cb968f21cb23b6d69;Sat Mar 20 03:29:48 EST 2004;Committer;eban;1;3;3;6;0
f2d983cb8dad16cfaa74b71b3efb4eb846858e96;Sat Mar 20 00:48:19 EST 2004;Committer;tadf;3;41;12;53;0
610b5d79759706fb2688b652da1c21006f9d4af2;Fri Mar 19 07:13:01 EST 2004;Committer;matz;9;57;87;144;0
91de9894fc5898b78878f8d4e9588794dd5bccc9;Fri Mar 19 03:29:26 EST 2004;Committer;usa;1;3;3;6;0
5af30c19a44422c9a905db4061fe07dc32583bdb;Fri Mar 19 02:35:27 EST 2004;Committer;usa;2;15;3;18;0
006e8d2e71375e5a9554115bc5771447bc44ec27;Thu Mar 18 10:49:20 EST 2004;Committer;eban;3;9;3;12;0
c223709c3b95127e7a0c0b3812ea2e89ecb8646f;Thu Mar 18 10:09:43 EST 2004;Committer;matz;6;18;9;27;0
311fdfdfeaceb581c51602f5aeeff40c12567a78;Thu Mar 18 09:50:14 EST 2004;Committer;nobu;4;33;30;63;0
29696a17382798c8f03d28000476bc7fcb77018d;Thu Mar 18 08:48:37 EST 2004;Committer;seki;2;5;1;6;0
29f163f1849355af3655b08a99677e0a00ff4279;Thu Mar 18 07:47:39 EST 2004;Committer;eban;1;3;3;6;0
bfb47068b0a888aa82ad027aadb36828ac396683;Thu Mar 18 06:59:04 EST 2004;Committer;matz;6;13;60;73;0
ab6963043df202bde77d67dfabff41cc3e7c11c8;Tue Mar 16 23:03:17 EST 2004;Committer;matz;3;14;6;20;0
a4d687f1c76874623e5a239279ca1d7886697abc;Tue Mar 16 15:28:16 EST 2004;Committer;eban;1;3;3;6;0
dbfe25c939c98f7ec93ca5de3d92682b16086d03;Tue Mar 16 15:25:28 EST 2004;Committer;ksaito;3;79;20;99;0
c2253d31cd409f3d4c22708778ac61836d223ed2;Tue Mar 16 15:20:15 EST 2004;Committer;ksaito;6;19;20;39;0
e1124ffa21685ece8854b6e198e47cafadd64d07;Tue Mar 16 04:12:50 EST 2004;Committer;ocean;1;2;2;4;0
eccaf153860aa930a425c958f0f0fb729a86a460;Tue Mar 16 02:46:06 EST 2004;Committer;usa;1;3;3;6;0
3210044a2b414b4bfbd46d3353f407f9d80945fe;Tue Mar 16 02:32:32 EST 2004;Committer;ocean;1;6;8;14;0
bbe76ca3130382f11ecf48132ff6588b9d17cb6e;Tue Mar 16 02:29:49 EST 2004;Committer;ocean;1;1;1;2;0
7307c01906482344e1df00c4dd4dbb7f0f5f8783;Tue Mar 16 02:24:47 EST 2004;Committer;ocean;2;37;23;60;0
d641a10d271570da7568e8bb6287fe1869b89a96;Mon Mar 15 06:01:08 EST 2004;Committer;eban;1;3;3;6;0
2fab242f668d719b319d155e3bfad2987117dd29;Mon Mar 15 02:27:29 EST 2004;Committer;matz;8;18;7;25;0
5bf96101305c9113122fe32935088613da3c2c50;Mon Mar 15 01:14:51 EST 2004;Committer;gotoyuzo;2;11;1;12;0
f52a248eae93f5ed661cb59e974d73047fbf4c3a;Sun Mar 14 13:09:59 EST 2004;Committer;nobu;1;3;3;6;0
2baa02ec9b70d232a83507aa18d25cd668935639;Sun Mar 14 13:07:42 EST 2004;Committer;nobu;2;7;0;7;0
8226628c80655568c134eacade56d885b00256c3;Sat Mar 13 13:38:13 EST 2004;Committer;nahi;1;3;3;6;0
c12e0136dc8abe0f5e13f0ae0593578331f13161;Sat Mar 13 05:58:00 EST 2004;Committer;seki;6;17;5;22;0
c6e5374aae7aeb3a047361410c6fa86e57c9d640;Fri Mar 12 15:00:39 EST 2004;Committer;ocean;2;145;106;251;0
e8ec668627b845ab25dbda9e575dcfb138a9ee67;Fri Mar 12 13:57:57 EST 2004;Committer;nahi;1;3;3;6;0
21410f4dfeee36f9dbadc611492516ebf2a427fa;Fri Mar 12 11:19:22 EST 2004;Committer;nobu;4;35;10;45;0
0d8a0904d93e9600ccd095eabd5e4165c15987ff;Thu Mar 11 22:36:11 EST 2004;Committer;gotoyuzo;3;13;0;13;0
3d92d0a135afef7dfc1b9530d3983d97d09fe9cb;Wed Mar 10 13:41:43 EST 2004;Committer;aamine;1;9;0;9;0
fb9d31c32756b28a1bc39452535ad1126a388ea5;Wed Mar 10 13:26:38 EST 2004;Committer;aamine;2;8;1;9;0
881844786748c130b364bd935e968f4ab82aeaa5;Wed Mar 10 07:32:37 EST 2004;Committer;matz;2;20;57;77;0
7c097dc8914e035dc4e1fb6913064e59fcb3d08c;Wed Mar 10 07:05:19 EST 2004;Committer;matz;10;373;112;485;0
86e988a55596ab35e48a39fff4638afdb619fbc7;Wed Mar 10 01:17:38 EST 2004;Committer;usa;1;3;3;6;0
f2b4e710139f473b467bde15708534a9a8cc39a0;Wed Mar 10 01:17:12 EST 2004;Committer;usa;5;40;26;66;0
f758077cc32707b95f22762825aa83a59fcfebc5;Tue Mar 09 01:05:35 EST 2004;Committer;usa;1;3;3;6;0
8829aa499531f0932eea49d48190b519ecfc9e38;Tue Mar 09 01:05:12 EST 2004;Committer;usa;4;88;11;99;0
e51bf1c605b8e4a61c8dea986ca3fc3527691a5f;Mon Mar 08 16:22:56 EST 2004;Committer;ksaito;2;25;3;28;0
2cb1399c8fead4dd191e52b043ffc82ea3964c04;Mon Mar 08 14:16:21 EST 2004;Committer;aamine;2;20;13;33;0
14371fce68acd0ce292af46d1b1ce7af9565bf3e;Mon Mar 08 12:40:34 EST 2004;Committer;aamine;2;5;1;6;0
f34d501658ede389ad13f904e844524244ff024b;Mon Mar 08 12:14:49 EST 2004;Committer;ocean;2;8;3;11;0
80a0920f5fb30fe8e05ba21fcc58c2de393e2ae1;Mon Mar 08 10:36:50 EST 2004;Committer;akira;2;6;1;7;0
6901d03914a2274750146aa060f8cce2e58c6d28;Mon Mar 08 06:10:22 EST 2004;Committer;ocean;2;43;30;73;0
945ae5eb59891dec8ecaf768dd983df24fe1c6dc;Mon Mar 08 05:46:19 EST 2004;Committer;eban;2;3;1;4;0
66e98764465a0dfe76522a06723e6bc0eb500986;Mon Mar 08 04:43:35 EST 2004;Committer;eban;1;3;3;6;0
30c77c8e9018532f47ef8f93316a6bc96985b72f;Mon Mar 08 04:40:39 EST 2004;Committer;eban;2;8;1;9;0
9b11fc8032b14fabacae74f77fbf02e1a3107eca;Sun Mar 07 16:06:43 EST 2004;Committer;gotoyuzo;4;35;11;46;0
4774e8fda58ec97cff435da6cdb13a3f0b377e56;Sun Mar 07 13:37:52 EST 2004;Committer;eban;2;11;6;17;0
81096d395c173030896bbba395cb61a9bae41e18;Sun Mar 07 07:28:10 EST 2004;Committer;eban;2;5;1;6;0
8627fc3c106c53564dd7b7ea8a44718ed1c7bd0f;Sun Mar 07 06:45:49 EST 2004;Committer;eban;1;1;0;1;0
8d8f6a0309e30dce93966bf2817a92fd3a865855;Sat Mar 06 21:06:06 EST 2004;Committer;aamine;1;3;3;6;0
39848fe845664948df5102837c84aca0973efeec;Sat Mar 06 20:35:19 EST 2004;Committer;aamine;3;227;53;280;0
316bf4e67bff2960945735bb2efb629f1ed13e9e;Sat Mar 06 18:11:40 EST 2004;Committer;aamine;2;76;19;95;0
3eedf9156cf01751423a99ef2939ec81964155d2;Sat Mar 06 17:08:21 EST 2004;Committer;aamine;8;371;384;755;0
dd53813e38e2839b08cc540df6296c392dbf3c25;Sat Mar 06 15:55:23 EST 2004;Committer;aamine;2;83;120;203;0
3b16f66bf7bb0b9d5a466d85544f71c9727ff4d3;Sat Mar 06 06:15:11 EST 2004;Committer;nobu;2;11;2;13;0
50c455507217045133f9ef3e9c5ac85cf68e6e79;Sat Mar 06 05:27:37 EST 2004;Committer;nobu;3;9;8;17;0
11229973f4936e46b71c17a6939787b9fa8fd4dd;Sat Mar 06 02:15:52 EST 2004;Committer;dblack;1;4;0;4;0
ad5c34fa0c9410e3b22db3d09ce0da2f97421305;Sat Mar 06 02:14:33 EST 2004;Committer;dblack;1;2;1;3;0
eddd3b4158435ea494ecf749a853d47e84abe84c;Sat Mar 06 01:53:09 EST 2004;Committer;dblack;1;6;2;8;0
ac9845a16c237e850bb5fa53cf0e9430fe2a302e;Sat Mar 06 01:49:40 EST 2004;Committer;dblack;1;2;1;3;0
1c77623b1be453327c3d85f0f6b63fd2d7efb96e;Sat Mar 06 00:53:04 EST 2004;Committer;nobu;1;1;1;2;0
999674030931a08b8f5b97a51cb4194e042b0a92;Fri Mar 05 22:37:35 EST 2004;Committer;nobu;1;10;10;20;0
fc188d38271d63844da0f47436e1bb506587296a;Fri Mar 05 17:00:51 EST 2004;Committer;aamine;3;99;94;193;0
76d2e91b4b0b5193c05ba04ea067081a394beb0e;Fri Mar 05 15:48:51 EST 2004;Committer;eban;1;3;3;6;0
f353d89d8254a6b065cac4f77f1dc4760aad2b91;Fri Mar 05 15:40:36 EST 2004;Committer;ksaito;6;110;4890;5000;0
5770336f8be4ac6dbdff43587fda2b508d3786de;Fri Mar 05 15:31:51 EST 2004;Committer;ksaito;15;17522;0;17522;0
33a06e4acac0cb7f080436507e06c82de45f7b9b;Fri Mar 05 14:13:31 EST 2004;Committer;aamine;2;114;0;114;0
a60a899eeb7e751bb47b94c54f1051093db4bc31;Fri Mar 05 11:59:09 EST 2004;Committer;aamine;2;19;2;21;0
492dfc7c0839f406008e52b2b09db349791e2895;Fri Mar 05 11:20:12 EST 2004;Committer;aamine;3;104;1;105;0
87275504ab0690e243401db6985f6253ccc17b65;Fri Mar 05 10:42:43 EST 2004;Committer;aamine;2;11;1;12;0
1c1a61a436623cda35085246aed2f5c81802b23f;Thu Mar 04 15:54:39 EST 2004;Committer;dave;2;263;259;522;0
f9da3539ed166d30e0bd797f6e1d7675da1e0359;Thu Mar 04 13:50:48 EST 2004;Committer;nobu;2;14;10;24;0
d6ad092f0efd195878627e72589389e573e66a20;Thu Mar 04 13:31:45 EST 2004;Committer;nobu;3;12;6;18;0
de4d3af245bd77445b7b4c7120b0722632e7b4c1;Thu Mar 04 02:46:37 EST 2004;Committer;nobu;2;7;1;8;0
af81ac5832d13b6d2a5294dd9c7cd419146702c6;Thu Mar 04 02:03:24 EST 2004;Committer;eban;1;3;3;6;0
9778625be8af59e0d9eb9707db019881a82480c1;Wed Mar 03 23:08:45 EST 2004;Committer;nobu;5;204;178;382;0
5dfa7cacd162be3164d259dcf6f2d4e035724fb5;Wed Mar 03 16:17:32 EST 2004;Committer;nobu;2;10;21;31;0
57cbecdb4f62df817c4d4fb694837b32b0f3b604;Wed Mar 03 09:58:25 EST 2004;Committer;nobu;2;13;9;22;0
54a04074256fa85db5da3bf0041773ddc3391196;Wed Mar 03 04:55:35 EST 2004;Committer;matz;7;125;13;138;0
e3b15cf111472455a75ec181ff676bf5d370038d;Wed Mar 03 02:27:50 EST 2004;Committer;eban;1;3;3;6;0
1184dd33d5030410e93b74ccafaec694be98530d;Wed Mar 03 00:52:10 EST 2004;Committer;nobu;2;9;9;18;0
40daca4a87d4e7177a1fce943f09b793582bb50d;Tue Mar 02 16:21:11 EST 2004;Committer;kou;4;42;45;87;0
a5e13ce5ffbf6febf65b74de3358e9b2f73a4e6b;Tue Mar 02 16:08:17 EST 2004;Committer;dblack;1;9;1;10;0
24aac11a56933f55149ead00b2dfab18f4facf16;Tue Mar 02 15:59:30 EST 2004;Committer;dblack;1;7;3;10;0
760691ca01f6785fa7c63a0a51dca04b82a2fc37;Tue Mar 02 11:21:32 EST 2004;Committer;dblack;3;57;66;123;0
5aad8206044f98b28bc303d5bd7d3e4f935e96ec;Tue Mar 02 07:30:35 EST 2004;Committer;nobu;8;79;39;118;0
95ce90a87ed0a058386eea410aeac0aac2ee2dc8;Tue Mar 02 03:31:05 EST 2004;Committer;usa;2;3;5;8;0
15691e6e980812b9e9ff2ead95ed6cb7cd0eb998;Tue Mar 02 03:26:33 EST 2004;Committer;usa;1;3;3;6;0
8e89487675db2e7ac66f1415d20ca51968a47295;Tue Mar 02 03:26:09 EST 2004;Committer;usa;2;8;5;13;0
06953dceed879bba1b2c31ae3a994cb872402cd4;Tue Mar 02 02:28:44 EST 2004;Committer;nobu;2;18;6;24;0
4bea8f3ce2b0542334ac38a8ef83e94cd1049b03;Mon Mar 01 21:26:25 EST 2004;Committer;dblack;1;4;0;4;0
2e9663f152d07c1ef57e70fa1348dfb2bdee8a37;Mon Mar 01 21:23:14 EST 2004;Committer;dblack;1;2;2;4;0
1362d3fca2afb46d800ba7dfe61ba99b35f7cf3c;Mon Mar 01 14:54:28 EST 2004;Committer;eban;1;4;0;4;0
e5f6e2c8b8d5ebdf325f1780f005da4d64ed730d;Mon Mar 01 14:37:52 EST 2004;Committer;dblack;1;5;0;5;0
b0c388896a1ce1d099df25e4a732ed6ab58569f8;Mon Mar 01 14:25:40 EST 2004;Committer;dblack;1;6;6;12;0
933fb96a12978ca76cb2538a1daf19f0e968226e;Mon Mar 01 12:24:42 EST 2004;Committer;dblack;4;422;0;422;0
cac6f19906cd88161c306baeca66802c021c7735;Mon Mar 01 10:58:33 EST 2004;Committer;ocean;1;2;0;2;0
ed694e74ffe1d54ed6c88c11ae97a13d47c9368c;Mon Mar 01 10:56:26 EST 2004;Committer;ocean;3;8;0;8;0
632b181ed79eee769860b830642184cebde6056b;Mon Mar 01 03:30:02 EST 2004;Committer;eban;1;4;4;8;0
b84917766d7adcb2fdf34d30d48f3d9c67565784;Mon Mar 01 03:26:05 EST 2004;Committer;dave;2;9;0;9;0
63fba925c3ef56cacde595dae1ebf9e0dd27b009;Sun Feb 29 14:21:37 EST 2004;Committer;eban;1;3;3;6;0
43d483d41d8b122c4fdc1bb6347f4172f2e5315a;Sun Feb 29 14:16:33 EST 2004;Committer;dave;2;13;12;25;0
8a5dba33b2f602066d7aed696593340ba884fddd;Sun Feb 29 08:22:48 EST 2004;Committer;ocean;6;52;23;75;0
04fae1c56c6a033e2a8ff6cd84d34d5c2442ea16;Sat Feb 28 09:33:21 EST 2004;Committer;eban;1;3;3;6;0
e5670724c512ec0a1df2595233bcc2a1619280ab;Sat Feb 28 06:21:20 EST 2004;Committer;ocean;2;3;1;4;0
3b7c2e12861ebaf0a0dddaf84db1b791473ca560;Sat Feb 28 06:13:11 EST 2004;Committer;ocean;1;4;0;4;0
cbd201f13d49159df1d268429ddd66506ee60cef;Sat Feb 28 06:11:44 EST 2004;Committer;ocean;1;1;0;1;0
c85e310795a30e2c5981d4eb9a9afd597dd9819c;Sat Feb 28 01:52:14 EST 2004;Committer;seki;4;49;1;50;0
bf08067ded3a38c12924cbb02289162e11792547;Fri Feb 27 13:30:00 EST 2004;Committer;matz;3;46;17;63;0
3255bc8fbf8485c60fab76a85cf70814bcbb22fb;Fri Feb 27 02:32:07 EST 2004;Committer;eban;1;3;3;6;0
a77fffc2507ad19d58e7a5554b25e41f14290154;Fri Feb 27 02:32:03 EST 2004;Committer;eban;1;1;0;1;0
aba4666e197331362f4a53b37bc21909144a3494;Thu Feb 26 17:15:00 EST 2004;Committer;matz;5;30;15;45;0
52e0246b61c3eb9871761692704e41687f8437c0;Thu Feb 26 15:56:40 EST 2004;Committer;seki;3;5;4;9;0
3632100c64f7f7c0780fd620751745808457bf98;Thu Feb 26 13:50:40 EST 2004;Committer;dave;3;3;1;4;0
5a6de8f5c5ccd76da97a9c821e55d0098f07108a;Thu Feb 26 03:15:53 EST 2004;Committer;nobu;1;3;3;6;0
0ff6bcae350dccd409f5db50cddec0c993faea00;Thu Feb 26 03:15:08 EST 2004;Committer;nobu;2;17;6;23;0
1eafe8b157cdb688a8007c42ed16f81b959a0761;Wed Feb 25 17:35:13 EST 2004;Committer;nobu;2;4;3;7;0
56e2c5243fd1caa769f2dff7ebc819af60a2562b;Wed Feb 25 17:19:16 EST 2004;Committer;nobu;2;7;3;10;0
920f5af3035c146a4b73d024a44757722eb05252;Wed Feb 25 12:20:21 EST 2004;Committer;nobu;1;3;3;6;0
b0e0f45571d509a3d76732b76aa63a96ad6b371f;Wed Feb 25 12:17:39 EST 2004;Committer;nobu;4;65;12;77;0
61deeb37417b040e93cb258e58d1a5777055842b;Wed Feb 25 12:16:30 EST 2004;Committer;nobu;2;10;2;12;0
8f2057e33d1c745a4e1636a6cbe4196ee798cc1a;Wed Feb 25 11:44:58 EST 2004;Committer;nobu;9;18;9;27;0
9418d16cbb6b0dd555c4e8bd3c9554832ac1ec8c;Tue Feb 24 10:06:46 EST 2004;Committer;ocean;1;1;1;2;0
b3818150149f4d55834924ce6a63a7236fe6e751;Tue Feb 24 09:49:59 EST 2004;Committer;ocean;2;8;2;10;0
9af2f9e0da00d211d69583585d685321df332e2d;Tue Feb 24 09:03:19 EST 2004;Committer;nobu;2;14;12;26;0
77d7ff7cbe2273457d3770ac9d267294afc8ef45;Tue Feb 24 08:17:10 EST 2004;Committer;ocean;2;6;0;6;0
d22ade523fbe9ebf4b4f8ca617385a538438554a;Tue Feb 24 04:24:02 EST 2004;Committer;dave;2;18;4;22;0
47d12ab8d05218cd297c0835764f177ef55e3a40;Tue Feb 24 04:07:46 EST 2004;Committer;dave;2;20;1;21;0
65db4654f6e762fa2e2950e958b12c34ddb7f8ef;Tue Feb 24 02:54:13 EST 2004;Committer;eban;1;3;3;6;0
810854455daf79ee979497fb7a9c5e8efb396f3e;Mon Feb 23 21:41:14 EST 2004;Committer;dave;2;9;2;11;0
a928cfed87c27f180ce9f76ffb8448282d629fc4;Mon Feb 23 21:34:01 EST 2004;Committer;dave;2;19;0;19;0
dc03b05a7e8461793963346bc73964dbc675b605;Mon Feb 23 21:17:26 EST 2004;Committer;dave;2;10;4;14;0
74d704c2635484a12a47aeb2fbcf4c5f48cdbebd;Mon Feb 23 21:10:42 EST 2004;Committer;dave;3;21;3;24;0
2d0e62faf11eeee5c7564113ae76ddae49626087;Mon Feb 23 18:45:41 EST 2004;Committer;gotoyuzo;2;59;10;69;0
31e13087b6b88e77c1acb561a17020bdef4e470a;Mon Feb 23 02:02:32 EST 2004;Committer;eban;1;3;3;6;0
d17841487575836516dc8a319313f6889473b0cb;Mon Feb 23 00:09:48 EST 2004;Committer;nobu;2;40;34;74;0
e10564a578f1824847285063607d46b2cfdb96d7;Sun Feb 22 05:58:10 EST 2004;Committer;nobu;3;5;3;8;0
d65d5e76615515a78fe84d361b81569b803785c9;Sun Feb 22 05:44:35 EST 2004;Committer;nobu;4;6;4;10;0
358ff2c1338216db600dfaa05f930d6e0e824011;Sun Feb 22 05:34:39 EST 2004;Committer;nobu;1;3;3;6;0
0990e0e8fc74da50850f71e102804ffa1a7c2621;Sun Feb 22 05:33:36 EST 2004;Committer;nobu;2;5;1;6;0
329b4782ff5eaae607dc3a05bc6e0004dd9fddd1;Sun Feb 22 04:06:09 EST 2004;Committer;akira;2;13;0;13;0
883857d8429c9cd94ffa9ff8968ee1afa243a0bf;Sun Feb 22 03:58:44 EST 2004;Committer;nobu;5;49;40;89;0
ac19769719846acc72a0ffe13995e1a8797ae5c0;Sun Feb 22 00:52:38 EST 2004;Committer;gsinclair;2;6;2;8;0
84e968f06c88e7a3c30d20e056036e9ca73d0f70;Sat Feb 21 13:49:40 EST 2004;Committer;gsinclair;2;700;7;707;0
cf8cd080e4e64bec5461093011940a64bd6c3ab6;Sat Feb 21 05:33:24 EST 2004;Committer;nobu;2;31;9;40;0
37e723a2fddfe248d099eb07baa33d1048dfb780;Sat Feb 21 04:09:34 EST 2004;Committer;nobu;1;3;3;6;0
59e3a0679e6e592fa68451214f8e2fa14e8586ac;Sat Feb 21 02:12:21 EST 2004;Committer;nobu;3;7;3;10;0
33e064affff29ac2a59dbc4d6a9e47b26da39080;Fri Feb 20 10:11:25 EST 2004;Committer;nobu;2;11;0;11;0
50b775851ad4cdae41b05bd133683f8894500674;Fri Feb 20 10:03:47 EST 2004;Committer;matz;5;21;3;24;0
611bb8f5a8771b618b8e81f08438fb770a8c2872;Fri Feb 20 04:13:30 EST 2004;Committer;shigek;2;8;8;16;0
ebe96d582e3bf048637663d6c51524bd40c3d3eb;Fri Feb 20 04:01:17 EST 2004;Committer;eban;1;3;3;6;0
f9bad7bf188d6ba6e077927b94ba9c67bd2832dd;Fri Feb 20 04:00:09 EST 2004;Committer;nobu;1;0;34;34;0
d6a70ac44c5980123bd5e8e2b3329299d098de82;Fri Feb 20 03:57:36 EST 2004;Committer;nobu;2;14;2;16;0
fc421cf6ac8728394624f206081373d04f50753c;Fri Feb 20 03:55:29 EST 2004;Committer;nobu;1;42;1;43;0
ba3a872a68618be4ab402850bccda1988955f57a;Thu Feb 19 14:26:05 EST 2004;Committer;dave;3;32;7;39;0
0425463a3dd625cb6ce489d2fd180b78c23d7961;Thu Feb 19 13:42:30 EST 2004;Committer;gsinclair;2;58;11;69;0
464fbf7b4fef77ddc352af2bd7582e3ed36fb643;Thu Feb 19 13:40:42 EST 2004;Committer;nahi;2;6;1;7;0
b61d1549d43e4c0afa2367a22c979d215976bd3e;Thu Feb 19 13:26:56 EST 2004;Committer;nahi;2;8;2;10;0
a077e7cec404cf9588ed846a1f8b5cbfb9f8f4bb;Thu Feb 19 12:32:09 EST 2004;Committer;gsinclair;2;39;30;69;0
ea5679c9794da8c807462fcc1f31c9763efcfb61;Thu Feb 19 09:08:23 EST 2004;Committer;nobu;3;30;34;64;0
23d081b993746ffe47d2f42266e4b7856f2450c3;Thu Feb 19 03:23:51 EST 2004;Committer;dave;4;34;3;37;0
86dcdabac87c8abb8947b15c939a43bffb7744e9;Thu Feb 19 01:48:15 EST 2004;Committer;eban;1;3;3;6;0
b06f1fb429688bbfd02aba58288143c2de1c777f;Wed Feb 18 18:06:14 EST 2004;Committer;aamine;2;35;3;38;0
e55e640a6f1a710bf1e344d462cc94316d5ecb39;Wed Feb 18 17:42:54 EST 2004;Committer;aamine;2;14;3;17;0
6f77e4b4ba78f0d74d297219cae251161b466a48;Wed Feb 18 17:38:33 EST 2004;Committer;aamine;2;460;5;465;0
fbac5a54a1458a70adf55f2e0c7908f4ce54f63e;Wed Feb 18 15:28:18 EST 2004;Committer;gsinclair;1;0;1;1;0
1399c1bca04aa992ef2a2b6bda70298f37892823;Wed Feb 18 15:27:06 EST 2004;Committer;gsinclair;5;16;0;16;0
847fd91e323d054121600c7a8568f0c734102fff;Wed Feb 18 15:12:55 EST 2004;Committer;dave;2;8;1;9;0
926a6fb1941437274613b7bc0dd76ab6cb0d3fdc;Wed Feb 18 13:55:22 EST 2004;Committer;seki;2;4;1;5;0
4e6c7c602ae799de4e48242c77ec9adee537bb67;Wed Feb 18 13:44:06 EST 2004;Committer;seki;3;372;0;372;0
994dfc0ae6a3c42bb9311f736ca30275779e348a;Wed Feb 18 13:08:08 EST 2004;Committer;nahi;36;32;84;116;0
44284f71c91b309d46b35fc683504235de6f8e50;Wed Feb 18 09:09:21 EST 2004;Committer;usa;3;82;0;82;0
953caaf9592ca97646cd4e26d48341149ebd517b;Wed Feb 18 08:22:18 EST 2004;Committer;eban;2;5;0;5;0
e7b48e43a33b49dd09de968a72d733919d79421f;Wed Feb 18 03:17:43 EST 2004;Committer;ocean;1;1;1;2;0
a7d4955188d072a51ded9ce0455d3a2b5fca7896;Wed Feb 18 01:24:13 EST 2004;Committer;usa;2;76;74;150;0
c87eaa3af219affdbb4461f1bd196efe6c71e1c0;Wed Feb 18 00:36:39 EST 2004;Committer;usa;1;3;3;6;0
e81b38b6d34c1959611fd4cfab6a293b07f199e9;Tue Feb 17 22:29:07 EST 2004;Committer;gsinclair;3;116;3;119;0
4b41d18b6ce05e48ac120274612cd76d6a1ccd54;Tue Feb 17 15:26:03 EST 2004;Committer;matz;4;63;41;104;0
dd23ad7e8489d331da2b280b42326a4cb84fe89b;Tue Feb 17 14:28:34 EST 2004;Committer;nahi;3;21;3;24;0
ffd075fad5187b5688f99e1b560c33e3ef9efd6b;Tue Feb 17 14:15:37 EST 2004;Committer;nahi;6;512;918;1430;0
bab1372a33543eaf89b265197866cac3466e78da;Tue Feb 17 10:34:31 EST 2004;Committer;nobu;3;31;11;42;0
919fc002ebaa2256d76ec25908918a8412a06ab1;Tue Feb 17 09:02:41 EST 2004;Committer;aamine;2;58;14;72;0
33f78212ceb6a09a392d23026afaa53f3ef1c00b;Tue Feb 17 03:12:53 EST 2004;Committer;nobu;3;20;8;28;0
dcb796c8d5b42abb9196f215c5ca113c4bd4f60b;Tue Feb 17 02:41:02 EST 2004;Committer;nobu;1;1;1;2;0
53f6129bbe578ea0033b85619f924c5f9d7bdad2;Tue Feb 17 02:33:34 EST 2004;Committer;nobu;2;7;3;10;0
3fac2b2519f4af1eceeaf4f900364d1ebe7ed8da;Tue Feb 17 01:51:40 EST 2004;Committer;usa;1;1;1;2;0
b12fe8025feb3039550ad6cce0fe61491df78123;Tue Feb 17 01:51:39 EST 2004;Committer;usa;2;6;2;8;0
bd00e2118ca8f08ad4336ac8386432fdb8b5fead;Mon Feb 16 22:48:25 EST 2004;Committer;nobu;2;5;1;6;0
511dceec5c9ce1d3164e4f1af9177cae7a7b10fe;Mon Feb 16 22:24:45 EST 2004;Committer;ser;2;2;2;4;0
b84ebdcb0597511207c4768e97ce313e0b9d4dbf;Mon Feb 16 21:42:10 EST 2004;Committer;ser;3;4;36;40;0
7430c46af697b32cd20d902b4613cea206f47d04;Mon Feb 16 16:40:50 EST 2004;Committer;akr;2;8;0;8;0
b2a4b4845c94f4e69c6f91a1489a713a3d120c94;Mon Feb 16 16:25:36 EST 2004;Committer;eban;1;3;3;6;0
b1772b8c404b56bf6ac5af3b330a09a12c65c436;Mon Feb 16 16:23:07 EST 2004;Committer;aamine;2;35;9;44;0
dd03a2ff20bf146885066435e0cfafd3fe70d757;Mon Feb 16 14:41:49 EST 2004;Committer;nahi;3;442;780;1222;0
0dea051ea19b57d12f8d9642079695aea4753081;Mon Feb 16 13:24:07 EST 2004;Committer;gsinclair;2;15;7;22;0
142b1b9503ae58d6548a304faa743b3c67288ec2;Mon Feb 16 11:31:30 EST 2004;Committer;ocean;3;8;2;10;0
cab6d2daddc7c4648c81a591611b7967fb4b9cbf;Mon Feb 16 09:39:48 EST 2004;Committer;usa;3;12;2;14;0
03d8c88b8774d40f3ff2596d7658f84938923caa;Mon Feb 16 06:45:32 EST 2004;Committer;nobu;7;549;393;942;0
3bc0f22fcea84f09ba347a0575779f935e044c12;Mon Feb 16 06:19:54 EST 2004;Committer;aamine;2;10;1;11;0
4ffed78b32021241638c9b297f6e10f3a3093cdb;Mon Feb 16 06:13:33 EST 2004;Committer;aamine;3;17;0;17;0
52510289842a8b643c4b699de39ffdc1b7a8a383;Mon Feb 16 03:29:16 EST 2004;Committer;nobu;3;96;10;106;0
4eae86c8bba7d5c9bd73013b5ef9144a45de7fc9;Mon Feb 16 02:25:04 EST 2004;Committer;usa;1;3;3;6;0
ba60b3f25fa528a7c5cdeb47db3d31ab5c8a8541;Mon Feb 16 01:33:12 EST 2004;Committer;ocean;2;32;36;68;0
86e01c98c732776983e725189fe79e6cd3cbc15b;Sun Feb 15 17:21:01 EST 2004;Committer;ocean;1;1;0;1;0
1b529182e1391bde429f4e48fd8e8ee26aee8dda;Sun Feb 15 17:20:17 EST 2004;Committer;ocean;3;7;2;9;0
a4b96f38ea91f4c1cd799a374102ec86bf652760;Sun Feb 15 12:08:24 EST 2004;Committer;ocean;1;1;1;2;0
5e379106b5e6e6c61958339fd3038119505e49b5;Sun Feb 15 12:00:51 EST 2004;Committer;ocean;2;6;2;8;0
3fd10dc40c268f3ca3c580c7704e92a88d569391;Sun Feb 15 11:50:02 EST 2004;Committer;nahi;10;60;16;76;0
c0f53ebf6d2a08bc60b5963dcae4b2f980df256a;Sun Feb 15 10:15:05 EST 2004;Committer;seki;1;5;0;5;0
c77eca435434e3d9bacf8cdbe2b3cfa91c9792ac;Sun Feb 15 10:07:18 EST 2004;Committer;seki;1;2;2;4;0
d7803283624d3f75fe327ee68fb83a34e14906bf;Sun Feb 15 06:53:15 EST 2004;Committer;suke;2;390;241;631;0
30fd29a174bb8ad17f4947af977992ff435643f1;Sun Feb 15 06:34:21 EST 2004;Committer;ocean;3;14;10;24;0
a4eb11ac447fb023111f80a15b8a384e7288dffe;Sat Feb 14 17:20:08 EST 2004;Committer;eban;1;3;3;6;0
19cb7ffd6c838bc0f3d4136a91f79557c13f33aa;Sat Feb 14 16:51:12 EST 2004;Committer;gotoyuzo;2;6;1;7;0
957874f20473063717974a3bf4f9e05a64252917;Sat Feb 14 15:12:40 EST 2004;Committer;nobu;1;1;1;2;0
25498896634334e4df3b708957d99dc257f819e5;Sat Feb 14 14:59:19 EST 2004;Committer;nobu;5;64;73;137;0
e8262c8f044505690aec95b65daf78b40ae8b2dd;Sat Feb 14 14:27:43 EST 2004;Committer;eban;2;34;22;56;0
34a18bb5264f65f6851f24f6d55731ac91158fab;Sat Feb 14 14:13:42 EST 2004;Committer;eban;1;45;0;45;0
6ebba7be60842a3f36c5addd844f9918e5bb61c0;Sat Feb 14 07:10:21 EST 2004;Committer;gsinclair;1;100;15;115;0
5a2b2fed70f98895cd38f777a1f5d0fefc06e5a5;Sat Feb 14 02:31:05 EST 2004;Committer;seki;1;4;0;4;0
30ff0b6aeb64ce114257710d9a534148515164a9;Sat Feb 14 02:28:02 EST 2004;Committer;seki;44;1966;0;1966;0
0562a84558afdc085172c102a4c913bc0c2ec57d;Sat Feb 14 02:16:05 EST 2004;Committer;seki;2;15;0;15;0
95be40a06d1227a0cd0a1cec4424ab33748d1450;Fri Feb 13 22:40:14 EST 2004;Committer;ser;13;110;50;160;0
be3b9b1c5c61b73884bbbf4a22fff16f9b197eb9;Fri Feb 13 16:15:54 EST 2004;Committer;eban;1;0;2;2;0
4df26a3d99a9887bfee726be0373400dcfbda4ed;Fri Feb 13 16:14:34 EST 2004;Committer;eban;1;3;3;6;0
829a44822d5e3fd4457f44c401d82eb14c52c8e9;Fri Feb 13 16:03:15 EST 2004;Committer;matz;6;35;8;43;0
be1de4f8db9626be0341d588b6b36aaae06a52d2;Fri Feb 13 12:53:42 EST 2004;Committer;gsinclair;2;13;14;27;0
c0306157d9dbb12447ba5288b8a2db73b2beef11;Fri Feb 13 11:02:03 EST 2004;Committer;kou;7;193;38;231;0
82482f67e25e8239d17a0ee9d209dca3c6fbb2f9;Fri Feb 13 05:46:49 EST 2004;Committer;nagai;2;29;16;45;0
9646cb4e840cebb12c1986a8bc3fc5715f62d8c0;Fri Feb 13 03:33:23 EST 2004;Committer;eban;1;3;3;6;0
ddc22d359619d8d9ed3a06e1368e0e96c007060c;Fri Feb 13 03:27:01 EST 2004;Committer;aamine;2;6;1;7;0
0c30c6836ba81c7d6388cb58e282986210594fe5;Thu Feb 12 20:21:24 EST 2004;Committer;aamine;2;7;2;9;0
08763eed7f47f7ae38149657cc70127252c2d219;Thu Feb 12 12:50:27 EST 2004;Committer;gsinclair;1;4;0;4;0
2facb107c4125e10bb6831dc8f044bfc8736c176;Thu Feb 12 12:22:18 EST 2004;Committer;gsinclair;2;59;25;84;0
d589b366bc52ad04ffd1bb3a989a45d66165deb6;Thu Feb 12 11:45:28 EST 2004;Committer;aamine;2;6;1;7;0
8bc9475793bd3218da4cd58570d6d9a6e7fd3548;Thu Feb 12 11:31:52 EST 2004;Committer;nobu;2;6;1;7;0
263769b65b64998ae972dcea86cfa795804e5131;Thu Feb 12 06:23:24 EST 2004;Committer;nobu;2;22;14;36;0
0b97d6f4581d32c77841ddd5de78942ccd629883;Thu Feb 12 05:20:09 EST 2004;Committer;eban;2;6;0;6;0
647419e4f2b3f15322ca4aee37ad25eb0ef0448b;Thu Feb 12 04:35:54 EST 2004;Committer;usa;1;3;3;6;0
eca7c7bdf01a8d99be3390e1ba1c6464419623c1;Thu Feb 12 04:35:30 EST 2004;Committer;usa;3;10;4;14;0
6531904a1c6eeb092da7d7f2f4b6a559b1edd6f6;Thu Feb 12 00:56:24 EST 2004;Committer;nobu;2;5;1;6;0
166b3957e08dd5f6c3221268a6df97212be4f53d;Wed Feb 11 17:36:37 EST 2004;Committer;akr;5;81;70;151;0
b187d1933b8bfb0edb4dec98c7142488cd80a42c;Wed Feb 11 15:15:16 EST 2004;Committer;nobu;1;3;3;6;0
6283babd218fa03f4f164bbbf0c0bdd40cfbaf35;Wed Feb 11 14:31:33 EST 2004;Committer;nagai;2;113;25;138;0
6aca74c7130728d2e477f1a8b220e72618de81ad;Tue Feb 10 20:54:00 EST 2004;Committer;nobu;1;1;1;2;0
b416c57c0a998c6f2435e419860b7645508816d6;Tue Feb 10 11:49:14 EST 2004;Committer;nobu;5;34;15;49;0
509fa974311b936279d9c25544fb06f41771ea0b;Tue Feb 10 08:12:04 EST 2004;Committer;nobu;1;8;0;8;0
beee54c7ce92249487b96e8bae5d1f1fcc9c5a42;Tue Feb 10 07:44:00 EST 2004;Committer;nobu;2;4;6;10;0
aab0773a86762fc1ab05122c65fac21d67bfff57;Tue Feb 10 05:37:44 EST 2004;Committer;usa;1;3;3;6;0
d255aa7b69401b81b0963f3c2c84d1be0003b62c;Tue Feb 10 05:36:34 EST 2004;Committer;usa;6;16;31;47;0
3d4b83aaba6ece74ca480803bf74bffb79dcfde8;Mon Feb 09 09:20:52 EST 2004;Committer;nobu;2;19;19;38;0
ec47d111790f6ffd302a7738d95b18bdeb3f79b6;Mon Feb 09 08:55:14 EST 2004;Committer;nobu;1;1;0;1;0
ff9c34b3f410bb41c78d9220c738be86fe8474a7;Mon Feb 09 08:48:55 EST 2004;Committer;nobu;14;453;96;549;0
77c6657723608f373247eff78e04f36b2b4ed59b;Mon Feb 09 07:41:29 EST 2004;Committer;nobu;1;3;3;6;0
4f5b070378fdf4c321fabaae707ba331f0525ed7;Mon Feb 09 07:30:17 EST 2004;Committer;nobu;2;14;4;18;0
216a50575199129b1e40361ccce60b992ec3b05b;Sun Feb 08 07:54:34 EST 2004;Committer;nobu;1;1;1;2;0
5e947e2d03657d87594ff77c5492b21065950635;Sun Feb 08 07:46:18 EST 2004;Committer;nobu;2;6;1;7;0
ebb7ed18646a10a0a735179f3008ec845cb5509f;Sun Feb 08 07:21:03 EST 2004;Committer;akira;2;11;0;11;0
4ca30a130d7baef02d0c91a1846beab68e954bae;Sun Feb 08 06:52:45 EST 2004;Committer;akira;2;11;0;11;0
54d612c27f60daf293ba97c5cd7ddae330cbfe65;Sun Feb 08 06:43:53 EST 2004;Committer;akira;2;22;0;22;0
992d2749aca335795b6cd943bf4025f5ff281699;Sun Feb 08 05:24:47 EST 2004;Committer;aamine;2;15;10;25;0
c5c6516c2d30704e1d9092f708dbbbcb8e161707;Sun Feb 08 01:46:38 EST 2004;Committer;ocean;1;1;1;2;0
0a96aa5adba5416b3ad26a0245eab346ed2656b0;Sun Feb 08 01:33:52 EST 2004;Committer;nobu;1;3;3;6;0
75fa29e4d0e4b6e67bcd48a4f8ad745a7b38cdd4;Sun Feb 08 01:14:33 EST 2004;Committer;ocean;1;4;0;4;0
3a8647ea9f91ea12a624c3e297f55ec4235a6c37;Sun Feb 08 01:07:09 EST 2004;Committer;ocean;1;31;28;59;0
208adf5c1f8eb2698c80e4944f097d444214a35a;Sat Feb 07 15:44:58 EST 2004;Committer;ocean;1;9;0;9;0
f232710cb8cc9e8ef784d4411662856094e37227;Sat Feb 07 15:06:40 EST 2004;Committer;nobu;1;3;3;6;0
c887d20966b2d17271fe88ccd62a51a298ebf362;Sat Feb 07 14:22:33 EST 2004;Committer;ocean;1;15;34;49;0
b839a4d72000489b10f2ffdaccddfae23fa00a7b;Sat Feb 07 12:51:57 EST 2004;Committer;ocean;1;2;2;4;0
776206b3e7a1374e8517431c9f63745079b3b1bf;Sat Feb 07 10:56:16 EST 2004;Committer;nobu;3;55;8;63;0
7f55b0c39ec801aa852824bf8b10c2f741a148bf;Fri Feb 06 13:49:54 EST 2004;Committer;dave;2;6;1;7;0
8fc2fa55f975045fbba58ae79a53dc6e3b6c77c3;Fri Feb 06 13:42:15 EST 2004;Committer;nahi;2;5;1;6;0
c47d29da45d6293a1a0a5684517b592ff6c93b9b;Fri Feb 06 13:24:17 EST 2004;Committer;nahi;2;6;0;6;0
9ab9489da4a93da074a9a71ad6a779cecee1e2ae;Fri Feb 06 09:55:43 EST 2004;Committer;akira;2;12;4;16;0
4d94e3ec4816e5b5bdf7afb5b10867bd998b78fc;Fri Feb 06 09:27:53 EST 2004;Committer;akira;2;22;0;22;0
77a16f0200303b6ba86881854b4816238e0cf85f;Fri Feb 06 01:16:08 EST 2004;Committer;nobu;1;3;3;6;0
87d5530af324d87c86a11c3b03b7e871f7754f45;Fri Feb 06 01:12:11 EST 2004;Committer;nobu;2;49;8;57;0
0e692c450b2b2a2146d136dbf2cb8f0fc7b735db;Fri Feb 06 00:16:50 EST 2004;Committer;nobu;3;32;0;32;0
7011dce58ef2dca98fd3c7b7ad42f1b0e2d86ec1;Thu Feb 05 15:50:43 EST 2004;Committer;akr;2;36;3;39;0
ed124303980f4f632d44d6fb14e70030c56c797f;Thu Feb 05 15:26:11 EST 2004;Committer;nobu;1;3;3;6;0
0c792a32b7e600320eb5eb3fd9e3ae1fe57e8b58;Thu Feb 05 14:59:46 EST 2004;Committer;akr;4;32;19;51;0
90d8cbb1ee3c7955642e1af995361eb0d9558aa9;Wed Feb 04 13:39:49 EST 2004;Committer;nobu;2;9;1;10;0
0388819018d796e1df32d5814ae70357ed8e331f;Wed Feb 04 04:16:51 EST 2004;Committer;eban;1;3;3;6;0
40f9219a8bd6d35b485655f63133ffc332524b8e;Tue Feb 03 17:20:08 EST 2004;Committer;akr;2;17;7;24;0
1a235738a8533edfe9314d79d327e2d2759366dc;Tue Feb 03 14:01:42 EST 2004;Committer;kou;13;95;60;155;0
7376af3092722b2d4c16e236b3cd530c3de07543;Tue Feb 03 10:42:39 EST 2004;Committer;gsinclair;1;7;0;7;0
486e68ea9a06f6741777ef7eadfbb178dfd94d5b;Tue Feb 03 02:30:30 EST 2004;Committer;usa;1;3;3;6;0
3f19bbb09404aedf7dd8c653eff1ef0bd1c6e4a2;Tue Feb 03 02:23:20 EST 2004;Committer;nobu;2;80;16;96;0
05172c42117ce60275d36e515c9ad7b9511b9c22;Mon Feb 02 23:09:38 EST 2004;Committer;akr;2;11;3;14;0
847d01a7c3b01ed56e60196073bff431fc21d230;Mon Feb 02 13:06:35 EST 2004;Committer;nobu;2;6;5;11;0
f57217cc5212bb7f16a97887a6a39c9f90fd957f;Mon Feb 02 10:01:57 EST 2004;Committer;eban;2;8;0;8;0
9ba59c3e528310ca70641b9a23d369b780226997;Mon Feb 02 02:31:01 EST 2004;Committer;eban;1;3;3;6;0
2e11b3262a39b6c92271bea05dce301761f2945d;Sun Feb 01 17:42:08 EST 2004;Committer;akr;1;2;2;4;0
d837280dc8fff1518655c63a45966e3fda87fa3e;Sun Feb 01 16:57:47 EST 2004;Committer;akr;2;21;4;25;0
678e4ea5b495893e2e9a7a6cf0045085623622f8;Sun Feb 01 15:31:59 EST 2004;Committer;akr;2;13;1;14;0
c9c51009cf154ef028d40d48d55607378867e312;Sun Feb 01 15:21:24 EST 2004;Committer;akr;2;41;16;57;0
0967d72815617a13f10fed36f3d00535eb4fedb6;Sun Feb 01 14:01:23 EST 2004;Committer;shigek;2;6;3;9;0
81d1f5f866c0a795d0f0e85ae12080ee968825ae;Sun Feb 01 13:59:53 EST 2004;Committer;eban;1;0;18;18;0
6a4d5aaae4049be9890b5c635e829019f44cbf02;Sun Feb 01 13:55:26 EST 2004;Committer;eban;1;4;4;8;0
9670d71ba9921e0dd5307b7661773aa630151f9d;Sun Feb 01 09:27:17 EST 2004;Committer;gsinclair;3;273;322;595;0
4d1dafdd9549baf792f2efa841150075e56798f7;Sat Jan 31 20:33:33 EST 2004;Committer;akr;2;3;1;4;0
192eb734bf945d4328d82c50df62fc8441a55454;Sat Jan 31 18:11:55 EST 2004;Committer;akr;2;14;0;14;0
976226b5de303ed852744c0291c280d1e5fd538f;Sat Jan 31 16:10:53 EST 2004;Committer;kou;24;100;2053;2153;0
35d62eb6a5f6521ed9297d99cb723a2efc85eb19;Fri Jan 30 17:39:04 EST 2004;Committer;eban;2;9;0;9;0
06a45a663c978e9ee6d00617a143de7ba4175a9d;Fri Jan 30 16:10:36 EST 2004;Committer;nahi;3;8;4;12;0
b685848c6658ffeb98d67498c984f5d38c5c6394;Thu Jan 29 14:56:26 EST 2004;Committer;eban;2;4;0;4;0
181a3a2af5df88d145b73a060d51fe437c8c4ad4;Thu Jan 29 14:18:42 EST 2004;Committer;eban;5;9;9;18;0
413c76d927474a7cd05cb530de9fce88938d471e;Thu Jan 29 14:08:24 EST 2004;Committer;eban;1;3;3;6;0
ef98285928af6533fb2ff210683a86f78d9e03d9;Thu Jan 29 13:44:48 EST 2004;Committer;dave;1;0;1;1;0
6dbf1140a4989e7b63c5ad22d131d01fb6a0c474;Thu Jan 29 13:44:04 EST 2004;Committer;dave;2;23;15;38;0
d52c3b1e94739f690d90277278794a2e7174eef2;Thu Jan 29 13:30:05 EST 2004;Committer;nahi;2;8;7;15;0
04b5228aba6e9aaaf3c082cb2aeafa124fcaca3b;Thu Jan 29 13:22:27 EST 2004;Committer;nahi;23;10;56;66;0
0ae750341e380f8bebd589d1348c17586fb03398;Thu Jan 29 11:59:55 EST 2004;Committer;matz;2;6;1;7;0
784360a978ab51dbf6515d97abcc67465782ca5e;Thu Jan 29 10:28:39 EST 2004;Committer;aamine;2;6;1;7;0
7a987b9bcd802ce9ad7424924def3075c26b0553;Thu Jan 29 08:05:29 EST 2004;Committer;matz;5;333;202;535;0
a84fc19203ff904c14d8e81065e342e3fb82e59f;Thu Jan 29 02:54:21 EST 2004;Committer;nahi;14;39;6;45;0
877408163a4d8725c24073784a5fee8511fdeb1e;Wed Jan 28 16:59:00 EST 2004;Committer;why;4;66;17;83;0
46f6b2026802fcd227beaac78c8d29378a96dceb;Wed Jan 28 15:19:56 EST 2004;Committer;kou;8;47;59;106;0
202bf6618f39f48e81b7bb3c67114a22c2eeda16;Wed Jan 28 06:09:27 EST 2004;Committer;nobu;10;30;8;38;0
43ab59f79bff1a6ae2a863c91877ffb01c3ce94c;Wed Jan 28 04:19:01 EST 2004;Committer;eban;1;3;3;6;0
7df9c8ca51bda367ca69f64c86c09e7254feeb04;Wed Jan 28 04:11:57 EST 2004;Committer;eban;1;0;1;1;0
0dfc492dd263ff232dfd0438aa7a6ca39294e199;Wed Jan 28 04:07:06 EST 2004;Committer;nobu;2;6;2;8;0
693a26ac7437a41f493e2e8e3a17cd33600569a0;Wed Jan 28 03:50:41 EST 2004;Committer;matz;1;46;0;46;0
8640f16308dce0b013af0470b926956e676ccc1a;Wed Jan 28 03:46:13 EST 2004;Committer;matz;47;6595;2;6597;0
51e6d9061dc8090bd1c9e3a1a8dadbbd9294a48d;Tue Jan 27 06:05:04 EST 2004;Committer;matz;9;39;24;63;0
8df4564367f895a5ba6f9186f7c90ebd07c874bb;Tue Jan 27 02:09:34 EST 2004;Committer;nobu;2;9;3;12;0
2a49751d8e14614229c28f5991898d37367b68a4;Tue Jan 27 01:37:32 EST 2004;Committer;usa;1;3;3;6;0
879da80895fb91623a9cdaac8d10150a09d4a910;Tue Jan 27 01:35:53 EST 2004;Committer;usa;2;5;1;6;0
d82950f40061791e2be4d08c96aa3dc77ded9a4d;Mon Jan 26 17:31:53 EST 2004;Committer;gotoyuzo;2;6;1;7;0
9b077b3490fe1d9db5eb7bff6e5ee2feb9dd511a;Mon Jan 26 13:54:41 EST 2004;Committer;dave;2;10;6;16;0
d7bbf4fdd29c9050d12d6d95237caf080ffec605;Mon Jan 26 03:49:21 EST 2004;Committer;nagai;2;10;0;10;0
f1e88899d9a87db905990ba604605c60cb2a1603;Mon Jan 26 02:40:11 EST 2004;Committer;nobu;1;3;3;6;0
6e0b3ca606ce09558ff6f5e6549230b254665da0;Mon Jan 26 02:35:30 EST 2004;Committer;nobu;4;29;15;44;0
c88e3627cfdf1ab2c7f1a558f3010f60bf7120ba;Sun Jan 25 20:19:16 EST 2004;Committer;dave;2;117;0;117;0
8d881def1a7f633f5254281a1487e4ea7c60e624;Sun Jan 25 10:05:26 EST 2004;Committer;gotoyuzo;1;20;14;34;0
3d045223db652b13331e2a69aaef7994829ad259;Sun Jan 25 09:40:26 EST 2004;Committer;gotoyuzo;1;10;0;10;0
3007fbf4f5e70a0ac23bb2daf322b0bef6d023ba;Sat Jan 24 16:54:02 EST 2004;Committer;eban;1;3;3;6;0
327182cada3e0873b0c05118ac533f39eb089121;Sat Jan 24 16:48:52 EST 2004;Committer;gotoyuzo;2;30;3;33;0
57e7333eea5a5280b532d885b3159ecedf3e1c9c;Sat Jan 24 12:39:31 EST 2004;Committer;usa;1;3;3;6;0
5e24c11a28fddc9f93012cf33769d89cfd3fc886;Sat Jan 24 04:24:06 EST 2004;Committer;gotoyuzo;3;99;44;143;0
b0ca18ec4cc32015c020748831b17cc3d6e71da5;Thu Jan 22 23:57:25 EST 2004;Committer;nobu;1;3;3;6;0
7df46a4493ea5b261aab64d482a840fbd57ffcca;Thu Jan 22 18:06:38 EST 2004;Committer;matz;5;64;103;167;0
edddc369705fa3d12f18f850d49e5362d011f72f;Thu Jan 22 14:01:15 EST 2004;Committer;shugo;2;8;2;10;0
e06502f3a4db56cd922167fc9217a2808b395b7b;Thu Jan 22 09:37:24 EST 2004;Committer;eban;2;4;2;6;0
225cd9f109ee4918d00c1b57f8e77b82c1321202;Thu Jan 22 08:31:33 EST 2004;Committer;matz;6;17;7;24;0
48b24fe53608844aa46a51e6e965b43c00e94a19;Thu Jan 22 07:21:40 EST 2004;Committer;nobu;2;10;1;11;0
002517aba82f3d318dab09f603491417240bfe0f;Wed Jan 21 16:47:23 EST 2004;Committer;matz;11;73;102;175;0
d0149b9e210450113353e9bc8dc1f151f4563313;Wed Jan 21 16:23:07 EST 2004;Committer;siena;2;28;0;28;0
a9f5c042ef8d293aeed9170bd551138018c58b95;Wed Jan 21 16:11:45 EST 2004;Committer;eban;1;3;3;6;0
357d0ffc2902c4d2e601586e82f1f3aec949e7d8;Wed Jan 21 16:09:40 EST 2004;Committer;siena;6;18;1;19;0
6ccba894a5a394cb64523870b39eddb7a3c3646a;Wed Jan 21 15:30:22 EST 2004;Committer;siena;1;4;0;4;0
fc69b2a7f6224fc590d8576a38eded521917c8a1;Wed Jan 21 15:26:11 EST 2004;Committer;siena;6;18;5;23;0
cb3cf6cfea9ebe102f2be5ac4967786805ffef87;Wed Jan 21 15:11:02 EST 2004;Committer;dave;3;8;3;11;0
72592e35ae573e7c34cdfa7b5bfe22d420321ddd;Wed Jan 21 14:53:31 EST 2004;Committer;eban;2;8;7;15;0
27e4c2fc27df925fe97f8ad289e3060329b58f5f;Wed Jan 21 14:06:21 EST 2004;Committer;seki;2;5;1;6;0
6010ca65fa1fba9633e4b014aaa25ce3f2745b3b;Wed Jan 21 14:05:09 EST 2004;Committer;seki;1;1;1;2;0
58145e6d93d8c62f827f229ae40d21f3556a786c;Wed Jan 21 09:05:28 EST 2004;Committer;nobu;1;0;1;1;0
a2f60e923e2f9f7628e0ec75b9092af1a3e18b3d;Wed Jan 21 09:01:23 EST 2004;Committer;shugo;2;60;32;92;0
2cff4c0126a7e003653a183119ebdf7633246a9e;Wed Jan 21 07:46:59 EST 2004;Committer;eban;1;3;3;6;0
f3e0252e5e51c8e47c7ad4f8d2b6235f3d5ee7af;Wed Jan 21 07:44:24 EST 2004;Committer;nobu;2;6;0;6;0
b89f4520e502e4e100c3d56216305eaf870243b6;Wed Jan 21 07:10:41 EST 2004;Committer;nobu;2;85;60;145;0
ce164c2a304b18d833d8e5835570df5f2534c636;Wed Jan 21 07:01:43 EST 2004;Committer;nobu;2;6;3;9;0
fb242251542b9b54c0e43d3e705383e586fe5b19;Tue Jan 20 06:20:59 EST 2004;Committer;dave;1;55;90;145;0
91482546b5a8e6bc0adf65291e87b995ec1eb1ec;Tue Jan 20 05:49:14 EST 2004;Committer;gotoyuzo;2;6;9;15;0
66186dd081986a3b921f7ddf2822af9a8c64fe11;Tue Jan 20 05:44:56 EST 2004;Committer;dave;3;62;0;62;0
e10e26d329fecc4f6bc056cf5a98d75da7b855e4;Tue Jan 20 05:27:23 EST 2004;Committer;dave;2;42;0;42;0
f8c7b41165042b3d398a6a237aac9207e2856aea;Tue Jan 20 05:04:31 EST 2004;Committer;dave;6;172;45;217;0
c354e35d79c955f1d39e52560655f46f86209110;Mon Jan 19 19:42:03 EST 2004;Committer;nobu;2;16;5;21;0
2bedaf01987fa0eecac0996f33112e1b4dae9d1d;Mon Jan 19 18:00:15 EST 2004;Committer;eban;1;3;3;6;0
0ecdbb65a8591a10d8c3eb7f9dc4308f303dd9ca;Mon Jan 19 17:55:18 EST 2004;Committer;gotoyuzo;2;16;0;16;0
108baac00aed6b4901deccabb77945c60f68d73e;Mon Jan 19 14:56:24 EST 2004;Committer;nobu;2;6;1;7;0
939e7877d39ce31135cf04ace96ffaa481b803ff;Mon Jan 19 14:05:55 EST 2004;Committer;eban;2;3;1;4;0
0ade226f58b270dde4e198f9818741d7684dcb60;Mon Jan 19 13:27:38 EST 2004;Committer;eban;2;6;2;8;0
224021104d13cbb060cdf87914361503226e4adf;Mon Jan 19 12:28:14 EST 2004;Committer;nobu;6;24;43;67;0
22c005569b8cd00ea6895dcc7b621b80d9f15068;Mon Jan 19 09:19:31 EST 2004;Committer;matz;11;196;115;311;0
8e877fc51727feed6c07292c3845970103ec109f;Mon Jan 19 08:39:43 EST 2004;Committer;nobu;3;11;4;15;0
8ccba1d12f55174437f39fb2bae2e0009e2cb11e;Mon Jan 19 07:32:47 EST 2004;Committer;akira;2;7;0;7;0
c24cfc6b436a0aad3bc0ad7506698f2f3a1c0750;Mon Jan 19 04:11:40 EST 2004;Committer;usa;1;3;3;6;0
fe5b6676b1013448f6c23b50778b9f57aa010f6d;Mon Jan 19 04:10:53 EST 2004;Committer;usa;5;34;13;47;0
5bcd6bd99f61b82e2d5cd1eb57dec97b8143d608;Sun Jan 18 22:14:02 EST 2004;Committer;tadf;1;10;0;10;0
720a23df0a4230dfeccce9911bd2eae4a303e19a;Sun Jan 18 22:01:12 EST 2004;Committer;tadf;3;197;156;353;0
91c798b670d3408db607dba74d782dc95982f23a;Sun Jan 18 14:59:49 EST 2004;Committer;nobu;3;49;8;57;0
a7b1a2ecedb3d7180a164c045b90be4b2b38704d;Sun Jan 18 14:16:47 EST 2004;Committer;nobu;10;21;2;23;0
736668f2b00b8c0f33a55cef16a0dcf8708fda7e;Sun Jan 18 11:49:46 EST 2004;Committer;eban;2;7;3;10;0
47d0703ee5fb25d5a0586e32932bdd43a7ef4b64;Sun Jan 18 11:13:11 EST 2004;Committer;nahi;2;189;0;189;0
290034fde815cbc389d29d3111553dbde4ab676a;Sun Jan 18 11:10:18 EST 2004;Committer;nahi;5;40;6;46;0
11685dc1eea123132fc6feebbd98d3e9dfcbb41c;Sun Jan 18 07:46:51 EST 2004;Committer;nobu;2;18;13;31;0
058fd783909219eb1cff4e33aa4f9f0eb48e01a4;Sun Jan 18 04:11:09 EST 2004;Committer;siena;2;21;8;29;0
4e880080a725af2f5c052a23635c773f70de315d;Sun Jan 18 04:00:00 EST 2004;Committer;siena;1;24;0;24;0
8e8cce4951aa5aa5def7335e72b13893aff3d2e0;Sat Jan 17 17:39:08 EST 2004;Committer;eban;1;3;3;6;0
14dc9c35084bc39842a0dcb72033b93b70223ce3;Sat Jan 17 17:39:05 EST 2004;Committer;eban;2;8;3;11;0
13fa93f777a40e55b41f0e89c4337a21d0e06058;Sat Jan 17 15:23:59 EST 2004;Committer;nobu;2;12;10;22;0
292b3ecbb4a5cde9abd7ec6ed430acb30856dd78;Sat Jan 17 14:58:57 EST 2004;Committer;nobu;3;113;70;183;0
f9c2dcec4eec842a3d35d83644fed4cc892d94dc;Sat Jan 17 13:13:42 EST 2004;Committer;usa;1;11;3;14;0
0a3a46b45ec316860a30640552d77ae0db864fee;Sat Jan 17 13:08:57 EST 2004;Committer;nobu;1;3;3;6;0
9d907ff12eb907fd6a550da12b7aaaa7811da8fa;Sat Jan 17 12:52:14 EST 2004;Committer;usa;1;1;1;2;0
3dea3d810fc488957a8ea66b55769925b6bbdbb7;Sat Jan 17 12:51:39 EST 2004;Committer;usa;2;29;14;43;0
154615ea666ce8d0ac44b2d450a226246358276e;Fri Jan 16 14:53:10 EST 2004;Committer;nobu;2;4;3;7;0
8e8c7f04ef6346fa3a4db5c1770933a489acc69e;Fri Jan 16 14:07:06 EST 2004;Committer;nobu;1;9;8;17;0
2cb9e7a2e87f521655e688189b01a4d4081e0b98;Fri Jan 16 08:41:39 EST 2004;Committer;nobu;1;1;1;2;0
fd23f145e6deee2315416a916bf8990bea44e7c2;Fri Jan 16 05:56:53 EST 2004;Committer;nobu;2;9;2;11;0
551e4171459820e8d35f19006dbbd833a0501411;Fri Jan 16 05:53:55 EST 2004;Committer;eban;1;3;3;6;0
10b86da1b19183fe6a2f436973ad57eaf52e267e;Fri Jan 16 05:36:54 EST 2004;Committer;nobu;1;1;1;2;0
ea339864afeeb59a3101d597b65ea2005531dc48;Fri Jan 16 05:33:39 EST 2004;Committer;nobu;2;22;4;26;0
5a8d60bf7fb39e9beb1bb8df69a9c82a70d7728d;Thu Jan 15 04:03:15 EST 2004;Committer;nobu;2;12;2;14;0
c3b99cc6f37ebea39c0d0a12bc1ea39272a10480;Thu Jan 15 04:00:21 EST 2004;Committer;eban;1;3;3;6;0
546dc52e790476e608c367013bbcb7df9cb9a2c7;Wed Jan 14 12:13:11 EST 2004;Committer;nobu;2;6;2;8;0
a9c7e160089dc9bba677abf44e6715d1bcae13cf;Wed Jan 14 11:17:36 EST 2004;Committer;eban;1;3;3;6;0
8802ebc9e1fa5bfe67aa0a5ae338b4194df0b732;Wed Jan 14 08:54:21 EST 2004;Committer;nobu;2;20;8;28;0
7e932df0d519797535020a38f58da02bdb59c13c;Wed Jan 14 04:31:11 EST 2004;Committer;nobu;2;6;2;8;0
55b4f439586a4781677ec42662c83f6d534ea67c;Wed Jan 14 00:35:33 EST 2004;Committer;usa;2;5;0;5;0
5cebcf9a2b06e00771e291d00b3fcdbde5e21394;Tue Jan 13 07:57:33 EST 2004;Committer;why;2;13;0;13;0
cfcebb7e8f41e808b5eec9cadeed287bc40ea18b;Tue Jan 13 07:52:03 EST 2004;Committer;nagai;2;6;1;7;0
6760a5ed9f693686fa1571850716360c676dc7f5;Tue Jan 13 05:48:59 EST 2004;Committer;matz;4;45;14;59;0
47c7c5bac646f4d0ac3640856354884b751b6be4;Tue Jan 13 05:27:24 EST 2004;Committer;nobu;7;10;24;34;0
45c950c1df411bb245ddc50138b6ab64f289753b;Tue Jan 13 04:06:31 EST 2004;Committer;nahi;9;20;16;36;0
aaa6511a15a04d53f37d4562df8e695482f4d862;Tue Jan 13 03:32:52 EST 2004;Committer;usa;1;3;3;6;0
b847262c8fd07d520a048821154adfad0935c747;Tue Jan 13 02:39:03 EST 2004;Committer;nobu;2;9;6;15;0
52e0ab245a1c7d446861f8882f741356b4d24bec;Mon Jan 12 22:55:09 EST 2004;Committer;why;5;717;617;1334;0
84c0dcfca25a7d67e45f6585962de38f7854bc2f;Mon Jan 12 19:32:24 EST 2004;Committer;dave;3;8;3;11;0
6c862db688a8a0152630f4fda7930298412f5d21;Mon Jan 12 16:26:05 EST 2004;Committer;matz;2;15;17;32;0
c8b7862e86cf4a5e940689071c46a80960daa215;Mon Jan 12 16:10:52 EST 2004;Committer;dave;1;7;1;8;0
6cea9bc9041bd8a74d53cb7b647d6957180b9957;Mon Jan 12 16:06:35 EST 2004;Committer;dave;2;6;0;6;0
d094d007202904ad036a8034f0b6b23feb6dbe38;Mon Jan 12 14:27:22 EST 2004;Committer;nobu;2;10;4;14;0
a739d26d0a494a141059c0e8045bff66bc66d39b;Mon Jan 12 13:34:26 EST 2004;Committer;matz;3;91;1;92;0
a1d3a8e8619b82fbff71ae7dd264926983be829a;Mon Jan 12 03:11:25 EST 2004;Committer;dave;5;39;9;48;0
e1f3e3496b28f53e801237be54aebecd2883c61b;Mon Jan 12 00:33:35 EST 2004;Committer;nahi;1;3;3;6;0
b4d94277bb37ff405c2ca5bd47809083a9bfa3ee;Sun Jan 11 17:34:05 EST 2004;Committer;dave;3;157;29;186;0
db4ec3c56a0ee43630234885039cc3bcd13f8026;Sun Jan 11 14:54:44 EST 2004;Committer;nobu;2;11;6;17;0
f32d0e89340ba610037c654eb89033e732ad0624;Sun Jan 11 04:58:18 EST 2004;Committer;usa;1;3;3;6;0
32ceec70bef5dea0e75b17ae327fb59457f61773;Sat Jan 10 17:52:38 EST 2004;Committer;matz;2;5;1;6;0
b07337fcb3a26397203a2c98f1b20d0d99dce946;Sat Jan 10 17:39:07 EST 2004;Committer;matz;6;123;43;166;0
60c8435e1f775ff27e81cac5a84a28f7d0f6319a;Sat Jan 10 17:10:19 EST 2004;Committer;dave;2;11;0;11;0
235ba61b594b067b74ee0b7e3f7333aaf02d3ef3;Sat Jan 10 14:36:42 EST 2004;Committer;nobu;1;3;3;6;0
482b9c2ce7837af5071ba38db0874046020a10db;Sat Jan 10 14:01:50 EST 2004;Committer;nobu;6;18;9;27;0
53157197d2fc18b2fcef62df05c2fca8707cd979;Sat Jan 10 13:46:21 EST 2004;Committer;nobu;2;28;0;28;0
33a899f09b690261df55de13c6fb7991f40c5eed;Sat Jan 10 01:32:20 EST 2004;Committer;nobu;1;3;3;6;0
f34ce620a79db7f21131a912fb6f456ded2d218f;Fri Jan 09 04:26:05 EST 2004;Committer;nahi;5;51;15;66;0
417a410892ac5a3c6e70f5d7abc9fd8ba9bc1914;Fri Jan 09 02:52:19 EST 2004;Committer;nobu;2;8;5;13;0
bafe6d850499ad30c4fd21fac6036cb7b5cae2d3;Fri Jan 09 02:20:28 EST 2004;Committer;nobu;3;24;1;25;0
6f69b2b00a269fd728bc350167ed14a6e36f6b68;Fri Jan 09 01:05:27 EST 2004;Committer;nobu;2;8;4;12;0
50fe8ab6aa95482ea79d69e0c9891c93f6856c0d;Thu Jan 08 14:58:57 EST 2004;Committer;eban;3;20;4;24;0
54d29aaba965a0405ff119dbadb70415621cc496;Thu Jan 08 12:24:22 EST 2004;Committer;gotoyuzo;5;89;22;111;0
0f3e58e707257f7456fd9be26ff27a973c722bce;Thu Jan 08 09:25:32 EST 2004;Committer;nobu;2;5;1;6;0
d69d6b6c368fef17958d647600c1d8ef7b602d7a;Thu Jan 08 07:55:00 EST 2004;Committer;nahi;2;24;17;41;0
973c2ad00d5d9f8636b9472a245e56d5729fe3e0;Thu Jan 08 02:21:28 EST 2004;Committer;eban;5;30;26;56;0
a68aa547a106b0b2dc1b4035a15b583d79b8492e;Wed Jan 07 23:46:18 EST 2004;Committer;nobu;2;184;176;360;0
2f7ebefa94450f524d9f583d98446e689b3a0294;Wed Jan 07 22:17:48 EST 2004;Committer;nobu;1;3;3;6;0
44e22e8d78e874ee3651b8987ecd9556740b2da6;Wed Jan 07 22:06:38 EST 2004;Committer;nobu;6;32;7;39;0
250cfdc0aae92fe4c69ed9afbd06d03360ec40b6;Wed Jan 07 19:37:36 EST 2004;Committer;gotoyuzo;2;6;0;6;0
debe0485f0eae6a2fcedf6326c994a6e8cc60fb8;Wed Jan 07 13:28:15 EST 2004;Committer;nobu;2;13;7;20;0
d5ffbb20e80202319957c74e75fbdd628cbda43b;Wed Jan 07 12:42:52 EST 2004;Committer;matz;2;6;0;6;0
16291a0db719e9c174ab6890eb0c50ebef1cf8f7;Wed Jan 07 12:22:19 EST 2004;Committer;gotoyuzo;10;185;0;185;0
b33d3cfb41b459c7599486a5d5c7e45a4ce2a009;Wed Jan 07 11:52:14 EST 2004;Committer;aamine;2;143;0;143;0
7050611cf98fc25d012d7dcdab92915b7fcb7f35;Wed Jan 07 11:42:21 EST 2004;Committer;aamine;2;7;1;8;0
6abca35457d4e16b561fed8b7936b06068b33697;Wed Jan 07 11:31:21 EST 2004;Committer;akr;4;14;14;28;0
c24349e32d6cd74e4df9103364af62a59095ef6c;Wed Jan 07 05:28:53 EST 2004;Committer;nagai;4;86;14;100;0
cd97e6e333ee327fbe1aa5ead4ba7776aff818b8;Wed Jan 07 05:28:02 EST 2004;Committer;nahi;4;351;0;351;0
305cc5d2d9dabbc61a03f65d22d94f9161ecd8a4;Wed Jan 07 04:05:25 EST 2004;Committer;dave;3;30;9;39;0
cc2fdd8213042eb81801deaaeacfb0cd2cb9dbf5;Wed Jan 07 03:43:12 EST 2004;Committer;eban;1;3;3;6;0
796ca6f201df28484151bd32ae39be5392f2625b;Wed Jan 07 03:42:00 EST 2004;Committer;nahi;2;10;5;15;0
0ea74ce4e7e2ecb90b5324bfc2a80e62b0bbc519;Tue Jan 06 23:26:42 EST 2004;Committer;dave;2;19;1;20;0
d231dc04d0000f888a476d72098234caedd79d67;Tue Jan 06 12:55:05 EST 2004;Committer;nobu;2;18;12;30;0
77cb3aeba154de96e0da03aba3b2265f4df76842;Tue Jan 06 11:55:08 EST 2004;Committer;nahi;3;29;30;59;0
96ff9b04c1e350621e3f2b4e5e35fa1bd7fb0b2d;Tue Jan 06 05:59:31 EST 2004;Committer;dave;6;395;296;691;0
79c0e644a175754540399ff2148f3fdb5c998339;Tue Jan 06 02:34:24 EST 2004;Committer;nahi;11;99;0;99;0
ff1b89a96d0f103ff0c917c458ddd3e36e9b3718;Tue Jan 06 02:20:51 EST 2004;Committer;nahi;26;473;215;688;0
1b31d09edd94a1bad3fa8e987490d82e7088ebad;Mon Jan 05 21:48:16 EST 2004;Committer;dave;7;108;40;148;0
791f55ef987d523855ffdcae709c054cf897e148;Mon Jan 05 16:05:34 EST 2004;Committer;eban;1;3;3;6;0
573b35d45ed202357cbeaca5b142ce015bc0a237;Mon Jan 05 16:01:54 EST 2004;Committer;usa;4;8;27;35;0
51826a7b81489af05c51bb44dee897bc882af434;Mon Jan 05 13:33:48 EST 2004;Committer;gsinclair;2;355;207;562;0
caaac4db27bcd33f7865faaf60d6a848c5204d03;Mon Jan 05 10:01:54 EST 2004;Committer;matz;6;90;29;119;0
7336cf5424cd9adb91fb56005cf55b39410d9305;Mon Jan 05 04:52:50 EST 2004;Committer;dave;2;18;6;24;0
90d913613c6992b326b1e0f2c18089bb78196209;Sun Jan 04 18:01:06 EST 2004;Committer;aamine;2;14;0;14;0
cd8f26b7d2850b3475ec8f036fbda4a7bf43c652;Sun Jan 04 16:49:21 EST 2004;Committer;usa;1;3;3;6;0
d110f97055a7d42c92ec5a62abf962b19ebb7a62;Sun Jan 04 16:48:45 EST 2004;Committer;usa;2;7;1;8;0
f206ed9bce9fa74e818da4b266a9f9d01590aca0;Sun Jan 04 14:49:26 EST 2004;Committer;eban;1;3;3;6;0
d35743aa00945aaaafd61f01daf0f32cf5e84cc8;Sat Jan 03 17:08:20 EST 2004;Committer;matz;1;1;0;1;0
88fb246cc7944b7feb5585a4f4ac3248df4b7770;Fri Jan 02 17:46:02 EST 2004;Committer;matz;2;15;3;18;0
59dbfa3e4cc8d4705ef5a4abd9904fa523f26bfa;Fri Jan 02 16:21:26 EST 2004;Committer;matz;11;402;264;666;0
88c127c19be3d12bc5edcb6ceb416985258396c6;Fri Jan 02 06:01:12 EST 2004;Committer;dave;20;1442;255;1697;0
eee1377a60de602723599d313e1379ba7d875add;Thu Jan 01 15:47:52 EST 2004;Committer;nahi;1;1;3;4;0
776ab7d14795ce3bb927b02bbee2a504f8c41d85;Thu Jan 01 14:15:06 EST 2004;Committer;eban;1;5;5;10;0
831a294b0c644159a7388e3dd8d324abbe9cc08d;Thu Jan 01 00:05:13 EST 2004;Committer;dave;2;6;1;7;0
bd45695886c6f0313abfca7b3c692d56722f00bb;Wed Dec 31 06:09:22 EST 2003;Committer;gsinclair;2;7;3;10;0
29b7f2efcae1d4d980f5d3d71f8cd56ab6a3f89c;Wed Dec 31 05:47:45 EST 2003;Committer;gsinclair;2;270;107;377;0
f5b7214548fc4b07db6a7f5bf14f44ed782f7257;Wed Dec 31 02:24:10 EST 2003;Committer;dave;2;8;1;9;0
e9a7fd1c92afb7f37a640d01c3f0173c08302fba;Wed Dec 31 02:21:07 EST 2003;Committer;dave;2;13;3;16;0
2c87fffec417971fdc7c3fa457dd17ac2be451c6;Tue Dec 30 19:29:56 EST 2003;Committer;matz;2;29;16;45;0
5e78715f2ca14906b6df594ffebe823955160c95;Tue Dec 30 18:14:19 EST 2003;Committer;eban;1;3;3;6;0
349f4e7db766e618d606768d5ead8cbc9f4ef74f;Tue Dec 30 16:38:32 EST 2003;Committer;dave;11;646;29;675;0
5e6d81e717879424edc46cda993799d8de7aa635;Tue Dec 30 10:13:54 EST 2003;Committer;gsinclair;1;2;0;2;0
3307bc7fee296837defa850852a9225949b8b682;Tue Dec 30 08:18:37 EST 2003;Committer;eban;1;3;3;6;0
5b76f13a8966e86c9fc0e1b0b8c84c71f54c7b82;Tue Dec 30 03:33:35 EST 2003;Committer;dave;2;24;6;30;0
e9b667daefb4bd785368e40dea7bfe0f56f0599b;Tue Dec 30 03:10:30 EST 2003;Committer;dave;1;1;0;1;0
1da4596b0f968900723517ea007c47db84310478;Mon Dec 29 23:38:09 EST 2003;Committer;dave;2;12;2;14;0
db93a78e634d2328b1ab9be876e6c8cf28a45fe3;Mon Dec 29 22:31:55 EST 2003;Committer;gsinclair;2;190;18;208;0
ef70baa40a40d62040ce6b2b52dddc9990e13ce8;Mon Dec 29 11:08:47 EST 2003;Committer;aamine;2;142;152;294;0
d993e38f1898a2edf29f304c8aa3b34aceb34c35;Mon Dec 29 03:56:22 EST 2003;Committer;dave;7;1108;7;1115;0
a5a5ac6c9257d646d1a53affe76ce11e811f943c;Mon Dec 29 02:02:08 EST 2003;Committer;dave;2;37;2;39;0
8d32798543cba1cca6b6d1e53383b93ba347f89d;Sun Dec 28 20:47:56 EST 2003;Committer;dave;5;282;2;284;0
f42c729a2e6bfa94e8eb86ac905571f24d0d3fc3;Sun Dec 28 17:31:10 EST 2003;Committer;gsinclair;2;260;262;522;0
d5005596bb1041fe52c77c375b75f134f5f06782;Sun Dec 28 17:27:42 EST 2003;Committer;usa;1;1;1;2;0
dfad21546ce92e3815bfa89b343437d312a281b4;Sun Dec 28 17:27:11 EST 2003;Committer;eban;1;3;3;6;0
923b55d35b560d11f13eea802a0f246a3c908ae6;Sun Dec 28 17:25:31 EST 2003;Committer;usa;7;68;25;93;0
bb2030498a14f28686472fb93fe492192f48c606;Sun Dec 28 17:24:32 EST 2003;Committer;dave;2;376;0;376;0
a12c70cd2ef0b1553345d35818c7c34b41632312;Sun Dec 28 15:44:07 EST 2003;Committer;dave;2;188;0;188;0
745ce54b4a46da48ced66c5d90496a0746cdded8;Sun Dec 28 11:27:42 EST 2003;Committer;akr;3;10;2;12;0
3c288b427d26d21580f515cb227335eab335ee84;Sun Dec 28 06:33:07 EST 2003;Committer;dave;8;1262;41;1303;0
45255b2e272c8012aef0c30e91115fdf01c84184;Sun Dec 28 05:10:22 EST 2003;Committer;eban;1;3;3;6;0
6dc12f6f74dfa2314d43d58e1f5b77c5930317e9;Sun Dec 28 03:52:15 EST 2003;Committer;nahi;5;19;10;29;0
4c9874991152b36467af408df03aaf9dba70c8a1;Sun Dec 28 00:02:59 EST 2003;Committer;dave;2;605;0;605;0
3f3c55f49c4d1b496a2b0e79f4eb5bc4acb993b9;Sat Dec 27 18:52:03 EST 2003;Committer;dave;2;7;2;9;0
3009adaee288c2f63d5e87091f3ed4f0b378720c;Sat Dec 27 16:49:22 EST 2003;Committer;dave;3;11;2;13;0
68d292236d0ad8687341669b272fb2536f120a95;Sat Dec 27 16:39:44 EST 2003;Committer;dave;2;48;1;49;0
75cc3e4f754b7b1ddcec69407b1641f396acf919;Sat Dec 27 16:07:43 EST 2003;Committer;dave;2;144;0;144;0
e55466442618ab707e03e9f1cc8e2bd75a2f6681;Sat Dec 27 15:50:03 EST 2003;Committer;dave;2;9;1;10;0
9eca8a4a5f27532791ffad5196a150153f3d4a84;Sat Dec 27 14:45:48 EST 2003;Committer;eban;2;10;6;16;0
56a004931238ccd47cd2102e8dc5f5f07df8d213;Sat Dec 27 06:33:45 EST 2003;Committer;dave;2;485;0;485;0
d89650c8cfc9eda306fc07f74f25eb0b2455bf0f;Sat Dec 27 06:09:08 EST 2003;Committer;dave;2;135;0;135;0
791f868395deea76a253c55101beb8c82d0ef868;Sat Dec 27 05:46:46 EST 2003;Committer;dave;2;360;0;360;0
e950d051e18abfb5f7b68e69133fed1ba0e7cff8;Sat Dec 27 00:44:05 EST 2003;Committer;dave;1;819;2;821;0
e973fe16f1c8becb17d5932a733c464885ea43ca;Fri Dec 26 17:08:57 EST 2003;Committer;eban;1;3;3;6;0
23f79ec2826888f02a91c63609a135cdbd8cbb09;Fri Dec 26 17:05:20 EST 2003;Committer;matz;2;36;12;48;0
d1fd7bdf484fbda6092c241989a89afb6882650a;Fri Dec 26 15:58:28 EST 2003;Committer;dave;1;419;0;419;0
b9a79bc0202072aeda560d13ff71dae4ea49721c;Fri Dec 26 15:34:33 EST 2003;Committer;matz;6;41;20;61;0
ab0c37d0cfdeff23a8392c71cbe7e8ea1bc0ac5c;Fri Dec 26 09:34:03 EST 2003;Committer;nobu;3;38;41;79;0
88947c09c4ca803df0a79a81b519cbb5e498e85c;Fri Dec 26 07:42:35 EST 2003;Committer;akr;2;6;0;6;0
16bcd53d215ba6a627a4dbb1c88ce67a3fece08d;Fri Dec 26 05:05:37 EST 2003;Committer;aamine;2;16;0;16;0
9008b4f3ea42c4b666d846da6f18f19814ee6d0f;Fri Dec 26 02:00:41 EST 2003;Committer;usa;1;3;3;6;0
f573bcd1293fcfd59528f2396b838769c2894a92;Fri Dec 26 01:59:42 EST 2003;Committer;usa;3;6;2;8;0
67331f24977410b5a5dc622ef994c4de5cf5cc21;Fri Dec 26 01:47:12 EST 2003;Committer;akiyoshi;2;10;5;15;0
3cb3f36ec8a53b31aa08c132c997b9f92095181b;Fri Dec 26 01:39:25 EST 2003;Committer;akiyoshi;2;120;61;181;0
67e1e119694192b663989829524bb5ecfb0f97fc;Fri Dec 26 01:38:31 EST 2003;Committer;akiyoshi;1;7;0;7;0
11edb88f70222390fba3a88692c7fc8908eba8b7;Thu Dec 25 19:59:39 EST 2003;Committer;dave;1;2;0;2;0
3e16f5a3f053645e2e640ff5068fd97cdaffb7de;Thu Dec 25 13:30:39 EST 2003;Committer;usa;2;5;1;6;0
f7d46c88609f4991ef899059a7d16801aa245574;Thu Dec 25 08:49:20 EST 2003;Committer;matz;4;24;15;39;0
33e05ba9163ef85d95d3117c5a56ef5e96cc99cb;Thu Dec 25 04:54:08 EST 2003;Committer;eban;1;4;4;8;0
2d83cd85ee0032fdd562d335cb68dce42933c2c5;Wed Dec 24 21:14:46 EST 2003;Committer;dave;1;1145;0;1145;0
daef2a1df2ff7924ee8be3e1fabc5203fca0f649;Wed Dec 24 20:08:12 EST 2003;Committer;nobu;2;14;10;24;0
cecdab3bf0e8b03cfdccb20fb5ae82c31fae623b;Wed Dec 24 19:38:15 EST 2003;Committer;matz;3;26;4;30;0
060f19e92c9b8978b36435f73ca45eefa48b2cbc;Wed Dec 24 15:44:41 EST 2003;Committer;dave;1;7;10;17;0
65d37c6cc5713fc51dff454e52d188bc691418e1;Wed Dec 24 15:19:11 EST 2003;Committer;matz;4;13;9;22;0
dc7549c0b0a54262b5e7939ee88a75557ef4c953;Wed Dec 24 14:53:17 EST 2003;Committer;nahi;4;15;5;20;0
8b279c0ddbcf417230b7e3fa08ca020bb8f309ad;Wed Dec 24 14:31:41 EST 2003;Committer;akr;2;4;14;18;0
8855456929e5d71ccadaddfc5be1823eb7c17e6c;Wed Dec 24 11:57:21 EST 2003;Committer;nagai;4;761;8;769;0
42da26054358e775d3d4f9f8f5fa88482c59b467;Wed Dec 24 11:54:12 EST 2003;Committer;eban;2;7;1;8;0
e9e100aa48cfc43a588ee411e1fbb861de956587;Wed Dec 24 08:47:36 EST 2003;Committer;matz;5;54;27;81;0
932075e82e1879bb0258bccd607c4c30b9ff486d;Wed Dec 24 07:29:40 EST 2003;Committer;gotoyuzo;2;38;12;50;0
6fe8d987ce2296174dcd3e4f3c382f8114728210;Wed Dec 24 05:23:32 EST 2003;Committer;nobu;3;30;0;30;0
73d77c8f572b760b4c868579188fc39f360151cb;Wed Dec 24 05:08:04 EST 2003;Committer;nobu;6;68;31;99;0
d05b3b1e4801903a3f6338af932be334049de1ed;Wed Dec 24 04:49:58 EST 2003;Committer;eban;1;7;7;14;0
e34f7ef3cca01d135d6290483851c2ceb31b5991;Wed Dec 24 04:44:25 EST 2003;Committer;shugo;2;6;1;7;0
bba2f6d4052235e9c8d62c0c3b7294e8dae1d7b7;Wed Dec 24 04:29:32 EST 2003;Committer;dave;1;184;0;184;0
f0346bd249ae29cdf4d9c2e88b09e63c41ff1ce8;Wed Dec 24 04:24:29 EST 2003;Committer;dave;14;1720;1309;3029;0
52975bb7a77b3a6409e50609b4baeafade035b3d;Wed Dec 24 02:26:44 EST 2003;Committer;nobu;2;18;1;19;0
c2b63d249f9e21d7b5d92680f614952490fbe708;Wed Dec 24 01:29:57 EST 2003;Committer;nobu;2;30;4;34;0
8365bb013f7d7493f398ff07de7cfa3da54053bf;Wed Dec 24 00:53:45 EST 2003;Committer;usa;1;3;3;6;0
170f4e21d3a4d754d9746028dcd8e5c5401c457a;Wed Dec 24 00:38:53 EST 2003;Committer;nobu;2;7;1;8;0
9146c954ffa4b5112d66273915a2fd74edbb38f3;Tue Dec 23 21:19:03 EST 2003;Committer;dave;1;3;2;5;0
0a4fc3d71ba383af2eb2da62509d3c5537eebb68;Tue Dec 23 19:53:45 EST 2003;Committer;matz;5;69;50;119;0
a3ecd5c83d57fb1556a40113f1b0c69c87261e33;Tue Dec 23 16:21:17 EST 2003;Committer;dave;3;1174;1;1175;0
fd4a3ee4ac45995639ae361bf7ccb61a59ec124d;Tue Dec 23 13:27:42 EST 2003;Committer;gsinclair;2;411;307;718;0
818ecd7d0b9455c57b30fd95535cc43246453c17;Tue Dec 23 12:35:29 EST 2003;Committer;eban;1;3;3;6;0
619587e205db1acb717af2a88555d705fcd3c3e8;Tue Dec 23 10:47:01 EST 2003;Committer;nahi;2;9;10;19;0
163a6e81b207525e4f35e21464ee5ab3afbd3cb5;Tue Dec 23 10:43:04 EST 2003;Committer;nobu;3;15;10;25;0
44182056f63e877e90f75abcd12df9695311180c;Tue Dec 23 10:07:45 EST 2003;Committer;usa;1;1;1;2;0
dbc5af97c766e667aa6aaa918cae1278afde69a7;Tue Dec 23 10:02:17 EST 2003;Committer;matz;5;18;12;30;0
d5ae9837ffe13841f26c073914d61f9abb279272;Tue Dec 23 08:29:54 EST 2003;Committer;usa;2;5;0;5;0
d83e21d15ddd9142c448aea80dbca6c452ecff6a;Tue Dec 23 07:13:59 EST 2003;Committer;nahi;4;18;3;21;0
4bb0fd231e66e61c76396b47b2b7eb8d72cec1c7;Tue Dec 23 05:17:00 EST 2003;Committer;akira;3;37;9;46;0
53ebcbf733d3eaeca1fb7a49d5621054917951c7;Tue Dec 23 02:12:10 EST 2003;Committer;nahi;2;12;1;13;0
4a663be97ea6b29923d0baab5a1e24699c0ecdef;Mon Dec 22 21:13:06 EST 2003;Committer;gotoyuzo;4;102;36;138;0
6bcf78e40df4b20e85ab1f2207dd88781e578867;Mon Dec 22 14:01:07 EST 2003;Committer;akira;2;5;1;6;0
54524ed8f036f993c0a2acd4b671783daa774d86;Mon Dec 22 12:59:28 EST 2003;Committer;nobu;2;5;5;10;0
65fed5dad3dbcbb60cc6ccffd4e43359ec29ffb4;Mon Dec 22 12:15:34 EST 2003;Committer;nobu;3;10;1;11;0
88695fc0ea105d16f3c40be0119c18ff7306331b;Mon Dec 22 11:49:20 EST 2003;Committer;akira;3;11;1;12;0
3fdd33b70c8128469fabb168edbd5a5b33ca9cfe;Mon Dec 22 11:38:48 EST 2003;Committer;nobu;2;49;68;117;0
d7ff8a6469709ddd3b226d9f417d32e393a81e19;Mon Dec 22 11:11:29 EST 2003;Committer;nahi;2;4;7;11;0
1c09bfad5c6dc798c53732095374ab27b7b0f59c;Mon Dec 22 09:37:13 EST 2003;Committer;matz;3;17;10;27;0
d0133e413db7a3b4ca7982f5c5548b47f68700ac;Mon Dec 22 09:26:24 EST 2003;Committer;usa;3;6;2;8;0
748b699d1b39cf9db5190a9b5f25fa8f32291677;Mon Dec 22 08:23:55 EST 2003;Committer;nobu;11;43;22;65;0
25b6ac95f2d2b034832e95a41536106c17c0fa07;Mon Dec 22 08:09:14 EST 2003;Committer;eban;2;7;0;7;0
1b0b3ec3387ba4a9b57281166b7a7583d854a023;Mon Dec 22 06:20:14 EST 2003;Committer;dave;1;150;0;150;0
3e2093695779b14c25d03b82129a6d1b7da5c8a2;Mon Dec 22 06:14:32 EST 2003;Committer;eban;1;3;3;6;0
b1d80f310f090aab0c8b8500dadd715ec65851aa;Mon Dec 22 04:41:35 EST 2003;Committer;nahi;2;12;12;24;0
a7b3a428501a855e3caee42474121fe8f387daf5;Sun Dec 21 15:38:01 EST 2003;Committer;matz;3;17;3;20;0
f8b298c5f94efd6405d9b34967b72235f7f3a3fa;Sun Dec 21 10:30:24 EST 2003;Committer;eban;1;1;1;2;0
d9fe29a7245232e4771802483b5f2700397dc3b1;Sun Dec 21 10:20:21 EST 2003;Committer;eban;1;3;3;6;0
7c34e359a1d8e1affabeaa43377cf49f09933dfd;Sun Dec 21 08:29:06 EST 2003;Committer;nobu;5;28;7;35;0
3e67076db01cbc53486e51f4b455220c9e4a3890;Sun Dec 21 07:28:59 EST 2003;Committer;akr;2;68;27;95;0
da99e407fbf36051bf9ebce01418589bff557298;Sun Dec 21 07:28:54 EST 2003;Committer;dave;9;1564;67;1631;0
6228cbe5efb35f3fb867f42525905cf2ded37aad;Sat Dec 20 16:59:09 EST 2003;Committer;matz;4;17;16;33;0
e91e9e7bbf1d93cdff89878b776a7824a9bc2d99;Sat Dec 20 15:45:15 EST 2003;Committer;matz;8;53;35;88;0
bb4f36de3a032909c90f6fa72f2134f198958145;Sat Dec 20 15:18:27 EST 2003;Committer;nagai;1;6;0;6;0
342aba0b84ebdfeab49f5ef0c6f9750d59e492f8;Sat Dec 20 15:15:51 EST 2003;Committer;nagai;2;78;0;78;0
a679f1861fc6ba25127433325e39d04e32c919c9;Sat Dec 20 13:01:33 EST 2003;Committer;gotoyuzo;3;22;13;35;0
07507fe37a01b461b5feb9f4c16dafe2f1276f28;Sat Dec 20 07:07:19 EST 2003;Committer;nobu;2;10;2;12;0
d4e661b4ad7589eb0656e92bc4b702b499a65cd1;Sat Dec 20 02:40:15 EST 2003;Committer;nobu;3;13;8;21;0
43920ad28c013f4b60799893942870ef9f1e9fc9;Fri Dec 19 19:05:04 EST 2003;Committer;gotoyuzo;1;1;1;2;0
1702e82e027aa09f13ad7fcacff94c4291b2ad39;Fri Dec 19 18:01:26 EST 2003;Committer;gotoyuzo;3;208;0;208;0
30d5fed40063ec7bd7555a983bbba62dfcb3ed9f;Fri Dec 19 17:57:37 EST 2003;Committer;eban;1;3;3;6;0
e6f473c3a0c8f3a70595ca58d1aa0b59a3996a90;Fri Dec 19 17:29:09 EST 2003;Committer;matz;4;66;52;118;0
5076ed519b124df90b2348f012d120e25e3820e0;Fri Dec 19 15:18:09 EST 2003;Committer;dave;4;421;33;454;0
a4874e20ae678606715fb40de8305e4368bd453e;Fri Dec 19 14:31:24 EST 2003;Committer;gotoyuzo;3;12;2;14;0
c1e9ce9ca6d888cc18d945c916db4f4acd685d6b;Fri Dec 19 13:59:27 EST 2003;Committer;nahi;3;154;70;224;0
a15cdb751223ba152ad73b4d39dbc30331c6168c;Fri Dec 19 10:24:24 EST 2003;Committer;akira;2;6;1;7;0
687cb911278d3c0dd0c408d9c6298914d5343cdc;Fri Dec 19 08:38:01 EST 2003;Committer;nagai;4;923;1;924;0
2b10a7d7fd8c506dfbb387ffa5374bb5297b39dc;Fri Dec 19 06:14:42 EST 2003;Committer;eban;1;3;3;6;0
8ed8664aa7ca657f536d507ac6de84d71e02e31b;Fri Dec 19 03:58:57 EST 2003;Committer;dave;7;191;16;207;0
d3b74e1806e572592b4242bee140813ffeefdaf1;Fri Dec 19 00:01:19 EST 2003;Committer;dave;4;295;18;313;0
84f0b051de55b80211eab0ad2438f500af45e4a5;Thu Dec 18 21:08:25 EST 2003;Committer;dave;12;692;14;706;0
f75aff0139347afb89fcb931f6cc78703bb5c36a;Thu Dec 18 19:08:11 EST 2003;Committer;gotoyuzo;2;6;0;6;0
b3b5b5e6b600d52ed429cdcf19144e431ab17296;Thu Dec 18 12:48:43 EST 2003;Committer;usa;4;43;26;69;0
77ffc8bf3fec9e5b0e5d34b765b2285d4cda2090;Thu Dec 18 07:38:48 EST 2003;Committer;nobu;2;9;5;14;0
41a8d90e7b884f3811eb65fa7cad566ff235890a;Thu Dec 18 06:46:06 EST 2003;Committer;eban;1;1;1;2;0
8781e7734f73ba5e5b735d9567daccd7e45f1608;Thu Dec 18 06:39:28 EST 2003;Committer;eban;1;3;3;6;0
60f87fe5997cfb4f76e8bb360b58dd1af0d5cd54;Thu Dec 18 06:38:30 EST 2003;Committer;eban;2;58;3;61;0
3270fda50052a7f9abf1ca340b0f75bb80a7170d;Wed Dec 17 07:16:05 EST 2003;Committer;nagai;1;3;3;6;0
e78cb14774c3c08f1475299bb684b933ba2591b0;Wed Dec 17 06:38:18 EST 2003;Committer;matz;8;53;47;100;0
1c1d2b9c34f6adcaf25667ab51f7f3720b4d8abe;Wed Dec 17 05:43:17 EST 2003;Committer;dave;3;211;12;223;0
313db605ed567959303ec9182e3d125d10dc0c6a;Wed Dec 17 01:29:35 EST 2003;Committer;eban;1;3;3;6;0
a366e19a1246f6100cde7c297a912706198b445c;Tue Dec 16 20:50:44 EST 2003;Committer;dave;1;2;1;3;0
bc8c73c42a552fcc1d414c3475c64099f5a246d6;Tue Dec 16 20:28:44 EST 2003;Committer;dave;10;1005;45;1050;0
6ef31af2d178fb4916150d317ceafe156fccdf65;Tue Dec 16 15:18:11 EST 2003;Committer;aamine;3;173;41;214;0
ff9f067f8977c64f1a09e676a28ae1043b932a51;Tue Dec 16 12:22:15 EST 2003;Committer;akr;3;194;188;382;0
c5bbcadbe64477433a243be191c41010c7ae10dc;Tue Dec 16 05:44:25 EST 2003;Committer;dave;12;1203;9;1212;0
dcd30a1236cdb2e06b6dd1a74a4c0a0c29549be6;Tue Dec 16 04:27:15 EST 2003;Committer;nagai;2;14;6;20;0
82275d47661a0234da26f66fcab8a988c2fc4761;Tue Dec 16 02:20:00 EST 2003;Committer;eban;1;3;3;6;0
b75b9455ac9fbf816f9eb38f2815f584dea6dc7f;Mon Dec 15 18:17:43 EST 2003;Committer;why;3;14;1;15;0
ee72d97e99c786f087c7ec39d5f2efbb7a505252;Mon Dec 15 16:14:49 EST 2003;Committer;nobu;2;26;33;59;0
5fd915fc83895dbfe698b6c7175dad76485c64b3;Mon Dec 15 04:32:23 EST 2003;Committer;nobu;2;7;7;14;0
70c1badcfd148a880a9d302b8d5f71d6d6a9fa2d;Mon Dec 15 04:13:44 EST 2003;Committer;nobu;1;3;3;6;0
52f81e0ce7cc58e438e31159453cfb80ec35f5b0;Mon Dec 15 04:11:34 EST 2003;Committer;nobu;2;2;2;4;0
12b5b81a975e2190aebe762b10ceadccd439a45a;Mon Dec 15 04:07:03 EST 2003;Committer;nobu;4;44;26;70;0
8e434982228dde94ced3e95a5ac1904cd2391441;Mon Dec 15 00:30:12 EST 2003;Committer;usa;2;10;3;13;0
aadcff240ed6e6ecb4f11d4f63e7258dbd693c75;Sun Dec 14 13:37:01 EST 2003;Committer;nahi;1;1;1;2;0
5e66c3ddd69ecd4cd8f2833031f8f3ffe0e3f88b;Sun Dec 14 10:04:38 EST 2003;Committer;eban;1;3;3;6;0
cd4d74e9bec14e97d4df2ed5cec8b3149a1f79ef;Sun Dec 14 10:04:35 EST 2003;Committer;eban;3;22;2;24;0
d2e6f552f3f0e19729c501fa30bb9198153d4a65;Sun Dec 14 05:25:37 EST 2003;Committer;eban;1;1;0;1;0
2298eb5f12ee4d8c192bc02e5dc957504a9ac30d;Sat Dec 13 09:55:21 EST 2003;Committer;nobu;3;24;3;27;0
6a3f682ff79266b0b38b8890f2fa61014089f6a3;Sat Dec 13 09:13:39 EST 2003;Committer;matz;3;76;20;96;0
fe7c38c8620cf65461285b8a1b8c9afbbb36e044;Sat Dec 13 08:18:03 EST 2003;Committer;nobu;2;6;0;6;0
9579041da8a1dbf29fdc935cb78eafa2e9bfe9e3;Sat Dec 13 02:26:24 EST 2003;Committer;nobu;1;3;3;6;0
acf4da163aadb698aac4a5e8976cf7f57eec18aa;Sat Dec 13 00:02:30 EST 2003;Committer;nobu;1;2;1;3;0
9fdbc41973971f4ef032d57c4e02ed0430227a0a;Sat Dec 13 00:01:28 EST 2003;Committer;nobu;3;44;23;67;0
47c59bb62beee384e2dc9492f83c1c8ed2ab4af6;Fri Dec 12 21:17:41 EST 2003;Committer;ser;8;44;48;92;0
ff2a47eb996b8bc03fc119b731689484c9eb3c78;Fri Dec 12 18:08:58 EST 2003;Committer;why;3;19;2;21;0
30e14294a74915ab359de5bc45881c391e259c4c;Fri Dec 12 13:44:58 EST 2003;Committer;nahi;3;46;1;47;0
232b4c20735aad320554d609b71c7a911c991abe;Fri Dec 12 10:33:24 EST 2003;Committer;aamine;3;53;30;83;0
6de4020c3069c68d954078d80e8f60c8ebaf9e94;Fri Dec 12 02:02:49 EST 2003;Committer;eban;1;3;3;6;0
aef04b63e626ae7cf7d8a8cda6d8ba6f1dda8fd5;Thu Dec 11 21:06:14 EST 2003;Committer;nobu;2;8;1;9;0
4ce5922b5c67e4d878cf92a3086248be690edf6c;Thu Dec 11 12:29:51 EST 2003;Committer;gotoyuzo;1;1;1;2;0
ab2e1c141fa996348d836b4e1537aace5e4d4463;Thu Dec 11 12:29:08 EST 2003;Committer;gotoyuzo;6;182;0;182;0
4f95ee24589bda93fd828d93cca8249ae7dbacc6;Thu Dec 11 12:07:17 EST 2003;Committer;aamine;1;5;0;5;0
d44d45450fc52176c043cd35116d628e2646e797;Thu Dec 11 11:54:50 EST 2003;Committer;aamine;2;9;2;11;0
50e61c533bbf4b62c0144bfcd13f627c8fe9e95e;Thu Dec 11 11:08:16 EST 2003;Committer;eban;2;9;1;10;0
5c3abcd043dca3794d68757a34640cb0ea9502b1;Thu Dec 11 10:54:17 EST 2003;Committer;aamine;2;7;2;9;0
eb5a1741196738df14f131c2e1b1a69412802964;Thu Dec 11 10:15:54 EST 2003;Committer;aamine;2;17;6;23;0
eec8dd6737d15e236e8f315d362e32d4c96253fd;Thu Dec 11 09:49:47 EST 2003;Committer;aamine;2;69;65;134;0
7a049ac594cf112bf4197cb1acde9b5ec9025e20;Thu Dec 11 02:56:28 EST 2003;Committer;eban;1;3;3;6;0
faab8f264d035e98f07ed57e74fb53d11d1608e5;Thu Dec 11 02:39:59 EST 2003;Committer;nobu;12;90;49;139;0
c5d4ee4a39df0f11a6ba98a8f5f19c9b64144baa;Wed Dec 10 10:29:00 EST 2003;Committer;nobu;3;43;25;68;0
62b368dc4ae950b8218097cafc9fc4591e1093de;Wed Dec 10 09:07:52 EST 2003;Committer;aamine;2;8;2;10;0
ba18b0c6cbcfd9afed3684cf667a9503d65d5ca1;Wed Dec 10 08:54:56 EST 2003;Committer;nobu;3;14;5;19;0
f449c04a3648f56a535399d4108b738e36059455;Wed Dec 10 08:26:36 EST 2003;Committer;matz;7;23;26;49;0
6395c3b38de70621232102597ee24c1fd136ca1b;Wed Dec 10 08:16:14 EST 2003;Committer;nobu;5;49;6;55;0
d6ce2b7b2b4dfb1c1e135138714c5fac48f50a3e;Wed Dec 10 07:56:07 EST 2003;Committer;eban;1;16;15;31;0
2a3f367151c37ed87c5a17bfa67f385a826267ca;Wed Dec 10 06:02:27 EST 2003;Committer;shugo;2;8;1;9;0
e5d803e671c4814074cbdb652436c1599e8e2549;Wed Dec 10 05:50:12 EST 2003;Committer;usa;2;11;1;12;0
3db654d88a95171401581b00c50b00e63cb6b7e0;Wed Dec 10 04:00:11 EST 2003;Committer;eban;1;3;3;6;0
79444dbdb9e59aecd6462c4c03767072f3fb1451;Wed Dec 10 04:00:07 EST 2003;Committer;eban;3;8;4;12;0
edc03a2912b60f319d5b424460f385c9926d3e37;Tue Dec 09 14:38:15 EST 2003;Committer;nagai;16;154;17;171;0
8edab1a9b47f91ac5b26844ac2890c9eaf163eec;Tue Dec 09 11:07:36 EST 2003;Committer;akira;3;15;1;16;0
1c09059ed85227d8feeab11f38e64e4cd506a1d8;Tue Dec 09 05:35:16 EST 2003;Committer;akr;1;1;0;1;0
75b3b1901cfb16af3ac3bd47ba53325f0696455d;Tue Dec 09 05:33:32 EST 2003;Committer;akr;2;11;0;11;0
231f7cb95ff551c4e1aa4c67d22bc36143b0ff42;Tue Dec 09 05:12:52 EST 2003;Committer;akr;2;5;3;8;0
39e04f4aa0a7b020c8ee28a40326299ffcdda109;Tue Dec 09 03:50:02 EST 2003;Committer;akr;2;5;0;5;0
92517eb4e3970f2b357a746036f34ee83c9e1449;Tue Dec 09 02:56:38 EST 2003;Committer;eban;1;3;3;6;0
6c64ca507697b5dfc4a8ef68d6fc1d253e12f26a;Tue Dec 09 02:43:05 EST 2003;Committer;ser;3;40;0;40;0
e6636fe890ab7cf8f8f1b86ca54a3e10f98d43e6;Tue Dec 09 02:41:33 EST 2003;Committer;ser;21;817;722;1539;0
31963249b96e11ea1df66be8a91f016af4364d14;Tue Dec 09 00:49:23 EST 2003;Committer;nagai;1;2;2;4;0
7bc53bf0f68d2c3c0b69dd3f588c372e2b39425c;Mon Dec 08 17:55:24 EST 2003;Committer;nagai;2;174;0;174;0
1253665ec4406c8972569abf680cc910319b3215;Mon Dec 08 15:58:41 EST 2003;Committer;ntalbott;3;30;17;47;0
af2dc0030084bc68355ea4ff2d599be311480249;Mon Dec 08 15:09:49 EST 2003;Committer;nahi;8;34;11;45;0
e67e930462b781f09e412e161c4ed8515640bdb2;Mon Dec 08 13:48:14 EST 2003;Committer;nobu;8;35;22;57;0
3fb4d657d8006c8f2332053d7ff3a92695c60ca4;Mon Dec 08 06:03:35 EST 2003;Committer;nobu;2;5;1;6;0
c3c0468f33a217ad2540e403c92bf340687f4332;Mon Dec 08 04:09:02 EST 2003;Committer;aamine;1;14;0;14;0
33565505819b313857f55a1f0b6309719e8799b3;Mon Dec 08 04:03:11 EST 2003;Committer;aamine;2;41;17;58;0
62848326c88c7784b493a09f58798760971975d2;Mon Dec 08 03:48:31 EST 2003;Committer;eban;1;3;3;6;0
64b15d98228481da0b2c124dcc46f25a242b3676;Mon Dec 08 03:47:04 EST 2003;Committer;matz;2;9;0;9;0
4baa7a3f0f605a4bfd908856b8df6e6e02df0615;Sun Dec 07 15:47:17 EST 2003;Committer;akr;1;2;0;2;0
d2041c1a790dd661c3e85e4dcc0478831bc7de24;Sun Dec 07 11:55:11 EST 2003;Committer;akr;2;3;3;6;0
27c6e0dd073032245674b6eef9780379adefefec;Sun Dec 07 11:41:21 EST 2003;Committer;eban;1;3;3;6;0
c4d502c93150ca3eba4612956dd63915f3b0610c;Sun Dec 07 11:39:29 EST 2003;Committer;akr;3;10;5;15;0
e735472d1f22fca2e2103b6d3868c101c54a2e2d;Sun Dec 07 02:54:38 EST 2003;Committer;dave;2;21;0;21;0
7cc4f065fa85d78ea64cde74d92af60919cabd5d;Sat Dec 06 14:33:52 EST 2003;Committer;gotoyuzo;1;1;4;5;0
70daacc533268d4bdf99ebfcc9f8a877453ab731;Sat Dec 06 13:59:31 EST 2003;Committer;gotoyuzo;2;37;6;43;0
a971d184ce825d22b78ca4f08564bd09857cf9a9;Sat Dec 06 12:48:51 EST 2003;Committer;eban;3;10;8;18;0
73da604dcc375a630e163c1c3942a3ffb7afb63d;Sat Dec 06 12:44:01 EST 2003;Committer;eban;1;3;3;6;0
2e2ef819345d7268085cd5f066471f06c70496d3;Sat Dec 06 08:26:15 EST 2003;Committer;nahi;3;13;1;14;0
6ffd5fe37ef9f162bcdf9e7ac639182d58cbc429;Fri Dec 05 14:24:19 EST 2003;Committer;nobu;1;1;1;2;0
33f0b0ae0b0eeb3bd510cd8525dd0e6076566437;Fri Dec 05 14:22:36 EST 2003;Committer;nobu;3;53;4;57;0
1ed39b739237bffd9c78e696c09462ce67017b95;Fri Dec 05 13:26:26 EST 2003;Committer;nahi;10;645;38;683;0
3be09a4f4ffee94601051c37e5303b9546d816e1;Fri Dec 05 08:27:19 EST 2003;Committer;matz;2;7;3;10;0
aabecebd69a59807ca27a860a096385fb90ac2e4;Fri Dec 05 05:54:00 EST 2003;Committer;matz;3;26;8;34;0
491b450f93961e2ff4c993ed7d287417d6f1869e;Fri Dec 05 04:18:37 EST 2003;Committer;akr;2;12;2;14;0
47dfa853ef377e54a21eeabfdd238fa60338bf41;Fri Dec 05 02:59:22 EST 2003;Committer;nobu;1;2;0;2;0
7fbf13f7f21876b4206701cb3913fab5e7d82843;Fri Dec 05 02:54:48 EST 2003;Committer;nobu;8;93;14;107;0
e3ed2691934d4f7e11b3d9469a7f744ac9e4b433;Fri Dec 05 02:06:27 EST 2003;Committer;nobu;1;3;3;6;0
7e6cecb76987cb1e61b20b1213dfd889ce8df930;Thu Dec 04 21:57:35 EST 2003;Committer;matz;4;27;14;41;0
01d06638b96eefdb5f6bd019289f1e479d3c5723;Thu Dec 04 17:49:39 EST 2003;Committer;nobu;2;30;12;42;0
e78a9cdcdb05a9f196b4c76c119626e519946888;Thu Dec 04 15:10:38 EST 2003;Committer;dave;1;17;1;18;0
9c40644850d3a3cf046d09a017524c8983f156eb;Thu Dec 04 12:50:13 EST 2003;Committer;nobu;2;10;0;10;0
05f6ee218391b3311666ef700316027e11221440;Thu Dec 04 07:41:20 EST 2003;Committer;nobu;2;10;2;12;0
8c9566435548bad6aadd5651e0694cec74e8af8a;Thu Dec 04 05:09:47 EST 2003;Committer;aamine;2;10;9;19;0
b6e4f347dc258130d7fd2d0a5c923bf4340fe28c;Thu Dec 04 04:35:26 EST 2003;Committer;nobu;1;4;4;8;0
7072d8279defb830d8c4551083a23588c50cc6ae;Thu Dec 04 04:25:10 EST 2003;Committer;shugo;2;10;6;16;0
541df88924aae308222d6af75afac754fdf57487;Thu Dec 04 04:19:12 EST 2003;Committer;nahi;2;10;3;13;0
20fa0df5cd7f297b1694b75b776516b51460ba55;Thu Dec 04 04:05:51 EST 2003;Committer;nahi;12;726;311;1037;0
b28a2a1ad645b21679d088c738d0e0ef70758a19;Thu Dec 04 01:53:14 EST 2003;Committer;nobu;1;3;3;6;0
4eaf7b118643cedd965b9ea6f09e7dbdb0a7f0c4;Thu Dec 04 01:45:07 EST 2003;Committer;usa;2;9;4;13;0
ad592fa016016d0e0f0e3498f5f4c249f51e0155;Thu Dec 04 01:27:39 EST 2003;Committer;aamine;2;5;1;6;0
f4ddca17e0466cf2ed6aec1fa578312aff04d93d;Thu Dec 04 00:26:15 EST 2003;Committer;gotoyuzo;1;1;1;2;0
7d6e215393998909178ee92c4733d33f83306cb7;Thu Dec 04 00:21:31 EST 2003;Committer;gotoyuzo;2;6;3;9;0
8e1714488ae78589741991ba7cc72b1c9e3e4028;Thu Dec 04 00:12:14 EST 2003;Committer;gotoyuzo;3;23;6;29;0
dc9603bd5c6b9618e1f4aa8a48c020c56425366f;Wed Dec 03 18:51:23 EST 2003;Committer;akr;2;21;2;23;0
4f5976cbb826df462c62a0a8e72ebe91c15a7ba4;Wed Dec 03 17:30:09 EST 2003;Committer;matz;4;25;8;33;0
ad27a1413640c63310da6c25b95bb6f2fad122be;Wed Dec 03 14:40:44 EST 2003;Committer;dave;1;5;1;6;0
3d9ba0390c467353d2117d4dd990dcf3f6bea717;Wed Dec 03 10:40:27 EST 2003;Committer;seki;2;5;1;6;0
2f4c13b0f070689e10f965c3ecc386381e092866;Wed Dec 03 07:55:54 EST 2003;Committer;matz;4;25;1;26;0
73bc1204e4a18e4dea08e102e8d448a071cdc76b;Wed Dec 03 04:55:57 EST 2003;Committer;nobu;1;1;0;1;0
a7c382223ceee47e2d5a2a7ef3e495e1259b9540;Wed Dec 03 04:55:07 EST 2003;Committer;nagai;6;76;63;139;0
e3bab670fcbcb8e9adced59e880aa0b4851949cd;Wed Dec 03 04:28:14 EST 2003;Committer;nobu;2;7;6;13;0
835e16733d0a8fa3baba4386688e92ad38bd149c;Wed Dec 03 04:20:22 EST 2003;Committer;dave;2;256;1;257;0
2fa85831dfd7182eb8d429ed4bde7a60515cf0eb;Wed Dec 03 04:03:01 EST 2003;Committer;eban;1;3;3;6;0
b1fd732b4fa3335978c9460ceaa80c828ecee641;Wed Dec 03 02:36:48 EST 2003;Committer;nobu;4;9;2;11;0
c772f4906adf06a429ce2d2785d91acc64817619;Tue Dec 02 23:29:02 EST 2003;Committer;nobu;1;4;3;7;0
44cc15a9a8a2c64e5e6e8d069fd4489ac10418d7;Tue Dec 02 14:18:49 EST 2003;Committer;aamine;2;8;1;9;0
953b293f2bd016a20f8a7992510952f20eb55227;Tue Dec 02 12:41:01 EST 2003;Committer;nobu;1;0;1;1;0
086745b7d6f0edb9b0537b9980e93952b9022b1e;Tue Dec 02 12:31:44 EST 2003;Committer;nobu;9;128;100;228;0
76eab3527f5fc7aa05c6475b348c01f1f8cad036;Tue Dec 02 11:03:37 EST 2003;Committer;aamine;2;158;0;158;0
3b7a1799ceaa39fc9aace7576b2719775326b2c4;Tue Dec 02 08:08:07 EST 2003;Committer;eban;1;3;3;6;0
a41f5816ddf971bc41ff46ec85b81d84c7d1250a;Mon Dec 01 23:02:44 EST 2003;Committer;ttate;2;92;0;92;0
6e4b8e19d77ee82f6759ef117c576df6d3d84320;Mon Dec 01 19:25:51 EST 2003;Committer;ntalbott;3;16;11;27;0
062616677f26b9dfd1576c4157afcd77874ff6b1;Mon Dec 01 17:00:05 EST 2003;Committer;dave;1;2;0;2;0
50629ec6db106e2399181bdecb618111ebbf339f;Mon Dec 01 15:45:54 EST 2003;Committer;why;2;15;10;25;0
ac761cda209ded2ef48bec9fcc54a979bc6caafc;Mon Dec 01 13:16:09 EST 2003;Committer;matz;4;62;43;105;0
b0acbc4c9afd41602ec9f4b0ee6914b4461ccd32;Mon Dec 01 08:42:53 EST 2003;Committer;matz;4;117;66;183;0
0f54ad5f6ce2a92e70854113c38d76a53a178ad2;Mon Dec 01 08:14:38 EST 2003;Committer;nobu;9;130;34;164;0
87762adcb0d38d6c575448f67c2906964215f3a1;Mon Dec 01 07:12:49 EST 2003;Committer;dave;36;12367;0;12367;0
c1c55573bdaecbd972f57b46dd22dfbd0e1a02dd;Mon Dec 01 06:28:35 EST 2003;Committer;dave;1;1;0;1;0
e5690fcd6dd932b3cf28ebc42f6b42498e161e97;Mon Dec 01 05:18:46 EST 2003;Committer;aamine;3;51;18;69;0
d8d81b35a43655a9009b1e7a11e22d28ef3ead2d;Mon Dec 01 00:30:37 EST 2003;Committer;usa;4;14;3;17;0
40538994def670a483fde86c82a0cd4291a824f9;Sun Nov 30 16:09:45 EST 2003;Committer;eban;1;4;4;8;0
c93b7ae9bd3b007830cbb8514f069fad8bd2ee3d;Sun Nov 30 16:09:42 EST 2003;Committer;eban;2;9;3;12;0
bf090992e0a54eccd8c5320ec6b569cd5a678f8a;Sun Nov 30 14:47:55 EST 2003;Committer;eban;2;5;2;7;0
8eb63567d8e5b8ccf24b52047c7ae9ff29337274;Sun Nov 30 14:20:35 EST 2003;Committer;eban;2;3;1;4;0
21e9506b22a52fafdd6aa6512549b9b79e885696;Sun Nov 30 14:00:05 EST 2003;Committer;eban;2;3;1;4;0
b0ffbc31e81be253e7f451dc81b4b215fb396217;Sun Nov 30 13:41:25 EST 2003;Committer;eban;1;2;2;4;0
c3f1c5280b5c71f89a7260dd6b00bb39129c5663;Sun Nov 30 11:27:34 EST 2003;Committer;eban;3;21;11;32;0
9a8cc1f4abdeacb4adf1a7b59fe2bd6f4ea0ad70;Sun Nov 30 09:33:03 EST 2003;Committer;eban;3;91;86;177;0
53dd83eebd58dc4bc537ce1cf476a66b5e1f6b1c;Sun Nov 30 08:41:15 EST 2003;Committer;nagai;2;5;1;6;0
d268bf305e926b5418d843098e35462cf97df662;Sun Nov 30 04:33:02 EST 2003;Committer;nahi;14;498;63;561;0
165d101eed53d09aa614d93557b077305a52006b;Sun Nov 30 00:39:37 EST 2003;Committer;nobu;1;3;3;6;0
a5031810492e168e0a834521112f42777d431506;Sun Nov 30 00:35:28 EST 2003;Committer;nobu;2;8;1;9;0
5eaf7e581661ea92c0468eb239ece86b27187ade;Fri Nov 28 14:23:33 EST 2003;Committer;matz;5;92;41;133;0
daa1423dea418737e2a0b371921c8d02df07f1f6;Fri Nov 28 13:51:31 EST 2003;Committer;seki;2;7;3;10;0
6ccd46b7b252a9f2d6468f5582b8630242ad88b6;Fri Nov 28 12:47:28 EST 2003;Committer;eban;1;1;1;2;0
f56d1d8777c7a9f188c1247a666bce38d928f63f;Fri Nov 28 12:46:36 EST 2003;Committer;eban;2;8;3;11;0
f2fdd59898305e22f3bff51ac07d94ad90af2783;Fri Nov 28 10:38:00 EST 2003;Committer;nobu;2;6;1;7;0
f284f6a41ba4de19a18dff6bde7ad8b2cba0f3ba;Fri Nov 28 10:28:21 EST 2003;Committer;nobu;2;8;2;10;0
275d6a57758b3b33628e3584c959b66c34110188;Fri Nov 28 09:00:48 EST 2003;Committer;usa;3;89;0;89;0
ff6169dfd5dc22d2897e7a38c5bbe73641546b0a;Fri Nov 28 08:53:41 EST 2003;Committer;seki;1;5;0;5;0
b20531b334c7a22ac5e6ef3b3e53d9041be50dac;Fri Nov 28 08:30:01 EST 2003;Committer;seki;1;3;9;12;0
a1a2b66e0d9302f25b7636f93af9b83e0155eea0;Fri Nov 28 07:45:27 EST 2003;Committer;seki;1;17;3;20;0
40cb49fce8575ff60ef761d03fe9ee1180622bc7;Fri Nov 28 07:04:52 EST 2003;Committer;akr;1;4;3;7;0
7754869905d9b3554882f175ec09d6d68488e288;Fri Nov 28 06:43:51 EST 2003;Committer;akr;2;10;3;13;0
42bca643c3ec41782d519c7676383f8f71e67a7a;Fri Nov 28 05:53:16 EST 2003;Committer;nahi;19;338;177;515;0
a017b0cc8aea236600d47ff04cd829f84499f414;Thu Nov 27 19:45:17 EST 2003;Committer;nobu;1;39;13;52;0
4148ae45cf820258788c8b847125214dd66160aa;Thu Nov 27 19:15:29 EST 2003;Committer;nobu;2;5;1;6;0
1d1111067f92f76972292e360139606a6af04d94;Thu Nov 27 15:49:49 EST 2003;Committer;eban;1;3;3;6;0
e788706235648df9bd98741c29b77dfc6e04ee2c;Thu Nov 27 15:47:33 EST 2003;Committer;nobu;3;8;5;13;0
99fb5f48711dc3267dc008060e9f5b97434c5121;Thu Nov 27 15:34:53 EST 2003;Committer;nobu;6;46;23;69;0
868d5ba485b1d50fe1163fd9f63fe43a34ca402e;Thu Nov 27 13:08:27 EST 2003;Committer;knu;3;23;0;23;0
66598727efaf03a47cad36a4884632574cd9d331;Thu Nov 27 09:13:50 EST 2003;Committer;eban;1;1;1;2;0
1dd762d181d1be653772653f7121655ad9e50046;Thu Nov 27 08:39:33 EST 2003;Committer;nagai;2;28;20;48;0
2d24928b425fcceddb8ff88f4005d27987621f7e;Thu Nov 27 08:00:28 EST 2003;Committer;eban;1;3;3;6;0
4539512afc2b29654a1a9695489cde475e3467ec;Thu Nov 27 08:00:23 EST 2003;Committer;eban;2;16;14;30;0
f3e1738d9c27c90730f355a6cabe6741178114ab;Wed Nov 26 06:42:52 EST 2003;Committer;eban;2;6;1;7;0
f5aa21c3959ff2181be731a1120c8094e9585933;Wed Nov 26 02:02:45 EST 2003;Committer;eban;1;3;3;6;0
bab2e6cfdf341baa65533be655563d5cb819f6ba;Tue Nov 25 19:51:38 EST 2003;Committer;why;6;144;91;235;0
3d0d2d5ff1a75dcf32f455f306079f139269f280;Tue Nov 25 16:02:45 EST 2003;Committer;gotoyuzo;3;10;1;11;0
8408fc1585e8f83fca46cba203213295c56c7c2c;Tue Nov 25 12:45:55 EST 2003;Committer;usa;1;2;1;3;0
2a9719235d9cc7b0ac402c6b2a33e07a481fe2ff;Tue Nov 25 12:44:26 EST 2003;Committer;usa;3;8;9;17;0
7e42e5c01b007e19c2af3000d519b93526e53d4f;Tue Nov 25 11:02:30 EST 2003;Committer;aamine;3;20;9;29;0
54e444d83435a678dbed3a364e8282efa595c51c;Tue Nov 25 10:04:37 EST 2003;Committer;akr;2;2;2;4;0
922dc8265f47af47327cf01bb5365f2ea8454d16;Tue Nov 25 09:56:49 EST 2003;Committer;akr;2;18;3;21;0
0452420e4c33b32050aa46bc08d39b7f35dc3864;Tue Nov 25 09:13:58 EST 2003;Committer;aamine;3;17;2;19;0
a3388b68b7d2babce3d696cacb3e4cbfcd898490;Tue Nov 25 08:53:42 EST 2003;Committer;akr;2;31;7;38;0
f1d89b24da13a8161a53ebe8bb20ce438fc86898;Tue Nov 25 07:44:41 EST 2003;Committer;nahi;4;5;109;114;0
6a09e1d9664f86b7deb576fb0dfe57e10503bb85;Tue Nov 25 07:31:33 EST 2003;Committer;nahi;98;1061;1599;2660;0
ec373c3e1c332f814225c3d49ded8217545470e2;Tue Nov 25 07:17:14 EST 2003;Committer;eban;2;5;1;6;0
13bc8622a014285983e2ab05acda4616de030f6c;Tue Nov 25 06:45:39 EST 2003;Committer;nagai;1;2;2;4;0
ab8e998216b9f5236607f72beb93575f4665aa62;Tue Nov 25 06:26:38 EST 2003;Committer;nagai;2;6;2;8;0
21ef0b6b1ccc05a99b026c18cedb785b7bc3f138;Tue Nov 25 05:00:06 EST 2003;Committer;akr;1;1;0;1;0
7a400f15897891afa666eb1add6377e8932d967a;Mon Nov 24 23:23:01 EST 2003;Committer;nobu;1;3;3;6;0
637f6122476ca1da7fa289a2b376c3d09324cc86;Mon Nov 24 22:31:19 EST 2003;Committer;nobu;2;8;3;11;0
6eaa5f2b05c17cf05db5ced5e24f818e99a39828;Mon Nov 24 14:36:18 EST 2003;Committer;akr;2;37;23;60;0
087a8db4d2bf4fb6807693b1da2caadffb33702c;Mon Nov 24 11:01:57 EST 2003;Committer;akr;2;15;2;17;0
9421725f53a40c8ac3e7ede3e76726f59eaddd51;Mon Nov 24 10:42:17 EST 2003;Committer;eban;4;18;3;21;0
483ac5644036ec1f1cf6e74b773c9315c611c8b3;Mon Nov 24 08:02:36 EST 2003;Committer;akr;2;127;8;135;0
f14589947e38ec0290098305612dbcdc5c5ee362;Mon Nov 24 05:54:38 EST 2003;Committer;usa;1;3;3;6;0
1b6755193bbb0f8bdb96f1e48d712e1e03ec6cf8;Mon Nov 24 05:54:05 EST 2003;Committer;usa;4;8;3;11;0
e2c426120498131945a3ceaa034756a5d6b580e8;Sat Nov 22 14:24:35 EST 2003;Committer;eban;2;5;1;6;0
3e6ec626118884be7353f15efb45f63faa82110c;Sat Nov 22 13:58:57 EST 2003;Committer;nagai;2;42;32;74;0
615a54e77d00c0b456fe6a6f8b6d48203e25b3ac;Sat Nov 22 13:52:48 EST 2003;Committer;nagai;6;438;4;442;0
448b1af751fed5976948d629d9b7028a7d044506;Sat Nov 22 09:51:07 EST 2003;Committer;usa;2;12;1;13;0
dbd254d4f4a7b93ce32bf0cf1d8b4b31bc4d689f;Sat Nov 22 08:38:07 EST 2003;Committer;usa;4;14;0;14;0
8fe4827d642deb28bc5d76a73300f703811574ba;Sat Nov 22 04:12:16 EST 2003;Committer;eban;1;3;3;6;0
061f8361daec6b4f9c77384af41b27e3980626bb;Sat Nov 22 04:10:32 EST 2003;Committer;aamine;2;5;1;6;0
6212cfb9c53bd93fda08915f9916a7c3ebace289;Sat Nov 22 04:00:03 EST 2003;Committer;matz;28;456;134;590;0
01257196948765da2601c3a6c489f2a55f7319a8;Fri Nov 21 22:36:13 EST 2003;Committer;ntalbott;3;15;4;19;0
cf971d47b97844352faf31ae9da6f6806b3af7e1;Fri Nov 21 07:49:11 EST 2003;Committer;nagai;3;19;5;24;0
ef85e302c84975ebb94b3556cb51380c9963b7c4;Fri Nov 21 07:13:43 EST 2003;Committer;knu;2;50;32;82;0
af1fb629e3e000624080d26149c9a2df75d3c99b;Fri Nov 21 05:49:59 EST 2003;Committer;aamine;2;33;0;33;0
1d68b43f827a71ef7159f6a68a0327c824aff309;Fri Nov 21 04:15:05 EST 2003;Committer;eban;1;3;3;6;0
c5061b6116266cb7e74e25fca0517871e8580619;Thu Nov 20 16:47:30 EST 2003;Committer;nagai;4;18;7;25;0
b31aeea632037ce95463267cb8c0369aed5a72b1;Thu Nov 20 15:45:56 EST 2003;Committer;ntalbott;3;11;5;16;0
65f4f950fb722396c823ce321245bf06a55e9492;Thu Nov 20 10:20:20 EST 2003;Committer;eban;2;5;0;5;0
edb9ab1b15d2326c7f0fbb0cef417b3d07140543;Thu Nov 20 10:16:27 EST 2003;Committer;aamine;3;37;21;58;0
fe411ce2459932684cc6b8ee5b489768d2146d97;Thu Nov 20 08:57:18 EST 2003;Committer;eban;1;3;3;6;0
f465e8a1c86883864990ea44b77b6262967ea8cb;Thu Nov 20 08:53:52 EST 2003;Committer;nagai;5;865;0;865;0
b33ea38a9bd76f6ee482802b18f8ce2dd344309b;Thu Nov 20 04:39:08 EST 2003;Committer;nagai;3;13;3;16;0
340a511fdf6571a1f4adfc254a07edc5605f46e4;Thu Nov 20 03:50:32 EST 2003;Committer;nagai;5;93;83;176;0
531022ace399a527c5735c2caf41921b4ba7afe7;Wed Nov 19 06:21:26 EST 2003;Committer;eban;1;3;3;6;0
39a97bf0035bd2059abe39bf6a60a750261e49f5;Wed Nov 19 05:45:44 EST 2003;Committer;aamine;2;5;1;6;0
a74dd747e3e2be1c6908196603b3e5ae059745eb;Wed Nov 19 05:33:07 EST 2003;Committer;aamine;2;12;4;16;0
0a50ed6611bec5e3ce9b1a401ec1ab48462b6f22;Wed Nov 19 02:06:37 EST 2003;Committer;usa;2;7;2;9;0
54ebae1ba1122300a6695bebf64b8609843918e9;Tue Nov 18 23:00:29 EST 2003;Committer;ntalbott;3;9;2;11;0
fbcac5f129bed8a9df4174f554ee018695e8c040;Tue Nov 18 14:34:18 EST 2003;Committer;eban;3;17;7;24;0
6874cb465a1a8193a64d946d1bdb7ff4756a7ed9;Tue Nov 18 13:24:48 EST 2003;Committer;aamine;2;14;2;16;0
17db3830504628bd85dfb383cbfd6576ceafb303;Tue Nov 18 12:08:55 EST 2003;Committer;eban;1;1;0;1;0
1c0cee4f833150bd83eb3cfa578bc4dc83ca3d25;Tue Nov 18 10:05:21 EST 2003;Committer;aamine;3;16;35;51;0
0c15b3a2221ff156452a9979b70b3e36d7bad6c0;Tue Nov 18 09:23:07 EST 2003;Committer;nobu;3;23;2;25;0
12eee69294f0692eb74b2daeb7dcf8e000491518;Tue Nov 18 09:09:41 EST 2003;Committer;nobu;2;37;6;43;0
914d8f7008cd1786686cb9bf6ea93b8d5e29501f;Tue Nov 18 05:40:52 EST 2003;Committer;nobu;1;3;3;6;0
2bfd5c1a3d9e09f9332da5b57090ebec17f15c74;Tue Nov 18 05:09:20 EST 2003;Committer;aamine;4;175;34;209;0
c88ad2a3871697dbc3edaa0cec8fc2ff8eff8e55;Mon Nov 17 21:30:31 EST 2003;Committer;mneumann;1;35;0;35;0
c531a61f38764e2fd9c42e1e357143ba82b8e9ec;Mon Nov 17 07:42:25 EST 2003;Committer;eban;1;1;0;1;0
81b7665e94670c5741a3b729482aaf22896e07cb;Mon Nov 17 01:53:09 EST 2003;Committer;nobu;1;3;3;6;0
bc94ec8f4c1b903236171c8b3cd062e3684514b8;Mon Nov 17 01:50:31 EST 2003;Committer;nobu;2;16;4;20;0
2d3a489f6dacd5c68ba1eeb99499f7c99ffe5a3d;Mon Nov 17 00:41:40 EST 2003;Committer;nobu;2;4;2;6;0
7f58e0ba4fbddabfec26b4b4cea9bd1a049affd9;Mon Nov 17 00:23:40 EST 2003;Committer;nobu;5;546;35;581;0
4e2fd6be8d1d731eb83de0de3f21382296e674c9;Sun Nov 16 09:11:01 EST 2003;Committer;nobu;2;16;4;20;0
1fc7d20da2b39f926c16c1d65ac90fcf37eb3466;Sun Nov 16 04:48:09 EST 2003;Committer;eban;1;3;3;6;0
8fe88cc466633dd59b9bc425c641f44dacdfa99f;Sun Nov 16 04:34:05 EST 2003;Committer;matz;2;12;4;16;0
5af124307659e37a47a90b9e9e40a4b017fa0a3e;Sun Nov 16 03:16:42 EST 2003;Committer;aamine;2;9;4;13;0
fb12e2380399a035aec5ab01a9ba326d9255e6c4;Sun Nov 16 01:53:12 EST 2003;Committer;gsinclair;2;17;10;27;0
5abcd32d57c490cd246af8bfd324d8c24b3195dc;Sun Nov 16 00:48:17 EST 2003;Committer;aamine;1;1;1;2;0
d4060e0467e64a8ae0c800de4e53ea0af0772dd6;Sun Nov 16 00:46:16 EST 2003;Committer;aamine;2;6;0;6;0
8eb537a88abf2f37b0728e628f8b7ac2d0d75252;Sat Nov 15 23:45:26 EST 2003;Committer;matz;3;79;51;130;0
abbffef10ccd7bb0b2022bcc73afc51c86bc49c4;Sat Nov 15 13:19:17 EST 2003;Committer;gotoyuzo;2;10;2;12;0
ff509230953bb8115192c3b4c5e75647885f9176;Sat Nov 15 08:50:57 EST 2003;Committer;eban;1;3;3;6;0
31ef5c2d5e47f0533ea89e7f617b4385386ba12d;Sat Nov 15 01:09:21 EST 2003;Committer;akr;2;25;17;42;0
9e1709139db044db3705fb3565ff2b7ae94f8799;Sat Nov 15 00:03:01 EST 2003;Committer;matz;1;0;9;9;0
ba2147ba40a147c10da3f8e202b4f78488bab6d9;Fri Nov 14 23:54:06 EST 2003;Committer;matz;5;27;2;29;0
83e19791ef93da8f13eab296abcc2d9afe320ab8;Fri Nov 14 06:01:16 EST 2003;Committer;eban;1;3;3;6;0
906d408e7c2212d450af8b3be1ea30258ebe8633;Fri Nov 14 04:25:11 EST 2003;Committer;nagai;4;21;12;33;0
810e7938fd12989db83b59a3c2e467f400e0480a;Thu Nov 13 11:54:31 EST 2003;Committer;akr;2;2;2;4;0
7924fca23e96b9b5bdfd400beeb09e42a7a4c6de;Thu Nov 13 11:46:31 EST 2003;Committer;ttate;1;2;2;4;0
e008c87423eb369afb4a189ac0b700c8920b7fa6;Thu Nov 13 11:39:16 EST 2003;Committer;akr;2;25;8;33;0
00c9f4cb9ba306d6aac1635e0b7d099e80633ab1;Thu Nov 13 10:18:31 EST 2003;Committer;nagai;2;51;12;63;0
bf67d8df27c87b666a5973a098e4d6f70e561f32;Thu Nov 13 08:58:20 EST 2003;Committer;akr;2;6;1;7;0
a3845916c0b78bab4adee895ba1b91ddb19d859e;Thu Nov 13 07:48:20 EST 2003;Committer;gotoyuzo;2;26;0;26;0
06a9101158bdc683d1273972ecc875ee2ee8feda;Thu Nov 13 02:42:25 EST 2003;Committer;eban;1;3;3;6;0
87bb4b54689c6d90d168ea1b7afda33a8f47e5e2;Thu Nov 13 02:31:17 EST 2003;Committer;nobu;2;24;13;37;0
c90fab98a2173f0af282ff8f948c479c1aef7a95;Wed Nov 12 21:11:40 EST 2003;Committer;nagai;3;16;10;26;0
5f4778d3479f4af21000dd194485519e41835d29;Wed Nov 12 08:32:54 EST 2003;Committer;nobu;3;23;12;35;0
ecec55085597dd393a340664f93e61e9a8876044;Wed Nov 12 05:10:54 EST 2003;Committer;shugo;2;51;32;83;0
64446f023cc7fa006d536f85b1a5c678a501c7c6;Wed Nov 12 04:01:21 EST 2003;Committer;shugo;3;149;0;149;0
db38b277a5aca9c009e64a5ba24ab4bb215125ea;Wed Nov 12 03:35:14 EST 2003;Committer;eban;1;3;3;6;0
891fa76825af992bd58778efb0fdeebfa1052b7d;Wed Nov 12 01:15:59 EST 2003;Committer;shugo;2;86;88;174;0
ed2a386f587e5ee045dee23ec52fc7dcf7f91314;Tue Nov 11 21:20:20 EST 2003;Committer;gotoyuzo;4;99;7;106;0
2fc95b6399d7120f38fa9a00b76bd4e3a30c5267;Tue Nov 11 15:50:28 EST 2003;Committer;ntalbott;2;5;0;5;0
4bbe1754993cb2d9130e0534de207250336a2150;Tue Nov 11 14:57:15 EST 2003;Committer;ntalbott;2;8;1;9;0
2c1140b3e0b72c9e33780a24706bc5757dff226b;Tue Nov 11 13:48:51 EST 2003;Committer;matz;3;16;4;20;0
4c5094d65d664f66b823d4de5b92402cf19ef1ce;Tue Nov 11 13:08:16 EST 2003;Committer;mneumann;1;5;0;5;0
48d440ac86b0047611a61cb2edaeb5f40b1a1324;Tue Nov 11 03:15:58 EST 2003;Committer;eban;1;3;3;6;0
0fd9439894eacedc17b2c4bc09e37b84ab92b828;Tue Nov 11 01:45:06 EST 2003;Committer;nagai;2;7;1;8;0
09306bcead5dee0fb3ce56d8bd0ff91b2cdca4fa;Mon Nov 10 18:31:36 EST 2003;Committer;gotoyuzo;2;15;3;18;0
ea00e4e454d56169412ac42a217aa02208249930;Mon Nov 10 02:44:49 EST 2003;Committer;shugo;2;7;0;7;0
23efc48d0d2f419ee3b27b60101860822a292774;Sun Nov 09 15:11:15 EST 2003;Committer;eban;1;3;3;6;0
a51ba48abcc65bb1fcb6d92d5da3f8b74237c7d9;Sun Nov 09 15:07:14 EST 2003;Committer;nobu;2;9;4;13;0
152380a87c7f26445141e845eaab95fe20c42918;Sat Nov 08 17:06:11 EST 2003;Committer;ntalbott;3;18;4;22;0
c103eb6793b69d98a5e135ad4ddef09db364ec5b;Sat Nov 08 14:38:15 EST 2003;Committer;ttate;1;9;7;16;0
84c2c9ac5ba0815efd234ac187743feb221c15b3;Sat Nov 08 13:32:07 EST 2003;Committer;eban;1;2;2;4;0
a2aed07f6a569984cb434a43852f351c44ce16ab;Sat Nov 08 12:35:58 EST 2003;Committer;eban;1;5;0;5;0
b7931c40fee8ec76c2ef0398f228e034d7ff64e4;Sat Nov 08 09:52:42 EST 2003;Committer;nahi;14;816;19;835;0
2c35c4254e36cb3c59acfb50b738930c49cfd3af;Sat Nov 08 05:02:42 EST 2003;Committer;eban;1;3;3;6;0
1ef5d9d44356ea8d704936039cba1535d3760730;Sat Nov 08 04:53:14 EST 2003;Committer;nagai;2;48;5;53;0
0f8d55fa98c37fb2b0925620c10fd305f63acd84;Sat Nov 08 04:48:35 EST 2003;Committer;ttate;3;73;2;75;0
3d337f360679bed00aafc40d77181016f902e862;Fri Nov 07 21:39:36 EST 2003;Committer;nagai;3;234;67;301;0
91669219efe42ec5cf57fe9f0634159838dd240b;Fri Nov 07 14:28:20 EST 2003;Committer;akr;2;51;12;63;0
ea6b397daabe2b5092a9fa51b59e271d927cdffb;Fri Nov 07 03:52:02 EST 2003;Committer;wew;1;2;2;4;0
fb55a6d12f0d54f9107de665a3e12fc522b46335;Fri Nov 07 03:51:15 EST 2003;Committer;akr;2;13;2;15;0
dc592364e62b75e778834dad8eaf1447f24ec573;Fri Nov 07 02:08:04 EST 2003;Committer;akr;2;8;2;10;0
e7688cebe5bea320b153436850c92ab63de9983a;Fri Nov 07 01:25:26 EST 2003;Committer;nobu;1;3;3;6;0
a51b5fa52bb66cb443f1084f0764287e7e5afa4e;Fri Nov 07 01:23:27 EST 2003;Committer;nobu;2;18;8;26;0
cac6465677edf7e8762b6e16ae40d0f091191aa3;Thu Nov 06 19:10:12 EST 2003;Committer;katsu;2;6;0;6;0
86327765f32b3158bc442b88eb39ae473b08bfa4;Thu Nov 06 16:08:26 EST 2003;Committer;matz;2;7;0;7;0
abc10cc28e60e1b04e26ea5e306bf2ba06955215;Thu Nov 06 09:23:15 EST 2003;Committer;eban;1;5;0;5;0
9fad82a6ba56b575f5f16255049393357f4f7751;Thu Nov 06 09:05:11 EST 2003;Committer;nobu;2;15;4;19;0
818d6a1e4f145f3ff9a60933f71336a034c59536;Thu Nov 06 07:22:39 EST 2003;Committer;matz;9;278;50;328;0
113423bdff9c888195c6e22949d5d7f849a05b04;Thu Nov 06 02:42:10 EST 2003;Committer;nobu;2;5;3;8;0
64465c4d808666f9876cacabd436c77ee5c811a7;Thu Nov 06 02:27:54 EST 2003;Committer;eban;1;3;3;6;0
2a40bbeea09f2355544bc47ccc46cbe1951031df;Thu Nov 06 02:01:23 EST 2003;Committer;nobu;2;16;3;19;0
4646ba6b2a8ff08a989a4c761a9b621343da9671;Thu Nov 06 01:17:59 EST 2003;Committer;nobu;3;26;9;35;0
cc2343e7b7b8bb54e0d2fb5ed45abb6141230624;Wed Nov 05 14:55:52 EST 2003;Committer;nahi;2;9;3;12;0
ea03c3fc2c0bfcf6351c3bce9496fd4607f4594a;Wed Nov 05 14:00:11 EST 2003;Committer;nagai;7;140;0;140;0
4dada1c8a20c0fab0e058d7cd934c1c011617049;Wed Nov 05 10:09:58 EST 2003;Committer;nobu;7;263;1;264;0
9983e4645ec127d90d402af42cb36e446cfaafe3;Wed Nov 05 08:05:24 EST 2003;Committer;nobu;2;8;4;12;0
9e830abab96364e92ee1659e1534722154864759;Wed Nov 05 02:16:23 EST 2003;Committer;usa;1;3;3;6;0
81160e93c9365ae99e05885dea6022c31b5fd061;Wed Nov 05 02:15:27 EST 2003;Committer;usa;6;14;4;18;0
ba5ae27d29562edd7ec10c721e6af12aa1de7659;Wed Nov 05 01:40:26 EST 2003;Committer;nobu;1;3;3;6;0
d61ba0cec68ba34bf8e044e7d111637705c7c34e;Wed Nov 05 00:15:17 EST 2003;Committer;shugo;2;17;20;37;0
d193b90d54419e253b48aff340887899230d6e63;Tue Nov 04 23:48:13 EST 2003;Committer;gotoyuzo;3;17;0;17;0
667bdeb0724cb33eb589b25463bb8e8ec17272bf;Tue Nov 04 14:45:23 EST 2003;Committer;usa;4;14;11;25;0
da191c4547d002b488deaf639e28ef766f594024;Tue Nov 04 14:40:30 EST 2003;Committer;eban;4;6;3;9;0
3d00f9fc96c36206b4617db5a8b433720bada116;Tue Nov 04 14:10:09 EST 2003;Committer;shigek;1;1;1;2;0
858017d6f90ed205ebdad421b03115aaa9e4f7e2;Tue Nov 04 09:40:59 EST 2003;Committer;usa;1;3;3;6;0
a4934a42cbb84b6679912226581c71b435671f55;Tue Nov 04 09:13:57 EST 2003;Committer;matz;13;92;151;243;0
89d1dff3439044201c36f601e1b1fb3b906132db;Mon Nov 03 14:00:38 EST 2003;Committer;eban;1;3;3;6;0
7bf9e6d2a1e4321724f69022458efe9ca2a16f9b;Mon Nov 03 13:55:01 EST 2003;Committer;aamine;3;271;281;552;0
a9da115662c04f3e440df1b841aea079c926578a;Sat Nov 01 17:30:40 EST 2003;Committer;gotoyuzo;2;7;1;8;0
e2ae64a7dc61e507a66e02e16f1054375bd5c839;Sat Nov 01 16:19:47 EST 2003;Committer;eban;1;3;3;6;0
fe85bcd644d60f7665ed2688b91c28c3def01526;Sat Nov 01 16:16:31 EST 2003;Committer;knu;3;19;4;23;0
92160dc6d0ca0ce81f551c2ec300b570b44b945c;Sat Nov 01 11:24:40 EST 2003;Committer;knu;2;0;6;6;0
fc133b89979195d350d30abbc92b00eaa4f540cb;Sat Nov 01 09:24:55 EST 2003;Committer;gotoyuzo;5;55;5;60;0
09125ff3d000a48509372391b19637c4c9815a62;Sat Nov 01 09:13:10 EST 2003;Committer;knu;2;6;0;6;0
3ed362106087644ca77dd093d912a7fed299513d;Fri Oct 31 16:55:49 EST 2003;Committer;eban;1;4;4;8;0
3f4d04564b979ddc74bcc6dc8c09491f3c96a4e6;Fri Oct 31 16:50:27 EST 2003;Committer;nahi;4;41;3;44;0
e6775cc1933ffcfa07235a1c030aad4ed88fa1bf;Fri Oct 31 13:36:19 EST 2003;Committer;uema2;3;8;2;10;0
0dfe20d3d4868bd8872e9648ea1c9e495ab537eb;Fri Oct 31 03:58:21 EST 2003;Committer;eban;6;18;2;20;0
1ff2d2a348b3d023bec48a853e028597970eb1e8;Thu Oct 30 22:47:08 EST 2003;Committer;gsinclair;1;175;182;357;0
c748f7f8caf7943dcb284adfecb3e7c1ee04a72b;Thu Oct 30 17:55:51 EST 2003;Committer;matz;1;1;0;1;0
35e098c1b1217c99667a0b342915f94fc3d1e03a;Thu Oct 30 16:40:29 EST 2003;Committer;usa;3;7;2;9;0
394738639ed4b4d2bacb40a1ac170950b09cbd95;Thu Oct 30 16:33:32 EST 2003;Committer;matz;5;34;10;44;0
2c2b30dde4f7b26fbe63b6ba74f2bc7ac98d35ba;Thu Oct 30 14:46:06 EST 2003;Committer;seki;1;8;0;8;0
6a512ba9a908d5a2ebe6dff79580f056c830031b;Thu Oct 30 14:43:03 EST 2003;Committer;seki;3;33;0;33;0
7eb52a8cd5ad6c40d86e6ea532114c9236a407a4;Thu Oct 30 14:25:21 EST 2003;Committer;nahi;4;24;9;33;0
1a4c78d7c108a189683903b6a2a9d1ddf1753933;Thu Oct 30 13:59:40 EST 2003;Committer;why;2;5;1;6;0
bddde75eb0929e24785d7c19eeaf67df8d1b01c2;Thu Oct 30 13:38:53 EST 2003;Committer;eban;1;1;1;2;0
1eb2a60a3dd8d1bf169251966a356265bb3c0451;Thu Oct 30 13:30:48 EST 2003;Committer;seki;4;19;5;24;0
6350cbb1b280dd12d7230cc2a176e6d9f722c38b;Thu Oct 30 10:15:05 EST 2003;Committer;knu;2;5;0;5;0
1a8ccefafc490875a90515907f05a565c4c8f7ba;Thu Oct 30 09:36:41 EST 2003;Committer;matz;6;135;75;210;0
cf22db8d6910a428b2bb51b3c78c34b86d83bf74;Thu Oct 30 04:37:50 EST 2003;Committer;matz;4;13;44;57;0
22b8cc47eb999311bef34240dd8c4f6cfdda849c;Thu Oct 30 01:17:40 EST 2003;Committer;nahi;2;6;2;8;0
abe7778a2bad444a3b43420fbe1443fee28479ae;Thu Oct 30 00:35:05 EST 2003;Committer;usa;1;3;3;6;0
f1ab0d3cab7f151b67f0f558982fe5829195db5a;Thu Oct 30 00:34:30 EST 2003;Committer;usa;2;6;0;6;0
525336fcc97a0c0fc8dae2e6f9fe63dfc6e645ab;Wed Oct 29 17:47:24 EST 2003;Committer;matz;8;71;27;98;0
2e0b6e28ada7713aab10343c2850f32dec4652ac;Wed Oct 29 17:27:59 EST 2003;Committer;gotoyuzo;5;41;3;44;0
2d6b30ee5704b349d2e8b4778427fc022e7cbb5a;Wed Oct 29 13:06:12 EST 2003;Committer;nahi;2;11;3;14;0
ef7845ad248cb704b8af45d9534e67f6b8e44980;Wed Oct 29 11:03:54 EST 2003;Committer;usa;2;37;50;87;0
a5c350aaba58732d2fe833881f142e59d2bd7f1a;Wed Oct 29 08:31:43 EST 2003;Committer;akr;3;120;32;152;0
8bf300f1490334055dd95f5cf5c0e5c865371dbb;Wed Oct 29 08:21:11 EST 2003;Committer;matz;2;6;1;7;0
27ff072349b9a5e0efc83977b7158f939f16df15;Wed Oct 29 06:53:48 EST 2003;Committer;matz;3;7;1;8;0
f6f8883202d89b371ebc14b635dc4f090342d326;Wed Oct 29 02:32:13 EST 2003;Committer;usa;1;3;3;6;0
91d2e58f1dab1c7ef4a234cdb38935c6719f8fc1;Wed Oct 29 02:30:08 EST 2003;Committer;matz;3;6;2;8;0
27ce94a366932d35f1f9ee428b86d8985fa6cbea;Tue Oct 28 14:14:41 EST 2003;Committer;seki;1;2;2;4;0
70b6fce162aea9ef44fd1b78722dd9e41df684ae;Tue Oct 28 06:23:47 EST 2003;Committer;usa;2;41;4;45;0
5f373d4f997c835c781d7739b2a3108267bd861b;Tue Oct 28 02:28:10 EST 2003;Committer;eban;1;3;3;6;0
a1096ba77cc2da7bb04f8948faad994a7d171363;Tue Oct 28 02:27:06 EST 2003;Committer;matz;5;63;72;135;0
ed5208d851e5cfc846a4b9c70c466b0bdb0a8cc5;Mon Oct 27 10:19:57 EST 2003;Committer;nobu;2;9;1;10;0
d1d617b4a27986522369d331ae3eb86408f0bb65;Mon Oct 27 02:28:31 EST 2003;Committer;eban;1;3;3;6;0
8f2e14aa3ab73a2e53809730ac7878aca48d8d82;Sun Oct 26 15:25:58 EST 2003;Committer;nagai;2;10;1;11;0
b9a216a6ef0510cd2a5b2675ec566bf55eff35b1;Sun Oct 26 13:07:58 EST 2003;Committer;seki;1;5;0;5;0
985549e00868b6e3f95aa2409bb8485383546a62;Sun Oct 26 09:01:51 EST 2003;Committer;eban;1;3;3;6;0
90e087b6977e564fb2ebcff9cd02dda97e9ea5a7;Sat Oct 25 22:36:50 EDT 2003;Committer;nagai;1;4;0;4;0
b6beb8d943761fe1d754ba4de5ba360018b8e767;Sat Oct 25 00:36:56 EDT 2003;Committer;matz;3;19;11;30;0
beb00bc582c0cbe6feb688026e469f824ee7ea44;Fri Oct 24 14:51:31 EDT 2003;Committer;eban;1;3;3;6;0
befb57053670b6b03a4bc46008beddb248a46af1;Fri Oct 24 14:31:14 EDT 2003;Committer;matz;5;51;7;58;0
f493f61f7303d1c2f9105792b081c3619aa9db8b;Thu Oct 23 11:29:29 EDT 2003;Committer;gotoyuzo;2;6;1;7;0
bd9898da420f8b58978a6a8e37094b4c331a47c3;Thu Oct 23 09:10:00 EDT 2003;Committer;nobu;1;3;3;6;0
d74e7e6837c92e33eeff2fdbdca8833c973dbd21;Thu Oct 23 08:59:42 EDT 2003;Committer;nobu;4;13;4;17;0
443ddb09699926f74798fdb8440a24ebda358088;Thu Oct 23 04:44:04 EDT 2003;Committer;nobu;2;17;16;33;0
38d2bcf47cf52dd00a3632aef16ab1b258def01b;Thu Oct 23 02:19:00 EDT 2003;Committer;nobu;1;1;1;2;0
00ac002f79d201db14734a0d997d35985f6aabce;Wed Oct 22 15:43:10 EDT 2003;Committer;nahi;5;21;9;30;0
618a4351784bc7aedf50f05b706f87ce9d193209;Wed Oct 22 15:04:35 EDT 2003;Committer;ttate;1;2;6;8;0
79c3e2d004c40449e987c1fb78602b7f3a93bd6a;Wed Oct 22 14:29:20 EDT 2003;Committer;ttate;1;5;8;13;0
f136a3225e5fdd37961b8ed0e29c96e4a40f0d64;Wed Oct 22 03:53:41 EDT 2003;Committer;nobu;8;36;16;52;0
4650c38d8b157667c6e9532174297f9e72bc4c34;Wed Oct 22 01:14:48 EDT 2003;Committer;eban;1;3;3;6;0
903f98a643e2277f7c15e03e774fd1d67813c9bb;Tue Oct 21 17:38:37 EDT 2003;Committer;matz;2;6;2;8;0
d0244508c2eda37dbe403261cb1f3a202e6ffaf3;Tue Oct 21 15:04:39 EDT 2003;Committer;matz;2;299;0;299;0
06d9340f2e1491697625afbf1fe94137e252319c;Tue Oct 21 14:42:15 EDT 2003;Committer;matz;9;117;406;523;0
8af34b7b33714eeb0f0dead1ce79a98b780ddb22;Tue Oct 21 06:57:14 EDT 2003;Committer;nobu;2;9;0;9;0
9292a6254e40e2e76a53e3c1ae31cbc01e8e0958;Tue Oct 21 06:23:51 EDT 2003;Committer;usa;2;11;2;13;0
d820362c5001c1f35992da9a3728769f56ef68ff;Tue Oct 21 06:10:12 EDT 2003;Committer;usa;2;7;0;7;0
0152ff5c241beb91eda2a4e46c3e4857c572532a;Tue Oct 21 04:48:59 EDT 2003;Committer;eban;1;3;3;6;0
477f730aa45adfb6867925cc232c22a002a76571;Tue Oct 21 04:46:21 EDT 2003;Committer;nagai;3;6;6;12;0
c2e6541a6a4c0f0c37fe6ac3d058c6fbe5e350e2;Tue Oct 21 03:52:43 EDT 2003;Committer;shigek;2;17;6;23;0
970ad34c958a62ba6794edd40dc85fc2dc4b9f77;Tue Oct 21 03:29:54 EDT 2003;Committer;shigek;1;5;1;6;0
87704d6a3c19eb991aa161b56a1a6b7ed1959504;Tue Oct 21 03:18:44 EDT 2003;Committer;shigek;1;45;22;67;0
212d962a3b8b538433235571c450d86766295928;Tue Oct 21 02:47:17 EDT 2003;Committer;nobu;2;17;17;34;0
208ff30c076d16db2e2b6fc3f0d635b3197e7ca4;Mon Oct 20 15:37:11 EDT 2003;Committer;nahi;5;29;0;29;0
bc867112ecb2ce355caf98c3627d50a7d0b60f3d;Mon Oct 20 15:24:00 EDT 2003;Committer;seki;17;1279;0;1279;0
d6153337f60acb466d48ac4b563aed8c847e8ecf;Mon Oct 20 14:55:50 EDT 2003;Committer;nobu;2;16;5;21;0
28f2a1da54bc3e201cc1c860c909c2b995d6eb22;Mon Oct 20 13:01:21 EDT 2003;Committer;nobu;2;7;2;9;0
229c37a6dad61030bffc8d07f9c708f8a911601b;Mon Oct 20 09:28:13 EDT 2003;Committer;nobu;2;5;13;18;0
6eb98c5ebe264eb0be6488c7db875137a44d8279;Mon Oct 20 08:33:49 EDT 2003;Committer;matz;4;24;13;37;0
8405551e6d05c08c4e6a25672e009d349d888aa1;Mon Oct 20 02:31:47 EDT 2003;Committer;nobu;2;12;5;17;0
de6f26a2966f9862598e0233b480093bf8c5588d;Mon Oct 20 02:11:42 EDT 2003;Committer;usa;1;3;3;6;0
e75c34c2e9f9e1c629cdab13c0c400494f49adb7;Mon Oct 20 02:06:42 EDT 2003;Committer;matz;4;42;21;63;0
0014687097c3c0ce8e728496ad7fa777372ea7fb;Mon Oct 20 00:46:01 EDT 2003;Committer;usa;2;4;1;5;0
a253e7c51214854f9139451a47bba87525cee75b;Sun Oct 19 04:29:08 EDT 2003;Committer;eban;1;3;3;6;0
2768ca8b909896c1b980c8f8b227d15a638dc250;Sun Oct 19 04:14:40 EDT 2003;Committer;akr;2;14;9;23;0
cf73166d47bee1156a5231844473fb5f677bb29a;Sat Oct 18 15:21:18 EDT 2003;Committer;nahi;8;24;11;35;0
df8b1ad9e8c15b4a25cd4b90292c5e4004794af0;Sat Oct 18 14:04:18 EDT 2003;Committer;eban;2;5;1;6;0
fa4875640883179f64e405e8700741b4b9875ddc;Sat Oct 18 05:18:41 EDT 2003;Committer;eban;1;3;3;6;0
ec40d939afd905626a14b77a68f34a42fb602964;Fri Oct 17 22:36:40 EDT 2003;Committer;nagai;2;31;6;37;0
9e2f9cf23311b883897f6e8d5a43da9974a8cb66;Fri Oct 17 21:03:16 EDT 2003;Committer;why;2;172;0;172;0
71a8bebf5a130735b6455426b25a817fb31463c8;Fri Oct 17 20:53:39 EDT 2003;Committer;why;9;4111;1558;5669;0
23f6b5bdc450abc5ce3a3dc7540a668f5d166dea;Fri Oct 17 14:09:43 EDT 2003;Committer;knu;3;14;2;16;0
a7ddb2e342a909cef7d1a73fcc1d0ba193654e35;Fri Oct 17 14:01:26 EDT 2003;Committer;knu;2;84;4;88;0
a4ba07c242ccb972e53f689ed368cfc241124116;Fri Oct 17 13:17:35 EDT 2003;Committer;knu;1;7;0;7;0
86bbeb6017e6df297945a3b938546fd668ea45ba;Fri Oct 17 13:16:03 EDT 2003;Committer;knu;1;5;6;11;0
8cdd299bf067147f142ab7c3ebc27918e03539ae;Fri Oct 17 12:32:52 EDT 2003;Committer;eban;1;3;3;6;0
b860656cb01b05ac26cd0a11d6c79c3875b78ebe;Fri Oct 17 07:59:32 EDT 2003;Committer;nagai;7;328;3;331;0
c7d278adb9356e78465de640f9a41cdc0fd1f09a;Fri Oct 17 02:18:01 EDT 2003;Committer;usa;3;20;0;20;0
4cb439cac913938e1b1f2be5e7e82a9565d0a3ea;Fri Oct 17 01:09:19 EDT 2003;Committer;nagai;1;2;0;2;0
8ef5da3be1577bb5ae7f55b60cf9fedb10ecb85e;Thu Oct 16 17:47:19 EDT 2003;Committer;matz;26;48;48;96;0
3ec0bc3828794a6ef6293b53b403af8bc2362934;Thu Oct 16 17:46:14 EDT 2003;Committer;matz;2;11;4;15;0
653ad6fd4bb186157514f36ca100917e09dfd78d;Thu Oct 16 15:14:41 EDT 2003;Committer;nagai;2;7;1;8;0
6559430fb75e921622f34d04049b2dfd46006ea8;Thu Oct 16 14:53:47 EDT 2003;Committer;nagai;2;23;1;24;0
0ed68132e55b9751f13349e0d7cdd7539cb80441;Thu Oct 16 08:03:44 EDT 2003;Committer;eban;1;3;3;6;0
231d3e9654cb7e3da7e242a97b2a9dd4b07911a1;Thu Oct 16 08:01:15 EDT 2003;Committer;matz;2;8;1;9;0
98a3a9db9718d8a54a66ae5f5e4da080c57cba5c;Thu Oct 16 07:45:51 EDT 2003;Committer;nagai;7;301;29;330;0
e45c4cd1ac8523f83b1d72b068ba009e3d9fe6db;Wed Oct 15 23:38:10 EDT 2003;Committer;nobu;3;31;3;34;0
c1b6f966bef5ee3ea3e08ad29c3616354d0e4ef8;Wed Oct 15 13:50:51 EDT 2003;Committer;knu;1;1;0;1;0
57292a2ab458a6681c8ac3ccc1a43d74360303e3;Wed Oct 15 11:25:41 EDT 2003;Committer;nahi;2;7;2;9;0
a23075a53ea30f57f539f4f5280ac4476bdc2749;Wed Oct 15 08:34:35 EDT 2003;Committer;matz;2;5;1;6;0
c12ae030baba113525dd54c2a9177faa0ff4c25d;Wed Oct 15 06:00:57 EDT 2003;Committer;nobu;2;10;5;15;0
0ac52b49f4999e2dc646a8b58783a7bef785ce1d;Wed Oct 15 04:19:48 EDT 2003;Committer;usa;2;6;1;7;0
87025fdd4345f48821236ff19090976bfc11a2bd;Wed Oct 15 02:27:56 EDT 2003;Committer;matz;8;41;14;55;0
0c25b62505c64973876e6281193ea6141d396564;Wed Oct 15 00:49:35 EDT 2003;Committer;nobu;1;1;1;2;0
08c383279b2ad6a928f91bf83b5d6ba7b5de1037;Wed Oct 15 00:39:17 EDT 2003;Committer;nagai;1;2;0;2;0
a6d7c6eee9fe24b66b9477cbc61fb032f0cde448;Wed Oct 15 00:38:59 EDT 2003;Committer;usa;1;3;3;6;0
888d06be019e63f6243e5d86c4ead9bb116acc30;Wed Oct 15 00:32:44 EDT 2003;Committer;usa;3;8;1;9;0
c76c3349e4d5cfc3d1452d32491647294c102a8b;Tue Oct 14 23:15:19 EDT 2003;Committer;why;12;2629;3647;6276;0
b215f2fdb93fba83199168e50c28adc458844a26;Tue Oct 14 20:14:53 EDT 2003;Committer;knu;1;2;0;2;0
3982f82b03eab18b9eee9e76190081ee942cfd7f;Tue Oct 14 20:14:20 EDT 2003;Committer;knu;4;383;0;383;0
6bd9229984446b774d5d3edb3275277eb61041bd;Tue Oct 14 19:36:09 EDT 2003;Committer;nagai;5;419;4;423;0
6d9c20d6a33d00db831ddb02209ea7e32db8fa45;Tue Oct 14 19:34:46 EDT 2003;Committer;knu;5;96;92;188;0
e437d32cc12c744caec9182f7cd355a7a450fad0;Tue Oct 14 18:55:23 EDT 2003;Committer;nagai;1;5;0;5;0
b4337be29ff0f6e9a461791c30c2ae7c4d4dbe5a;Tue Oct 14 18:54:21 EDT 2003;Committer;nagai;1;7;2;9;0
382b4ae9a34c2f697464e1e42fd0fdc277fdd3c3;Tue Oct 14 15:25:45 EDT 2003;Committer;nagai;6;1015;67;1082;0
6adad139461f64d6bc011df2236d21f53c5fac8c;Tue Oct 14 15:14:49 EDT 2003;Committer;nahi;1;22;0;22;0
9cba39a1a1b09f94a5d890e0ad6f4c74bb9f36bf;Tue Oct 14 15:14:02 EDT 2003;Committer;nahi;21;689;375;1064;0
0b841783b508c9bddb1c0117b1970fc7c350843b;Tue Oct 14 10:09:39 EDT 2003;Committer;nobu;2;8;3;11;0
921d595fd4d1115e5cdccaaa2e68703fc8282436;Tue Oct 14 02:53:53 EDT 2003;Committer;nobu;3;8;2;10;0
839ef7bfbb446db531983e391a52df4e4a0eb8aa;Mon Oct 13 19:46:07 EDT 2003;Committer;akr;2;45;9;54;0
345f1ac53dc4e7bdbeb0bdc4994110109c524773;Mon Oct 13 17:57:53 EDT 2003;Committer;knu;1;3;3;6;0
83fbff2f748f49e393f78da58fa50ab7e01e96a1;Mon Oct 13 17:34:50 EDT 2003;Committer;nobu;1;1;2;3;0
e7257aa72e817601c033c256c1df388f2b03dcbc;Mon Oct 13 17:29:34 EDT 2003;Committer;nobu;2;8;7;15;0
b2de95d4afece89abd4ccf536295359f058c2043;Mon Oct 13 17:09:23 EDT 2003;Committer;knu;12;318;1;319;0
046dff7f11b57d91e58ac9845b60e82fdad38b14;Mon Oct 13 14:59:25 EDT 2003;Committer;eban;2;15;2;17;0
4de0bb549b9d28e7f6e0799d3c3a08f615a49f51;Mon Oct 13 14:57:36 EDT 2003;Committer;nobu;5;202;161;363;0
1b8c124c8d19a572d94a6187372da1f3295f11ed;Mon Oct 13 13:16:32 EDT 2003;Committer;eban;1;3;3;6;0
1184373d867f0e4792b3a6da11acfd2cf4c0b330;Mon Oct 13 13:05:24 EDT 2003;Committer;matz;6;63;39;102;0
b6f1c0e2846acbbc9d694b1207c778e1d6db63e3;Sun Oct 12 05:54:05 EDT 2003;Committer;eban;1;3;3;6;0
5d0f8cdc6f195ed0c7d6b0b6904cdf419326cca6;Sun Oct 12 05:46:59 EDT 2003;Committer;eban;2;6;1;7;0
d430692b95b459b3706cda58e6e3b56406fab76a;Sat Oct 11 08:10:07 EDT 2003;Committer;eban;2;6;1;7;0
6e41de6767a282e4b133d3c80085c294bc49b307;Sat Oct 11 07:12:09 EDT 2003;Committer;akr;1;3;1;4;0
31fd8aa6814e590d10c4e962068a70c9cf708ce3;Sat Oct 11 07:09:19 EDT 2003;Committer;akr;2;4;2;6;0
b01f0cab31d34451d00f1ee1ecffb79a7e11851b;Sat Oct 11 06:42:41 EDT 2003;Committer;akr;2;35;57;92;0
79aca9eb60856e5c10112cb8d1a2070e4a2431d5;Sat Oct 11 05:51:03 EDT 2003;Committer;eban;1;3;3;6;0
6fc32eb8bbd0ab3c9b24dd73a3b6b17fd180379d;Sat Oct 11 05:37:41 EDT 2003;Committer;akr;2;13;6;19;0
764722dc2737f7ee2686c1012539d1c5bd6446b8;Sat Oct 11 01:20:45 EDT 2003;Committer;shugo;2;25;13;38;0
45b46d78fa09c085089a9e4ea17fde522ea1f0ef;Fri Oct 10 13:26:03 EDT 2003;Committer;eban;1;2;0;2;0
ece4dc43e53c0cf12b4bf2ae772c332d0b9d6b6f;Fri Oct 10 12:58:23 EDT 2003;Committer;ser;2;1;8;9;0
7d21c237ccd46ec1d56639ce53b5882bf97d9de3;Fri Oct 10 12:54:46 EDT 2003;Committer;ser;23;183;222;405;0
662532be008867582fc86dd813dcf8f6a79136eb;Fri Oct 10 00:26:26 EDT 2003;Committer;nobu;1;3;3;6;0
3354489d06b48f6123a451ece969750a86522df7;Thu Oct 09 22:50:57 EDT 2003;Committer;nobu;2;51;34;85;0
90a88ab9a09d19165cf3668b6a8473024e064fa7;Thu Oct 09 17:45:53 EDT 2003;Committer;matz;6;62;51;113;0
80549d5f17e09173251204f08d288a71bad39256;Thu Oct 09 16:20:22 EDT 2003;Committer;gotoyuzo;3;16;7;23;0
67a98cd52f380857d3aea57cfb26dde38bdbaa97;Thu Oct 09 14:50:24 EDT 2003;Committer;nobu;2;7;1;8;0
8022abdc69b3707db7371ab21a2fdc40d578f614;Thu Oct 09 10:11:48 EDT 2003;Committer;nobu;2;7;1;8;0
dd3eed4f08dd5232b5634f7f444bb8db60e65f60;Thu Oct 09 08:43:39 EDT 2003;Committer;nobu;2;10;34;44;0
0b2e94b2abcce9301d75ccd4c986f8c3324a50c7;Thu Oct 09 06:46:40 EDT 2003;Committer;matz;4;20;3;23;0
582b7e1ca9b1fe56516d84698cbfaad7ee317bad;Thu Oct 09 05:05:43 EDT 2003;Committer;nobu;2;11;0;11;0
894d8d9e618d352a1a54f19210f6e1d99d18cdd8;Thu Oct 09 01:51:08 EDT 2003;Committer;nobu;2;8;1;9;0
99e2ecdebf9c60c8d62cf591c637fb061f2365d5;Thu Oct 09 01:33:18 EDT 2003;Committer;eban;1;3;3;6;0
5cefaf0c8f211428e45f9963ab061f2136df2fc2;Thu Oct 09 00:09:40 EDT 2003;Committer;nobu;1;10;10;20;0
517f01985162c82238998dfbf31cd694327552c0;Wed Oct 08 22:40:22 EDT 2003;Committer;nobu;1;0;4;4;0
c0e5a7c63fc93cbf0c7c856b397022ec5fc532e7;Wed Oct 08 21:43:36 EDT 2003;Committer;nobu;2;50;22;72;0
99fb4ed24e70145cd7b7151856e0a4f3deba37fe;Wed Oct 08 13:28:57 EDT 2003;Committer;eban;1;3;3;6;0
540653f474e8873aa95cf96756be013331afd649;Wed Oct 08 13:28:54 EDT 2003;Committer;eban;1;4;0;4;0
09d2946061379d18407d4de2002a01f3a82c8c84;Wed Oct 08 13:21:28 EDT 2003;Committer;ntalbott;10;775;233;1008;0
777681bda1fe3fbc33bd2c3d4ce132e6b8c0042e;Tue Oct 07 11:22:16 EDT 2003;Committer;mneumann;1;3;9;12;0
885ea0a9f74ff7cbb71afc6f1585c59f4eb3d7cd;Tue Oct 07 06:32:22 EDT 2003;Committer;eban;1;1;0;1;0
dc952ac536993e55aa2b73f3ccc2fa0f042dfc36;Tue Oct 07 06:32:18 EDT 2003;Committer;nahi;2;1;15;16;0
cd8d08b5329fd86660cced8a5b91c4a042f2e2a0;Tue Oct 07 06:27:11 EDT 2003;Committer;nahi;5;119;19;138;0
0a5f6fd37d7b83dd78adfbaecb050fd3cc4fb3e9;Tue Oct 07 03:30:55 EDT 2003;Committer;akr;2;3;3;6;0
4f6558a4eca8cdee8dba8eab202b23a68f13f64d;Tue Oct 07 03:24:11 EDT 2003;Committer;akr;2;8;1;9;0
9c6cfb5672328af8376e71f849bea871017538ea;Tue Oct 07 01:04:07 EDT 2003;Committer;akr;2;6;2;8;0
cda830ff333146b1f4e2b4692ec1f391b88d3e03;Tue Oct 07 00:13:29 EDT 2003;Committer;nobu;2;9;1;10;0
6fc88be3d97172841ad099a9489ed80d8ecae5de;Mon Oct 06 19:15:29 EDT 2003;Committer;nobu;2;6;2;8;0
8a4abe47cacd613a2d77287df75245fef6693246;Mon Oct 06 17:59:53 EDT 2003;Committer;matz;5;44;35;79;0
0dd4fde745f2c33a473ea3ee54b01a1d24d4586c;Mon Oct 06 16:55:00 EDT 2003;Committer;gotoyuzo;2;61;1;62;0
11d2edffe68fdd52d3a8a6bad26f774c9dd27dfa;Mon Oct 06 14:03:58 EDT 2003;Committer;nahi;3;62;14;76;0
26d111540e3aac50a9bfe2b363ea2d98a5339f7c;Mon Oct 06 11:11:07 EDT 2003;Committer;akr;3;20;1;21;0
2a07445e0bb51e16c801329856234acc78dd28ce;Mon Oct 06 07:23:40 EDT 2003;Committer;nobu;2;5;1;6;0
64e098503a75ea72fbb96ba97c9e95c5441be758;Mon Oct 06 07:10:25 EDT 2003;Committer;eban;1;3;3;6;0
49e8bdf7a352eda0c5cc1403801c2624460ed69e;Mon Oct 06 07:03:20 EDT 2003;Committer;matz;2;7;2;9;0
6e6b863d53253c67b4b6d013a8f26b77f1ac354a;Mon Oct 06 06:18:45 EDT 2003;Committer;nahi;2;16;6;22;0
3d307549a5ab70856adb1707e3fbe82471a20d6c;Mon Oct 06 02:58:39 EDT 2003;Committer;nahi;3;24;1;25;0
56235e083dc8acae32d8eb79e56b602433806a95;Mon Oct 06 01:50:41 EDT 2003;Committer;matz;4;11;3;14;0
4fca6e91dc77ac84255ac27aa1fc2784c23bef4f;Sun Oct 05 14:31:35 EDT 2003;Committer;akr;2;43;3;46;0
92abdcefe4517e628e55dc06a210f73484d3c73e;Sun Oct 05 14:07:07 EDT 2003;Committer;nobu;2;5;0;5;0
f58812a7e22c0ffe04758e660c8f5b60bc65f58c;Sun Oct 05 13:58:02 EDT 2003;Committer;gotoyuzo;3;35;0;35;0
474e9004deea5bf8cd321532eb1c054202486ac3;Sun Oct 05 13:56:11 EDT 2003;Committer;eban;1;7;0;7;0
fde4c2dce890a774c5285d357c2f0ebe861e8b7c;Sun Oct 05 12:23:33 EDT 2003;Committer;seki;4;652;0;652;0
4aa8b47bb9a7ba33828b7a1b654a3c4ed1d8bdf9;Sun Oct 05 08:56:34 EDT 2003;Committer;nobu;2;20;7;27;0
12c8c18f096722f5497f054edcf6c24435c5f879;Sun Oct 05 06:09:26 EDT 2003;Committer;akira;7;76;167;243;0
16658578a55558271c76f305e62f526e6296c8e3;Sun Oct 05 05:42:04 EDT 2003;Committer;nahi;4;19;3;22;0
d50d6d396ae47d78a9d8d07a754868f35492d7fc;Sun Oct 05 04:51:05 EDT 2003;Committer;nahi;3;48;3;51;0
d77b17aa73110c289c354316bb9c600f53bb3684;Sun Oct 05 02:56:42 EDT 2003;Committer;nahi;5;43;5;48;0
1e85ca8a02a4e0e77f2144e91bf12d920993a303;Sun Oct 05 02:23:48 EDT 2003;Committer;ntalbott;2;6;17;23;0
b60827ba047b594dea58adf68f4e983f21c32c04;Sun Oct 05 02:17:07 EDT 2003;Committer;ntalbott;7;721;9;730;0
0cf763af9c99cace8b4a44ce8160269931d207d2;Sun Oct 05 02:00:29 EDT 2003;Committer;nahi;2;8;3;11;0
cc32628660d5210815200bf7a6952e649a7958c8;Sun Oct 05 00:59:02 EDT 2003;Committer;ntalbott;3;41;10;51;0
82f064a5244dd2ac0b5ded26ff186d85f1938220;Sat Oct 04 21:40:17 EDT 2003;Committer;ntalbott;4;100;104;204;0
960f29a956a4f39d8c205c13f53746cea9a72a61;Sat Oct 04 19:18:52 EDT 2003;Committer;ntalbott;2;98;108;206;0
0afc6e3f4ff543562b08c0ebe72b4d08fe499646;Sat Oct 04 18:48:32 EDT 2003;Committer;gotoyuzo;1;0;1;1;0
d0dd2997f3be288120d1a5752c70431c85c6c988;Sat Oct 04 18:45:53 EDT 2003;Committer;gotoyuzo;2;24;18;42;0
993783d84ab3c43e575450ad94f17e20623933a8;Sat Oct 04 18:06:19 EDT 2003;Committer;akira;2;96;0;96;0
16ea4a3192a6e30ab3233cfa2d3a1f5b8565b038;Sat Oct 04 17:55:54 EDT 2003;Committer;eban;1;3;3;6;0
415283ac95e1dd93518836dbaad4545cca4dfa57;Sat Oct 04 17:51:11 EDT 2003;Committer;matz;7;80;29;109;0
28af5f6cf58158ea366cf31177db7b4ced43a714;Sat Oct 04 17:18:27 EDT 2003;Committer;ntalbott;3;106;64;170;0
22c0d83eb1bfc8ccddab65b98612366d3fcb4acc;Sat Oct 04 17:15:50 EDT 2003;Committer;seki;1;6;0;6;0
824bc6692b1fd69ff50ec5e5cfe5e6f1ce39c899;Sat Oct 04 17:09:06 EDT 2003;Committer;seki;1;2;0;2;0
8d2a8dbfb0d6b4eca0e21434dfd8eeaf184eeed3;Sat Oct 04 17:08:23 EDT 2003;Committer;seki;2;329;0;329;0
e6b60ce2fef3b1460098d612bacceaf12cf98a9a;Sat Oct 04 17:06:41 EDT 2003;Committer;seki;1;1;1;2;0
0e2cb1e5b2cfa0c21ddf04f3d5892808e1fdc5f6;Sat Oct 04 12:54:29 EDT 2003;Committer;eban;1;7;0;7;0
d821751c850f73a21ebcdb771979ce98ad071082;Sat Oct 04 12:51:32 EDT 2003;Committer;eban;2;6;1;7;0
cbef5b65dbbb89fe560fcc56a67d0ff1d40b5510;Sat Oct 04 08:57:11 EDT 2003;Committer;nahi;4;43;5;48;0
94e01ab6450beda3ae5d5ed2c7f779477b475bfe;Sat Oct 04 06:04:59 EDT 2003;Committer;akr;2;115;19;134;0
ef5883c016d02059beff0f7c5711e54a35318b32;Sat Oct 04 04:02:16 EDT 2003;Committer;akira;7;1079;1;1080;0
d6f70951dbf2dcdec6515ee783de539d739875dd;Sat Oct 04 03:49:01 EDT 2003;Committer;akira;4;7;3;10;0
51267d117721b017f00493085c8e45a7d0efed05;Fri Oct 03 22:35:19 EDT 2003;Committer;ntalbott;5;63;23;86;0
df0e9dbe9772d7327481ec95ad4dd33a12c1d470;Fri Oct 03 19:51:25 EDT 2003;Committer;why;4;1189;10;1199;0
7d18f560f5b25bee62c26a80ccc97f7de618fc8f;Fri Oct 03 19:29:13 EDT 2003;Committer;gotoyuzo;3;12;0;12;0
9d04d1df145bace824d89c66947994a5e0c93566;Fri Oct 03 17:59:44 EDT 2003;Committer;gotoyuzo;2;0;3;3;0
6ea9e723ea7ccff688c7bc093d868314d29fe95a;Fri Oct 03 17:15:23 EDT 2003;Committer;nahi;8;1201;135;1336;0
18b1fd953f5df852ce0298ddb8bf4ab5833ebd2e;Fri Oct 03 16:39:34 EDT 2003;Committer;eban;1;3;3;6;0
f047918d094bba0379149bb839d274ec243c951c;Fri Oct 03 16:36:24 EDT 2003;Committer;akr;2;31;3;34;0
29e64f7d3613f425f36cf7a617f319f9a3aabc6c;Fri Oct 03 14:46:45 EDT 2003;Committer;eban;1;284;281;565;0
5af0a758d4454587f7d5ed4ff4cf610968642837;Fri Oct 03 08:58:01 EDT 2003;Committer;gotoyuzo;7;1035;14;1049;0
b0ccb799ec0a0893699470dadda7715fe1afcc35;Fri Oct 03 04:04:26 EDT 2003;Committer;ntalbott;4;111;29;140;0
a3ef2d79fa1da0f7c0fea5417f5ece0347f6dc54;Fri Oct 03 02:52:17 EDT 2003;Committer;eban;1;3;3;6;0
47bd3ed9ce1bfe9116925b95f4c2b342e864af5a;Thu Oct 02 23:03:13 EDT 2003;Committer;ntalbott;11;219;67;286;0
56db4c8fb04617549c4b1c3aee3a39b3a4adada9;Thu Oct 02 14:26:43 EDT 2003;Committer;gotoyuzo;1;1;1;2;0
08ba967d264ea7198e1a1e7881a32f91c921d637;Thu Oct 02 13:56:05 EDT 2003;Committer;gotoyuzo;1;1;1;2;0
4d5204c990aad34cae43048218d89519c59b74bc;Thu Oct 02 11:33:52 EDT 2003;Committer;nobu;2;58;43;101;0
38d1922038082d13ada31909956d20ff0a373840;Thu Oct 02 09:20:31 EDT 2003;Committer;nobu;2;5;0;5;0
d77b606edd788a52e40b27838c6b1b588c1f33cd;Thu Oct 02 08:47:11 EDT 2003;Committer;gotoyuzo;10;375;5;380;0
10c4bb29b237ccdbf99cfe8ef44c81de5a4a9018;Thu Oct 02 08:25:00 EDT 2003;Committer;matz;6;189;80;269;0
a70a430f83a725decf1826aca35ebfca791e5b54;Thu Oct 02 05:19:18 EDT 2003;Committer;nobu;2;42;7;49;0
83740fa4bda976d6aef50a452a9dd433b5446af1;Thu Oct 02 03:00:23 EDT 2003;Committer;nobu;3;20;7;27;0
18ef8f10782e202f1605ff2d3d59241f62989b67;Thu Oct 02 02:20:42 EDT 2003;Committer;ntalbott;7;40;17;57;0
8caf81f1eafc07c14ec8ed006e07c362965ed32f;Wed Oct 01 18:26:11 EDT 2003;Committer;usa;2;5;1;6;0
35ea1379e3df5c778753b4d3afd40d7b87800f22;Wed Oct 01 17:11:58 EDT 2003;Committer;eban;1;3;3;6;0
63aa00cb085cca1f2992d09cddc78014ffea82dd;Wed Oct 01 16:36:47 EDT 2003;Committer;matz;2;14;3;17;0
f5a7147634b1369a8c0bc79d2d46e4a8285804a0;Wed Oct 01 16:06:19 EDT 2003;Committer;matz;2;16;7;23;0
637af54751be6cae06f9cafda9e6ba50b76c61eb;Wed Oct 01 15:29:43 EDT 2003;Committer;nahi;7;95;77;172;0
379c5c1e437821941802946fd370f0b84eb7363b;Wed Oct 01 15:26:06 EDT 2003;Committer;nobu;2;3;3;6;0
5c547fd3e240509579cf737df843859289ba2f9b;Wed Oct 01 15:14:23 EDT 2003;Committer;nobu;4;12;4;16;0
969f4d4c68ecb9dd03bfc1fa8b12c19ea08046fe;Wed Oct 01 13:41:35 EDT 2003;Committer;matz;7;237;231;468;0
cbb7a67c325e4eeaafd999f0b82704b8470810e5;Wed Oct 01 11:49:44 EDT 2003;Committer;nobu;2;39;26;65;0
af69003eb5badf914907e9bed0d40ca0385b261e;Wed Oct 01 11:37:19 EDT 2003;Committer;eban;2;5;0;5;0
ee3ae436cca4aebd5973b2dfd90ee1ebc2771470;Wed Oct 01 09:00:20 EDT 2003;Committer;nobu;1;4;4;8;0
28057a36b6036e945197b2be4ad10427853fd9c3;Wed Oct 01 08:01:33 EDT 2003;Committer;nobu;2;5;1;6;0
85ead97f2be8233156d35342ad99cf4b5ff24bfb;Wed Oct 01 05:12:25 EDT 2003;Committer;uema2;2;11;0;11;0
952e9b9fba7d1212f22b78d9281b6baf7e84ddd4;Wed Oct 01 01:17:41 EDT 2003;Committer;uema2;4;49;22;71;0
3ea7376bca04278433e14894f00b64b67187494b;Tue Sep 30 23:05:39 EDT 2003;Committer;uema2;2;6;0;6;0
77d7066abeea8bf80c422479775a34057ddf4b82;Tue Sep 30 02:31:24 EDT 2003;Committer;akr;2;6;2;8;0
28965ac88ad1a1c6403c4ae5a2d4ec9ae5d7151b;Tue Sep 30 00:33:57 EDT 2003;Committer;nobu;1;3;3;6;0
24639abab7e7c96162ee5fb70a4b1c197970fe08;Tue Sep 30 00:31:59 EDT 2003;Committer;nobu;2;14;3;17;0
13ac4447f6a11498d84f668c636fa2b8eecb5d22;Tue Sep 30 00:21:14 EDT 2003;Committer;matz;4;24;6;30;0
e377a12bff690512a568b93c018ec42961ac2a48;Mon Sep 29 18:12:20 EDT 2003;Committer;aamine;4;51;9;60;0
2eeb39b3cf1b069f309126daed5cbec67ea3f616;Mon Sep 29 17:59:03 EDT 2003;Committer;aamine;2;44;0;44;0
8f52e4912475e838d51dc82ead041d125668ffcf;Mon Sep 29 14:42:03 EDT 2003;Committer;aamine;1;2;1;3;0
819e8e6c82f05203c28d4e191d7dbe351d2f2905;Mon Sep 29 14:39:54 EDT 2003;Committer;aamine;4;14;12;26;0
ccf1c21d3e0b0de90dc4fbaeab186f69296983ea;Mon Sep 29 10:19:47 EDT 2003;Committer;eban;1;1;0;1;0
3015c5f7cb966b6d5a222d09860ada1ba0ecb0d6;Mon Sep 29 10:08:20 EDT 2003;Committer;eban;2;6;1;7;0
523cd7be9c8284487317bb0286fc680acc45675c;Mon Sep 29 07:27:57 EDT 2003;Committer;nahi;4;68;15;83;0
14f9af6015ce3a10f17f05db1ea63b416f9e3b93;Mon Sep 29 07:16:02 EDT 2003;Committer;aamine;1;1;1;2;0
a484962d955a09f872362480ccf85dc82b6aadca;Mon Sep 29 07:13:45 EDT 2003;Committer;aamine;1;1;1;2;0
6d582bf22e054e39674886f3e0c58044bcd8a6e8;Mon Sep 29 07:11:50 EDT 2003;Committer;aamine;2;9;4;13;0
ee299ab2ef2774b140b394777b9edb1d756e0436;Mon Sep 29 02:49:45 EDT 2003;Committer;eban;1;3;3;6;0
4699b4afbb8e0fd96957de6dd6f23ecbe2a1bdd0;Mon Sep 29 02:44:49 EDT 2003;Committer;matz;8;69;5;74;0
b2cf59aa1cbfb8109f0f2579427159c47f93e6eb;Sun Sep 28 17:50:52 EDT 2003;Committer;gotoyuzo;2;14;8;22;0
eb8ee5e401cf49a31d4dc5ba2c8e74f379bb2408;Sun Sep 28 09:33:59 EDT 2003;Committer;nahi;1;11;8;19;0
d57fc5a48922bbdcc6ab8dc0c2e02fe796c70afc;Sun Sep 28 09:29:07 EDT 2003;Committer;nahi;2;32;4;36;0
1e14eb61c9fad7030def09fc4df37da1da0f50b9;Sat Sep 27 10:14:04 EDT 2003;Committer;nahi;1;1;0;1;0
6671baa96b2921e2cdaeb4ca4a16bcd05f5e45ff;Sat Sep 27 07:03:29 EDT 2003;Committer;nahi;9;33;14;47;0
eb4ace3c49b2834b38c7f79bbd8ca3e6ee6e1c3a;Sat Sep 27 00:53:19 EDT 2003;Committer;aamine;1;1;0;1;0
0be9d09430da15aa38dde56ef650499bb1a39c23;Sat Sep 27 00:44:50 EDT 2003;Committer;aamine;3;59;21;80;0
11150ba747dc6e86130856a4a9968ba94990fa79;Fri Sep 26 20:00:03 EDT 2003;Committer;nahi;3;41;1;42;0
2e0b087b02de40dd7398533522d2cfcf209771df;Fri Sep 26 18:34:41 EDT 2003;Committer;nahi;13;105;9;114;0
746a4fb43fcc14dcdac95a1c2c26bb3fba55b345;Fri Sep 26 18:08:14 EDT 2003;Committer;nahi;1;1;1;2;0
98442fdf46051a9e0cf619676c2b0d724b763cc5;Fri Sep 26 16:41:50 EDT 2003;Committer;eban;1;3;3;6;0
39aafb4c78a52f287316ff903bebc0fe123e6126;Fri Sep 26 16:35:07 EDT 2003;Committer;usa;2;7;2;9;0
dfe0aab04f7039660f4f567988accbf8ce0d6e7b;Fri Sep 26 09:35:44 EDT 2003;Committer;nobu;3;25;12;37;0
13391b4047d4bddd6d0447265e46a45c3ec9d851;Fri Sep 26 09:30:07 EDT 2003;Committer;nahi;1;1;1;2;0
e0741eb05f6fe7f6928922f1c6487a3cb39702c3;Fri Sep 26 08:41:28 EDT 2003;Committer;nahi;2;284;0;284;0
af337b6c2a4c0bde18a363b439a5bf4f1f93de86;Fri Sep 26 01:09:13 EDT 2003;Committer;eban;1;3;3;6;0
ac8ef7a5c878b5d6871826841824c6bbf69be394;Fri Sep 26 00:52:49 EDT 2003;Committer;nobu;3;19;7;26;0
b4c805cc4447b0e34df9e3a767ceb31a87013de7;Thu Sep 25 15:10:46 EDT 2003;Committer;nahi;2;23;1;24;0
07cae563bd5129938e53fc7c8da7687103a02c21;Thu Sep 25 14:51:23 EDT 2003;Committer;eban;1;1;0;1;0
3a9772f651ddb7e9582c7c3ff5af15615f837d99;Thu Sep 25 08:49:36 EDT 2003;Committer;usa;3;10;2;12;0
fb1f07049fc74830e3e3965de1ce61f010acb266;Thu Sep 25 00:03:11 EDT 2003;Committer;ntalbott;3;37;0;37;0
94bfebb3fad44c5418de4ef20493e314344b64c6;Wed Sep 24 23:56:11 EDT 2003;Committer;matz;4;19;0;19;0
5747a6c480edc60cd8d7f1deaabd3d65f5d14778;Wed Sep 24 22:55:33 EDT 2003;Committer;nobu;5;10;4;14;0
4b229a30756dc8a8e559c81ea9796aa5a8ae72a5;Wed Sep 24 15:24:00 EDT 2003;Committer;eban;1;3;3;6;0
6ac122d7626d0a0a41d2636cbe2cab601b15d4df;Wed Sep 24 15:23:56 EDT 2003;Committer;eban;2;148;0;148;0
db9445103c082a306ba085f7677da02ea94b8841;Wed Sep 24 15:18:44 EDT 2003;Committer;nahi;145;20938;0;20938;0
8c2fb77787d1f20b4c19c9c52552856c339b86e9;Wed Sep 24 07:44:09 EDT 2003;Committer;eban;1;3;3;6;0
fca2b319b58e3249086c039c24f84e044a840765;Wed Sep 24 07:42:06 EDT 2003;Committer;nobu;2;7;2;9;0
9cdd5fcb621c4311017e83e870a6c9e45c079c8c;Tue Sep 23 17:14:39 EDT 2003;Committer;gotoyuzo;2;9;2;11;0
f7294937f69126feb0b8bbccdf07cb17689bc35b;Tue Sep 23 14:51:45 EDT 2003;Committer;eban;1;3;3;6;0
406fd7754e804312d457fb09e0ded92afe0c0d54;Tue Sep 23 14:12:42 EDT 2003;Committer;nahi;3;45;1;46;0
603e0b1f19928422594c6a2d934663c01214f42f;Mon Sep 22 12:29:33 EDT 2003;Committer;eban;2;206;187;393;0
1e7a048bbd59ad06e7b64a84d20f81bf918c22fb;Mon Sep 22 10:26:57 EDT 2003;Committer;eban;1;3;3;6;0
0645683e26823389954e30a92c2d3961df8b3429;Mon Sep 22 10:25:24 EDT 2003;Committer;gotoyuzo;2;6;1;7;0
ca8be43f0e1d20bb569fda156baf2410286ddc7e;Sat Sep 20 19:18:22 EDT 2003;Committer;gotoyuzo;4;18;0;18;0
879944aa32c235f99fc67ec6fadd7864a0a97580;Sat Sep 20 02:54:52 EDT 2003;Committer;nahi;1;3;2;5;0
deb2caf4b50e3736cde8460aec9064ee4c32668d;Sat Sep 20 02:51:06 EDT 2003;Committer;nahi;4;227;5;232;0
1469fdd06c6a88dbc59aead0ebd9ef5129574842;Fri Sep 19 07:47:46 EDT 2003;Committer;gsinclair;1;3;2;5;0
34ab8c77a1cfdef07478a2d0b297f542d1be9412;Fri Sep 19 06:53:02 EDT 2003;Committer;gsinclair;1;36;22;58;0
fc5df6466792d5a00b9bce4557aae838bb6a5ab7;Fri Sep 19 06:39:07 EDT 2003;Committer;gsinclair;1;423;460;883;0
65fe176ea49b3094c8d5aa031cd8016de1c9d134;Fri Sep 19 02:48:46 EDT 2003;Committer;ntalbott;17;1448;24;1472;0
50cd24f1cf4c859b8a602f1cf44baf636b775326;Fri Sep 19 01:51:17 EDT 2003;Committer;gsinclair;1;1;1;2;0
df7c89b442a2e8853f44b47f98fda1b1c531c3a7;Thu Sep 18 16:09:02 EDT 2003;Committer;gotoyuzo;2;10;5;15;0
54fec448f53826368426ca415bc4e15df9b4b817;Thu Sep 18 13:57:53 EDT 2003;Committer;matz;2;7;1;8;0
5f1db6ea963689f4992a92ecd3d90d80df6d2e2e;Thu Sep 18 13:43:42 EDT 2003;Committer;matz;2;2;2;4;0
def3aa514abd24d4846f43d0774f370497b7aac2;Thu Sep 18 11:35:38 EDT 2003;Committer;akr;2;9;3;12;0
c40f4227f576a6433ffd1d61e1e53cad81ad1e7d;Thu Sep 18 07:58:09 EDT 2003;Committer;nahi;1;2;2;4;0
7e1c97611ac9ca75b7b0ded320c0d988f486a3e4;Thu Sep 18 06:38:13 EDT 2003;Committer;eban;1;3;3;6;0
9c219837b3b275fdd2cba39d23050ecfe1c38e97;Thu Sep 18 06:31:25 EDT 2003;Committer;nahi;6;684;0;684;0
ea2e8d3592aa35148da0c28f99d6a74855c5b585;Wed Sep 17 14:45:25 EDT 2003;Committer;matz;2;14;7;21;0
6d779ac139129329bdee76afb7500d76163badc4;Wed Sep 17 11:39:28 EDT 2003;Committer;nobu;1;1;1;2;0
d3b780b1cf6793996c36c3345cb85f0764bbfc25;Wed Sep 17 11:34:02 EDT 2003;Committer;nobu;2;16;49;65;0
577fa4c6a88fe5a503c2c91d60f03652e10905cc;Wed Sep 17 09:52:50 EDT 2003;Committer;aamine;5;463;0;463;0
ed970e251343cca6d02eab806ff129b111e69a32;Wed Sep 17 09:51:32 EDT 2003;Committer;aamine;2;5;8;13;0
45ca1d07546fb4f53dd28798c241b7b9b21aa43d;Wed Sep 17 09:40:17 EDT 2003;Committer;gotoyuzo;1;1;1;2;0
d83381e7174fece05a92dc5cefa1b4b56a04ae4d;Wed Sep 17 09:39:49 EDT 2003;Committer;eban;1;3;3;6;0
dbfd0ae0bbe86deb547d577be848fabf0ce160f1;Wed Sep 17 09:36:04 EDT 2003;Committer;aamine;3;408;0;408;0
ad143475b979f8ebbb153a93c880d2b98fb4aa9b;Wed Sep 17 09:09:31 EDT 2003;Committer;gotoyuzo;1;1;1;2;0
30103702c367c5cdaa18b6a622f3916cec6c701e;Wed Sep 17 09:05:02 EDT 2003;Committer;gotoyuzo;25;601;594;1195;0
12196ee24fce0e601106036e67526819cac07291;Tue Sep 16 17:37:34 EDT 2003;Committer;matz;3;31;13;44;0
a59f05a4559ac7634bf3c8f469af69ba18070751;Tue Sep 16 13:26:10 EDT 2003;Committer;nahi;2;20;0;20;0
2b935b504197df01849f0e034d4111025c908092;Tue Sep 16 07:50:02 EDT 2003;Committer;eban;1;3;3;6;0
57606ec408ab88b6601f41f644d445547bf68ad9;Tue Sep 16 07:50:00 EDT 2003;Committer;eban;4;10;3;13;0
ffc136a024c26d1047421f900002bce32b8c9a2d;Mon Sep 15 10:07:42 EDT 2003;Committer;nahi;4;327;177;504;0
bd96b4c8ccbfbaf68c6996d74515fd603b2aea63;Fri Sep 12 13:46:48 EDT 2003;Committer;michal;17;409;335;744;0
ecf0c48d5a8308500f2331287fe88c88d6c43b70;Fri Sep 12 03:30:45 EDT 2003;Committer;nobu;3;13;4;17;0
1a98699db611246783f24452d069514342f400a0;Fri Sep 12 03:27:25 EDT 2003;Committer;eban;1;3;3;6;0
fc8e62d0df805059eb73cf4c6dd54db0210db084;Fri Sep 12 03:16:31 EDT 2003;Committer;matz;7;55;24;79;0
20e165a04090a024db4d295d00af6ed1ac67578d;Fri Sep 12 02:29:38 EDT 2003;Committer;wew;1;799;38;837;0
960b91c629ee3ca11decc86ff4fb3a1fb1bf92f9;Thu Sep 11 22:15:58 EDT 2003;Committer;dblack;1;2;2;4;0
689389ac950adabf50a4cdbf40dd4826530bf422;Thu Sep 11 22:13:50 EDT 2003;Committer;dblack;1;5;0;5;0
e7653fa093086b86fcf9adc25d9ecfaccdf92839;Thu Sep 11 22:06:14 EDT 2003;Committer;dblack;1;18;18;36;0
fb65eed72ea35ff40ce9d89aa336a7e8c5d57850;Wed Sep 10 13:58:31 EDT 2003;Committer;gotoyuzo;2;14;0;14;0
8852a09e9e539dfff79df88b1cea23ffc75262f7;Wed Sep 10 13:45:14 EDT 2003;Committer;eban;1;3;3;6;0
3587c1c725f9ff49347a36716125ee91090efd75;Wed Sep 10 13:43:27 EDT 2003;Committer;usa;4;18;0;18;0
46b5d7308b4c92b87b6f6c59176593d081025840;Tue Sep 09 02:19:56 EDT 2003;Committer;eban;1;3;3;6;0
703848483147fd54e63e218e00efbcfe94a398ce;Tue Sep 09 01:44:16 EDT 2003;Committer;nagai;1;4;4;8;0
80edcf82a1498caa58a53668c8b311cbcf98816d;Tue Sep 09 01:39:58 EDT 2003;Committer;nobu;3;19;10;29;0
9edcc5e99af8a859b0b3f4f0f3ac9174a611d8c9;Mon Sep 08 20:19:01 EDT 2003;Committer;gotoyuzo;2;22;0;22;0
be28a6ffd8f3bc6b80fa4325091f518642f93bf9;Mon Sep 08 20:13:15 EDT 2003;Committer;gotoyuzo;1;1;1;2;0
dba351e9c27266f76cb653d59cd36a20586bdda0;Mon Sep 08 16:57:25 EDT 2003;Committer;gotoyuzo;3;12;2;14;0
56663d45fcd45daaa16303a4c3ba7026c681dceb;Mon Sep 08 13:21:16 EDT 2003;Committer;nagai;1;2;1;3;0
8951a69a16e446251b6c45a96aa1eea668d120ca;Mon Sep 08 13:16:57 EDT 2003;Committer;nagai;2;16;4;20;0
4b98d170229844cbd81f20f8da44900a852810ad;Mon Sep 08 11:02:35 EDT 2003;Committer;eban;1;1;1;2;0
22bb1debf99c168cd2248bb62f76bf6137bf1ce8;Mon Sep 08 11:00:17 EDT 2003;Committer;nobu;3;29;9;38;0
78ff3833fb67c8005a9b851037e74b3eea940aa3;Mon Sep 08 10:31:38 EDT 2003;Committer;gotoyuzo;6;316;61;377;0
7fb00c94e8dc777b5d7cd164c511b9197c012b0d;Mon Sep 08 10:28:46 EDT 2003;Committer;gotoyuzo;1;21;0;21;0
f75ecd3a224cf952406bbf3b2d1fd7fac44215c2;Mon Sep 08 10:04:45 EDT 2003;Committer;eban;1;3;3;6;0
ddae426a47653b29f5e84e84d73437259e58a4c6;Mon Sep 08 09:52:34 EDT 2003;Committer;gotoyuzo;8;33;14;47;0
865ff7fb4f11bbf1f0e139e16470727828f54e63;Sun Sep 07 07:10:44 EDT 2003;Committer;nagai;17;229;79;308;0
a7357c196559f3181e359662d92cb06d7b18e3cb;Sat Sep 06 17:27:58 EDT 2003;Committer;nahi;10;28;28;56;0
d7c5b0518a91b9e636f441c9488d749c435e2247;Sat Sep 06 16:22:35 EDT 2003;Committer;eban;1;3;3;6;0
b3a729a1073d8f3fcff9ccd8e6f23b3fbafeff65;Sat Sep 06 16:18:02 EDT 2003;Committer;matz;2;6;1;7;0
40fce3e7ee6b9c381e00197642566fdceeb82d7f;Sat Sep 06 08:56:57 EDT 2003;Committer;gotoyuzo;1;0;2;2;0
256d273e69081484b1a30a66a9be196b7d2e1ac2;Sat Sep 06 08:56:09 EDT 2003;Committer;gotoyuzo;17;102;37;139;0
dc29af2a0641f839f4a624468f73da50a614b300;Fri Sep 05 17:36:32 EDT 2003;Committer;nahi;1;7;9;16;0
8bb12bed08ea16822fe91d857ed19f4cd8346181;Fri Sep 05 16:26:34 EDT 2003;Committer;usa;1;3;3;6;0
05ea0b76e6425003f994376f999a489f82edda98;Fri Sep 05 16:25:55 EDT 2003;Committer;usa;2;18;6;24;0
b6367d64f400ee44eb2baf309924949e987d6d16;Fri Sep 05 15:36:21 EDT 2003;Committer;nobu;2;5;9;14;0
30f5a38b46f6f64f647c25edc39caf9a1613137a;Fri Sep 05 15:21:59 EDT 2003;Committer;nobu;2;8;2;10;0
44785befeabd09d5d34f33b33783c0ec54f06a1f;Fri Sep 05 15:15:43 EDT 2003;Committer;nobu;32;788;802;1590;0
01e3a55648559ba3d54cdf72d5c55f71a41e69e9;Fri Sep 05 15:00:33 EDT 2003;Committer;nobu;3;88;44;132;0
d833e3db01f8a293c36d1df14cb9d8fff600ea73;Fri Sep 05 11:34:55 EDT 2003;Committer;nahi;2;3;3;6;0
5b21dbe9568d54a89fe5b9cd6019c64606e818cd;Fri Sep 05 11:30:17 EDT 2003;Committer;nahi;1;1;0;1;0
65264eadbd3a8e1a3a96024e559a4a72d97c71e4;Fri Sep 05 11:28:27 EDT 2003;Committer;nahi;25;569;563;1132;0
d9f38cbee88fdbb06d8577496062918da39fdeab;Fri Sep 05 09:08:40 EDT 2003;Committer;gotoyuzo;6;56;1;57;0
8d4d2e43233afcb075b4663828568bd5a5f16712;Fri Sep 05 06:32:07 EDT 2003;Committer;nobu;2;7;2;9;0
c492b9b0857a76a94db586c87e3ab5a270b20746;Fri Sep 05 05:07:54 EDT 2003;Committer;matz;5;60;28;88;0
4198feb844a2fe307843d346bbde39894bd72faf;Fri Sep 05 04:32:51 EDT 2003;Committer;nobu;2;5;1;6;0
bd895e909d5591bc771bb4f8bf3c0ec3934726df;Fri Sep 05 03:12:29 EDT 2003;Committer;eban;2;17;7;24;0
742a44d579eb227627ca5b86f59341aa80de0842;Fri Sep 05 02:57:49 EDT 2003;Committer;nobu;1;2;3;5;0
594f527d76fd1d703e7f635ac8e45022c1291c2a;Fri Sep 05 02:38:33 EDT 2003;Committer;nobu;1;4;3;7;0
73e4384a23b61761cc9fa013e28b290393569d09;Fri Sep 05 02:32:24 EDT 2003;Committer;nobu;5;53;16;69;0
e45738a2976eed3ff291ec075606f64baa3198cb;Fri Sep 05 01:47:41 EDT 2003;Committer;nahi;3;49;6;55;0
af49aecff16d6969551eec0072e0713702aac18f;Fri Sep 05 00:36:47 EDT 2003;Committer;nahi;2;47;0;47;0
d43872e7dfb8446aa7bfbb6a21cdd3bc3b3d48f4;Thu Sep 04 18:00:09 EDT 2003;Committer;nobu;2;90;104;194;0
c447ac777b927c9a545514f9e80886f84b944861;Thu Sep 04 16:43:33 EDT 2003;Committer;eban;1;3;3;6;0
e5a56409cb37618cd19d05b489006118dc4ae4bb;Thu Sep 04 16:20:42 EDT 2003;Committer;nahi;1;28;1;29;0
aaf5d9c03cd41818edb34a154ac570b7fe61687c;Thu Sep 04 16:18:59 EDT 2003;Committer;nahi;30;2234;1;2235;0
822a72b8ee2752051e11b3b62fc6c5cd21c9409e;Thu Sep 04 16:06:41 EDT 2003;Committer;nahi;2;186;151;337;0
e168b64b03403fb4efbd8dcbbdaeed83710b4d39;Thu Sep 04 14:59:43 EDT 2003;Committer;nobu;2;10;1;11;0
0d1896a88fe091000ce0d9c8ef3cf7ef1e2e991b;Thu Sep 04 10:59:15 EDT 2003;Committer;nahi;2;12;12;24;0
4ebf0c8fe7a9478505ef29f681848e7b8221e0b8;Thu Sep 04 10:55:28 EDT 2003;Committer;eban;1;3;3;6;0
a6663a94e5d10789a2e091647be3dfadc1e25f80;Thu Sep 04 10:39:29 EDT 2003;Committer;nahi;3;12;0;12;0
5f84c80fc580bdd64b0f2f67a92a840965148e40;Thu Sep 04 10:31:29 EDT 2003;Committer;nahi;25;1657;1650;3307;0
11d439a7bdd714a8b3a057be8a7a6afc01249f31;Thu Sep 04 09:08:30 EDT 2003;Committer;nahi;2;77;76;153;0
0b9b7d630a55f21387b49b76bb199c0841785d24;Thu Sep 04 08:41:34 EDT 2003;Committer;nobu;2;26;18;44;0
af5a9fd8c2c8e8418661b806844968f42471d778;Thu Sep 04 06:41:00 EDT 2003;Committer;nahi;2;32;42;74;0
98abf532a4cb6c365c3218e90931a8fab30c5314;Thu Sep 04 03:50:37 EDT 2003;Committer;shigek;1;1;1;2;0
4e0868d03fedd0793dd0e4cbf146e0a686e50fa9;Wed Sep 03 18:58:27 EDT 2003;Committer;why;2;567;546;1113;0
65c26edcf767947e50e81190ae9e1d91f67f8a23;Wed Sep 03 14:00:05 EDT 2003;Committer;nahi;1;3;0;3;0
8e541dd0aea76df10876a13600a0a6302d74f377;Wed Sep 03 13:02:35 EDT 2003;Committer;eban;1;3;3;6;0
5995377228b166f8906ec07d4024474ec0f349b6;Wed Sep 03 12:45:36 EDT 2003;Committer;nahi;3;1521;0;1521;0
da24c258c351372f0f065fab975794cbad1d4f19;Wed Sep 03 10:47:44 EDT 2003;Committer;shigek;1;1;1;2;0
28e962d92cdaa1ec8651a48d09ea318ddaae8368;Tue Sep 02 11:41:33 EDT 2003;Committer;gotoyuzo;2;11;2;13;0
05bb6b505c1be3169a9c1e2bdd18c0c0ade0e9d4;Tue Sep 02 05:12:39 EDT 2003;Committer;matz;4;38;2;40;0
9388ed284d600f2225a745dfb3edb6ac1758fdb8;Tue Sep 02 05:04:30 EDT 2003;Committer;nagai;9;410;139;549;0
645d4abf426fb2ef4ae72d0d46c24607b71be3a8;Tue Sep 02 00:51:39 EDT 2003;Committer;nobu;2;10;1;11;0
37ddebafeb3a233c1847f2aa1cf2331e9c48f4ce;Mon Sep 01 16:27:47 EDT 2003;Committer;eban;1;3;3;6;0
157c60a09ff02cd89397fc480bb86dd539dd456e;Mon Sep 01 15:44:39 EDT 2003;Committer;nobu;2;17;10;27;0
26fcfd1bb5c39506f3be79b0bb9be2efce8febab;Mon Sep 01 15:41:31 EDT 2003;Committer;nobu;3;57;12;69;0
6f8f0a86f5964f36ea81b327c1f4538a9ccedbd2;Mon Sep 01 09:34:30 EDT 2003;Committer;nobu;2;7;2;9;0
b6feeb2945307a655c1a79b3ee61eafc89a7b09b;Mon Sep 01 09:02:43 EDT 2003;Committer;matz;4;11;2;13;0
531310d20e39a0b9dea424dff6fc6640f4e9ab91;Mon Sep 01 08:18:48 EDT 2003;Committer;nobu;1;4;4;8;0
d9acb91ae3afe2c96e6c1f1bc432cf88b89add33;Mon Sep 01 07:59:18 EDT 2003;Committer;nobu;2;41;18;59;0
6f8f8959b7da90d56398b033c2c8e0da6f4ade64;Sun Aug 31 13:57:38 EDT 2003;Committer;eban;2;4;2;6;0
ea1dc90ae43d1fe68752de2fddb497bbec8b4f86;Sun Aug 31 13:47:48 EDT 2003;Committer;eban;2;5;1;6;0
803a1302072e919b4d0fcd3a5fc345cdf0094e67;Sun Aug 31 13:29:54 EDT 2003;Committer;nagai;2;5;0;5;0
50ca9237b33eed8a3132833b7622f9f0fb61fc83;Sun Aug 31 13:04:25 EDT 2003;Committer;gsinclair;2;318;316;634;0
34e218f14d1af48d9d31820f7c7f1cc5e3157391;Sun Aug 31 04:50:58 EDT 2003;Committer;eban;1;3;3;6;0
7ba2529696d2adc94d4e05a1bb5528a9233da0f2;Sun Aug 31 04:50:53 EDT 2003;Committer;eban;1;1;0;1;0
89c73f237e6c99a217955407733e8657e756a155;Sun Aug 31 03:25:11 EDT 2003;Committer;nobu;3;59;4;63;0
782b6ceac38f6979dd223d2b2336cd44af82d35c;Sun Aug 31 01:26:29 EDT 2003;Committer;tadf;3;8;4;12;0
84c506745a1425f16e4c8f151ee816a1de324091;Sat Aug 30 05:26:47 EDT 2003;Committer;matz;2;7;2;9;0
8e9fbbf6d6f4c47286a6fbc4e2c4e77189be119b;Sat Aug 30 00:04:02 EDT 2003;Committer;matz;4;183;260;443;0
da84ad63ee95265dfbdd51c370cdfe5f91e58d59;Fri Aug 29 13:37:44 EDT 2003;Committer;shigek;4;74;51;125;0
8ab241075728792ed56ef7371e424bec9ee187aa;Fri Aug 29 13:34:00 EDT 2003;Committer;shigek;1;2;0;2;0
38b9eb1674afbff4517f082413ba6c7acbf8beff;Fri Aug 29 13:33:37 EDT 2003;Committer;shigek;1;9;7;16;0
1ea6c0aa9bb66b5876cb3a74f49f0cd2759ba493;Fri Aug 29 13:27:20 EDT 2003;Committer;wew;1;46;1;47;0
3a0144865a69c3f1d50ef7d762ffc3558c7586dc;Fri Aug 29 12:12:45 EDT 2003;Committer;eban;1;3;3;6;0
24ff3f444882ba60418a6736d6c5d57ba3c0b80c;Fri Aug 29 08:34:14 EDT 2003;Committer;nagai;10;1660;170;1830;0
22a5aec4b322c1be9eced78967e5cfd0ae54b6cb;Fri Aug 29 03:52:24 EDT 2003;Committer;wew;1;278;4;282;0
11f521b98e276262e140f1a40469c910267a7021;Thu Aug 28 08:35:43 EDT 2003;Committer;matz;3;24;22;46;0
b89299260ee0e70473cf43a14264f14776f8d95f;Wed Aug 27 20:04:23 EDT 2003;Committer;matz;3;9;5;14;0
22b955d9bff9f736af9e81ca5e49bad6608cb987;Wed Aug 27 19:43:50 EDT 2003;Committer;matz;6;82;49;131;0
a5729ea05a55c86142c57dbb176638c0e4f54cc6;Wed Aug 27 13:33:27 EDT 2003;Committer;nobu;2;22;13;35;0
0ec868314558e7b0583235a3fd363c767bb35ecc;Wed Aug 27 13:29:23 EDT 2003;Committer;shigek;1;6;5;11;0
e1a6b435db5427aefd13fa3ba5f30bdc814fcbe4;Wed Aug 27 06:08:14 EDT 2003;Committer;aamine;2;6;1;7;0
cff50d9f9391110d715a7ec5f0551df322c5851d;Tue Aug 26 20:18:05 EDT 2003;Committer;usa;1;3;3;6;0
92dbabb0a49b57aa8651ff7922fcbcdb0e77b5aa;Tue Aug 26 20:17:18 EDT 2003;Committer;usa;3;107;48;155;0
1cece7f80fec00f3b1d39e549d081501c48213f4;Tue Aug 26 14:54:51 EDT 2003;Committer;matz;2;8;0;8;0
4b159597af39db858f15fba6b7e49cdbf191469a;Tue Aug 26 13:22:32 EDT 2003;Committer;shigek;1;11;6;17;0
e0a51801f8b101c6acbe1af505071dd1fe34bc6c;Tue Aug 26 12:48:13 EDT 2003;Committer;shigek;1;23;25;48;0
be297cff9b4117bcd74784079cb446a3ea8427c0;Tue Aug 26 11:37:45 EDT 2003;Committer;nobu;1;3;2;5;0
7672b2605aabfd23b3401ade7938caf3f78b133c;Tue Aug 26 11:08:01 EDT 2003;Committer;eban;1;3;3;6;0
4abb1838072b418507c9174ab0378b61da2df587;Tue Aug 26 11:03:53 EDT 2003;Committer;nobu;2;62;46;108;0
822a11d47edcb410c67839c035d3010007cc07a5;Tue Aug 26 07:02:19 EDT 2003;Committer;why;3;89;79;168;0
9942c6ed13910504726ac688a205313b44ed3895;Sat Aug 23 17:06:55 EDT 2003;Committer;matz;3;11;5;16;0
8211f8f8afe664a96b8c1473037463293a48a75e;Sat Aug 23 17:02:53 EDT 2003;Committer;eban;1;3;3;6;0
b8dfb46df78af9f46debb81805e0fc70243bb9fc;Sat Aug 23 16:06:25 EDT 2003;Committer;nobu;2;7;7;14;0
33c9c0005b28c9897ef03ac595047e423221103e;Sat Aug 23 15:44:05 EDT 2003;Committer;nobu;2;18;8;26;0
3e7ba606a2b1198d3db40db359a31442fd7f6acc;Sat Aug 23 12:00:21 EDT 2003;Committer;wew;1;764;5;769;0
04ff391e0cb55453c84de0a0601cb65599cc5d68;Sat Aug 23 10:13:44 EDT 2003;Committer;nobu;1;1;1;2;0
a52968035fb606ae1455689c880bb5eca0cd5387;Sat Aug 23 09:58:56 EDT 2003;Committer;nobu;1;235;235;470;0
5f5c0a0cf45e184c66285b095053cfc766d9c712;Sat Aug 23 09:56:56 EDT 2003;Committer;nobu;2;244;237;481;0
197ce26993041e9f9a89069c0359bd1a60218201;Sat Aug 23 07:51:19 EDT 2003;Committer;keiju;2;4;1;5;0
0124af90634dd27e29206a9a05ec50beae95f7e4;Sat Aug 23 07:00:02 EDT 2003;Committer;nobu;2;55;45;100;0
fcaadb96af8f26c0af2d170399a5bf0f5ce064c3;Sat Aug 23 04:48:49 EDT 2003;Committer;nobu;1;3;3;6;0
46e1454dea07eeb4396a85f41dc5753055a17b06;Sat Aug 23 04:05:42 EDT 2003;Committer;matz;3;73;8;81;0
fc63eb3a7763d460a451af88dc34403a7977749a;Fri Aug 22 17:43:57 EDT 2003;Committer;matz;3;9;1;10;0
47773e62a68c4b4d79daaae3de31fc7d89a4af6a;Fri Aug 22 09:34:26 EDT 2003;Committer;eban;1;17;16;33;0
dc0f677ef834a73e2ca6ce521a1c92512174b94f;Fri Aug 22 08:13:36 EDT 2003;Committer;matz;1;1;1;2;0
7ff7bcbf9dbb0f22a9802a7b3474c59c9bbd0b70;Fri Aug 22 08:09:58 EDT 2003;Committer;matz;8;41;14;55;0
7cca6c25f0682053b861fa987fa5b415346d044f;Thu Aug 21 21:16:58 EDT 2003;Committer;why;5;767;719;1486;0
52e6a899ea1895363f0e61c8e1ef6295ac83fcab;Thu Aug 21 16:24:43 EDT 2003;Committer;eban;1;3;3;6;0
5eafb6e10dcc90af83bfe10045244a0fef12bdd2;Thu Aug 21 16:00:34 EDT 2003;Committer;nobu;2;11;0;11;0
39503e4d0fca75b03e78a03a55dec8f063dec224;Thu Aug 21 15:13:45 EDT 2003;Committer;shigek;2;29;31;60;0
87f143f99d836f51fab39e4f378f139ab88d817f;Thu Aug 21 13:36:31 EDT 2003;Committer;eban;1;3;3;6;0
be7c88a3e2c6f5ff0eb0706901bc81380ef1a6df;Thu Aug 21 09:56:21 EDT 2003;Committer;gsinclair;1;5;2;7;0
f3f7c40c492b791eecae4980eb817eb1aae02442;Thu Aug 21 09:07:57 EDT 2003;Committer;gsinclair;5;43;21;64;0
ed8152d68cd47d4f481c6cc6055bd5a56cfe8fd5;Wed Aug 20 08:09:08 EDT 2003;Committer;eban;1;3;3;6;0
b1f01153943b95019ecc56192527e9fb00adb240;Wed Aug 20 07:44:53 EDT 2003;Committer;nobu;2;28;5;33;0
360b0a015aba72f62ea2ffee4f52ce2b9132a2d1;Tue Aug 19 16:38:02 EDT 2003;Committer;why;5;63;49;112;0
94c2e6f18a7e3146802ebc5c08b4cbec627143f5;Tue Aug 19 14:39:47 EDT 2003;Committer;gsinclair;1;1055;724;1779;0
62acad914e81f79ebfe02727b7fa7e8e3c215a05;Tue Aug 19 14:21:13 EDT 2003;Committer;shigek;5;105;499;604;0
caf213d9ad1fd277d1cc615306d3eb662c2283af;Tue Aug 19 14:16:09 EDT 2003;Committer;shigek;1;22;3;25;0
c41b3b96ab097540bcf66a43639233ce47b8e219;Tue Aug 19 13:50:43 EDT 2003;Committer;eban;1;1;0;1;0
65652ecdb5145fae92e3c86611a4425a476da6ec;Tue Aug 19 06:00:36 EDT 2003;Committer;gotoyuzo;8;201;165;366;0
90e010abb9efeaaf706c363af31beedf65c8be3b;Tue Aug 19 02:21:04 EDT 2003;Committer;shugo;2;10;3;13;0
ba64282cdc2e02a742ae5e0159d606051f188aa5;Mon Aug 18 22:49:48 EDT 2003;Committer;gotoyuzo;7;95;38;133;0
40fc7dba9e429b59089a45020245ec61ea4d8086;Mon Aug 18 16:42:11 EDT 2003;Committer;eban;1;3;3;6;0
d45bda0bf853a18645b795e2d43c8481696bea31;Mon Aug 18 16:24:42 EDT 2003;Committer;nobu;5;34;17;51;0
857d380411b9903309eb84cae040a483043e755d;Mon Aug 18 02:26:55 EDT 2003;Committer;nobu;1;3;3;6;0
43e4a5001542c4d823334a83195600b5c2e7df26;Mon Aug 18 02:23:13 EDT 2003;Committer;nobu;2;8;3;11;0
c7b5c0489b472b92f297e7ff64a10ee03523f570;Sun Aug 17 14:40:00 EDT 2003;Committer;nobu;3;7;1;8;0
a8027639b842e8a77ce0909be9f90efbb6f081ab;Sun Aug 17 14:35:53 EDT 2003;Committer;shigek;1;20;24;44;0
39c4886fe761cf4cc4f4f137cf3602c9ee616184;Sun Aug 17 08:22:45 EDT 2003;Committer;gotoyuzo;4;28;3;31;0
7544cb39302fc5964849d43b80472c2071f28261;Sun Aug 17 07:21:03 EDT 2003;Committer;eban;1;3;3;6;0
7d7f1ef157f9b7ab4d5c661fd155e2160efd4419;Sun Aug 17 02:32:07 EDT 2003;Committer;nobu;2;9;4;13;0
25a327ae76c2ca4079ab49d1484baac72cd36c39;Sat Aug 16 15:00:18 EDT 2003;Committer;nobu;1;3;3;6;0
8695612caf8afe1138a7baaa142658dd93c70293;Sat Aug 16 14:58:34 EDT 2003;Committer;nobu;13;92;93;185;0
32df87feabb8b2b99fc47e64896b2c922dca6451;Sat Aug 16 13:36:40 EDT 2003;Committer;shigek;1;2;2;4;0
3fe728e76b5020fbe0277ffc039e79f3c2834229;Fri Aug 15 14:13:49 EDT 2003;Committer;shigek;2;46;5;51;0
6b0e6a7ce7757c42fbfbf244ce917cbb67fa6d50;Fri Aug 15 14:09:51 EDT 2003;Committer;shigek;2;42;42;84;0
625c1361e368f6f13f303de0310e6625d7b5296b;Fri Aug 15 03:01:52 EDT 2003;Committer;nobu;7;91;27;118;0
befd57c7ea203d37531798dda95eaf488ef74dee;Fri Aug 15 02:53:19 EDT 2003;Committer;eban;1;3;3;6;0
f3d25fdd9c58942d5e2d909f16b1dd8adabd21e1;Thu Aug 14 17:20:14 EDT 2003;Committer;matz;6;46;7;53;0
206efa13561648716e65fc7e87f4967cbb707571;Thu Aug 14 15:42:42 EDT 2003;Committer;shigek;1;10;1;11;0
1e97118d8faf46ae5db00d69bfe3673de5fcc120;Thu Aug 14 15:34:17 EDT 2003;Committer;shigek;1;147;0;147;0
67ea373c70104fba22bd33b4221881f21c29052d;Thu Aug 14 15:33:36 EDT 2003;Committer;shigek;1;6;36;42;0
9b1dbc0c774499c284dc55fffb15a8da3266d9a3;Thu Aug 14 15:32:17 EDT 2003;Committer;shigek;1;1;0;1;0
588c9c66bf99411d3fb41f0f68b7b6d24772f670;Thu Aug 14 15:11:44 EDT 2003;Committer;shigek;1;5;3;8;0
2f2cb647c1c91d76ec3f6739aaddce96560a63f5;Thu Aug 14 11:01:43 EDT 2003;Committer;suke;2;17;5;22;0
ed485b4dda0c53cdfd2611da6ddd819a9458877b;Thu Aug 14 02:28:46 EDT 2003;Committer;usa;1;3;3;6;0
364772613fb37a298c3976e4ffc44b8702a9cb96;Thu Aug 14 02:28:14 EDT 2003;Committer;usa;2;6;0;6;0
0b6cf4bea8d9c676a3f344e74c55756fe6f8dd40;Wed Aug 13 14:33:31 EDT 2003;Committer;shigek;5;97;70;167;0
3d7147bcea7323a6dd2dbfc0c02c442c7f2caa39;Wed Aug 13 11:41:13 EDT 2003;Committer;gotoyuzo;2;7;1;8;0
c791dc1345ad8ebe7b707e8922b42a7a43c53b89;Wed Aug 13 10:31:33 EDT 2003;Committer;matz;3;44;4;48;0
855f1ff1323e7eca763b34cc9f7b850dddaa1c0c;Wed Aug 13 07:13:51 EDT 2003;Committer;eban;1;3;3;6;0
d434a6973e099caea90df5810f0843881cd7aa19;Wed Aug 13 07:13:45 EDT 2003;Committer;eban;2;8;3;11;0
2c46069f9654db6a6c9d135634b6cfca5aac124e;Wed Aug 13 04:52:35 EDT 2003;Committer;usa;2;6;1;7;0
1efae2f585a44a0acfbde086c45acab492514554;Tue Aug 12 08:06:22 EDT 2003;Committer;nobu;1;1;1;2;0
cc4f2f8fcb6cdc7175eaa65242ebe87285c154c9;Tue Aug 12 07:55:14 EDT 2003;Committer;nobu;2;8;7;15;0
d43d26f25208ce6e54e3e0076154568e5e434c2c;Tue Aug 12 02:30:54 EDT 2003;Committer;eban;1;3;3;6;0
fd36ed94f302e79e5184bceff68f7e36d6a17e3d;Tue Aug 12 02:12:48 EDT 2003;Committer;nobu;3;28;11;39;0
8eb6b7328ecc7108fd589aa1b48e029c28392308;Mon Aug 11 22:42:08 EDT 2003;Committer;gsinclair;1;381;248;629;0
09590a73fab0000777c16e9f97dba31bb3c7126e;Mon Aug 11 18:18:40 EDT 2003;Committer;matz;2;22;2;24;0
0933db5a900d183f7236315fb87012bcc6188963;Mon Aug 11 17:58:25 EDT 2003;Committer;matz;1;1;1;2;0
466c684881ccd374232e2a1889fc761232992c2e;Mon Aug 11 17:52:24 EDT 2003;Committer;matz;3;82;4;86;0
d4506dfcedac975ac63a07a0cdce986498016397;Mon Aug 11 13:41:18 EDT 2003;Committer;nahi;2;13;6;19;0
7915b1d2f9c9ef0d60121321541f04f0a0938ad6;Mon Aug 11 08:46:10 EDT 2003;Committer;eban;1;3;3;6;0
5256bca931a809d8518c55b2d98e8169a128b37e;Mon Aug 11 08:35:54 EDT 2003;Committer;matz;2;12;3;15;0
b2385db8963cebbdebff7333e33f740594ea9dc6;Sun Aug 10 14:28:08 EDT 2003;Committer;shigek;1;2;4;6;0
923044bba260830d7c698fe4dd18f35671df966a;Sun Aug 10 01:54:05 EDT 2003;Committer;gotoyuzo;3;10;1;11;0
b325fc2d5745d71fc4079631f05ce13d6ce1e183;Sat Aug 09 15:36:27 EDT 2003;Committer;eban;1;3;3;6;0
e1a019a65aa02e9a8b19a65bc337921215ea6e52;Sat Aug 09 15:36:23 EDT 2003;Committer;eban;2;6;1;7;0
df71dae11f5884ffef23abed0e59fe88d3496fac;Sat Aug 09 15:19:17 EDT 2003;Committer;matz;2;7;2;9;0
95cd9e4bb2d97c31a52b4b0e7ac2b5d4776aaf1a;Fri Aug 08 15:38:46 EDT 2003;Committer;shigek;1;1;1;2;0
faf68391a4126ec17ba897c2a8fd76a37429996f;Fri Aug 08 15:37:21 EDT 2003;Committer;shigek;1;7;0;7;0
9cfc06d9ae74ff8680f5615740a4932526b98f2e;Fri Aug 08 15:31:53 EDT 2003;Committer;shigek;1;1;1;2;0
606c473683f53af6be614bec8fdb5c7a7d0e974d;Fri Aug 08 15:31:27 EDT 2003;Committer;shigek;4;267;108;375;0
0a0c87bb1204096c0fa28627340771fe88ca0d3b;Fri Aug 08 03:48:58 EDT 2003;Committer;eban;1;3;3;6;0
c49c51b76ec544e310f1881de087024f4def7585;Fri Aug 08 03:48:33 EDT 2003;Committer;matz;2;8;4;12;0
25358510afd53a718e3b2b810be7ee1e7cf56ea4;Fri Aug 08 03:35:46 EDT 2003;Committer;eban;2;6;1;7;0
4eb40640854aa3bbb3b1c3b1b352e397afc6bbd0;Thu Aug 07 18:24:27 EDT 2003;Committer;gotoyuzo;2;6;2;8;0
430eabfe13989b4bf8be2761cc2f9a968b5a9653;Thu Aug 07 07:11:50 EDT 2003;Committer;eban;2;10;0;10;0
6f059f33ef1eae43e2648a6a8d4c8275b97a191e;Thu Aug 07 05:43:59 EDT 2003;Committer;eban;3;33;12;45;0
755dc335a511994e3b34a4abadb4a3332705c334;Thu Aug 07 04:24:27 EDT 2003;Committer;eban;1;3;3;6;0
3d621a4c3d8ac8f1f88a4aeee708743230807316;Thu Aug 07 04:09:56 EDT 2003;Committer;matz;2;19;22;41;0
697af8e54cccfcba46ab9bbe56cd6e645f30a0b1;Wed Aug 06 21:54:46 EDT 2003;Committer;matz;2;5;1;6;0
b51416e21f7c0df7d29a7ccd7660f794b6055620;Wed Aug 06 21:50:06 EDT 2003;Committer;matz;10;161;111;272;0
1e51675654ec0a5624d78786e23851df73e14030;Wed Aug 06 19:21:24 EDT 2003;Committer;knu;2;10;0;10;0
657a5c4b969e2309ed4e0a253024ea384eeda129;Wed Aug 06 15:18:46 EDT 2003;Committer;shigek;1;1;1;2;0
3d9f4a7c771e9d388e1096c4aa19c031cbfb548e;Wed Aug 06 15:16:37 EDT 2003;Committer;shigek;1;6;44;50;0
7ba3a706f2d3ea3f99b60c34ec5f7b45c5957644;Wed Aug 06 15:15:41 EDT 2003;Committer;shigek;1;5;0;5;0
3158b75b0bf9c259ca6668cc4383de3836ad8f07;Wed Aug 06 14:03:21 EDT 2003;Committer;ntalbott;4;29;3;32;0
a7fd686ba4cd9ca635de087903744157b660c42a;Wed Aug 06 12:04:23 EDT 2003;Committer;eban;1;3;3;6;0
08a96d4380b5251f6d4570a0a419ba91af4c2576;Wed Aug 06 11:37:55 EDT 2003;Committer;gsinclair;1;302;326;628;0
fb5efbaaecc60145fe00d4b6e5240c4f542ef3ab;Wed Aug 06 08:28:52 EDT 2003;Committer;nobu;2;7;7;14;0
94d17c1f1fbacf7dffcdbbe508b37c7719ba6778;Wed Aug 06 03:11:14 EDT 2003;Committer;nobu;5;78;23;101;0
6fa004b2e87c82952f95bb90f8576f04a9e510aa;Tue Aug 05 19:58:43 EDT 2003;Committer;usa;7;21;3;24;0
5ae5596491c35e826678f88dfc38caf82523e601;Tue Aug 05 16:12:05 EDT 2003;Committer;aamine;4;88;69;157;0
e6c23c67e9ef9b7b0607d0272bf10c99bb0c46a8;Tue Aug 05 14:48:33 EDT 2003;Committer;gsinclair;1;204;135;339;0
de20b0bf59e766b1aad7ca62bdca8b2bcfb6c649;Tue Aug 05 14:03:57 EDT 2003;Committer;shigek;1;0;2;2;0
a179c38e4c5b75469703720efa45c09e6f6a40c6;Tue Aug 05 14:03:09 EDT 2003;Committer;shigek;1;3;1;4;0
717848493c02584d1a7ae379766a01860ad548ee;Tue Aug 05 13:22:20 EDT 2003;Committer;gsinclair;1;405;467;872;0
f2c49270e75313b9438bfb80bd99925dbe9ca1b2;Tue Aug 05 09:32:09 EDT 2003;Committer;shigek;1;5;8;13;0
70903de1cdd517cc5c4f679e33d0a6ae59d8063a;Tue Aug 05 09:31:36 EDT 2003;Committer;shigek;1;4;1;5;0
808aa5f3183a0ebb20e61c80260fa111b337bec9;Tue Aug 05 09:27:21 EDT 2003;Committer;matz;5;21;6;27;0
5e12815fb1cbc102258bfe4904acf7e75f4c7e54;Tue Aug 05 09:09:35 EDT 2003;Committer;eban;2;9;5;14;0
b54ac875c21cb75ac8012eb595511dde006f6bc5;Tue Aug 05 07:29:37 EDT 2003;Committer;eban;1;3;3;6;0
1ea78bb8ff454b386583856eabb3a29da48d99e5;Tue Aug 05 06:47:37 EDT 2003;Committer;nobu;2;13;0;13;0
a21b0c47c34613f72942f23e9bb2b9eaa0755d08;Tue Aug 05 04:12:00 EDT 2003;Committer;shigek;1;0;3;3;0
73b86b2f8e2ec08e8fecccd0cb4e677295e82a3b;Tue Aug 05 04:07:35 EDT 2003;Committer;shigek;1;27;38;65;0
5f7be2983b3af36a01c37ac24d55c6694b4e60b2;Tue Aug 05 03:08:16 EDT 2003;Committer;keiju;2;5;2;7;0
fb4d3c4df61f51b0cde842a5194ba82903a42d50;Tue Aug 05 02:23:07 EDT 2003;Committer;keiju;1;2;1;3;0
ef066d4dade99c513c1084cd2db92e354d46ab53;Tue Aug 05 02:14:52 EDT 2003;Committer;eban;1;1;1;2;0
480fa2f5cc1763a28b5f986085159dc007a42379;Mon Aug 04 13:47:29 EDT 2003;Committer;shigek;1;1;1;2;0
804e475b666c2f46ff4e484a2b869f44cbfa7c0b;Mon Aug 04 12:45:03 EDT 2003;Committer;matz;1;6;0;6;0
8141083006da043e6ea614e56514dd9c7d7e87ad;Mon Aug 04 12:39:19 EDT 2003;Committer;nobu;1;1;0;1;0
816803095da12023293cbd2793e22de52a751849;Mon Aug 04 08:31:24 EDT 2003;Committer;matz;4;24149;24053;48202;0
4aaa5493f94965fb3bbf85628f59310ff1a7a8d4;Mon Aug 04 05:28:50 EDT 2003;Committer;matz;5;16;8;24;0
dd9b0df999306d9f4106eb9aaad744b42a9cddc8;Mon Aug 04 03:28:33 EDT 2003;Committer;eban;1;3;3;6;0
acf543e5a6ba639f554d4d4487b1e1dcda687e35;Mon Aug 04 01:56:17 EDT 2003;Committer;matz;2;7;0;7;0
a9a7ee4be858aabc23b25ea3ff61a18286bdc900;Mon Aug 04 01:27:25 EDT 2003;Committer;nobu;2;8;5;13;0
594eb2e0fe69956a2945a5cd85b6ee4fcc8117a0;Mon Aug 04 01:02:16 EDT 2003;Committer;shugo;2;38;17;55;0
79c0605534b0db23ec715ebfa30f8645e46b9fcb;Mon Aug 04 00:46:06 EDT 2003;Committer;shugo;1;871;812;1683;0
efd9ddc8a9bda406e5e544c68d8d7a41f6d47697;Mon Aug 04 00:24:03 EDT 2003;Committer;shugo;1;4;0;4;0
a09c02a600e06aa4f90bc4cb5ccd5f5f1a56a97a;Sun Aug 03 22:07:47 EDT 2003;Committer;nagai;3;45;25;70;0
381ff055059337befcdf33ef8590ac2c065cb9cc;Sun Aug 03 17:48:51 EDT 2003;Committer;usa;2;21;15;36;0
096f7a4c89c9f42872e96268995beed4b64af516;Sun Aug 03 14:56:54 EDT 2003;Committer;nobu;2;6;1;7;0
d170fe2cd0380f3e59adf25bd99ac1e560c544be;Sun Aug 03 12:11:14 EDT 2003;Committer;dblack;1;4;0;4;0
ebe22aafa2d04921d5ee914be3e8ca607df0f12f;Sun Aug 03 10:53:09 EDT 2003;Committer;nagai;1;1;1;2;0
685082d06f160d51b2b27c0bdbb40ff8be57122b;Sun Aug 03 10:25:32 EDT 2003;Committer;nobu;2;13;10;23;0
d6653222e9b78bb07279577da58cb72b908eb79f;Sun Aug 03 09:32:23 EDT 2003;Committer;eban;2;46;13;59;0
6c526497b60108d800dc35eff96e38b7ae03829f;Sun Aug 03 09:22:50 EDT 2003;Committer;eban;2;7;6;13;0
2dd7a6ab7e1f7b48f92f488448c5d1e02114904a;Sun Aug 03 09:18:22 EDT 2003;Committer;nagai;2;16;0;16;0
d34dbd11183932edff06e20a9ec21c0ce450a52f;Sun Aug 03 08:53:06 EDT 2003;Committer;nagai;2;4;4;8;0
25cd84e00cba7c64240561eb3b019cf451ed6f71;Sun Aug 03 08:17:41 EDT 2003;Committer;nagai;5;253;4;257;0
8ef6ee0d1b532d45392ef195f78a61f4c34933f0;Sun Aug 03 06:38:55 EDT 2003;Committer;eban;1;3;3;6;0
6c288fe84a865a20c7bc9ba5eea4d65ab38b4358;Sun Aug 03 06:00:54 EDT 2003;Committer;nagai;1;0;12;12;0
c1c4b6b501388ab8e556b6ced4a4822bdbb70249;Sun Aug 03 02:55:52 EDT 2003;Committer;nagai;1;1;1;2;0
a144ffe53f0293bc087a741484489aa426ab7989;Sun Aug 03 02:34:02 EDT 2003;Committer;nagai;1;2;4;6;0
f820839f17c05b9e67388db44fa98c9e4cde3a17;Sat Aug 02 21:39:23 EDT 2003;Committer;nagai;16;1509;35;1544;0
2c225e77e0521f91477b0f470df0a788a199d3c1;Sat Aug 02 18:05:02 EDT 2003;Committer;matz;5;260;221;481;0
086830cbac0972291297fa4a094919ebeace8659;Sat Aug 02 12:01:48 EDT 2003;Committer;gotoyuzo;2;7;2;9;0
ce3fb6ceea1f3e0ee2d7fea4bae3369bf43b860e;Sat Aug 02 10:12:22 EDT 2003;Committer;aamine;2;6;1;7;0
6277a66deb30559a8ea991175c274e0fd899e48e;Sat Aug 02 09:58:13 EDT 2003;Committer;nagai;12;650;6;656;0
08719ea2380b179ef98a10cd5e871be7a44fff43;Sat Aug 02 06:45:57 EDT 2003;Committer;matz;2;9;0;9;0
1038c25a097516cdcfcda408945848c982497325;Sat Aug 02 06:14:53 EDT 2003;Committer;eban;2;4;11;15;0
63f5a7164bd906beebef677004dbd0722d0462cc;Sat Aug 02 05:54:00 EDT 2003;Committer;nobu;3;28;8;36;0
306b93466aa0ed0b65971de663058eb9e6d937c4;Sat Aug 02 05:50:11 EDT 2003;Committer;eban;1;3;3;6;0
4c3328f5476f54c84b1f048eed075e6edf5e5b1d;Sat Aug 02 05:04:30 EDT 2003;Committer;nagai;33;297;134;431;0
d7bdf5df56f337d8ca1152598ff138703896c54b;Sat Aug 02 05:02:43 EDT 2003;Committer;nobu;2;20;20;40;0
9b5701bc6ff9935c4bdc4961d2de8eb516f40f8c;Sat Aug 02 04:21:10 EDT 2003;Committer;eban;1;13;0;13;0
a138367a973b53672d6f46fd4ee25f6749ade1ec;Sat Aug 02 00:29:03 EDT 2003;Committer;nobu;1;10;10;20;0
2e9ba7e77ba49410e62c8e93ef3eafdc1cdb795b;Fri Aug 01 20:19:40 EDT 2003;Committer;matz;1;2;2;4;0
cdacb127fc82920afed967222716d6775273432a;Fri Aug 01 20:16:53 EDT 2003;Committer;matz;6;404;288;692;0
baf02b9a6330acff09c80f27cfc2e7b8536f5f68;Fri Aug 01 18:51:10 EDT 2003;Committer;nagai;1;4;4;8;0
c1c349edb616be517867cf870ffde23cb19a3bc4;Fri Aug 01 18:23:35 EDT 2003;Committer;why;2;6;1;7;0
20f4a2f322f3f2a7a05d9225cdbb8e63eaf006fd;Fri Aug 01 15:42:35 EDT 2003;Committer;aamine;1;4;0;4;0
b1139297c36fd376e6fdba2a57f8723306abfd20;Fri Aug 01 15:41:41 EDT 2003;Committer;aamine;1;174;118;292;0
dd15b0555b5765555d83a6a7e842cdd782b6ffdb;Fri Aug 01 14:57:48 EDT 2003;Committer;nobu;2;15;11;26;0
5abe0a9b6955a9a9e86638f5c6a732fd23a3bf1a;Fri Aug 01 14:35:51 EDT 2003;Committer;seki;2;6;0;6;0
a2ef7ef62c7708716f1d112c791024ed76a2d844;Fri Aug 01 14:01:14 EDT 2003;Committer;aamine;2;571;591;1162;0
cf92c461052e0c6d0c4f1fe277cdb0550a2c85d0;Fri Aug 01 11:06:51 EDT 2003;Committer;matz;1;2;2;4;0
b27aa02015e479a1ed3138e3ab7d1524e83ed6ec;Fri Aug 01 11:01:04 EDT 2003;Committer;matz;1;1;1;2;0
070fcde39dcdca522658950247ab465010db60c9;Fri Aug 01 10:57:32 EDT 2003;Committer;matz;3;35;7;42;0
a222ce3000ec27229e9041cc953e04f28e43f950;Fri Aug 01 08:20:20 EDT 2003;Committer;nobu;1;1;1;2;0
2c2e81ff98313387480f2d9f29949dc65fcf87b5;Fri Aug 01 08:13:29 EDT 2003;Committer;nobu;2;11;3;14;0
f95261c6b327906b00df8364486ea52f7f140fd1;Fri Aug 01 07:25:17 EDT 2003;Committer;usa;1;1;0;1;0
e36f44caa8d63e5643924e2f7f242174b4484fa9;Fri Aug 01 07:23:00 EDT 2003;Committer;nobu;2;14;6;20;0
7162db6632fa895b1cf7f2e87b2b4259d8f6afe8;Fri Aug 01 07:02:54 EDT 2003;Committer;nobu;3;9;1;10;0
f3999874e4772bdd8fe6fc8eaa4a3513265ceb92;Fri Aug 01 06:54:28 EDT 2003;Committer;usa;2;5;1;6;0
c07f1bf06e9d17d0e9804f4e0ae2969cfb7e40d1;Fri Aug 01 04:58:55 EDT 2003;Committer;nagai;2;19;0;19;0
5d8f3617e0528ca169c7c6bf32833c9cc9afbe5a;Fri Aug 01 04:48:32 EDT 2003;Committer;shigek;4;87;74;161;0
fd5bdcd21cf4b691a5c9965618323610d83f50da;Fri Aug 01 04:45:19 EDT 2003;Committer;nobu;2;6;1;7;0
c49c8a942e632d8ead1f70cc49f6fb4783bb28ca;Fri Aug 01 03:53:38 EDT 2003;Committer;nagai;1;3;2;5;0
aa9ffb6c8066649edb0b367657c5334f0d106427;Fri Aug 01 03:12:39 EDT 2003;Committer;matz;1;1;1;2;0
601354bd6b661950663746bc41fe364b67bb8cd5;Fri Aug 01 02:52:21 EDT 2003;Committer;matz;6;61;34;95;0
81f52e532b8923f2544d129f90ccb1514f1615e0;Fri Aug 01 02:43:42 EDT 2003;Committer;eban;1;1;1;2;0
df6dd46b1868f7d86f416cbfe1360ab3073b67ab;Fri Aug 01 02:24:06 EDT 2003;Committer;eban;1;4;4;8;0
66e0051193779a4918ca34cf15575f6316a7507c;Fri Aug 01 01:23:15 EDT 2003;Committer;nobu;1;139;0;139;0
bc8b42fc1eb3f1adf9d170dc353a33f53bdab92f;Thu Jul 31 23:04:45 EDT 2003;Committer;nagai;5;72;12;84;0
75362fbd47cedf4b4906a361a6c54bc4ad8ea5ec;Thu Jul 31 20:52:40 EDT 2003;Committer;nagai;141;19495;25;19520;0
0cdf0d99c1e5164c53676a39265ff99120c8a026;Thu Jul 31 16:45:07 EDT 2003;Committer;matz;1;1;1;2;0
23bcab8d6320b193a385125ad5a91efcf42f8d1d;Thu Jul 31 16:34:07 EDT 2003;Committer;matz;4;18;4;22;0
6b43c9bfbfea4d1fd6c82f1503510beadc0ff4ed;Thu Jul 31 14:49:19 EDT 2003;Committer;seki;2;13;9;22;0
fabe115f9bb0e22afc7157483237295512581dcf;Thu Jul 31 14:03:34 EDT 2003;Committer;usa;2;8;1;9;0
5b9afca5e435f37c7affce56e81e6bc20a5d8b3c;Thu Jul 31 08:42:44 EDT 2003;Committer;matz;7;91;83;174;0
7126624b4effe49919e35224054cc48e86716f39;Thu Jul 31 07:59:18 EDT 2003;Committer;nagai;4;117;24;141;0
89769459ba6ab5987ac257f35e2559726437e35b;Thu Jul 31 07:57:52 EDT 2003;Committer;nobu;1;4;4;8;0
2047c47d638b8fb5c1d756a202962ea872153997;Thu Jul 31 06:30:35 EDT 2003;Committer;usa;2;9;4;13;0
00dfd7d7cc1f5ead0bbd8e239eaffa555c8c6686;Thu Jul 31 05:22:06 EDT 2003;Committer;gotoyuzo;2;31;26;57;0
f8817c7262afd77028e7cb704e440b67a1104cb7;Thu Jul 31 03:42:17 EDT 2003;Committer;seki;3;155;17;172;0
1358ec597ba04489834c8265b554aede2ebd6c76;Wed Jul 30 15:28:20 EDT 2003;Committer;shugo;2;37;26;63;0
59b2d551e89d56df06933a428c35cf0b03b264a4;Wed Jul 30 13:35:23 EDT 2003;Committer;nobu;2;31;11;42;0
f3e173c18e51e6d544d451bf9baa97f826c56b39;Wed Jul 30 09:10:38 EDT 2003;Committer;matz;1;92;12;104;0
32fcbb5b6bd5e35e3ea4b78bece5d7a942b3289d;Wed Jul 30 08:59:47 EDT 2003;Committer;eban;1;103;21;124;0
d468497778d85703900bc8a91e8a0c85350ec6c1;Wed Jul 30 07:24:11 EDT 2003;Committer;matz;2;6;1;7;0
8b97353bf26e29070ff53464278d4733ca47beb1;Wed Jul 30 07:23:14 EDT 2003;Committer;nagai;1;12;6;18;0
4e0bb56f210c245e5208ae4ca12e8597b1ff64af;Wed Jul 30 07:15:00 EDT 2003;Committer;nagai;6;33;6;39;0
029e9449ce7fa4710eac7a66e605afb3dc8a99ce;Wed Jul 30 07:08:56 EDT 2003;Committer;matz;3;10;3;13;0
c9b177327d20863d67120eb884d2ac56d0a1dbd2;Wed Jul 30 06:58:43 EDT 2003;Committer;gotoyuzo;2;10;0;10;0
d197683232bb603a09f0ec9643515ea7006da6e4;Wed Jul 30 06:39:06 EDT 2003;Committer;nobu;1;1;1;2;0
3404b920d6447f42efd18df034142459027ce83d;Wed Jul 30 06:10:09 EDT 2003;Committer;nobu;4;63;66;129;0
b873f41c1e577168b6322bd96f38b077b44d5314;Wed Jul 30 04:36:29 EDT 2003;Committer;nagai;4;32;13;45;0
2555db608ec305fdd478c48b6e689715e711b037;Wed Jul 30 02:15:13 EDT 2003;Committer;eban;1;1;1;2;0
e155879b4602b7cf1cdd4b780dc5576f31c27c64;Wed Jul 30 01:56:45 EDT 2003;Committer;shugo;2;8;3;11;0
5172e595c90357ff0d66dbda52e58baeaa394336;Wed Jul 30 01:31:43 EDT 2003;Committer;nobu;3;24;1;25;0
252df14e6befc846d6c7b3b444fc956267440f4d;Wed Jul 30 00:50:29 EDT 2003;Committer;usa;1;3;3;6;0
db8874aa1b41ddcebdf79b8ad1ef736028ef45e3;Wed Jul 30 00:32:03 EDT 2003;Committer;nobu;5;52;15;67;0
fe13785cc699692cefbdf94908fcaa7c99672f0f;Tue Jul 29 18:26:55 EDT 2003;Committer;matz;9;130;36;166;0
7d1de7464b31bdd5b4e61897ef9b37e3e8d5389a;Tue Jul 29 16:20:36 EDT 2003;Committer;nagai;2;10;1;11;0
12d3662b3921970127c7beaaf182d45a26a7006e;Tue Jul 29 15:45:51 EDT 2003;Committer;nagai;1;1;1;2;0
a3dbb3c822702067bbf3b8a8d72e179c362db0d6;Tue Jul 29 15:39:59 EDT 2003;Committer;nagai;4;90;56;146;0
38ac53f0c1f1deb37ef7d544cd43f423bfaaafdb;Tue Jul 29 14:35:42 EDT 2003;Committer;seki;1;14;6;20;0
e078a75b73284f265092bb8e66871a87ce47a249;Tue Jul 29 14:27:26 EDT 2003;Committer;gsinclair;1;1;1;2;0
f1d9d32a678cac7ce3b2fea71780312c8391c753;Tue Jul 29 13:29:53 EDT 2003;Committer;aamine;2;9;3;12;0
42f3ae0286dde31fa217a95f11d3264ef4fba60f;Tue Jul 29 10:44:27 EDT 2003;Committer;nobu;1;0;1;1;0
1a291e4544ff6a9e1928588c9c2daf50b7ba6bf5;Tue Jul 29 10:38:30 EDT 2003;Committer;eban;2;4;2;6;0
de9a5238c3d08c92c6c191ef11b63645da5059fa;Tue Jul 29 10:31:21 EDT 2003;Committer;eban;2;3;0;3;0
3fbbec0c39f5a166e3bd5016c6dfaf30c26bb498;Tue Jul 29 10:24:28 EDT 2003;Committer;eban;5;123;14;137;0
23301726b08691c0f2706ad9d340da62a0902cc6;Tue Jul 29 09:48:30 EDT 2003;Committer;aamine;3;10;4;14;0
28cbfaba2b6e1a385f3e7331a0a223e8ecda2071;Tue Jul 29 08:28:54 EDT 2003;Committer;usa;2;5;1;6;0
7544bfc130b6d75fd77defff3f47fd06e2ebf9bd;Tue Jul 29 08:05:30 EDT 2003;Committer;nagai;6;25;15;40;0
37b2487c7097aa72775f0f3f17f058cfc820dabd;Tue Jul 29 07:52:55 EDT 2003;Committer;matz;7;30;10;40;0
847bac1daf8d1ea2209c5dfb589e88e6db34c57b;Tue Jul 29 07:08:18 EDT 2003;Committer;eban;1;4;4;8;0
706536ff0f0ea0ec21ea9507523f83aca78918bd;Tue Jul 29 07:08:04 EDT 2003;Committer;eban;2;19;11;30;0
49ad283b972b7e18436bd56465130b5d90fcedb6;Tue Jul 29 03:27:01 EDT 2003;Committer;why;4;107;96;203;0
49c85058af832dce0ea0cbc389945f45459bb43c;Tue Jul 29 03:17:13 EDT 2003;Committer;usa;3;66;62;128;0
b221254f6f2ad3dcf29ec416a9d8ef3647fa2b3a;Tue Jul 29 01:45:33 EDT 2003;Committer;nagai;1;5;4;9;0
df3301293599e54747ad99d5f85f8bae4059bc22;Tue Jul 29 01:24:32 EDT 2003;Committer;nagai;3;89;36;125;0
0a75581a37b360542d05fc6560c8a9567b642955;Mon Jul 28 19:27:42 EDT 2003;Committer;why;10;225;132;357;0
ea837fc6feab1b2f1b5400b79b87879aa160f42b;Mon Jul 28 19:06:31 EDT 2003;Committer;gotoyuzo;2;15;1;16;0
e156194ce6ebdef607657d07ec8795acdbd4a52d;Mon Jul 28 14:32:00 EDT 2003;Committer;nobu;1;0;1;1;0
c7ea47eef137f9d7aa4e6b98744ac220d09d3e37;Mon Jul 28 14:31:01 EDT 2003;Committer;nobu;1;0;32;32;0
0d95887b867eb8f32a1b255ee571bf80ea89a9e8;Mon Jul 28 14:29:35 EDT 2003;Committer;nobu;1;1;1;2;0
a644c35a99c043a7870bc3c550940052976ece56;Mon Jul 28 14:23:12 EDT 2003;Committer;nobu;2;6;1;7;0
ce356b524e0339568ff06f826877a586110fa175;Mon Jul 28 13:47:19 EDT 2003;Committer;shigek;1;4;1;5;0
906ab8e25d2e074f3dfd5c49570a674f13a19a42;Mon Jul 28 09:55:12 EDT 2003;Committer;eban;2;8;1;9;0
dea1baa169ca752a5bde28c88d96feb622a0787b;Mon Jul 28 07:31:52 EDT 2003;Committer;matz;7;196;91;287;0
4158a73ee47321de856b8bce5668b07a824d3374;Mon Jul 28 06:10:13 EDT 2003;Committer;nagai;2;318;14;332;0
ad50cacf19cac418accfde8f4978b8a63aef4735;Mon Jul 28 02:57:55 EDT 2003;Committer;eban;1;3;3;6;0
4cbf09d1fe858f39bd091a6cbe59dcc56ce463aa;Mon Jul 28 02:56:43 EDT 2003;Committer;shigek;4;86;71;157;0
b388591ab76c81eb2c7b4a5d66a840235f1365df;Sun Jul 27 19:35:06 EDT 2003;Committer;nagai;10;1142;144;1286;0
e4ffaf6ea862785cef27ec5bd1083d2622ff0121;Sun Jul 27 18:10:54 EDT 2003;Committer;knu;2;5;0;5;0
dbe85f1ef0c7a13da7c6abfbd9535d42dfb3ba0e;Sun Jul 27 17:20:29 EDT 2003;Committer;matz;4;28;14;42;0
baf3f1cbacd9846610643e5a6872774d0430f24c;Sun Jul 27 12:55:35 EDT 2003;Committer;eban;2;8;1;9;0
93f8a40494566bf1f01130becc343f03280c8712;Sun Jul 27 12:20:21 EDT 2003;Committer;eban;1;1;1;2;0
39bc97b078fd819a41f4c026e3cb131fe54b25e1;Sun Jul 27 12:19:18 EDT 2003;Committer;eban;2;20;10;30;0
f5b3d426c86ae0513d608ccafcfe4168d683000d;Sun Jul 27 05:49:03 EDT 2003;Committer;nahi;2;35;27;62;0
8d64baf2a81ce014f8c37f5a6881af48c9098f4c;Sun Jul 27 01:25:58 EDT 2003;Committer;seki;2;12;0;12;0
e1dcc80d4cb4bd1b2e8782104fa99fb527994556;Sat Jul 26 18:14:36 EDT 2003;Committer;nobu;1;3;3;6;0
f01fe1351eb46d1c13010aef245405b890efd191;Sat Jul 26 18:10:47 EDT 2003;Committer;nobu;2;34;24;58;0
2dfe646bae7d76ca1a234daf4b168499d07853bf;Sat Jul 26 15:38:58 EDT 2003;Committer;eban;2;6;1;7;0
f0b77b0cdefb95e843e4bc40ed3079fa6167c808;Sat Jul 26 15:03:16 EDT 2003;Committer;matz;5;123;87;210;0
472efdfeb41af1b2b5376af3f5a5e870f02b7374;Sat Jul 26 13:04:57 EDT 2003;Committer;shigek;2;71;57;128;0
92aee059e87f97b8ea0a56a85196109005702ffe;Sat Jul 26 12:53:09 EDT 2003;Committer;gsinclair;1;3;1;4;0
b4312303967924bda5e280e189dbbcf3538ec1dd;Sat Jul 26 12:27:04 EDT 2003;Committer;usa;4;13;17;30;0
c83e7dfab210b2be7fa5f18621d0d1c6de54fc48;Sat Jul 26 10:11:05 EDT 2003;Committer;eban;1;3;3;6;0
56408f7abcc35f0c999f8e03fc9014825d2ecb6a;Sat Jul 26 05:27:42 EDT 2003;Committer;matz;1;4;0;4;0
7a1482c3ee639eb102661b9cb34f53d6f1209407;Sat Jul 26 05:14:17 EDT 2003;Committer;nobu;2;7;0;7;0
34ca2ab05891c41e28deecde6a8548127f286525;Sat Jul 26 02:26:08 EDT 2003;Committer;matz;8;18;38;56;0
eb51666a192204ea1689154404d03a03dc5a64de;Fri Jul 25 22:06:15 EDT 2003;Committer;seki;1;4;0;4;0
74709388228b2a00bbdaf39c82ec4d7b90fc0898;Fri Jul 25 22:03:52 EDT 2003;Committer;seki;1;21;11;32;0
0a39c5748964df1bc9d742d25a97965d09cd0601;Fri Jul 25 20:40:57 EDT 2003;Committer;gotoyuzo;3;11;3;14;0
d89358aba3e24fccd8215a8bbd101249e4ae5f8b;Fri Jul 25 19:16:19 EDT 2003;Committer;gotoyuzo;2;6;1;7;0
cc66b1fae449cd360ab33fbbe8b598510e3fec26;Fri Jul 25 16:43:03 EDT 2003;Committer;nagai;4;186;36;222;0
2b15bd05d3ec35390b07e1305a118040a4c320b3;Fri Jul 25 16:40:26 EDT 2003;Committer;usa;2;13;2;15;0
ec75bfe3646c00f20cab7c9c154318609b3cf41d;Fri Jul 25 15:19:51 EDT 2003;Committer;nahi;1;4;0;4;0
ccdc8d302adfe78d0f49c4a50755bc320b39f821;Fri Jul 25 15:12:26 EDT 2003;Committer;nahi;5;1232;5;1237;0
b35031495aa90afed7f82c55d36ceb6382e9e62a;Fri Jul 25 06:50:55 EDT 2003;Committer;gotoyuzo;4;37;2;39;0
e4bbe657dc9f11157c6b12afbea23b90ac153dab;Fri Jul 25 06:10:39 EDT 2003;Committer;eban;1;3;3;6;0
1edc2ccc44a6d0ecc09a2de21e0a61f98a034c9f;Fri Jul 25 05:38:13 EDT 2003;Committer;matz;1;0;1;1;0
85911c410a6b367ba3555f5e86c8e33db37344af;Fri Jul 25 05:36:55 EDT 2003;Committer;matz;14;55;48;103;0
43601a1d171333cccea5d656e0f18b77cb1ff987;Fri Jul 25 04:38:42 EDT 2003;Committer;nobu;2;26;16;42;0
651f324a278e133a1cb809ec8ba9b0ff9e69d1d9;Fri Jul 25 02:27:33 EDT 2003;Committer;shigek;2;5;6;11;0
aafd6b025cdd52c3ef97796a6dc2bda02011f670;Fri Jul 25 02:26:56 EDT 2003;Committer;shigek;4;224;266;490;0
cb5798876e0ed4b6aa2b29f30dae22dee6fbe6d6;Thu Jul 24 18:56:09 EDT 2003;Committer;why;2;6;2;8;0
5dd2b7102c42cd31a0fec424addbdeaeefb235ac;Thu Jul 24 18:33:50 EDT 2003;Committer;matz;17;15;59;74;0
c9aad4c098193cad0440228595c85aadc44bebe5;Thu Jul 24 17:58:56 EDT 2003;Committer;gotoyuzo;2;25;20;45;0
4d859f926a2bacd21f06630ff185da3d09a1a314;Thu Jul 24 16:30:43 EDT 2003;Committer;why;5;248;117;365;0
c37d8b287e63815e09c82f4fb9bc63dca6193489;Thu Jul 24 07:50:36 EDT 2003;Committer;matz;1;3;10;13;0
1a890d82c387d2902c22c9a5b86007281cfe86d2;Thu Jul 24 07:41:36 EDT 2003;Committer;nobu;3;96;1;97;0
71c9abdd06bd07a6f8658a6f256b72afc813be2c;Thu Jul 24 07:21:44 EDT 2003;Committer;nobu;1;7;2;9;0
789612882294ffc91de0acb3621e9ddbcfba8822;Thu Jul 24 07:05:28 EDT 2003;Committer;nobu;4;21;4;25;0
c1008ab51b5a01f541136a5920f665a7edd10205;Thu Jul 24 06:56:02 EDT 2003;Committer;gotoyuzo;3;19;15;34;0
e02b469de182c1d87ead38fa82630eaaee75c379;Thu Jul 24 05:18:47 EDT 2003;Committer;matz;8;88;26;114;0
169300a4f8f6c704d9ef1dbed0b73f2dd7efdb68;Thu Jul 24 04:12:57 EDT 2003;Committer;akr;1;1;0;1;0
326569b7dffb805838768d985b6a2c78dfa046c1;Thu Jul 24 04:10:35 EDT 2003;Committer;akr;2;527;0;527;0
85aa73835eb427a4131a0bbb6249865a9bd003ca;Thu Jul 24 02:22:32 EDT 2003;Committer;nobu;2;9;20;29;0
4f0f5abf348c78148857f28291d3ca24657690fd;Thu Jul 24 02:10:09 EDT 2003;Committer;eban;1;3;3;6;0
3150436c85677732b2b48e33f939565074f550c8;Thu Jul 24 02:10:04 EDT 2003;Committer;eban;2;6;0;6;0
8861263bcb8db9b200e9b840b23534804a1de1e4;Thu Jul 24 01:05:36 EDT 2003;Committer;usa;1;2;1;3;0
7871b3b32a8b666931af9d0500f22306f6e5c4c9;Thu Jul 24 01:03:28 EDT 2003;Committer;usa;4;424;41;465;0
f00c14ca25cd2298ccd9eb3765a4559b4306582c;Wed Jul 23 19:08:35 EDT 2003;Committer;gotoyuzo;3;17;3;20;0
3f71dcc79bfec202cdc144c35e275d6895005c5e;Wed Jul 23 18:48:07 EDT 2003;Committer;michal;2;4;14;18;0
85f1f858684d6b571040b6e0fe51ca2d45ec4fb5;Wed Jul 23 18:44:29 EDT 2003;Committer;usa;2;6;0;6;0
30b4904fd755c671bbebdb510aaa37a9d0eb7044;Wed Jul 23 16:52:43 EDT 2003;Committer;gotoyuzo;2;39;0;39;0
01eba908adcd150a7b816af0dbe167c4c4912a90;Wed Jul 23 16:51:36 EDT 2003;Committer;gotoyuzo;33;3881;0;3881;0
02f036ddbcb3409092e397b2df247bd9447e8b3f;Wed Jul 23 16:37:35 EDT 2003;Committer;eban;5;36;15;51;0
231247c010acba191b78ed2d1310c935e63ad919;Wed Jul 23 16:12:24 EDT 2003;Committer;gotoyuzo;63;12561;0;12561;0
fd46a1da0a41b7939424bc5a393027be7940908e;Wed Jul 23 16:07:35 EDT 2003;Committer;nagai;17;612;449;1061;0
528b6c3f6470cc24d6d5d39f0b573c76a74cc5c9;Wed Jul 23 14:09:52 EDT 2003;Committer;eban;2;8;4;12;0
e96641be8e30f63d62944e76c2d6e4f078865dd7;Wed Jul 23 09:47:16 EDT 2003;Committer;seki;2;173;131;304;0
eb5a52e0706c7321eaf04f1c3240618532db8ca3;Wed Jul 23 09:26:53 EDT 2003;Committer;nobu;5;165;0;165;0
2436525ed8cd7b95a3a98173afd23804fedf6676;Wed Jul 23 06:48:52 EDT 2003;Committer;matz;3;11;6;17;0
cabf75ae6aaf9daa87442cce10a993cf70c3cf7f;Wed Jul 23 05:19:22 EDT 2003;Committer;nobu;2;11;6;17;0
28f3cb3fd86c329666cdd86cbdf8b7d0d01ab9aa;Wed Jul 23 04:48:56 EDT 2003;Committer;shigek;3;15;8;23;0
f802b755759ed2ef9403a173a10bccfe4854df29;Wed Jul 23 02:50:37 EDT 2003;Committer;eban;1;3;3;6;0
3e8d70c95c7fd294e2c3c06f0f7b4de7312611c0;Wed Jul 23 02:39:46 EDT 2003;Committer;nagai;2;788;9;797;0
0770898bb915924fb9963e96a44bb4200b4f100d;Wed Jul 23 01:11:20 EDT 2003;Committer;nobu;2;73;34;107;0
66910f17b7a7c458eac88fbb1086191886caf459;Tue Jul 22 14:04:23 EDT 2003;Committer;shigek;2;78;55;133;0
0d1df1cd7dde2396d1b81379b47e65e98b1b60f2;Tue Jul 22 08:42:47 EDT 2003;Committer;matz;7;89;50;139;0
27daa53c544d2654a8fe05fad95df6bce18cdf7a;Tue Jul 22 08:17:46 EDT 2003;Committer;eban;2;7;0;7;0
8f81d082affc872be901a1db8c48e494d4658bf5;Tue Jul 22 01:53:58 EDT 2003;Committer;usa;2;6;2;8;0
c26663f24b0c26906b62d70ae113fbc45efe29f8;Mon Jul 21 18:48:58 EDT 2003;Committer;matz;3;7;5;12;0
fa284f8127be2cccb3775309fd5747d79f55ca3d;Mon Jul 21 18:37:07 EDT 2003;Committer;matz;3;9;2;11;0
ced623cd8a69a650e6cd846788887b62906016d7;Mon Jul 21 16:51:59 EDT 2003;Committer;eban;1;3;3;6;0
9ca1f80192b841b4ce1f1aefec5533d068a43996;Mon Jul 21 16:29:32 EDT 2003;Committer;eban;1;1;0;1;0
24162714051692617fe25fda7e88c58e25013c97;Mon Jul 21 15:34:18 EDT 2003;Committer;matz;6;45;8;53;0
15c3df744f228f3d967ca624533d17f491555e93;Mon Jul 21 14:49:25 EDT 2003;Committer;shigek;3;28;17;45;0
e4de8e756634e95ff3cdbd7563153bc8270fca2e;Sun Jul 20 17:17:52 EDT 2003;Committer;matz;5;84;41;125;0
6a867d33b5aa4ed67800cd64fe19d2902250bd96;Sun Jul 20 02:06:15 EDT 2003;Committer;katsu;2;6;1;7;0
fe4de8b4b8a614e6fdd04766a45b996346d9e028;Sat Jul 19 17:26:04 EDT 2003;Committer;matz;3;24;1;25;0
3f39e3e2a0e3d0fdbf71c7de12348f243b4fbb98;Sat Jul 19 14:12:35 EDT 2003;Committer;eban;1;1;0;1;0
e3556affad811976cfe2b24e69368b683d2f27c3;Sat Jul 19 12:34:45 EDT 2003;Committer;dblack;1;697;0;697;0
d675dbc2798ba922adb3afdffc6d8a2d9d6e5139;Sat Jul 19 10:05:54 EDT 2003;Committer;matz;15;3370;2;3372;0
c7d2ebd71ee024db66c1630fed24d83fead4ac35;Sat Jul 19 10:02:57 EDT 2003;Committer;uema2;2;22;0;22;0
6d696136d53d8cce2e2b931abdc3dae248894954;Sat Jul 19 03:40:16 EDT 2003;Committer;eban;1;3;3;6;0
5b7d9087520581a7b2aecb33a78acb1ac3a7ae1a;Sat Jul 19 03:23:05 EDT 2003;Committer;matz;1;8;8;16;0
91d6fe9a027cf4b532268640a8cfcc4dd76d8788;Sat Jul 19 03:19:36 EDT 2003;Committer;matz;1;1;1;2;0
adec8b726cb6a9e7b053b83592358cb8c0d2c537;Sat Jul 19 03:18:44 EDT 2003;Committer;matz;2;9;3;12;0
3b1e7ac7855a2d5cb4a075d652835cf52ea123a6;Fri Jul 18 19:51:42 EDT 2003;Committer;nobu;5;143;5;148;0
c88efe5fa2ba6e6b565630e3049c8307ed540c9f;Fri Jul 18 18:11:45 EDT 2003;Committer;usa;2;22;14;36;0
d0878214803bb2f71be28890ea73600a9a42cd27;Fri Jul 18 17:00:43 EDT 2003;Committer;nobu;2;4;2;6;0
1bb3071bde8344427a5fe3f5998dc491d2630d2b;Fri Jul 18 15:26:37 EDT 2003;Committer;shigek;5;325;0;325;0
e242cf9defb5442ef223535abe93399352cf139e;Fri Jul 18 15:24:25 EDT 2003;Committer;shigek;4;0;243;243;0
b10272dc371a03844f685dc6db765c2bea11d29b;Fri Jul 18 15:23:23 EDT 2003;Committer;shigek;5;263;174;437;0
b31bca1b45fa65e8b4da102505871ca77aa1a45b;Fri Jul 18 09:44:28 EDT 2003;Committer;nobu;2;6;3;9;0
c1c86a37df4afa6a4c9f9a55d8fe4a6667b4032d;Fri Jul 18 08:34:45 EDT 2003;Committer;nobu;3;39;21;60;0
e06379839c3a47e7da1da572047616231e0d16ad;Fri Jul 18 06:34:49 EDT 2003;Committer;nobu;1;1;1;2;0
5b1008a005da0a6d4a65873e0f26e458002c9bd9;Fri Jul 18 06:00:24 EDT 2003;Committer;usa;2;178;211;389;0
8654ce809b09e2422ef4d37acc76241582c98786;Fri Jul 18 05:43:05 EDT 2003;Committer;eban;1;3;3;6;0
909c2274f9a7d4ee4d4267f9f6dcb35b21a62109;Fri Jul 18 05:29:46 EDT 2003;Committer;matz;5;14;10;24;0
2d28a9b130660c81c8d31202503d3a84ea8fd81c;Thu Jul 17 09:53:16 EDT 2003;Committer;matz;2;6;2;8;0
8cee72d5c6184e8ea1680b79390e869ea231ac01;Thu Jul 17 08:58:16 EDT 2003;Committer;matz;5;38;33;71;0
9a27cf9499be318b478346959c6d3b571653bcc9;Thu Jul 17 06:40:28 EDT 2003;Committer;nagai;1;4;0;4;0
81cb5de20ba8ab0f1d7c1ed539cfa866d3259f49;Thu Jul 17 05:29:25 EDT 2003;Committer;eban;1;3;3;6;0
46bf6217378e0dca4ff56446cf7233023f21778a;Thu Jul 17 05:23:54 EDT 2003;Committer;matz;6;31;14;45;0
06f82d38838e3d588c96e12bf492b685ff1d8322;Thu Jul 17 04:56:09 EDT 2003;Committer;eban;2;5;1;6;0
0eb5a42b910728cea4d382867827f4a1b8bbb392;Wed Jul 16 09:23:33 EDT 2003;Committer;matz;2;27;1;28;0
1d3b7cfd744da2b279c2ab92517da05ad21f4adf;Wed Jul 16 07:12:46 EDT 2003;Committer;eban;1;3;3;6;0
7406260aed6598b4e2769b22c3a1532da85dbe7a;Wed Jul 16 07:11:30 EDT 2003;Committer;matz;6;78;61;139;0
0caa77e7bceca57b9d684728fbef63790f927424;Tue Jul 15 10:50:54 EDT 2003;Committer;nobu;2;24;3;27;0
9a3da66892722e4a0d0fafa79430c44e8dd174b6;Tue Jul 15 07:56:21 EDT 2003;Committer;eban;1;1;1;2;0
5a38061f456fee1c29337a2077da270cb928b854;Tue Jul 15 07:46:34 EDT 2003;Committer;eban;1;3;3;6;0
9ef8a2a5db011a0071a4232b368b1cc4d2346351;Tue Jul 15 07:35:14 EDT 2003;Committer;matz;6;98;59;157;0
bdfce148a7f85a14e24c6365e72ba59241c4be9f;Mon Jul 14 20:35:07 EDT 2003;Committer;why;2;10;1;11;0
40f7baddde8d2f97447b8b49cab71dd7601c2fae;Mon Jul 14 02:32:04 EDT 2003;Committer;nobu;1;5;0;5;0
dbb2e33eef72ffd720f83a312655918307546833;Sat Jul 12 08:02:26 EDT 2003;Committer;usa;3;15;10;25;0
a706d6ddac4d79e20621e97ee83ad8ef919aebe6;Fri Jul 11 23:56:42 EDT 2003;Committer;why;1;241;0;241;0
d3a43fcca0bf90d41b10e52d154c5689f90e063f;Fri Jul 11 23:44:37 EDT 2003;Committer;why;2;318;0;318;0
a1e257ec48911d3ca1aaeda0127061c244f36147;Fri Jul 11 22:52:14 EDT 2003;Committer;why;9;359;271;630;0
30399f6c758c85ac9794d4298ee2b51426a144bc;Fri Jul 11 19:23:13 EDT 2003;Committer;nobu;1;20;19;39;0
c649dcc857a886a3f42b8843f47513b0e5b18e09;Fri Jul 11 16:37:05 EDT 2003;Committer;nobu;1;4;5;9;0
b2ffc1fcab6c523dba05ab28380572f2609fae42;Fri Jul 11 16:22:01 EDT 2003;Committer;nobu;3;38;31;69;0
bc7a97c82647406ee0df4bc2066e4f77c8572eb0;Fri Jul 11 13:37:22 EDT 2003;Committer;nobu;2;6;1;7;0
b2d25f72c8a60c87c04dc555d58163e6b7c65e91;Fri Jul 11 09:40:53 EDT 2003;Committer;eban;1;1;1;2;0
3ed23a541f9132d8b8ddc03dc59531daec260f74;Fri Jul 11 09:39:09 EDT 2003;Committer;eban;2;5;1;6;0
37f26903b0ed779c56ef1f20cd71875622a1e429;Fri Jul 11 07:29:33 EDT 2003;Committer;eban;1;3;3;6;0
7a89869340973e53cd2d95f11381eeaf98b16c7d;Fri Jul 11 07:17:46 EDT 2003;Committer;nagai;1;2;2;4;0
538e8190bc68afcfd2f8308cb0e4c92394e93935;Fri Jul 11 07:10:14 EDT 2003;Committer;matz;2;5;1;6;0
0f33529f639d112dff43137c0d9c618a583d4244;Fri Jul 11 05:26:30 EDT 2003;Committer;matz;4;18;33;51;0
28595a72a9d0f90d75d9d64ae1203c80e576a895;Thu Jul 10 05:48:43 EDT 2003;Committer;eban;2;10;2;12;0
1b3ba48101f37b5d48b3f2837e393ac5a2179a89;Thu Jul 10 03:08:12 EDT 2003;Committer;eban;1;3;3;6;0
d65dab3dfb570bbdd4f99f33fa47753f511ece06;Thu Jul 10 03:08:08 EDT 2003;Committer;eban;1;2;1;3;0
570befe608c7e8b0fde9374bffdafcf7a7e088c8;Thu Jul 10 02:30:08 EDT 2003;Committer;matz;2;4;4;8;0
95b7ffce0fd924277a344613943778663c1ced22;Wed Jul 09 22:32:54 EDT 2003;Committer;matz;1;1;3;4;0
662e3cf1f94bb50f6a27568c7526f867956e5b55;Wed Jul 09 22:28:42 EDT 2003;Committer;matz;11;111;46;157;0
d54accfe3ff3fd8a139cc7b899fc1e20104dcc97;Wed Jul 09 14:52:20 EDT 2003;Committer;nobu;2;7;2;9;0
eeba4b02e8bcdfab4f97c85956469f239d2428a7;Wed Jul 09 09:27:40 EDT 2003;Committer;eban;2;3;1;4;0
279385a00287e57cecc240fda4ef846c4afcfdea;Wed Jul 09 07:09:06 EDT 2003;Committer;eban;1;1;1;2;0
039fd6a8f9335ba6d2f45082a2f47635f384a606;Wed Jul 09 06:45:45 EDT 2003;Committer;eban;2;7;1;8;0
3d43a19c747227a7320816514616c5d3f9466e27;Wed Jul 09 02:16:42 EDT 2003;Committer;usa;3;8;3;11;0
9a9c8090d8ec6493e2a29ccf5626a29c4f00409b;Mon Jul 07 08:31:17 EDT 2003;Committer;eban;1;3;3;6;0
3de67ca69de67a67e564458e66dc962064fd4f42;Mon Jul 07 08:28:19 EDT 2003;Committer;matz;5;38;12;50;0
444d4435ba78fdb15f136cbb1d3c8e71c87ad559;Mon Jul 07 01:30:02 EDT 2003;Committer;eban;2;6;1;7;0
9ae79bfcb96a4cc4ff62cb8c4f858f1197ea7ee6;Fri Jul 04 15:30:35 EDT 2003;Committer;matz;4;116;113;229;0
2c58277c5b52693d9b89dbec682b3e07da98f982;Fri Jul 04 12:54:38 EDT 2003;Committer;nobu;1;6;0;6;0
a4aa765cb680691e8aef1c88eadf48a073d8df2f;Fri Jul 04 12:51:42 EDT 2003;Committer;nobu;4;137;121;258;0
c3c31026104b774975e198a805ae379cae1f8a08;Fri Jul 04 07:31:10 EDT 2003;Committer;matz;1;1;2;3;0
cc4dec07018b20b17b87561a0f23509c741075ed;Thu Jul 03 15:58:03 EDT 2003;Committer;matz;2;1;4;5;0
554f524ee53c8f924c739867608ed7a147aa920e;Thu Jul 03 14:44:46 EDT 2003;Committer;akr;2;10;2;12;0
40f3699376a5df74b82f6c1b5e7eb32cd75d5d17;Thu Jul 03 11:07:55 EDT 2003;Committer;eban;1;1;1;2;0
3312bdf544754bda95790506b5a1376c98ef5b92;Thu Jul 03 11:04:21 EDT 2003;Committer;eban;1;3;3;6;0
9d22a06ea06e9bec5030fd6e2c8481958fcd30d9;Thu Jul 03 11:02:53 EDT 2003;Committer;matz;13;157;96;253;0
a11ab83884c47f729a8630ab5ef21c7522b48386;Thu Jul 03 03:20:32 EDT 2003;Committer;eban;2;6;1;7;0
f126a442e2e0bfe78e46f0bbbe48f0ba35b92cbf;Wed Jul 02 04:46:30 EDT 2003;Committer;eban;1;3;3;6;0
447578a8a02a32fc3594cf62d3c0f928fe63221a;Wed Jul 02 04:27:29 EDT 2003;Committer;matz;4;26;11;37;0
f261bdf66cb3a40b44c8830049d1ec57016777fe;Wed Jul 02 02:39:53 EDT 2003;Committer;aamine;3;325;171;496;0
c20ecb1ba48fde8e81701f1365b738625c25582d;Wed Jul 02 02:34:39 EDT 2003;Committer;aamine;4;408;327;735;0
f473140e62d438e845c9d1d9b62985f970a9a27a;Wed Jul 02 02:05:35 EDT 2003;Committer;aamine;3;20;1;21;0
28f8fc7f880ff06c296f7399b4e09a1db48e19fa;Tue Jul 01 22:08:19 EDT 2003;Committer;nagai;2;24;10;34;0
2e4fc59d1c8cff7c4575588f08247d73e90ce194;Tue Jul 01 16:34:58 EDT 2003;Committer;eban;2;5;1;6;0
49298086d087812225d7d54d8e693d2ff8983129;Tue Jul 01 14:14:18 EDT 2003;Committer;shigek;1;2;2;4;0
e8aa990f92e2a150114138ebcb7b7b789736be65;Tue Jul 01 10:03:04 EDT 2003;Committer;eban;2;6;2;8;0
249f3f8361d46d3ae2f8c29c7185adf58c3b3afc;Tue Jul 01 01:40:15 EDT 2003;Committer;nobu;1;4;4;8;0
442c836bfe7396f81a0f1f2f8daeeeabbf0d0343;Tue Jul 01 01:36:25 EDT 2003;Committer;nobu;4;15;27;42;0
7bb1e40d8b5928a7d3740b72f02f6a5d5fb0d21b;Mon Jun 30 09:08:48 EDT 2003;Committer;nobu;1;3;3;6;0
6e85f9c99c71c58d3f472c477fcd791328e7c492;Mon Jun 30 08:53:10 EDT 2003;Committer;nobu;2;9;0;9;0
a40a92f04c6b3edeede0afcd939c17cff66f7d11;Sun Jun 29 13:20:08 EDT 2003;Committer;shigek;1;4;2;6;0
d5f31755fc38100a76e0d89f07951995504a4bf7;Sat Jun 28 22:03:41 EDT 2003;Committer;seki;3;8;56;64;0
3d4c49ee3bc232431ce67c6008b785f7e80544d4;Sat Jun 28 03:41:22 EDT 2003;Committer;nobu;1;3;3;6;0
e5a9dcb9d8863fc2ad44c4f85a10a95329e3c154;Sat Jun 28 03:29:00 EDT 2003;Committer;nobu;4;82;26;108;0
057dcc0495e9f6e85c322bf294dd03dde3899de7;Fri Jun 27 05:41:28 EDT 2003;Committer;nobu;2;7;1;8;0
f64d6232ab41b1b04305f577f868b606ae0fa9d1;Fri Jun 27 04:40:25 EDT 2003;Committer;shigek;1;4;4;8;0
d3ce235babf3a5fa9a7904c45ec193e8962fe845;Fri Jun 27 04:38:57 EDT 2003;Committer;shigek;4;740;614;1354;0
7e91b4b546634afa0203f7bd6d0e5092f8f7ee61;Fri Jun 27 03:05:12 EDT 2003;Committer;eban;1;3;3;6;0
7a425f71e38df08a35d0d416b508bd5c95ed5fa6;Thu Jun 26 18:24:58 EDT 2003;Committer;nobu;3;21;2;23;0
894d2b643d67ffa9919208327146911e56020ad4;Thu Jun 26 12:40:48 EDT 2003;Committer;nobu;1;3;3;6;0
8c8e4f59c2e8247e1b485b458b38dbfa0744bfc9;Thu Jun 26 12:34:51 EDT 2003;Committer;nobu;2;27;25;52;0
79edd1af703289bfa827ac6418916ba28f490690;Wed Jun 25 14:40:32 EDT 2003;Committer;nagai;2;154;2;156;0
dff438fba3e5d4da6f2aad0b0dafe28a2fc61619;Wed Jun 25 07:12:10 EDT 2003;Committer;matz;2;24;38;62;0
9a47a0460792a1c7447cff0dfe1059877da87be2;Wed Jun 25 05:49:10 EDT 2003;Committer;nagai;3;128;40;168;0
f3d3cfb30dc3f8ea018ef23ae4295b10d8bdb963;Wed Jun 25 05:34:28 EDT 2003;Committer;eban;1;3;3;6;0
0c4fe2b522b3c51f4c815d37e3d953d59a32f29e;Wed Jun 25 05:28:24 EDT 2003;Committer;matz;3;11;3;14;0
17e1936d8bdd897cebd03ed198a826ee395572ac;Tue Jun 24 16:46:07 EDT 2003;Committer;nagai;5;204;22;226;0
b60ba5942968e782cfc407385e175c449924f1d7;Tue Jun 24 14:12:03 EDT 2003;Committer;why;2;6;1;7;0
5f80d051a685021ed423c9ab8c7816626a587078;Tue Jun 24 08:59:34 EDT 2003;Committer;nobu;2;17;8;25;0
170aaabe4b118d2d2cc85e138d79f11c86166b4e;Tue Jun 24 07:42:46 EDT 2003;Committer;aamine;2;6;1;7;0
9fa20b9973a31c9e7482e7cc9cc075dc0aec8268;Tue Jun 24 05:26:18 EDT 2003;Committer;aamine;2;7;2;9;0
988653ad27f409218cafd296589bd4014e56b9db;Tue Jun 24 02:07:30 EDT 2003;Committer;eban;1;3;3;6;0
2f7fde4e4e41f378b62f4cb1fb69e19c4abea722;Mon Jun 23 19:54:41 EDT 2003;Committer;aamine;2;12;13;25;0
d749616333e092b13948405164f4799b2884eddd;Mon Jun 23 17:40:14 EDT 2003;Committer;nobu;2;11;1;12;0
9d05b9a4b34862c7c9db80b5c3b3ed88bb526733;Mon Jun 23 14:55:09 EDT 2003;Committer;aamine;5;16;1;17;0
30235cd14e09b0b70ecf7b92728aea7cd24e22f5;Mon Jun 23 14:30:27 EDT 2003;Committer;eban;3;17;9;26;0
65e7ebb14fde52fee2cd08f38f467adbd4fe6e25;Mon Jun 23 14:22:44 EDT 2003;Committer;nagai;1;23;8;31;0
d061e2aab748052bcdec92fe73920c94b4a0312f;Mon Jun 23 08:45:59 EDT 2003;Committer;nobu;1;1;1;2;0
61927637e810f20c01a8700da07020d556986b13;Mon Jun 23 08:45:09 EDT 2003;Committer;nobu;1;1;1;2;0
69459d98ef81c26291d8504dbcd904eda71e7e31;Mon Jun 23 08:41:07 EDT 2003;Committer;nobu;6;75;30;105;0
2aba26fa521e1a4405546b50c08de0d90b5bfd44;Mon Jun 23 07:19:03 EDT 2003;Committer;akr;2;4;2;6;0
67dcad92b7fb9f8b95c8e4925061527fc8a8db3d;Mon Jun 23 06:52:39 EDT 2003;Committer;matz;11;113;47;160;0
eb050525c069ae82473a63fa0788acd5ceb7e04c;Mon Jun 23 04:49:50 EDT 2003;Committer;eban;1;3;3;6;0
41e018a46d466799b2728ab242725a538c224d6c;Mon Jun 23 04:47:30 EDT 2003;Committer;akr;2;6;0;6;0
f34b15e5d294dafa3e5f3eec00b0a14326589d47;Sun Jun 22 16:17:02 EDT 2003;Committer;nagai;2;165;11;176;0
25f8578b13a85fa0b64eee55c51b270528047c4a;Sun Jun 22 10:40:05 EDT 2003;Committer;nobu;1;2;2;4;0
25e0ff2e4b2df5365c760e1036df8c8a65d54e7f;Sat Jun 21 17:15:53 EDT 2003;Committer;matz;1;1;0;1;0
47b57348e6d85926d8da91b2136b22f0a079388a;Sat Jun 21 15:36:06 EDT 2003;Committer;matz;2;5;4;9;0
9060b3355a9d67e547b71e81a6bb20d7199822f2;Sat Jun 21 14:51:21 EDT 2003;Committer;matz;2;15;5;20;0
07cff4bd71d4d71e4901aac5df11746ce96f009b;Sat Jun 21 12:55:17 EDT 2003;Committer;nagai;2;52;6;58;0
818157eae67c00be5610ce6e9488d448009a40ba;Sat Jun 21 12:40:45 EDT 2003;Committer;eban;1;3;3;6;0
f96ab4131c9542dfe2696e7209a803e3d2eccc63;Sat Jun 21 12:27:21 EDT 2003;Committer;nobu;2;7;2;9;0
e8ab40d239baa5a473e81731c828f2c75dfcb06d;Sat Jun 21 08:47:22 EDT 2003;Committer;nagai;8;82;22;104;0
aa49df66ae0f39d9480cc20d19d7225b762296a0;Sat Jun 21 04:55:59 EDT 2003;Committer;uema2;3;7;2;9;0
0347d29810521261d12959fde5a49eadc33e5f0b;Fri Jun 20 17:22:27 EDT 2003;Committer;matz;2;10;5;15;0
ff75ab3e3cd76b1b457661edf6b20661d45c8d78;Fri Jun 20 14:52:45 EDT 2003;Committer;nagai;2;12;7;19;0
f289fddace1c84075e6794e24a3d46aee6b35d69;Fri Jun 20 07:11:44 EDT 2003;Committer;matz;10;149;38;187;0
65ba3eba645a61ae9995f9f1e88cab6150c858a7;Fri Jun 20 06:22:50 EDT 2003;Committer;usa;6;55;23;78;0
068bc7e43a7e88d9d48aa627a846ef5f22660694;Thu Jun 19 16:14:43 EDT 2003;Committer;nagai;7;284;12;296;0
13e15cecf3f3bec0514ce9b2b4576135fe3f944c;Thu Jun 19 16:08:52 EDT 2003;Committer;nahi;3;1340;13;1353;0
8fa0e58e61f6345b723dedee16043e118ee9b647;Thu Jun 19 14:00:31 EDT 2003;Committer;seki;1;7;0;7;0
bbd5c60e1850b88d4a8f95974117c008ed5f1a4c;Thu Jun 19 07:16:58 EDT 2003;Committer;eban;2;5;1;6;0
7bb51e6ce911f70d7f850f1495f93ef987a1603d;Thu Jun 19 04:21:25 EDT 2003;Committer;usa;3;14;9;23;0
d8b02b509608c5b90056c7befa89fa29fda45f8f;Wed Jun 18 19:46:20 EDT 2003;Committer;nagai;14;1650;432;2082;0
151f1241c665b0307234e931bec2c32bfea0138d;Wed Jun 18 15:45:12 EDT 2003;Committer;seki;11;1353;0;1353;0
34cdb70d14ea1fdddf3f3991f6097fe5c24310ba;Wed Jun 18 14:51:53 EDT 2003;Committer;katsu;1;17;2;19;0
6262a99e9b72bd6bf235fb1c37f7b035191093d9;Wed Jun 18 14:38:06 EDT 2003;Committer;katsu;1;5;0;5;0
d21bd1c06dbd04b89cdf4d50ce85fede95a7bcc9;Wed Jun 18 01:06:00 EDT 2003;Committer;why;5;112;20;132;0
ae28f1b6b3b22afb529f599385d1f2af258624e9;Tue Jun 17 16:55:54 EDT 2003;Committer;why;9;1049;765;1814;0
77e941269fcddc8f5af6e553592fc3ef0132727c;Tue Jun 17 12:30:15 EDT 2003;Committer;usa;2;8;1;9;0
f7afa61a0a8bc08908155eab51921afa25cba606;Tue Jun 17 03:12:28 EDT 2003;Committer;matz;3;35;44;79;0
ae6fd90c18f7fe4b1729d2e3d55bb2bff3418229;Mon Jun 16 09:10:17 EDT 2003;Committer;eban;2;5;1;6;0
401805ec1330c761ee922e895f797da05968ca20;Mon Jun 16 08:03:03 EDT 2003;Committer;nobu;2;8;3;11;0
51e7fc687e6d66d02b37550ca1dd005247bc715f;Mon Jun 16 07:25:38 EDT 2003;Committer;usa;3;9;2;11;0
590a37880c46ce080dde5864497758e0a83a24f4;Mon Jun 16 07:14:50 EDT 2003;Committer;matz;19;162;177;339;0
5fb3efb267a40d0b2410af36cd3421ef94492170;Mon Jun 16 05:44:22 EDT 2003;Committer;eban;2;5;1;6;0
4b0115beb5a500b6ffae8f2c5b16a3d5e1916c0a;Mon Jun 16 05:03:03 EDT 2003;Committer;eban;1;1;1;2;0
8b684d1926c52b6459594cc9cace36d868e5895f;Mon Jun 16 04:53:10 EDT 2003;Committer;eban;1;3;3;6;0
aabb7851972e36291ca53551815a3b7f3dea046e;Mon Jun 16 04:49:25 EDT 2003;Committer;matz;2;13;2;15;0
2403ad9e7de8976a83798f9d86f82f3b5ae0d2cd;Sun Jun 15 18:31:16 EDT 2003;Committer;ser;5;28;26;54;0
4d33715fe4b0c9750b4cf4e71166e8d67ecc8395;Sat Jun 14 13:48:52 EDT 2003;Committer;eban;1;3;3;6;0
d616f6005c9ca66db6d1aea08d7235a00f7fab58;Sat Jun 14 13:41:29 EDT 2003;Committer;matz;2;15;7;22;0
e0a5ffa941d22ef4320db4ea803594e4dbb480d6;Fri Jun 13 00:26:51 EDT 2003;Committer;shugo;2;14;1;15;0
2850b7c4812894a616bca1af09f901fe9a202fb0;Thu Jun 12 22:13:13 EDT 2003;Committer;nagai;3;28;8;36;0
598e9930183162bb8cee510b7931e87a20e2e497;Thu Jun 12 21:14:11 EDT 2003;Committer;nagai;3;135;0;135;0
e921ea2d78f693c57fcb289faff3fc126dc8617a;Tue Jun 10 14:15:27 EDT 2003;Committer;why;7;1227;1175;2402;0
3079dcab4ad9e7624703d772f6fc54dc10e45bce;Tue Jun 10 07:51:10 EDT 2003;Committer;eban;1;1;1;2;0
e08f18becd2fdb9fde29c2e501ad84120a475d58;Tue Jun 10 07:07:52 EDT 2003;Committer;eban;3;4;4;8;0
50e7c1c1495828120ad766e6fca0efba70f011b9;Tue Jun 10 06:43:29 EDT 2003;Committer;eban;1;3;3;6;0
77aa4521921bc05b4a514b83f5caf20b5211ba9e;Tue Jun 10 05:37:44 EDT 2003;Committer;matz;1;1;1;2;0
aec748ff1363557f0afb47eac9ad756bd4ed4e97;Tue Jun 10 05:36:35 EDT 2003;Committer;matz;2;11;10;21;0
373a59b95b71b54b99a0ba229cd5860fac308115;Tue Jun 10 05:22:17 EDT 2003;Committer;matz;6;30;11;41;0
434e71244a50ff874a14113e7cc46ce02bacb34e;Tue Jun 10 02:05:17 EDT 2003;Committer;ser;1;3;3;6;0
b5d9609df5e2132ec5ad704141ac350ce9193dbd;Tue Jun 10 01:44:55 EDT 2003;Committer;ser;1;53;0;53;0
ea7a527a2ae7024a5cf2885dee8f7a5c21fedd5d;Tue Jun 10 01:31:01 EDT 2003;Committer;ser;53;6674;0;6674;0
ca02190d8887ecd852e4e3f18f3a3ea91e9c6f7a;Mon Jun 09 18:09:11 EDT 2003;Committer;nagai;1;27;6;33;0
1a28365c0ad995a14d894824c2c4765d41416dab;Mon Jun 09 15:50:24 EDT 2003;Committer;nagai;1;66;24;90;0
879d09b6f82c409ae1653f1cb09ae4ec7baf96a3;Mon Jun 09 13:22:15 EDT 2003;Committer;eban;1;3;3;6;0
1fe598da35b01627da052926aa5409502517846b;Mon Jun 09 10:02:36 EDT 2003;Committer;nobu;3;7;5;12;0
31094808f99856180fb45e4fd5359621788b28f3;Mon Jun 09 04:27:17 EDT 2003;Committer;nobu;2;17;0;17;0
32bd3c5679d39b1679a25f0bdb1453858376dce0;Sun Jun 08 04:38:06 EDT 2003;Committer;uema2;3;14;6;20;0
9481face427a93e1a557ecd980ec82f5d04da8d5;Sat Jun 07 15:34:31 EDT 2003;Committer;matz;8;175;61;236;0
a4c37a4b7fb14c1eb81cbd3226761c522f3a49bc;Fri Jun 06 11:34:28 EDT 2003;Committer;nobu;1;3;3;6;0
fb81dcb863e6a796b113212f6b3e6086b11bffb8;Fri Jun 06 11:29:20 EDT 2003;Committer;nobu;3;74;25;99;0
bad7546f15573e06208651a39b9c41ff921c25a2;Fri Jun 06 09:44:22 EDT 2003;Committer;matz;11;53;36;89;0
9e77e91a13a8ae1d8bb4bba8974da390fbadedc0;Fri Jun 06 09:24:59 EDT 2003;Committer;matz;6;104;31;135;0
1fa5c630cda65f69d2ccffb614f45b5e9470b167;Fri Jun 06 07:05:52 EDT 2003;Committer;aamine;3;24;7;31;0
56796022a658e31133ee05c10718ca8af8e20045;Thu Jun 05 17:42:06 EDT 2003;Committer;why;5;76;63;139;0
b5d717afda44c19b652dfd1a6a2b721fa93a2762;Thu Jun 05 12:33:19 EDT 2003;Committer;uema2;2;21;0;21;0
b1937a53e664fec371cbb0f7985cbd845cf33b81;Thu Jun 05 09:38:01 EDT 2003;Committer;usa;6;111;8;119;0
d9f893b70ba3c5a62f3a053aad7b6340e34afff9;Thu Jun 05 09:36:30 EDT 2003;Committer;eban;2;7;3;10;0
5fe3feca281137488397269ad6467d7582328ef9;Thu Jun 05 06:42:17 EDT 2003;Committer;eban;1;3;3;6;0
c004ecfa1ecc447b764d1ab91cbf9a23c2ed79ca;Thu Jun 05 06:40:42 EDT 2003;Committer;matz;7;36;2;38;0
bd368e97495ba28ea56da862cd8ef0d695572604;Thu Jun 05 05:40:03 EDT 2003;Committer;why;3;45;15;60;0
017d4ff10ae32ed6570b5d33a8106bd1f22e008f;Thu Jun 05 04:43:05 EDT 2003;Committer;why;7;326;193;519;0
45c7ea552d0293aa217bbb496d4238754ba701d2;Tue Jun 03 13:57:06 EDT 2003;Committer;matz;2;13;10;23;0
7db609e8bd2fcf604fe79a56bb026278c1b681c2;Tue Jun 03 09:48:35 EDT 2003;Committer;eban;1;3;3;6;0
30f934d341d45966b40ea6473dd3c87c4c04c586;Tue Jun 03 09:46:43 EDT 2003;Committer;matz;1;1;1;2;0
c5fc4bca6d45ac58be7ccba26fbb90664643eab3;Tue Jun 03 09:40:21 EDT 2003;Committer;matz;9;62;50;112;0
63ae7e1c1351da7cd7291e417ba559098ee5c715;Mon Jun 02 04:53:30 EDT 2003;Committer;eban;1;3;3;6;0
6125313d69c158b423d1f4aff2e206cfd43a036a;Mon Jun 02 04:49:46 EDT 2003;Committer;matz;12;113;56;169;0
f5a7f85917abed4d64ad908a4837e0db0499c951;Sun Jun 01 18:43:36 EDT 2003;Committer;keiju;1;1;1;2;0
4893c5cce142ffebc108bc92c8c22650d7298746;Sun Jun 01 15:39:52 EDT 2003;Committer;eban;1;1;1;2;0
e7bcd2ee33e3da1fd3989737e4521212b6484b6d;Sun Jun 01 15:27:09 EDT 2003;Committer;eban;1;1;1;2;0
9b616a5e85eb17eaf2f8cd1f7972cca4e59fa3cb;Sun Jun 01 14:20:58 EDT 2003;Committer;eban;2;3;1;4;0
fd681fe0e5240ae112b15ff437d3259f202b9705;Sun Jun 01 12:58:56 EDT 2003;Committer;eban;4;27;22;49;0
dc13952417e5c918de9bd51f504db7a289ddabed;Sun Jun 01 04:44:45 EDT 2003;Committer;uema2;5;57;14;71;0
9f6f32c7378fd933af37ea1ddedca133bf4431e9;Sun Jun 01 01:39:54 EDT 2003;Committer;nobu;1;4;4;8;0
7b6452389d2cce226151fde516667b1ca105b6a8;Sun Jun 01 01:38:32 EDT 2003;Committer;nobu;2;5;10;15;0
e13e58bef695d094665068e73f322e639505635f;Sat May 31 09:11:12 EDT 2003;Committer;usa;2;6;2;8;0
38df1a90cc68d132306c9484ed57faa0be656b0e;Fri May 30 23:09:54 EDT 2003;Committer;why;5;417;282;699;0
1ce0018ba1b26fcb5c8f294d2908a56ef0310464;Fri May 30 16:50:41 EDT 2003;Committer;nobu;1;0;12;12;0
5388ef52fa776f8ca102e85366561399b89b25ac;Fri May 30 16:09:50 EDT 2003;Committer;eban;1;3;3;6;0
979f006b9e63cc787551d98b9bea9e94d61744de;Fri May 30 16:08:03 EDT 2003;Committer;matz;6;69;31;100;0
045eb9773e37dbe31c5ff595d380beb71ac62863;Fri May 30 13:28:10 EDT 2003;Committer;nobu;3;60;8;68;0
7d9628ef0200936d1deb0ab866a006a94fe00d91;Fri May 30 05:55:50 EDT 2003;Committer;nobu;3;40;22;62;0
f6dd3316eb02d8d8f0d229f28d513d6ad4895fca;Fri May 30 01:48:08 EDT 2003;Committer;eban;1;3;3;6;0
5b743d275e5e6be6ef1fb47b85a106aa197057d1;Thu May 29 23:51:16 EDT 2003;Committer;why;2;66;63;129;0
5d47fda3f8b7148087a866cfd3033ab185e492fd;Thu May 29 23:33:10 EDT 2003;Committer;why;5;477;561;1038;0
4ca5e66ee793f0c8b7f96d4f82d813c8f98a26be;Thu May 29 21:35:50 EDT 2003;Committer;nobu;1;5;5;10;0
f130d47f6a60228933c451f82b6a1da7fc1d69e2;Thu May 29 21:21:23 EDT 2003;Committer;nobu;2;22;2;24;0
e617fd0bf84f80de8fc40a1ea86e96bd2848493a;Thu May 29 09:11:18 EDT 2003;Committer;eban;4;15;7;22;0
9a4786104165f7f6b15cc26e349d138e465dacf2;Thu May 29 00:26:23 EDT 2003;Committer;nobu;1;3;3;6;0
c40c6bd38607ce042ebd65b6d263e86f0036a649;Thu May 29 00:25:40 EDT 2003;Committer;nobu;1;0;2;2;0
5ddce4f7bccc47a3c73860622f55f40c987ce592;Thu May 29 00:11:11 EDT 2003;Committer;nobu;6;287;156;443;0
144caca6bbc27ce2d2c681e381ffb912189c73b1;Tue May 27 13:00:56 EDT 2003;Committer;eban;1;3;3;6;0
dc2bab2207d3bf9d7576194abf191fead31735c5;Tue May 27 11:33:46 EDT 2003;Committer;nobu;3;3;13;16;0
aa37cc71279123d870263f9e9b315e7fd48095eb;Tue May 27 11:07:57 EDT 2003;Committer;nobu;2;7;2;9;0
771240704854bd767f5873fa4199966f756f5b93;Mon May 26 13:17:07 EDT 2003;Committer;nobu;4;10;5;15;0
c0eb57417cb5f6ebce13c0349f51ed6a9e22e91f;Mon May 26 13:10:02 EDT 2003;Committer;eban;1;3;3;6;0
6e242d868eea16011ca564455b8147cfaf749a09;Mon May 26 12:21:24 EDT 2003;Committer;nobu;2;9;3;12;0
b4fd4d6018a8ad72f69912606c60ec42ee3b62b8;Mon May 26 08:22:33 EDT 2003;Committer;matz;7;337;166;503;0
ea325deab0729bf17d3f366aa6369d93a4db54fd;Sun May 25 14:52:18 EDT 2003;Committer;nobu;1;3;3;6;0
c13ca745209883e1d68bda80d9a1a2c9d2a932d8;Sun May 25 14:48:26 EDT 2003;Committer;nobu;2;6;0;6;0
d5d2ca754ba2d2848d398e419d926c519fb033b5;Sat May 24 18:24:26 EDT 2003;Committer;aamine;2;45;10;55;0
0ece2407d2e1dec907d59d458c70ee6c5d1c6602;Sat May 24 09:17:35 EDT 2003;Committer;uema2;6;64;16;80;0
8a82c68e5bd07476bf51d386b1fe1cb1dad4a682;Fri May 23 09:39:13 EDT 2003;Committer;nobu;1;1;1;2;0
0cc87df01c49ef96e4fb7cbd5ce74135c409db90;Fri May 23 09:34:09 EDT 2003;Committer;nobu;2;35;5;40;0
cec20793cb3dd76ea310b443171e22e24e484247;Fri May 23 08:11:21 EDT 2003;Committer;matz;4;12;5;17;0
228604473da9819e031ea2b48017f9246d1dbd48;Fri May 23 06:16:20 EDT 2003;Committer;nobu;2;23;0;23;0
2e4ffa7a447f94f2aaa44c206db845da029be484;Fri May 23 05:25:00 EDT 2003;Committer;nobu;1;178;180;358;0
9bb41601890f6f224bdb6370476b9295a19598fc;Thu May 22 17:56:30 EDT 2003;Committer;why;4;100;51;151;0
3458bf43288ae4b76564e538f35e9c423ea4f620;Thu May 22 16:43:57 EDT 2003;Committer;eban;1;3;3;6;0
c3584231bad01fd85827814f640590de7a9637ad;Thu May 22 16:37:22 EDT 2003;Committer;matz;5;11;5;16;0
717302e2c4de9b86bf53fe65173500a33586001c;Thu May 22 08:30:58 EDT 2003;Committer;matz;3;19;10;29;0
df62bb4fc987317e209679ef60ea98b31ebae431;Thu May 22 07:45:53 EDT 2003;Committer;matz;2;8;3;11;0
9780fc27d941d6975fb29e96584add5383f0316c;Thu May 22 06:14:17 EDT 2003;Committer;why;3;11;2;13;0
5e1c96af5323f757c9875ea1fb5b754e4dd257cd;Thu May 22 05:41:06 EDT 2003;Committer;why;5;132;119;251;0
a2cd1bbf3e70dfa1be172851ffd4b6bad3190560;Thu May 22 02:25:51 EDT 2003;Committer;eban;1;3;3;6;0
b80c02b4f137d0a892dc293863ae1f0262f121fd;Wed May 21 18:27:35 EDT 2003;Committer;nobu;1;0;5;5;0
9cf879d7a5f27d1965c99196c6364936f95b256d;Wed May 21 18:04:11 EDT 2003;Committer;matz;3;13;7;20;0
63a5a45a01b656adbc0457036a0f575b847b2a08;Wed May 21 17:49:18 EDT 2003;Committer;nobu;1;1;1;2;0
d547df4c537226112777086f52bc23f39eadb0e7;Wed May 21 17:46:42 EDT 2003;Committer;nobu;2;4;2;6;0
874eca3c042a42f7bd5de245a76f79d6ff4f5dcf;Wed May 21 17:42:56 EDT 2003;Committer;nobu;3;32;9;41;0
1359207bf865f6b413f5d7816caeb098485026b2;Wed May 21 16:11:18 EDT 2003;Committer;nobu;1;7;0;7;0
498365d0ee972a6c301e3a238f6e0918d114e81a;Wed May 21 16:01:49 EDT 2003;Committer;nobu;1;18;3;21;0
77324837a35cf4308f227727986c8e6699ffdcd8;Wed May 21 11:51:59 EDT 2003;Committer;nobu;1;3;3;6;0
a4d277f5544c49b6e39664d2124ae67115e17093;Wed May 21 11:51:56 EDT 2003;Committer;nobu;5;74;64;138;0
062351e6bb492d206c305840f4a69c70efcb5131;Wed May 21 08:48:05 EDT 2003;Committer;matz;6;32;13;45;0
564c80b10a116c49ac0dbcfe620e3f776c0d3845;Wed May 21 04:27:06 EDT 2003;Committer;nobu;6;34;14;48;0
bec6d3b1b9a5fcc4ed37c98814e114066cfcc0a5;Tue May 20 10:02:06 EDT 2003;Committer;matz;2;7;0;7;0
56a4cc27edbe89dc65147a6a5f667cb838cfabc3;Tue May 20 08:40:50 EDT 2003;Committer;matz;2;7;2;9;0
fdc0d3306c856a604e5add86696173f21d8bb9c6;Tue May 20 08:18:16 EDT 2003;Committer;nobu;2;13;2;15;0
b614db0432aa9ab228cc4eca773fdc30ec6c900a;Tue May 20 06:48:04 EDT 2003;Committer;eban;4;25;5;30;0
82cf98939f76cb0af206571b50ea81746bfeed7f;Tue May 20 06:29:23 EDT 2003;Committer;matz;8;83;28;111;0
3b68b107e9a58e8e42241a7a1330fe9843c8cdbb;Tue May 20 04:32:52 EDT 2003;Committer;usa;2;22;11;33;0
7f425b216b18f44489c46cadcc7186ba4f04cbb7;Tue May 20 01:51:32 EDT 2003;Committer;nobu;3;100;36;136;0
340e5082e23d731695a6156e5259caa3ded77b4c;Mon May 19 18:46:57 EDT 2003;Committer;why;3;3181;1488;4669;0
f5b2e6b149d13213b7f72df0e2b02d3f86b74ee1;Mon May 19 16:37:20 EDT 2003;Committer;why;5;77;69;146;0
6f55b686819f214416425f2cf44b90d0642aaea9;Mon May 19 16:05:18 EDT 2003;Committer;eban;1;3;3;6;0
9ac15a773dac304e4bb2617ad719b050085d914f;Mon May 19 15:54:37 EDT 2003;Committer;matz;2;6;1;7;0
7e35911e105409fabe48dc2a6214479b6a6ffa24;Mon May 19 15:45:46 EDT 2003;Committer;matz;10;149;68;217;0
e08bc0a22ae6c2d2ac0664d82675ca81a30df607;Mon May 19 07:11:48 EDT 2003;Committer;aamine;4;11;0;11;0
db0b2bb24174aa7d960c01f63d2ac637f24ebbfb;Mon May 19 06:27:06 EDT 2003;Committer;matz;3;9;2;11;0
6e52d10fe63fa99b6bfb12e5abb232c1165c804f;Mon May 19 05:41:08 EDT 2003;Committer;matz;12;61;55;116;0
81882bac13c17769128552d983ba05bb0926d0fc;Mon May 19 05:05:17 EDT 2003;Committer;aamine;1;1;0;1;0
3c9389778f9f59340ad0ded1de08489fc1802c96;Mon May 19 05:01:17 EDT 2003;Committer;eban;1;3;3;6;0
f4ff7ccddf1f7090e23234d6cb37c17c617b4cd2;Mon May 19 04:52:55 EDT 2003;Committer;matz;4;49;10;59;0
f50984366b923176b4e5f10efd87e0a85829afa8;Mon May 19 04:48:57 EDT 2003;Committer;aamine;2;13;6;19;0
fd2f7ab576b71f4c40def22d30109e544553a93a;Sun May 18 23:13:15 EDT 2003;Committer;tadf;3;11;9;20;0
03f8ef900a3640f077b96617baf4881300d25ae9;Sun May 18 15:30:32 EDT 2003;Committer;tadf;2;6;2;8;0
7e190d7568c93e0f0d5397629f426780d608016c;Sat May 17 13:49:08 EDT 2003;Committer;suke;6;38;3;41;0
8d67caddea374eee9f95a127767a55dd1626bd4b;Sat May 17 12:15:27 EDT 2003;Committer;eban;1;3;3;6;0
25fd1d7ff2de52b8670b50be68a5d09a5ddedd38;Fri May 16 23:28:31 EDT 2003;Committer;matz;4;47;10;57;0
ae8463b03c8882da342f0d4318175ab950280f0b;Fri May 16 17:19:41 EDT 2003;Committer;nobu;2;7;2;9;0
e9d1dd838844b1205b62918058d1d2fd0d62ddd5;Fri May 16 15:18:14 EDT 2003;Committer;nobu;2;42;15;57;0
6cbcafb9b953308f62c9d54ed3283fe4ddf002d5;Fri May 16 05:13:17 EDT 2003;Committer;matz;3;19;16;35;0
c601cf5318c035460250284057a62b7eddcb79fc;Thu May 15 21:46:47 EDT 2003;Committer;why;6;197;172;369;0
d8bd0ea32ed5952ea4052d48a1142f27e5c1af74;Thu May 15 10:23:52 EDT 2003;Committer;nobu;1;145;145;290;0
131c29ffff862728d02cbbde473ae789e84630fe;Thu May 15 09:48:12 EDT 2003;Committer;akr;2;19;0;19;0
068170e47ac498d4c905bae04fe55c5addf05d64;Thu May 15 07:57:07 EDT 2003;Committer;matz;3;35;19;54;0
42fd4ff686071388417a5533a6d86d75f89ecbdc;Thu May 15 07:38:10 EDT 2003;Committer;why;4;603;580;1183;0
d81342e3afc0fda6fc4d44bd431fc693901c0f30;Thu May 15 04:47:24 EDT 2003;Committer;usa;1;3;3;6;0
c92a8f21a62539a3f8811a952ae6c6a80570aa70;Thu May 15 04:27:14 EDT 2003;Committer;matz;2;19;2;21;0
2046e06513f6998359174ccd8e46fba3acef9fc4;Thu May 15 04:20:31 EDT 2003;Committer;matz;3;14;92;106;0
8bdfa739ad8ea1e57fbfc30d88ef6ade328ae4fe;Thu May 15 00:52:28 EDT 2003;Committer;usa;2;9;0;9;0
277d89447adf85d01f624675db3174189fa0a68a;Thu May 15 00:33:57 EDT 2003;Committer;usa;2;30;6;36;0
f5a6a36471123985aa452b6c03d1667c4e447d29;Wed May 14 20:01:09 EDT 2003;Committer;why;8;198;115;313;0
cf13323ff4bd0214fed144907637bd149f283989;Wed May 14 11:47:24 EDT 2003;Committer;eban;1;3;3;6;0
1b92c12743b02a1d311fc3fa6678afeb68e25752;Wed May 14 10:57:42 EDT 2003;Committer;usa;2;9;1;10;0
d0507efdc1980651d310ee35da1d468e967f3bca;Wed May 14 09:44:14 EDT 2003;Committer;matz;3;7;3;10;0
ee6a0ecbcb7787d2ccbfdc33721f9ee9cf85c2e4;Wed May 14 03:20:16 EDT 2003;Committer;aamine;2;6;1;7;0
445c938f7bb3428a1406e8e40888805357e83d10;Wed May 14 00:11:25 EDT 2003;Committer;aamine;2;24;30;54;0
17f705e8cd357158916481eb2a8f13e0f91f2299;Tue May 13 22:29:52 EDT 2003;Committer;why;10;75;18;93;0
bee670e33a3b42cd6783ef40e7a6e3ee2cd41c6b;Tue May 13 16:25:41 EDT 2003;Committer;eban;1;1;1;2;0
43b1770ed6debca4a3f037b787497e82241b493d;Tue May 13 11:41:19 EDT 2003;Committer;eban;3;10;6;16;0
e4ada45df17a2ccda0073db6fc586ee1641337e4;Tue May 13 11:34:48 EDT 2003;Committer;eban;2;9;1;10;0
161e19ded988df158b4bec5fca0f4f977fa581e8;Tue May 13 08:59:36 EDT 2003;Committer;usa;5;11;0;11;0
bd810795c589a81e8939b53ad921f823e7133ee9;Tue May 13 06:34:18 EDT 2003;Committer;why;10;435;401;836;0
cea30a129ac3e25d1f45947b346788aeff8ee4d6;Tue May 13 05:55:17 EDT 2003;Committer;eban;1;3;3;6;0
5e8a9873a2c7d40444af807d3a5aa374a2514d48;Tue May 13 05:53:08 EDT 2003;Committer;matz;6;127;57;184;0
e44e2ef2e84012bd842228c8b86de776a9a334d6;Sun May 11 06:32:13 EDT 2003;Committer;why;4;121;91;212;0
0b5d8d2d664a544e524a40082affa7c8aa0bc44d;Sun May 11 04:53:57 EDT 2003;Committer;akr;3;19;12;31;0
93aa87568b5fcd0fd03dd8c9f6fed5ed46e23891;Sat May 10 20:53:58 EDT 2003;Committer;akr;2;28;5;33;0
4b25d0d2cb5e47907c3586ba86646b25bd25ceaf;Sat May 10 19:55:18 EDT 2003;Committer;why;8;1000;149;1149;0
b2bb895aab7422fd95ce883be5b19d2f82981da5;Sat May 10 09:59:11 EDT 2003;Committer;uema2;3;28;71;99;0
45278aeb762beec8d9611cb55b682f13253ae4b1;Sat May 10 09:43:54 EDT 2003;Committer;eban;1;1;1;2;0
304a99ff6511593385240b0d53904374822a2dee;Sat May 10 09:29:26 EDT 2003;Committer;eban;2;14;0;14;0
46b2fa3ef406a34452ab96632e3b84f40a57e09f;Sat May 10 07:55:57 EDT 2003;Committer;shugo;1;9;9;18;0
afb9ea97eabeba2fce78e79e6b887e3a0c432d88;Sat May 10 07:19:35 EDT 2003;Committer;shugo;2;151;0;151;0
55f4dc4c9a5345c28d0da750d1ee00fbb0870885;Fri May 09 21:25:50 EDT 2003;Committer;why;25;7962;0;7962;0
605adb86e2c2889c13e07cadf328f8032eebae7c;Fri May 09 12:34:54 EDT 2003;Committer;nobu;1;3;3;6;0
4870c89f777c8ae4403e9127a4df9f9c06cb5995;Fri May 09 08:12:52 EDT 2003;Committer;matz;2;46;2;48;0
13230a3417e37edaf5cdfaedafde5b7e19a34e6e;Thu May 08 09:45:52 EDT 2003;Committer;matz;4;15;14;29;0
698a24674eb0707fdc8d934084932e845db955cd;Thu May 08 03:56:12 EDT 2003;Committer;nobu;4;55;40;95;0
908300d44f0d072d4ef2e6813794aa9170b9f618;Thu May 08 00:22:26 EDT 2003;Committer;nobu;1;3;3;6;0
89c25a3dd633f8cbb788be42d84f0ad06b768b51;Wed May 07 23:56:11 EDT 2003;Committer;nobu;2;29;4;33;0
a03dd84dbc7844f33d90aeee867de14ed4fb9a8d;Wed May 07 06:10:14 EDT 2003;Committer;eban;1;3;3;6;0
e49203726e2d6feee19d46d12bd93a1fe948248d;Tue May 06 16:48:51 EDT 2003;Committer;matz;3;7;5;12;0
3f8d7303c18a9a3de1438dfa7299d2e71bbab031;Tue May 06 13:18:26 EDT 2003;Committer;shigek;4;41;46;87;0
273a14a44cd790874e94bb7335eeea687477fe3e;Tue May 06 08:48:51 EDT 2003;Committer;aamine;2;24;26;50;0
01ca1341da8bfbd9826b03525f113349d8ca3ccd;Tue May 06 08:25:46 EDT 2003;Committer;aamine;2;6;0;6;0
9a01d2aea0f384112f72514739e17f7db1c8c543;Tue May 06 08:21:36 EDT 2003;Committer;aamine;1;6;0;6;0
6ea61fce292a9bdead1032777d4cdf8413898ed7;Tue May 06 07:10:02 EDT 2003;Committer;eban;1;3;3;6;0
7752fb4205ecf5de2021a7924c213516c8a8d858;Tue May 06 06:51:31 EDT 2003;Committer;matz;13;128;26;154;0
6154ce97a7915ac70326c007ee04a22fe5742e04;Mon May 05 14:02:14 EDT 2003;Committer;tadf;3;8;2;10;0
b65e3629dad9fba8f37202d3dc0103d9d08c1396;Mon May 05 10:05:11 EDT 2003;Committer;eban;4;12;4;16;0
79f7c2b1b69fa8eb3d6aae5c881c9ac3015001fb;Sun May 04 16:44:05 EDT 2003;Committer;eban;1;3;3;6;0
f595d5b0d24d9b0323aba79ae07a6e1c9dbfbe36;Sun May 04 16:03:24 EDT 2003;Committer;matz;12;241;98;339;0
f001f2f6d584d948b9b321171875ee872048df23;Sun May 04 10:14:07 EDT 2003;Committer;tadf;2;19;15;34;0
55d98580600f577a780f7955bfa5111fa018bf84;Sun May 04 06:18:19 EDT 2003;Committer;aamine;2;6;2;8;0
af9bb04a6fe879f8208de99b5d080b9f4b602325;Sun May 04 06:04:03 EDT 2003;Committer;aamine;2;12;8;20;0
49cd34df39ba022e32d40239ec2e36d570ac01d6;Sat May 03 02:17:26 EDT 2003;Committer;suke;1;26;2;28;0
4c26b23dbb944cc4848b8b9a5cab00815a635b44;Fri May 02 16:11:48 EDT 2003;Committer;matz;3;32;6;38;0
e221d6826a67e6e2fc3e12303e4e070452069b2e;Fri May 02 15:19:20 EDT 2003;Committer;aamine;5;24;3;27;0
e3056c880364f5cb79eb9280b4d34b34c3eb4f93;Fri May 02 14:35:01 EDT 2003;Committer;aamine;5;651;638;1289;0
fd5f913f333dbdca213c2adffe5b680aa9915eac;Fri May 02 09:20:21 EDT 2003;Committer;matz;2;18;5;23;0
c9356d82bc56fae5858f0cbdb9078637ed3c779b;Fri May 02 08:42:00 EDT 2003;Committer;matz;2;10;3;13;0
954ba9bab249a3492c70b583aa47a3f7656a3afd;Fri May 02 08:24:43 EDT 2003;Committer;matz;2;96;119;215;0
7c08de46cde52513e54edc893346c5bb4958b00c;Fri May 02 06:43:35 EDT 2003;Committer;eban;1;3;3;6;0
776e2693e738975b2bdbeb1ec43e4993a5520665;Fri May 02 06:41:33 EDT 2003;Committer;matz;8;127;93;220;0
f701792f6f5d21a3762aec4a23a2b134e52ab94e;Fri May 02 06:07:54 EDT 2003;Committer;aamine;3;195;206;401;0
fa0108a9a34b5ebef22e5decc928b343de22c453;Thu May 01 02:50:10 EDT 2003;Committer;eban;1;4;4;8;0
4bdf9a6c61bdbd3ff9402e7dd5626648532bd8d6;Thu May 01 00:00:37 EDT 2003;Committer;matz;3;11;2;13;0
d9d40c0d797ef6e94886c2dced746eeb7c335eb1;Wed Apr 30 05:50:24 EDT 2003;Committer;shugo;2;91;0;91;0
2f25f8680e4d3bc83b037447674c12a470bb7c98;Sun Apr 27 14:20:31 EDT 2003;Committer;nobu;1;3;3;6;0
93695ed08a6e8f35aa7d26b3f4aa7d546a921e70;Sun Apr 27 14:13:25 EDT 2003;Committer;nobu;2;8;0;8;0
38bde8a9e0487db2eeb59227ae90d4391fbf0663;Sat Apr 26 14:59:19 EDT 2003;Committer;matz;3;15;17;32;0
5f0df5186540dd5a6f11063f6e420c86636b235d;Sat Apr 26 05:25:30 EDT 2003;Committer;uema2;34;1951;3660;5611;0
6068cd754095d7f0742438ffd21d201775eda229;Fri Apr 25 12:19:19 EDT 2003;Committer;eban;1;3;3;6;0
de57d0601540864a9f88b466ddbf045fb6c930e2;Fri Apr 25 09:45:43 EDT 2003;Committer;uema2;2;5;1;6;0
60be77013646a8819276a5e3da1ae80b7bc35d8a;Fri Apr 25 09:41:08 EDT 2003;Committer;matz;2;8;13;21;0
a268f439f21477489a1072e23ed564a6bb0bd4ae;Fri Apr 25 09:20:51 EDT 2003;Committer;matz;3;11;46;57;0
d47be3973548e80112955be57a3e256331235ac9;Fri Apr 25 08:54:52 EDT 2003;Committer;matz;2;75;47;122;0
aaebe679198ee8e701e8036d19c497f232a5c566;Fri Apr 25 08:37:33 EDT 2003;Committer;shigek;1;30;30;60;0
0df57ab54767e90e09da834348bd774d87d770e8;Fri Apr 25 00:54:01 EDT 2003;Committer;shigek;6;0;12;12;0
dd8c12962464f7582ddb53f97dbe789add80110b;Thu Apr 24 22:51:46 EDT 2003;Committer;dave;2;9;2;11;0
caea614d4a6222c615fbb99710556f23f51711f8;Thu Apr 24 20:25:45 EDT 2003;Committer;dave;2;12;5;17;0
033ea1c46459c258f6b8854641cdeb84ed8edc30;Thu Apr 24 20:10:02 EDT 2003;Committer;dave;2;5;1;6;0
8d73177ad930f766152984ba8a0dd414d0294860;Thu Apr 24 13:41:29 EDT 2003;Committer;shigek;6;12;0;12;0
cff57b4a267b61561b04c527b5ce04d64cbcf78b;Thu Apr 24 13:37:32 EDT 2003;Committer;shigek;7;137;136;273;0
558c428b72e666a58d6819cb45b63e75f15ae537;Thu Apr 24 13:32:30 EDT 2003;Committer;shigek;2;2;1;3;0
782d0f0d32663c1adc2b9a9f4b3523665daf23e1;Thu Apr 24 13:31:20 EDT 2003;Committer;shigek;1;1;1;2;0
ab6e5c655ca15457c0ce1be10a16b958994ca2f9;Thu Apr 24 10:49:57 EDT 2003;Committer;eban;2;13;1;14;0
8e19c02e8f14be0254e7a3978cce6ff07677abd2;Thu Apr 24 06:08:32 EDT 2003;Committer;nobu;2;18;3;21;0
1de4203c5150088bd795d04e0f6fc4dd75ac00f3;Wed Apr 23 06:31:29 EDT 2003;Committer;matz;4;13;5;18;0
c6c5771e50ecc68e6e7f20fa051a7d1b9ba8f96a;Tue Apr 22 23:39:32 EDT 2003;Committer;nobu;2;5;1;6;0
5c4c320c81873df388acfd806336eb51d9e9229a;Tue Apr 22 16:29:47 EDT 2003;Committer;seki;1;3;1;4;0
a16fc220ca2c65ae5d9108fb23c69146d82234ee;Tue Apr 22 11:58:08 EDT 2003;Committer;uema2;2;8;0;8;0
aede0cf378b29b13b701ba23d45a123bda00c7a2;Tue Apr 22 10:08:57 EDT 2003;Committer;nobu;2;65;17;82;0
b4945ec14135e6b1280ca93f2371e346351850ce;Tue Apr 22 08:47:21 EDT 2003;Committer;eban;1;4;4;8;0
f550e69efc38c659575e0bca179475ddb714cddd;Tue Apr 22 08:18:19 EDT 2003;Committer;matz;4;18;14;32;0
808e9289e6031eba0241e7be159669f8fd0073a3;Mon Apr 21 21:14:08 EDT 2003;Committer;akr;3;34;7;41;0
3939629ddf939e62a5811ffa1f067f0efbc961a6;Mon Apr 21 13:02:08 EDT 2003;Committer;nobu;2;5;1;6;0
71e0bb92d13af4f8aabb79689a3a7edb81b6680a;Mon Apr 21 12:26:08 EDT 2003;Committer;nobu;5;32;28;60;0
3819849ac195b9034e0cb9f6101978adfc18b6f0;Mon Apr 21 09:36:31 EDT 2003;Committer;nobu;2;6;1;7;0
05ebd131cf45588e9225aa0ecdf3c7ec28138f47;Mon Apr 21 08:44:38 EDT 2003;Committer;nobu;2;45;15;60;0
7e1d69f231ca1de06ee629b0d24d56258067d2e3;Mon Apr 21 08:17:18 EDT 2003;Committer;matz;3;8;2;10;0
472672dfe6e968c41c16b81c8db3f0f73d2f825f;Sun Apr 20 15:52:56 EDT 2003;Committer;eban;3;13;5;18;0
3f0eab216fb87faec688f772ad7c6cc13b5fdefd;Sun Apr 20 15:11:20 EDT 2003;Committer;nobu;2;69;6;75;0
b7e6fc019cff276f04a076d094561b997facf83d;Sun Apr 20 14:35:41 EDT 2003;Committer;eban;4;13;5;18;0
4b0276d818c5d3095a3a0c3ca17cabf61d6cea6c;Sun Apr 20 14:14:03 EDT 2003;Committer;aamine;1;1;1;2;0
c43dc6596da9b5476525cdfd99335d063dfdf1f2;Sat Apr 19 18:20:26 EDT 2003;Committer;eban;1;4;4;8;0
534c5a29107b741cd322fe0dee17146de6e84087;Sat Apr 19 18:17:59 EDT 2003;Committer;eban;3;7;2;9;0
f7b5d336208e64a1b95dc403ee902157783bfdc3;Sat Apr 19 13:02:59 EDT 2003;Committer;eban;1;3;3;6;0
ef3c974c89ce66907c62e83db102cc4724c8e739;Sat Apr 19 12:55:59 EDT 2003;Committer;knu;7;11;9;20;0
6987b0806e970c7e4b19800c2a2effc290947b78;Fri Apr 18 18:05:11 EDT 2003;Committer;matz;6;60;16;76;0
18cdaa6828045306da4aa95f3828f634a8c9d0ee;Fri Apr 18 07:22:46 EDT 2003;Committer;eban;1;3;3;6;0
8836a1d2654d7ee8eddc14065a1028b15d49b53f;Fri Apr 18 06:27:53 EDT 2003;Committer;usa;2;6;0;6;0
694059769211a571169e9e7b7707668981631548;Thu Apr 17 16:49:23 EDT 2003;Committer;nobu;2;82;55;137;0
57c6f017a02da946781589924595e2f67375131a;Thu Apr 17 14:00:42 EDT 2003;Committer;shigek;1;14;1;15;0
e07677d30835819be5733ac53c118879ea10ac1b;Thu Apr 17 05:41:27 EDT 2003;Committer;usa;3;15;0;15;0
457e29ad1416fe2365a23a3bada569f9e02d50c3;Thu Apr 17 05:24:11 EDT 2003;Committer;nobu;1;3;3;6;0
ecdf51dfc405ec0f9505caef7abb13be163cd926;Thu Apr 17 05:22:40 EDT 2003;Committer;nobu;2;39;1;40;0
05654dddc4837ba93d8d76dea83e6d261c9d091a;Thu Apr 17 02:14:23 EDT 2003;Committer;eban;2;7;3;10;0
4cec316bbc464c936639d198b73b1588f036c3bf;Tue Apr 15 15:14:15 EDT 2003;Committer;nobu;2;7;1;8;0
cd74de7314503ad640f18916c88d57eb9f2d0188;Tue Apr 15 10:28:04 EDT 2003;Committer;aamine;2;6;0;6;0
93db1877cf2833b058252e18f3eabd97f6065426;Tue Apr 15 10:22:03 EDT 2003;Committer;nobu;1;1;0;1;0
df61e2aad698c74e1c98c01f5456856fcbcf46b6;Tue Apr 15 10:12:25 EDT 2003;Committer;nobu;2;22;0;22;0
d79a04f0d455d3ec54b0669bef0fd5b73b9d2f1a;Tue Apr 15 08:02:09 EDT 2003;Committer;eban;1;3;3;6;0
fae5cc75fabb394bede13a01d50cd504a3077e0d;Tue Apr 15 07:05:15 EDT 2003;Committer;nobu;2;6;1;7;0
7a332f23ce609f6c2e224d030135db7df4af5d66;Mon Apr 14 10:46:00 EDT 2003;Committer;nobu;2;7;0;7;0
f34f20ebc5ef12d37315d8228ba21b6cd4bcb9a1;Mon Apr 14 09:04:43 EDT 2003;Committer;matz;6;42;23;65;0
0b4c9491ec5eba33edd2cebb591d7531b7b54d76;Mon Apr 14 06:57:37 EDT 2003;Committer;nobu;1;3;3;6;0
3f4472433d09fbeedaa9c41c7d76eb1299e31638;Mon Apr 14 06:54:27 EDT 2003;Committer;nobu;5;98;69;167;0
d39d90f86ae5b61530dd76689921f31505290272;Sat Apr 12 18:24:55 EDT 2003;Committer;eban;2;5;1;6;0
f79b715829b5a96c6c3b160c347d03345f14dfa4;Sat Apr 12 12:03:26 EDT 2003;Committer;nobu;1;1;1;2;0
6cdf714126ee1c3a00b49f87e282ce8d31123179;Sat Apr 12 11:59:45 EDT 2003;Committer;nobu;2;163;128;291;0
6e4a83c0a3d631593260b0b9c75f8ea08a44e6be;Fri Apr 11 10:02:37 EDT 2003;Committer;nobu;2;13;6;19;0
fd0fdbe90880a202b8570760a81e6952e6980170;Fri Apr 11 06:56:13 EDT 2003;Committer;nobu;2;26;0;26;0
76d7e7d54c16cd4cc151fdb7d0de43c8f6c13770;Fri Apr 11 06:37:48 EDT 2003;Committer;nobu;2;43;20;63;0
a700bcfafa78cc719cc5e758cbbd20076bee6adb;Fri Apr 11 05:49:34 EDT 2003;Committer;matz;2;8;5;13;0
1fab5e27c3dfe4d229510d27b2562f5aa904558c;Fri Apr 11 03:21:08 EDT 2003;Committer;eban;1;3;3;6;0
4347eb8a7f4e4bd17396df691f82250cbd887da2;Fri Apr 11 01:51:14 EDT 2003;Committer;nobu;2;6;1;7;0
0b984f51a184d1a5714eb8b917f0ddfece2ce08a;Thu Apr 10 17:41:40 EDT 2003;Committer;nobu;2;31;7;38;0
95eb316d448a47d510592a2e2e8bdea16dc748e8;Thu Apr 10 12:15:33 EDT 2003;Committer;aamine;2;6;0;6;0
59dc82ae1afdd2cd7bf4f23b458123c3214aa831;Thu Apr 10 09:48:15 EDT 2003;Committer;tadf;2;8;0;8;0
e74149056bae388e35d4a4cab8cfa38114eb16b1;Thu Apr 10 08:37:12 EDT 2003;Committer;matz;5;55;49;104;0
dc08e8a60f3ea931598f7d240c76ad3f09ae3cef;Wed Apr 09 18:33:52 EDT 2003;Committer;matz;3;10;5;15;0
ae6b9ced18f366e4ae054f8cc6d1eae3bb8cce9e;Wed Apr 09 16:52:28 EDT 2003;Committer;nobu;2;5;0;5;0
769610b6f0c5079fb85d62f534abfd11aad69155;Wed Apr 09 15:56:13 EDT 2003;Committer;eban;1;3;3;6;0
66ca3af2ba570fea4d02004181f4ff337cd012d3;Wed Apr 09 15:45:28 EDT 2003;Committer;akr;3;12;4;16;0
2e10fa962f8b7e93e1e208e22de75820732271c7;Wed Apr 09 15:27:39 EDT 2003;Committer;nobu;2;8;2;10;0
8e09f5b907868d3524e3e0557ca7bdf7cd2d73c8;Wed Apr 09 15:06:57 EDT 2003;Committer;matz;3;42;14;56;0
e5877f1c96b759a7468341c354027638ca7ced33;Wed Apr 09 08:27:01 EDT 2003;Committer;matz;2;40;25;65;0
fcb42a16dc97f2790fb59616e670dd43cc6fd3e3;Wed Apr 09 06:54:36 EDT 2003;Committer;eban;1;3;3;6;0
22af5fa8812d1ac3123dfcbabe3be9d6a93df24a;Wed Apr 09 06:49:51 EDT 2003;Committer;matz;2;5;1;6;0
5cb4133e6719ba8b54f3bb5f838cd548288cedd0;Wed Apr 09 06:44:34 EDT 2003;Committer;matz;5;37;31;68;0
bb4ade0ab6d298837891224d839026cc7c7c988a;Wed Apr 09 06:39:02 EDT 2003;Committer;usa;2;7;0;7;0
db24e481b356aab7a2f589f096f8672b42be42c0;Wed Apr 09 05:08:25 EDT 2003;Committer;nobu;2;26;23;49;0
f92f8b565f2e749c58f0998fdcf6f23d52096fe3;Tue Apr 08 09:02:04 EDT 2003;Committer;matz;3;17;1;18;0
5c9d3fac30ada76110bd0fcd31402e4bd979bb36;Tue Apr 08 05:47:46 EDT 2003;Committer;eban;1;3;3;6;0
ed0b5771084dfed171dc52ff41802f12f9025b92;Tue Apr 08 05:40:29 EDT 2003;Committer;matz;5;29;6;35;0
6acc44d2e458de7c9b8b7cd6c2cea61c80b4e687;Mon Apr 07 07:20:10 EDT 2003;Committer;eban;1;3;3;6;0
e11f6de3c590f5c735fa370b7ad38d1c877d1491;Mon Apr 07 06:58:31 EDT 2003;Committer;matz;6;31;15;46;0
e393f0ad16f1f6646076ae9f38430422a72c800c;Sun Apr 06 09:29:21 EDT 2003;Committer;katsu;1;1;1;2;0
add23cc22ee306d4aa3e2ec04883564554b5f582;Sat Apr 05 15:38:16 EST 2003;Committer;akr;2;6;2;8;0
267b39cfb4e6acb233af8eccda3c30060285a580;Fri Apr 04 11:45:49 EST 2003;Committer;eban;1;3;3;6;0
79557dcbb0198f3f33951835469e47734d0ffb6d;Fri Apr 04 05:12:19 EST 2003;Committer;matz;4;22;5;27;0
75c2f3cbc5ebc106821f71adf43d2b0af0e38dc1;Thu Apr 03 13:24:02 EST 2003;Committer;eban;1;4;4;8;0
c94187bce08dc83ae0c3d30835a73eb6dfe4689e;Thu Apr 03 05:25:00 EST 2003;Committer;matz;7;26;9;35;0
153f513f4906aebb5e4b718b25011ddeb5769810;Wed Apr 02 06:11:28 EST 2003;Committer;nobu;3;10;3;13;0
8d3e57221a6fbd4a5f2aa2b13b32c67678f98853;Mon Mar 31 03:59:26 EST 2003;Committer;eban;1;3;3;6;0
d0932798885381b1160614cdc2562a084f043d67;Mon Mar 31 02:06:23 EST 2003;Committer;matz;3;15;5;20;0
5bfef93c44f00eb7028520e8437e0f957e3cd3b0;Sat Mar 29 11:17:55 EST 2003;Committer;matz;2;13;4;17;0
7c9b9e39bda0587e09d3198e55ea2189201c07b2;Sat Mar 29 08:22:44 EST 2003;Committer;eban;1;3;3;6;0
0977fe17053680310cb0611e9ad2df705d05a070;Sat Mar 29 06:39:50 EST 2003;Committer;akr;12;44;37;81;0
fec60bc7c4f851d0cf1c4670ef8f2d9c597b7598;Sat Mar 29 02:56:18 EST 2003;Committer;matz;8;85;34;119;0
95785964f693e4af9b93513dce3960ebc5aab452;Sat Mar 29 00:50:32 EST 2003;Committer;nobu;2;4;1;5;0
6f19027e4016dde04f41cc7cc58dba968fb4c2f7;Fri Mar 28 17:21:24 EST 2003;Committer;katsu;4;3749;0;3749;0
8a18a837f360557a7172e7a7e3c89a447e0cb1bd;Fri Mar 28 10:33:58 EST 2003;Committer;nobu;1;3;3;6;0
2cefaf671a0d32068ed6c2b35c28f377c4dd209f;Fri Mar 28 10:33:43 EST 2003;Committer;nobu;2;18;1;19;0
15e11a88c67334ea0ebae13cf59889f43d47ee6a;Fri Mar 28 07:50:28 EST 2003;Committer;shigek;2;10;12;22;0
640c19405c8c5c4c982b83184086045295f52e8d;Fri Mar 28 05:15:59 EST 2003;Committer;shigek;1;0;7;7;0
993d361bff304bc4be82e67c1a92256c359527a2;Fri Mar 28 05:08:01 EST 2003;Committer;shigek;6;12;0;12;0
77443517086c68cb51f26f68f5d25279f1be7daf;Fri Mar 28 05:00:21 EST 2003;Committer;shigek;17;6325;0;6325;0
8369db4b3bf760a9a59822104966b78489ee8ada;Fri Mar 28 03:20:13 EST 2003;Committer;gsinclair;1;5;0;5;0
576f18654d2f17384af99b7688cc92d8c009b25f;Thu Mar 27 03:16:23 EST 2003;Committer;akr;2;39;34;73;0
313579f507fc48dd4e5f122f33f5178b2fd535a7;Thu Mar 27 02:23:46 EST 2003;Committer;eban;1;3;3;6;0
1072ad1c2b1c1f55a3677b74f32635d3551a1aaa;Wed Mar 26 18:26:45 EST 2003;Committer;nobu;2;6;0;6;0
d82d9923cbf775e795ea0473b6b1e359c920fb09;Wed Mar 26 11:28:39 EST 2003;Committer;nobu;1;2;1;3;0
7d5435bb1b467c2fbaeaf2dbdddff37b6585c837;Wed Mar 26 11:27:00 EST 2003;Committer;nobu;2;8;1;9;0
54a5eae8a9b00f17b5950a68311eacc0b6ed680b;Wed Mar 26 07:06:21 EST 2003;Committer;eban;1;3;3;6;0
e9b5878c4168ec6b5ed5129d897ee9be7636ca71;Wed Mar 26 07:01:14 EST 2003;Committer;matz;9;113;56;169;0
8478ba513fd23c72b99790144be4fa17ebef3b35;Wed Mar 26 06:23:17 EST 2003;Committer;nobu;1;2;2;4;0
80a97f173f109364b5457b45f53c6d91102c242f;Tue Mar 25 15:25:18 EST 2003;Committer;matz;3;20;6;26;0
cd6f64e37cba29badce8260a68747b54fc6a5f9e;Tue Mar 25 08:30:50 EST 2003;Committer;eban;1;3;3;6;0
0cd7c01c6a4eaea12990fbcbd4d5b7c1a517683b;Tue Mar 25 08:26:08 EST 2003;Committer;matz;3;12;2;14;0
d4db9e9c6091e5763a869792f63006fb0498a1b8;Tue Mar 25 03:11:27 EST 2003;Committer;matz;6;34;2;36;0
2d505ae6f664ab8b5bf7cbff1a59c0c933e59954;Tue Mar 25 01:11:08 EST 2003;Committer;aamine;2;25;19;44;0
ece972717b2e752532b222f03500f23b03280327;Mon Mar 24 09:38:37 EST 2003;Committer;matz;9;175;158;333;0
ab7dac4027c063222ad5e4ea68012020f97c047d;Mon Mar 24 07:56:37 EST 2003;Committer;ttate;4;23;1;24;0
e5282ef182fbd11e2cfd41b752003367320e409f;Sun Mar 23 17:58:57 EST 2003;Committer;matz;6;6;11;17;0
0b7b4c775dc471bf675616dbdd4af9891e29482e;Sun Mar 23 16:47:44 EST 2003;Committer;akr;1;77;76;153;0
94f40186c0b576b4e4ead89d369712990285baa1;Sun Mar 23 15:38:44 EST 2003;Committer;matz;4;16;12;28;0
5aadcd934937f0898fdd3d9bbec3550f65598b98;Sun Mar 23 15:09:07 EST 2003;Committer;nobu;2;5;0;5;0
051eca3268b769aec21ad3c8405f299016d9b330;Sun Mar 23 13:24:45 EST 2003;Committer;eban;2;6;1;7;0
31e2a889a0c203f21336be3b8e1cf19868ef41eb;Sun Mar 23 10:56:37 EST 2003;Committer;nobu;1;3;3;6;0
100074c178ca336b3017f1d2564c70c32ac9d925;Sun Mar 23 10:55:39 EST 2003;Committer;nobu;2;10;1;11;0
8f8a31b0e9972ea9495331980561d548d1ebd72e;Sat Mar 22 06:54:29 EST 2003;Committer;akr;2;27;30;57;0
e689d077e30d4680af140be5549a369590e3db39;Sat Mar 22 04:31:24 EST 2003;Committer;akr;4;18;13;31;0
9b3344c94d527d58886c5774f77d3cec01e472d1;Sat Mar 22 03:46:16 EST 2003;Committer;akr;2;2;2;4;0
cdfb48ea7da4439d12b3a1936ad6d17b221e6740;Fri Mar 21 17:00:59 EST 2003;Committer;akr;3;9;4;13;0
58ef7c20880642c88d06b351f8bbaaa291898e58;Fri Mar 21 15:13:23 EST 2003;Committer;akr;14;56;46;102;0
108cf940d8d617dcabb5e5b17e6315b023ecc301;Fri Mar 21 14:42:02 EST 2003;Committer;eban;1;3;3;6;0
1714176963ccec3a6aa7498c6d2b4ba7139eea3a;Fri Mar 21 14:37:32 EST 2003;Committer;matz;3;21;2;23;0
dfb2c7aa14f8453832e8c8c75e394d1bca6bd570;Fri Mar 21 09:12:25 EST 2003;Committer;nobu;2;5;1;6;0
f83c5da39d1339f8d3ab00be0b214fc65cd69f44;Thu Mar 20 17:01:30 EST 2003;Committer;matz;2;9;1;10;0
3c59330bfea992d86df30aed2181a75ad37aafeb;Thu Mar 20 16:43:24 EST 2003;Committer;matz;2;10;0;10;0
eac185d84881e10244657052a2de12d871f1ca94;Thu Mar 20 09:33:40 EST 2003;Committer;nobu;1;1;1;2;0
d666a5183c3fd8500f0a9514be81d70a37918ac2;Thu Mar 20 09:31:41 EST 2003;Committer;nobu;2;6;1;7;0
923b68836283cca812491cc5ceafff365b2136a7;Thu Mar 20 07:15:48 EST 2003;Committer;nobu;1;3;3;6;0
0b39cf78fe2d0c4e9dc93eeeec51b5252f2cd944;Thu Mar 20 07:15:29 EST 2003;Committer;matz;2;6;1;7;0
bf12ea0deb5a9019bd4bbd6dfc0970d2714706e8;Thu Mar 20 07:03:22 EST 2003;Committer;nobu;2;36;16;52;0
85dd7bb0ef28fe4ce63641e653d92e42327b0207;Thu Mar 20 06:27:22 EST 2003;Committer;matz;12;685;516;1201;0
5782e5b0006ca5f941e8cdd7101ca07218c9d816;Thu Mar 20 01:48:42 EST 2003;Committer;akr;2;6;2;8;0
5ff36b57be5cdc599f5d4ea3524a65ca4d65433d;Wed Mar 19 14:15:07 EST 2003;Committer;nahi;2;9;3;12;0
b6c5aa09a83e96ca8821c75e81ed2894f83b4d57;Sun Mar 16 03:57:52 EST 2003;Committer;akr;1;5;0;5;0
0eeff37f94ca82353df343d4edeca8316cdec0c9;Sun Mar 16 03:32:40 EST 2003;Committer;akr;2;6;1;7;0
38ceb49b79cbc623efe3b4844faa2a26078d3b08;Wed Mar 12 07:59:28 EST 2003;Committer;eban;3;12;5;17;0
caa55aa13f84e811a01089055c8b5841761565f4;Tue Mar 11 12:52:02 EST 2003;Committer;nobu;1;3;3;6;0
d5ca993bc30083d69923f9da6b170f3eb3337ba1;Tue Mar 11 11:54:30 EST 2003;Committer;aamine;2;8;2;10;0
cacf41f3b65e1812273396950a2eb0781a97f206;Tue Mar 11 11:01:22 EST 2003;Committer;aamine;2;11;4;15;0
2abf664151aa8ea7769d2a6d0c7ebe82bddaba7c;Mon Mar 10 23:03:06 EST 2003;Committer;matz;3;52;31;83;0
eccf9342c753ceeebe9187ac435ceae9ddad3402;Mon Mar 10 15:45:44 EST 2003;Committer;nobu;1;3;3;6;0
bb544954b2679d4bd86fa6da6da29171e65e017a;Mon Mar 10 15:05:18 EST 2003;Committer;matz;4;24;10;34;0
70b55f2018ba19a0a1b516bd7bf8b112cd7ae5fb;Sun Mar 09 16:53:30 EST 2003;Committer;aamine;2;110;74;184;0
ced8bbee7ce905518603bb414d928d608dace621;Sun Mar 09 10:39:50 EST 2003;Committer;eban;3;9;3;12;0
bf115a5e417184eef6601120df974c9b4dbe104e;Sun Mar 09 08:17:02 EST 2003;Committer;eban;4;18;6;24;0
2de2ab3e000c46a8468e2845530f3330dff98b27;Sat Mar 08 07:55:06 EST 2003;Committer;eban;1;3;3;6;0
951e8de1adab0db229dcbe0285643dcadbf4e101;Sat Mar 08 03:54:58 EST 2003;Committer;akr;1;1;1;2;0
e4f5562f17d4a89d1ae20d1914ff9cb1fd9d3529;Sat Mar 08 02:31:02 EST 2003;Committer;nobu;2;6;1;7;0
03e45b46eaa6f91ec337847afbadc1f3c0170e71;Fri Mar 07 13:02:29 EST 2003;Committer;akr;2;18;0;18;0
1cf8e928018a2424bdd8fb602abea143d54c7144;Fri Mar 07 11:45:01 EST 2003;Committer;nobu;2;12;2;14;0
51bea808f37f828a970c65e662c1ca2074fdf43e;Fri Mar 07 06:06:58 EST 2003;Committer;eban;2;5;0;5;0
9d77639f30172b0e3b88ea22df0724df61240161;Fri Mar 07 05:59:42 EST 2003;Committer;matz;9;119;100;219;0
5208fec1cfd93841e0b1a89c42cc2e8692e1aa9c;Thu Mar 06 16:26:43 EST 2003;Committer;eban;1;5;0;5;0
280039eb20e48de88e3664f130820864a361bbd1;Thu Mar 06 15:45:14 EST 2003;Committer;eban;4;61;192;253;0
2b214ff6a356e019f2529a00b0ea258a63a348d9;Wed Mar 05 03:15:06 EST 2003;Committer;eban;3;17;4;21;0
33deae506919c1e676d301d61cc57059009e3ad6;Tue Mar 04 14:13:47 EST 2003;Committer;nobu;1;0;11;11;0
f3bdfcc41662826fce673515e73c9a7bf333bbb1;Tue Mar 04 14:12:19 EST 2003;Committer;nobu;10;121;103;224;0
72dfee9a96069791b888d1596a48ddd07caf5c51;Tue Mar 04 09:31:02 EST 2003;Committer;matz;3;25;0;25;0
f9833b7d5f4cc54193049043e04bf4fcf27b13e6;Tue Mar 04 09:16:17 EST 2003;Committer;eban;2;19;1;20;0
d37e836a58ac1ac680ee8716ab1f0b4fc00a1f89;Tue Mar 04 07:04:11 EST 2003;Committer;matz;5;33;22;55;0
a38c2ac2dd0480502d83ad73fce54f25c993ab91;Tue Mar 04 06:13:24 EST 2003;Committer;eban;4;13;6;19;0
196583d6eb70322e49ec9e54a0925828d3bda6d6;Mon Mar 03 16:20:45 EST 2003;Committer;knu;2;5;1;6;0
904a3a2e28db5ee065e02346ab0ff56aeccc6370;Mon Mar 03 16:18:06 EST 2003;Committer;knu;2;5;0;5;0
10a8d5462b89d0bd431a2a08c36a5fa5ebf97ec7;Mon Mar 03 15:35:04 EST 2003;Committer;knu;2;27;0;27;0
3738f871aa74477e56920f0f43d59b31677db45d;Mon Mar 03 07:34:24 EST 2003;Committer;matz;2;6;0;6;0
6d0b44501edaa1ba10b58c7b9ca430d9a5d4049d;Mon Mar 03 07:20:17 EST 2003;Committer;matz;2;41;58;99;0
6a6d0ad22009c437217eb6aeb4c3750f7a3aaa6d;Mon Mar 03 05:17:39 EST 2003;Committer;matz;7;62;46;108;0
0cd0eab641a16d6e59f424ab3f5fad3550fa54b5;Sun Mar 02 16:42:39 EST 2003;Committer;nobu;2;76;24;100;0
63f3bb891c12cf907ce02884c618c3c76caa23b0;Fri Feb 28 15:01:56 EST 2003;Committer;usa;2;167;49;216;0
a7447572dded7ef0da6687ea5c147692ad755b8e;Fri Feb 28 13:55:07 EST 2003;Committer;nobu;1;3;3;6;0
801406cb5d53a7994bad11419d8bbaf383ea4887;Fri Feb 28 13:54:14 EST 2003;Committer;nobu;2;38;33;71;0
f649db5b16387fa6e6e1b27e95e034156667c25e;Thu Feb 27 11:32:09 EST 2003;Committer;eban;1;3;3;6;0
e5c5576aeb40eb593d02cb00174ae5a8256f19f6;Thu Feb 27 08:04:32 EST 2003;Committer;matz;5;69;38;107;0
780e1aa291d41e065f799e35e02543206f912b4f;Wed Feb 26 08:39:05 EST 2003;Committer;akr;2;5;0;5;0
ecc5c37818a0172152ffdd46e30db8830f4b83b6;Tue Feb 25 14:11:40 EST 2003;Committer;nahi;2;6;1;7;0
8d5ad9c1b30aac5db1230aa0c84c2634faa88891;Sun Feb 23 09:00:51 EST 2003;Committer;eban;2;6;1;7;0
a068f1cc07c1aa4e844cf943502c225e715f8198;Sat Feb 22 06:03:38 EST 2003;Committer;eban;1;3;3;6;0
8327de7c84247eff8e47c1090d9a239b8db1435c;Fri Feb 21 18:02:19 EST 2003;Committer;matz;1;8;0;8;0
77923d719fcdab79ea39c79de96d264caf445f99;Fri Feb 21 11:57:31 EST 2003;Committer;aamine;2;74;46;120;0
ca014ae071bbd6ce820b8907e5191d5a876500a7;Fri Feb 21 09:32:18 EST 2003;Committer;matz;2;5;1;6;0
5527d3ae593a9fd666cd4c894fafd6b2ed2a89fe;Fri Feb 21 08:25:18 EST 2003;Committer;eban;2;5;3;8;0
b3686317a774249c4ff4b7514cba880c9adbd9ca;Fri Feb 21 03:52:27 EST 2003;Committer;matz;2;7;2;9;0
8fc299e8bc5a8c0347597da6b271f21db8f5f3cc;Fri Feb 21 03:33:29 EST 2003;Committer;matz;2;2;6;8;0
973b1eb274a077ba6bebc394e724a2f8a44b71de;Fri Feb 21 01:20:54 EST 2003;Committer;eban;1;3;3;6;0
f11cb2455604040eb09c19830291795f4838a88b;Fri Feb 21 00:28:04 EST 2003;Committer;matz;2;47;50;97;0
64db238388ecf74d3d2e26524bb5d0f6eb70f152;Thu Feb 20 20:40:20 EST 2003;Committer;matz;4;41;12;53;0
697462490a8099a765e34523e30867e4ca65a202;Thu Feb 20 14:15:57 EST 2003;Committer;knu;1;3;3;6;0
2cd6d0f5971b3b5b5d7178e2e7b44b718b4bd36b;Thu Feb 20 10:09:31 EST 2003;Committer;matz;3;13;1;14;0
79d91e36081423ef090c84825b3c5e6ace87d44b;Thu Feb 20 09:44:54 EST 2003;Committer;nobu;2;11;2;13;0
42de8af413596a544c5438222260d3a16483be8e;Thu Feb 20 09:11:05 EST 2003;Committer;nobu;2;41;13;54;0
db0539c4479eb7c6a1848e606ed570d0c48dc607;Thu Feb 20 06:49:00 EST 2003;Committer;eban;3;8;4;12;0
2e13a4ff3770b5328936e4f21685f679ae0b6f81;Thu Feb 20 06:23:39 EST 2003;Committer;nobu;1;1;0;1;0
d88376b1352ad96e35bfc08f2bfce885ed6d72ca;Thu Feb 20 03:35:44 EST 2003;Committer;matz;5;107;35;142;0
afca4f0cfd0bcc769451d5160320c7a33b3c4ed1;Wed Feb 19 16:27:47 EST 2003;Committer;nobu;2;7;1;8;0
0b78e04234ee5cd79c9d7a11c215450816ee805f;Wed Feb 19 09:40:49 EST 2003;Committer;nobu;1;3;3;6;0
884efe7c5ecfe5bf0621008b7a535729b4c07b97;Wed Feb 19 09:27:49 EST 2003;Committer;nobu;5;93;24;117;0
d22fc7c4d8849c86774b049bd6ef02005187c671;Tue Feb 18 14:51:12 EST 2003;Committer;eban;1;3;3;6;0
ddd9d609dca9844e1d62ef4dd58f5d62c9bebc0b;Tue Feb 18 14:30:17 EST 2003;Committer;matz;5;37;4;41;0
b4f940b76799a3cdcc5a39f34dfadd76e83bbd2f;Mon Feb 17 15:13:54 EST 2003;Committer;nobu;2;198;45;243;0
d019ce0ad1b8e55e511427193b1ccb391d865ef9;Mon Feb 17 05:36:59 EST 2003;Committer;nobu;2;7;3;10;0
396f32c98eeef66f67c87336deab94774db00650;Mon Feb 17 05:17:46 EST 2003;Committer;usa;3;103;1;104;0
c510198c3bda2e4c1554a2926c3803c84c9f6b94;Mon Feb 17 04:30:38 EST 2003;Committer;nobu;1;3;3;6;0
b97db4b7ad98d0ad5cdd4a842482e1dabd3826cf;Mon Feb 17 04:29:14 EST 2003;Committer;nobu;1;5;0;5;0
8fe2085eb774e216da8298eaf922c1c928a49905;Mon Feb 17 04:27:45 EST 2003;Committer;nobu;1;7;8;15;0
d0d70d648d7ef2a8c1de2f141b1ab5cda109d561;Sun Feb 16 10:22:36 EST 2003;Committer;nobu;3;59;46;105;0
2f7275db779be068e3401376224601251f01046b;Sat Feb 15 18:16:52 EST 2003;Committer;eban;3;24;3;27;0
f2d07eb82dd00174c15a10cd9a2e1bcdc0eb668e;Fri Feb 14 16:09:07 EST 2003;Committer;nobu;3;40;17;57;0
bfa0275833b60de39c8f890d6f47045d1ef4b26e;Fri Feb 14 05:32:48 EST 2003;Committer;akira;6;33;10;43;0
246800d42bf1cb6d2031491ebb26c999b19ddeea;Thu Feb 13 09:58:57 EST 2003;Committer;nobu;3;15;9;24;0
937092b8203c373c919a6f307f91e17d4bec5bb1;Thu Feb 13 09:11:11 EST 2003;Committer;matz;7;36;4;40;0
050f2d84603bd9b3761f1e498f81ce74719caeea;Thu Feb 13 03:02:19 EST 2003;Committer;nobu;2;10;11;21;0
2f7ee35065368d71d4225842f02ecdaddba6a44e;Thu Feb 13 00:59:22 EST 2003;Committer;nobu;1;3;3;6;0
2f6595c1edc2b7768a814e4cf2651c1da4e7cede;Thu Feb 13 00:59:00 EST 2003;Committer;nobu;2;18;11;29;0
168f2f470f42033364fe374f199a4beb8180baec;Wed Feb 12 16:30:13 EST 2003;Committer;nobu;2;8;1;9;0
4ef1062c6f0b26d8976eba8c8f227e18ba7c6a15;Wed Feb 12 15:10:51 EST 2003;Committer;nobu;2;7;1;8;0
6f780a30fcee86f2169eb9dc7220dee0df29ea38;Wed Feb 12 14:56:49 EST 2003;Committer;nobu;1;3;3;6;0
7dd303419e4a07aacd2138a10297470cc2b2474d;Wed Feb 12 14:56:45 EST 2003;Committer;nobu;2;121;83;204;0
04f2b8f7bf16ad37d3c28f0e06eb02d63ab6a731;Wed Feb 12 03:12:14 EST 2003;Committer;ntalbott;23;2337;0;2337;0
4a44a6d474cc793d75344b3a0e4c9b0031802689;Mon Feb 10 12:01:22 EST 2003;Committer;eban;1;1;1;2;0
986bfd904c239e9aaacde2cb41d892841ccbe0fb;Mon Feb 10 11:59:26 EST 2003;Committer;eban;2;7;3;10;0
dc502aea7e1fb937fef652b4b480c3a416b70365;Mon Feb 10 10:48:38 EST 2003;Committer;aamine;2;7;2;9;0
ab24be4e98660f4fbef44a03262f25988a260b9f;Mon Feb 10 09:40:13 EST 2003;Committer;matz;5;70;3;73;0
b53549941d4d543191c91054e974598b0e29210b;Sun Feb 09 18:36:22 EST 2003;Committer;eban;3;9;4;13;0
7f9964c14eed2e0a1a87d06f31d44bed71fbfa42;Sun Feb 09 06:58:31 EST 2003;Committer;eban;1;3;3;6;0
8fc90b887bc94ca7a47b8a9e2bb9a2efb8b9007e;Sun Feb 09 06:16:08 EST 2003;Committer;nobu;3;10;3;13;0
7aa4cb1f0670ff02767dfda8b0dd7fb4accb170f;Sun Feb 09 03:28:22 EST 2003;Committer;nobu;2;7;2;9;0
e3ab724e00c6bfecdd7306b3a78044a5975cefa3;Sat Feb 08 23:29:07 EST 2003;Committer;aamine;2;7;2;9;0
9952524a74a70697e9e040afc25e6bdee9e6e906;Sat Feb 08 22:01:53 EST 2003;Committer;aamine;2;27;14;41;0
a9da9667d0c033b28d4017e3dbe997d53bece69e;Sat Feb 08 10:37:43 EST 2003;Committer;akr;1;2;2;4;0
8f9e39b14162fdb8d70ca4b2d82d0ae5bba64138;Sat Feb 08 09:57:32 EST 2003;Committer;nobu;1;3;1;4;0
075e9a5555f810fe57af08ef7a064152f706aac1;Sat Feb 08 09:35:36 EST 2003;Committer;nobu;2;12;4;16;0
718b4e9ea018afd023a9e82251954d10814c0244;Fri Feb 07 19:00:21 EST 2003;Committer;knu;10;43;35;78;0
916f41d7175e67d2c9bfa022dd4cc94094c94960;Fri Feb 07 18:47:06 EST 2003;Committer;knu;1;3;3;6;0
9a4111c7948e9c95cd58be5796e0787afaff5d81;Fri Feb 07 18:45:54 EST 2003;Committer;knu;1;9;9;18;0
0644ac3f8e2be9fe9025fa9c5b0768f15e31072b;Fri Feb 07 18:37:03 EST 2003;Committer;knu;3;12;0;12;0
59483da886b65acddfc6675dbae15d31c74036cc;Fri Feb 07 09:31:41 EST 2003;Committer;eban;1;3;3;6;0
a4d9a91b96d1c3604af8cb14d4c665112454a3e8;Fri Feb 07 06:36:53 EST 2003;Committer;nobu;1;1;1;2;0
34033db665f806bf37f142171c391c739a9f5409;Fri Feb 07 06:35:26 EST 2003;Committer;nobu;4;13;3;16;0
b89cbf192b09dcdd6df6256a0c8d61e17664e2ad;Fri Feb 07 06:30:18 EST 2003;Committer;nobu;2;6;0;6;0
766f2adb74adbe476e693c0e541ea265c5a62f36;Thu Feb 06 10:06:47 EST 2003;Committer;matz;2;22;15;37;0
f3607247c805ad1f32acfca3ba3eeb844e590e9b;Thu Feb 06 09:56:13 EST 2003;Committer;aamine;2;59;62;121;0
117b4df7c78ccb9437e2f14ecd2cd6f51cb757f3;Thu Feb 06 09:49:12 EST 2003;Committer;matz;3;29;9;38;0
9a4c66277185ea3239f05704c881c72520a6da90;Thu Feb 06 08:40:44 EST 2003;Committer;eban;1;3;3;6;0
e2b92403d5fdb91ed3c7eb26a693c82a4cf4b046;Thu Feb 06 08:25:12 EST 2003;Committer;matz;3;12;3;15;0
da19d16b1c5efa1b2d9076e245ababc5ec9ad2dd;Wed Feb 05 10:44:05 EST 2003;Committer;akr;2;43;46;89;0
5504f490a6a2684bcacadee836c6933243e65a4f;Wed Feb 05 09:58:18 EST 2003;Committer;akr;2;12;1;13;0
b50100a7697f6ad1a26217953d372ea0fcc11682;Wed Feb 05 08:54:42 EST 2003;Committer;eban;1;3;3;6;0
bb7085084e32ad15c51688bf55b841dad4f880a3;Wed Feb 05 08:11:27 EST 2003;Committer;matz;2;8;10;18;0
aa8b38793f86e41ab7ece75010227b2674a622fb;Tue Feb 04 07:40:52 EST 2003;Committer;nobu;1;1;1;2;0
6f83a60747ab690b0265b827319f7af8533d13d5;Tue Feb 04 07:31:08 EST 2003;Committer;eban;1;3;3;6;0
1d5e19f624bc09d66d80ec7bc89db9dbc895b477;Tue Feb 04 07:27:43 EST 2003;Committer;matz;6;38;7;45;0
c46774cdb34e30241d49393c43be254a9bdfd060;Tue Feb 04 03:47:42 EST 2003;Committer;gsinclair;1;148;37;185;0
bed06ae87de4c981f84e15356dc8ea90e48b1b6c;Mon Feb 03 13:52:21 EST 2003;Committer;gsinclair;1;147;3;150;0
41bb73b28a82a957464745e6111b3923e00cd0ac;Mon Feb 03 08:48:32 EST 2003;Committer;matz;2;2;1;3;0
467035750e83a2d532bd8c2c5fb9fd78c1810132;Mon Feb 03 08:45:26 EST 2003;Committer;matz;6;65;41;106;0
056585d6dc58c4b9b1e4bf5e58c0bc81b5122fc6;Mon Feb 03 07:34:06 EST 2003;Committer;nobu;2;17;12;29;0
ddce7d5ebf870f437abe10bcc67ce6dbe6c4980b;Mon Feb 03 06:13:51 EST 2003;Committer;nobu;1;3;3;6;0
be6749bd0c0879992dca506bde4ccd3cc032ca24;Mon Feb 03 05:44:48 EST 2003;Committer;eban;1;4;4;8;0
0c90036fd14fd5aef136afccfb38e42c4d3c01e3;Mon Feb 03 05:34:16 EST 2003;Committer;matz;9;108;63;171;0
e58e5cb5caf8aeac402ebe2db617c20beca2c0eb;Fri Jan 31 14:33:42 EST 2003;Committer;gsinclair;1;230;22;252;0
d18922065b186a88a8b37b19779a20a6eb1d9993;Fri Jan 31 06:48:54 EST 2003;Committer;matz;2;28;2;30;0
466d685a76b39695ac20cd9f55957e2e54b7636e;Fri Jan 31 04:16:51 EST 2003;Committer;nobu;1;1;1;2;0
74d5623029b0b8fb987a45190f3a3eac082990e1;Fri Jan 31 04:00:17 EST 2003;Committer;matz;19;92;64;156;0
e474ae633851e9956a94bd96fc40540740a367c0;Fri Jan 31 03:22:42 EST 2003;Committer;eban;2;4;4;8;0
f758195486cbe49c647140a9e1c5623eeebbeaac;Fri Jan 31 03:15:33 EST 2003;Committer;matz;5;31;27;58;0
e13bfb15096a9d12e93055fbe6526d15bc54e20c;Fri Jan 31 00:41:40 EST 2003;Committer;nobu;2;16;5;21;0
1c37352f8a267f7ac5c540ab0b25bd0b56021a34;Thu Jan 30 17:50:37 EST 2003;Committer;nobu;2;6;1;7;0
15805c17aa0dc2d8ebba8446c8a41e74bd4dc473;Thu Jan 30 14:06:33 EST 2003;Committer;eban;1;3;3;6;0
4cad680bc25460dd53035c0af589816baa0b3fa4;Thu Jan 30 08:11:21 EST 2003;Committer;nobu;2;52;24;76;0
b18b4423c9f21f06bfdc13c2430582722981338e;Wed Jan 29 23:28:47 EST 2003;Committer;nobu;2;9;2;11;0
79862de36334225179ee4e462ccb982ea5250800;Mon Jan 27 19:48:02 EST 2003;Committer;knu;3;23;33;56;0
f24b4d0532c94ded83219d03ab991267b4c81bab;Mon Jan 27 12:26:23 EST 2003;Committer;eban;1;3;3;6;0
ec458f636c4437524cf7536e41116ba245f29e11;Sun Jan 26 18:31:03 EST 2003;Committer;usa;2;9;3;12;0
2403d9188daf8bc6d753365bd84bc01ffeb515fd;Sun Jan 26 17:09:16 EST 2003;Committer;usa;2;6;2;8;0
6bdae1594e30829f7645800972f3d0a6567f99f3;Sun Jan 26 10:56:43 EST 2003;Committer;knu;1;9;0;9;0
18caa8f178c971ff61ccc4c5730c657a2bac3e84;Sun Jan 26 10:29:05 EST 2003;Committer;usa;3;11;1;12;0
8b222cea6bcd69b6a854be03f2362c5961b43a03;Sun Jan 26 10:11:30 EST 2003;Committer;knu;1;36;24;60;0
91758efa95b07503a880815ce9d108df6df067e0;Sun Jan 26 08:56:01 EST 2003;Committer;knu;3;38;13;51;0
171df94c2751146c894fe7cb2812020e17c47fc3;Sat Jan 25 22:23:17 EST 2003;Committer;nobu;2;17;3;20;0
3380618f1cf432e89c3abb2e06021fa09069d14a;Sat Jan 25 21:45:31 EST 2003;Committer;nobu;1;9;0;9;0
1f267f1ee5cac23ca05baade186d20f8ad726cf2;Sat Jan 25 21:42:42 EST 2003;Committer;nobu;2;23;19;42;0
78f457a5d57b06e2e28931e46bef2ee64a0de8a9;Sat Jan 25 18:59:34 EST 2003;Committer;knu;6;122;58;180;0
cdc46f0f833cad58fd3a2e3499a6f06a11eebb5c;Fri Jan 24 16:13:33 EST 2003;Committer;gsinclair;1;321;261;582;0
cbd08dbf3b40dcebd5d91c4da85c0cf9196eed49;Fri Jan 24 09:25:12 EST 2003;Committer;eban;1;3;3;6;0
d35979cdfe6192450503da23e6fc77218d09e829;Fri Jan 24 09:18:04 EST 2003;Committer;matz;3;8;5;13;0
69a7d012c406fd47c2416a87da33c7e6b7df81df;Thu Jan 23 20:12:59 EST 2003;Committer;nobu;2;13;16;29;0
333eb8380f00d50c3a1d4d86ada9cc4c879a4053;Thu Jan 23 08:27:06 EST 2003;Committer;matz;3;11;2;13;0
8637a41d2add02b92858073707070798841b1074;Thu Jan 23 06:53:06 EST 2003;Committer;nobu;1;1;1;2;0
5799eb9d5efbfe162abc29328fb2c386827a8ca0;Thu Jan 23 06:50:10 EST 2003;Committer;nobu;2;6;2;8;0
37aa8eeb0b271635e5daac638abb56941bb53f6c;Thu Jan 23 06:42:41 EST 2003;Committer;nobu;1;3;3;6;0
a9ec8adff324bffa6f3cd18620b674e5737ce0bc;Thu Jan 23 06:22:50 EST 2003;Committer;matz;5;67;63;130;0
259ba31d8a9bde12f412ba500d80180022d7416e;Thu Jan 23 04:25:47 EST 2003;Committer;matz;2;5;1;6;0
affe49b23b9295ec30d50c363686324038d09158;Thu Jan 23 03:39:25 EST 2003;Committer;matz;5;102;55;157;0
f4f0be3a12c4fdba190df790c55805142cf71d1b;Wed Jan 22 21:42:25 EST 2003;Committer;nobu;1;3;2;5;0
0505b3889c42697d82de3d9b4565b91a55878de6;Wed Jan 22 21:37:38 EST 2003;Committer;nobu;2;5;1;6;0
0243dab59887193ae86a69d06f25747f21a4235b;Wed Jan 22 14:21:07 EST 2003;Committer;usa;2;41;76;117;0
c80a51e89f0c16c9a444fd0918e359f106401277;Tue Jan 21 19:33:19 EST 2003;Committer;michal;2;11;6;17;0
d67106c081409e9dad99085c90f174f7e1da429f;Tue Jan 21 16:38:42 EST 2003;Committer;gsinclair;1;9;9;18;0
b95357be1a2f971fdd0a3e4514af519037cd19cd;Tue Jan 21 16:06:32 EST 2003;Committer;gsinclair;1;164;175;339;0
064f07ace5916a8b33a4a9824d20376a98edc094;Tue Jan 21 15:15:26 EST 2003;Committer;knu;1;3;5;8;0
3f3ad7e4d5ed4366ec1cf7a68df39c83a2916b04;Tue Jan 21 15:09:12 EST 2003;Committer;gsinclair;1;1;1;2;0
a443067ba2dec25185260857bdb22c5637e263c9;Tue Jan 21 13:52:21 EST 2003;Committer;michal;2;6;4;10;0
32f85f3caa42dd0d896b1d049dd74bcb6b4beb12;Tue Jan 21 13:03:29 EST 2003;Committer;eban;1;3;3;6;0
8a51d2df6e243e3dc17ed34e050c80196d3ce17d;Tue Jan 21 09:05:30 EST 2003;Committer;nobu;2;6;2;8;0
1c770e707762d6737d7f0c297c2fb8b362fa0099;Tue Jan 21 08:12:07 EST 2003;Committer;matz;2;24;0;24;0
ff7e65eb845069ab1d865b61e6fe8a989c41c800;Tue Jan 21 08:03:05 EST 2003;Committer;usa;2;28;14;42;0
fce7467e601e76d64a175929f2f14f89cfd450dd;Tue Jan 21 05:51:41 EST 2003;Committer;akr;5;113;89;202;0
c2dbfe53fc1d34b3c38172bda2a801fc60f26e66;Mon Jan 20 19:54:56 EST 2003;Committer;akr;1;8;0;8;0
d0ea0b4a8dd44a90bdd3cd83ac94fe1ba4aea440;Mon Jan 20 19:17:15 EST 2003;Committer;akr;2;4;24;28;0
f345126746242a7269654a0d9db64f0518462f41;Mon Jan 20 17:58:24 EST 2003;Committer;akr;2;39;65;104;0
1c0641991146d3b0716b583f14aef571696463f0;Mon Jan 20 16:05:47 EST 2003;Committer;gsinclair;1;2;2;4;0
2f2a51a47b5998077e8d148850d5ac32b409f090;Mon Jan 20 15:17:13 EST 2003;Committer;gsinclair;1;43;10;53;0
7828a12f1971d5b722b717112b7f650d62bbc05e;Mon Jan 20 12:51:50 EST 2003;Committer;knu;4;69;7;76;0
244bb8db51a8417e299bed5cea19340a9a30ac33;Mon Jan 20 12:27:53 EST 2003;Committer;knu;2;24;2;26;0
49123e550aa6fa21e6edfa09b58a73178dab5bd6;Mon Jan 20 12:11:35 EST 2003;Committer;seki;1;0;3;3;0
7bd881187db10eabad2ed5d9a829daa98f3b739b;Mon Jan 20 12:10:40 EST 2003;Committer;knu;2;91;18;109;0
9f22034ae016b6091063ca99309c20aa46077a18;Mon Jan 20 11:32:19 EST 2003;Committer;seki;1;74;44;118;0
c1d00ec453cc02e66fb40914e0d2800a7638dd89;Mon Jan 20 10:44:10 EST 2003;Committer;knu;2;318;298;616;0
4a464c1fa244d5f04062fe6547eff211d76c8bc9;Mon Jan 20 10:22:04 EST 2003;Committer;eban;1;1;1;2;0
79847e0b363ae7607cdd00355b20347b91b0ceec;Mon Jan 20 09:22:45 EST 2003;Committer;nobu;2;45;30;75;0
36583aac970ec5d1bee0bb0ac7670c5c371e3f9b;Mon Jan 20 09:01:44 EST 2003;Committer;eban;1;3;3;6;0
198c4f8946f00aa9c72c78eba23ba90ec7610b1f;Mon Jan 20 08:51:18 EST 2003;Committer;knu;2;7;0;7;0
de531fe04c41d02d45d0faca2577401c1dab723d;Mon Jan 20 08:41:26 EST 2003;Committer;knu;1;1;0;1;0
4bf5b5f58894ca3726608bc7eeebd221a5bef0dd;Mon Jan 20 08:39:46 EST 2003;Committer;knu;2;393;0;393;0
496acb03d3181504911d34dd90ac94a1fd562a61;Mon Jan 20 08:32:15 EST 2003;Committer;knu;2;5;0;5;0
d242ae60d8d8bccb8e209130d3bdb1cc41333b8c;Mon Jan 20 08:29:24 EST 2003;Committer;matz;5;55;26;81;0
181edd12a09a76e2443c702ff2e17777fe8cfeb5;Mon Jan 20 07:16:01 EST 2003;Committer;gsinclair;1;375;27;402;0
971d5f8480853b036d40ab9befdb78253c35d195;Sun Jan 19 19:14:22 EST 2003;Committer;nobu;2;18;5;23;0
9e1339a68f606f7c5ab50aac72c37f0d7dd69aa6;Sun Jan 19 17:16:24 EST 2003;Committer;nobu;2;4;12;16;0
81768d1da5a134c735955ec916b67b9851e0a93e;Sun Jan 19 17:15:00 EST 2003;Committer;nobu;1;9;30;39;0
e83f4151398feb42c59971103505206ee37c0dbf;Sun Jan 19 15:19:52 EST 2003;Committer;usa;2;7;2;9;0
4ae8470a48e9491ccccb6f989f0481aa8e8c8e78;Sun Jan 19 14:13:01 EST 2003;Committer;knu;2;7;2;9;0
02e3fb8cf64576ad021486dc6870bae698ec9f81;Sat Jan 18 06:14:20 EST 2003;Committer;eban;1;3;3;6;0
587e7ac7e7b36f80022d3959a0c6b9fa4aaf23a9;Sat Jan 18 05:53:53 EST 2003;Committer;nobu;2;9;2;11;0
b1e4030244ddbaadd22f4ca01512cb22fba1771b;Fri Jan 17 15:17:20 EST 2003;Committer;gsinclair;1;57;24;81;0
99a3e3fdfa4fdeb9c72af7bddebc13fbb7a4c1ff;Fri Jan 17 14:06:27 EST 2003;Committer;gsinclair;1;76;0;76;0
94d28746c2ad68fb18e2238f2a27eb782090e453;Fri Jan 17 09:30:11 EST 2003;Committer;gsinclair;1;136;0;136;0
b63bab709abd4698dcf98c168a425daec8d5384d;Thu Jan 16 18:52:16 EST 2003;Committer;knu;1;3;3;6;0
b4406583e6fe03f92fe2672a7d611359464f9c49;Thu Jan 16 18:48:20 EST 2003;Committer;knu;2;40;11;51;0
0df980f610dcf6b72b3236a1eeb3b77c29978e1a;Thu Jan 16 14:38:04 EST 2003;Committer;eban;1;3;3;6;0
bc9c12fcbc8d2f270d3922a41ae86e8b56780559;Thu Jan 16 11:02:21 EST 2003;Committer;usa;1;1;1;2;0
4e13d36561868d78e9e5ff9b24aba67d418c67ed;Thu Jan 16 07:38:40 EST 2003;Committer;michal;20;35;62;97;0
9df466b287471d386f962ea41cf49c40f2059c8b;Thu Jan 16 07:34:03 EST 2003;Committer;michal;44;45;45;90;0
a973f9698fe0045e3fd494ebb9f85c2f686a9ed9;Wed Jan 15 08:07:41 EST 2003;Committer;matz;3;35;4;39;0
ed8fb0876d09647ac1baf64b3f67cdcb135c7413;Wed Jan 15 06:44:53 EST 2003;Committer;nobu;1;3;3;6;0
08771defc6bec4eedb0d90f5819212121530e6ad;Wed Jan 15 06:29:05 EST 2003;Committer;nobu;3;11;3;14;0
17bb511df2d33f4c344d7aefc2f5dfcd53fdaaf7;Tue Jan 14 12:56:34 EST 2003;Committer;nobu;2;13;3;16;0
6e1f15fc8b7e62360d32bc6ca47b1309d25b7766;Tue Jan 14 07:45:19 EST 2003;Committer;matz;5;76;34;110;0
8c900ac9bfa9566462d96d1f870dff87df81da8c;Tue Jan 14 04:06:14 EST 2003;Committer;eban;1;3;3;6;0
51308528f2e9d7df96d789855d5a0447181a1666;Mon Jan 13 16:24:40 EST 2003;Committer;nobu;2;5;1;6;0
ada8110f7ffd38eb0309b3a9561c1ed993021aca;Sun Jan 12 17:36:24 EST 2003;Committer;eban;2;6;6;12;0
0af783bef40c2a9bd652f2aa70c25a878233cc2c;Sun Jan 12 13:11:32 EST 2003;Committer;ttate;1;3;3;6;0
7af9f795609db767ee6bc9f3862a87f6a6a6f8f6;Sun Jan 12 09:24:28 EST 2003;Committer;eban;3;14;3;17;0
81dded0d178d0c6d9b251da5a1ee132f2e1449b4;Sat Jan 11 17:28:59 EST 2003;Committer;ttate;1;18;18;36;0
3074716cadfffd28432f5bb6a6eef4762555efb8;Sat Jan 11 15:00:56 EST 2003;Committer;eban;2;21;14;35;0
d15f5e8d55834b229f9426fa01e8a6d758baf117;Sat Jan 11 07:06:39 EST 2003;Committer;eban;1;3;3;6;0
4e6dbec8c84961424d5beb9a9d1fb66912a78957;Fri Jan 10 16:47:03 EST 2003;Committer;nobu;3;28;17;45;0
5fd433efbb3481fe13995cb33b27c1b39092e4f1;Thu Jan 09 16:26:43 EST 2003;Committer;nobu;2;10;4;14;0
bd86e81602cb4c5672891f03b61fecdb027256c7;Thu Jan 09 14:46:09 EST 2003;Committer;nobu;2;5;1;6;0
00eedd2da9bb601745002e572dd43d220020849c;Thu Jan 09 08:20:32 EST 2003;Committer;nobu;1;3;3;6;0
99628bf1f0f401ef2ad877675321432ebb9a7586;Thu Jan 09 08:05:32 EST 2003;Committer;nobu;5;59;32;91;0
639ec768584589b8ebfc98dcb41dfe8db76a1aba;Thu Jan 09 07:33:27 EST 2003;Committer;matz;2;6;1;7;0
8916851b50ae368811a896c39246b23f5c4c021d;Thu Jan 09 06:53:38 EST 2003;Committer;eban;1;3;3;6;0
dadb16d894109891f21fb514e6ae11f0f598e14f;Thu Jan 09 06:16:43 EST 2003;Committer;matz;3;59;5;64;0
e29b4b4862f4e3a6a727c407a711939f74124941;Thu Jan 09 04:28:28 EST 2003;Committer;knu;3;13;12;25;0
c65638ce2944e020eac4e80eb760486001e47945;Wed Jan 08 08:12:16 EST 2003;Committer;usa;2;832;0;832;0
d6cba99ea5590944e7b043d64cbbc4e8da57ba69;Wed Jan 08 08:03:45 EST 2003;Committer;eban;1;3;3;6;0
9796a9bc1ca13fe3c30b1199650b238b4e0461b6;Wed Jan 08 06:59:38 EST 2003;Committer;matz;3;26;22;48;0
17065d47a68eaa6a854297b94e4d85d379b23f2d;Wed Jan 08 06:05:08 EST 2003;Committer;matz;4;31;8;39;0
a89ac45548573342400a563b407f13a8d5b06841;Tue Jan 07 08:56:51 EST 2003;Committer;matz;2;5;1;6;0
6d481a4ae440532dcf674adf910c5cfa802f4679;Tue Jan 07 07:36:40 EST 2003;Committer;matz;10;507;126;633;0
954826f7a84722628b5386868dfdf7da2f4bd58a;Tue Jan 07 04:12:52 EST 2003;Committer;eban;1;3;3;6;0
520416fdc5cb1d2424ed9906ee244977174655a1;Mon Jan 06 22:50:18 EST 2003;Committer;nobu;2;6;1;7;0
220649ca78f729f8d65f75ebd45025d8c9f9cbe6;Mon Jan 06 16:37:29 EST 2003;Committer;knu;1;1;5;6;0
91b9d37a853d4b8629c2719328ba6473d8766959;Mon Jan 06 15:55:43 EST 2003;Committer;knu;10;131;101;232;0
8eba0580798736ee144793e24afdb31d4ddb1cb5;Mon Jan 06 11:47:53 EST 2003;Committer;knu;4;18;0;18;0
2b442c240a40a0d0a1b3cbfda5e9c2d230e340de;Mon Jan 06 09:44:15 EST 2003;Committer;usa;2;202;4;206;0
4de3dfd8d33113eddc4897fcb08a64c3ec849889;Mon Jan 06 09:35:51 EST 2003;Committer;eban;1;3;3;6;0
6254d7103bb1208ed1e11f94dfb904da3f7e54b0;Mon Jan 06 09:34:16 EST 2003;Committer;eban;2;8;2;10;0
a8bb4ed57719a231d4a15bda964476b0b373d03c;Mon Jan 06 04:30:27 EST 2003;Committer;usa;4;83;22;105;0
6a29dec1fde8d2d18bb3eb21f27ad45527d20734;Sun Jan 05 22:16:45 EST 2003;Committer;nobu;1;1;1;2;0
a01112eafe4bb4b8a00622225371001787355066;Sun Jan 05 20:11:20 EST 2003;Committer;nobu;2;9;1;10;0
e1949185d324cee0a261f020326a058e26c4eec3;Sun Jan 05 17:40:29 EST 2003;Committer;nobu;2;5;0;5;0
27ff93a4eea5d1e681d4f9af323b3581599eb6ea;Sun Jan 05 14:00:57 EST 2003;Committer;eban;2;5;1;6;0
1fbea3bef7065455a760e512a5a908a21022536a;Sun Jan 05 08:50:21 EST 2003;Committer;nobu;2;19;10;29;0
15774ab1fbc7149adb9864817ed336375bfcc005;Sun Jan 05 07:04:10 EST 2003;Committer;eban;4;25;15;40;0
a287a10df79e77b288921e9c330cf31d6d23a317;Sun Jan 05 03:06:51 EST 2003;Committer;nobu;1;3;3;6;0
10c93d6c7469e0b33f268c86e61ff87eb9ccbb9e;Sun Jan 05 01:40:24 EST 2003;Committer;nobu;5;22;11;33;0
af8250ec340fa7d5b02739ecbad3519874253bdc;Sat Jan 04 18:57:37 EST 2003;Committer;knu;2;2;2;4;0
50e62191ecf65a7118041447da8e629b2ff62e7a;Sat Jan 04 18:48:24 EST 2003;Committer;knu;4;25;9;34;0
b369eea79f5ef06a8b314e5ef3a25a0db36db410;Sat Jan 04 18:17:30 EST 2003;Committer;usa;10;34;55;89;0
d80285a9fe71b2e5474c66614d48ad03f0d17d6b;Sat Jan 04 06:26:10 EST 2003;Committer;usa;4;109;18;127;0
c471e19f22671662011bc8256e4f942b2ae2fa50;Sat Jan 04 05:33:29 EST 2003;Committer;usa;3;9;1;10;0
2ce6988e5561628095f15e755783dbca90b05dc0;Fri Jan 03 16:52:56 EST 2003;Committer;nobu;2;5;1;6;0
e56b74195c743712d5c0b0cd7894f217149aabfd;Fri Jan 03 14:24:47 EST 2003;Committer;nobu;1;3;3;6;0
41c46ceade33bc3cc0a0142d968d379a6e472db9;Fri Jan 03 13:26:48 EST 2003;Committer;nobu;2;9;8;17;0
5f075c2fdab5005fcc335c4edfda83ccc4f1d49c;Thu Jan 02 17:03:43 EST 2003;Committer;nobu;1;1;1;2;0
afc6ad0561c430bc508bd22719915d0b5f5e83f8;Thu Jan 02 16:56:16 EST 2003;Committer;nobu;2;5;1;6;0
3ff112ae075960329b15416affa40599672d88d5;Thu Jan 02 02:01:38 EST 2003;Committer;nobu;1;3;3;6;0
ed506c07d1936659fdc85c5b976e6d5606b7923a;Thu Jan 02 02:01:25 EST 2003;Committer;nobu;2;5;0;5;0
4d676cf76f2ea4d19486593a9bf542f1450ad517;Wed Jan 01 10:49:14 EST 2003;Committer;matz;1;8;4;12;0
a3c545a7bc6ad5838576183f46921c77f053001a;Wed Jan 01 10:05:46 EST 2003;Committer;eban;1;1;0;1;0
1361e7d0ca20e79882187b76ecbf3c92dc9f94ee;Wed Jan 01 09:26:45 EST 2003;Committer;eban;3;14;1;15;0
b6c63738b24548fa265c2da72856151c961a5426;Wed Jan 01 03:40:01 EST 2003;Committer;matz;1;1;2;3;0
0082edfd3d4c0288cf8464fac54d7655db5a29ca;Wed Jan 01 03:24:29 EST 2003;Committer;matz;5;185;213;398;0
2a54402839534bff1bebbf0feb2e53298819aee9;Tue Dec 31 21:01:40 EST 2002;Committer;knu;2;0;707;707;0
c56fa0649dfd8f2fb73e1cf37623fce233ea6b07;Tue Dec 31 19:43:29 EST 2002;Committer;knu;1;1;1;2;0
709b8378115a7a5b37cd934d9489f04f5307c3c3;Tue Dec 31 19:38:42 EST 2002;Committer;knu;1;6;6;12;0
59e61e038afb58c5e9994ac90a66b965758becfb;Tue Dec 31 19:25:48 EST 2002;Committer;knu;1;5;5;10;0
d0588e9822496a4b0bbd5717419491174e6e79bd;Tue Dec 31 19:24:29 EST 2002;Committer;knu;2;8;1;9;0
5ec897d3061347d5e8fedc9135760a92ab4a310a;Tue Dec 31 13:22:46 EST 2002;Committer;eban;1;1;1;2;0
86c90aea3612e901d24232b8ec476339175a6fb9;Tue Dec 31 12:31:12 EST 2002;Committer;eban;8;92;50;142;0
b8ad2fa064c41e679142d8620381cc966b83dfdf;Tue Dec 31 11:47:29 EST 2002;Committer;knu;1;2;2;4;0
7ca084da853c28307877784f6b301e350064bf31;Tue Dec 31 11:44:29 EST 2002;Committer;matz;2;10;0;10;0
b491d7a64fe3463ba32e639480588a7aa03ac1ae;Tue Dec 31 11:17:40 EST 2002;Committer;knu;2;8;0;8;0
b18e1a0b4a56d7f2bfe4265ca9d0e70cd234e1cf;Tue Dec 31 11:13:44 EST 2002;Committer;knu;2;18;26;44;0
969bb67169be00b51533884b30376f7bcebefbf1;Tue Dec 31 10:53:14 EST 2002;Committer;knu;3;15;4;19;0
653b0c120fb2ef2f1efe9df3c68c3e5cdb4afe09;Tue Dec 31 10:28:52 EST 2002;Committer;knu;4;16;2;18;0
559ca6258a4926b4e813e1341345b0e5f432017c;Mon Dec 30 22:56:21 EST 2002;Committer;nobu;2;55;38;93;0
378a6bdea5106f02196e821a9574cca61aab9ed3;Mon Dec 30 19:56:06 EST 2002;Committer;knu;2;273;254;527;0
c2e3d3971be8cc5b2a5b7ab624e516cc0d1ce496;Mon Dec 30 18:19:08 EST 2002;Committer;eban;3;20;14;34;0
67a7c345248496622e42bb742937128f160e0d6f;Mon Dec 30 12:23:11 EST 2002;Committer;eban;1;1;1;2;0
71da1d91b013249d0573600d940f52af95304818;Mon Dec 30 12:17:41 EST 2002;Committer;eban;2;7;2;9;0
fb0b931709d92ccfe3ac1bfe2f883cf36eda9e20;Mon Dec 30 10:16:53 EST 2002;Committer;nobu;5;32;13;45;0
20d146389cd347cf51a7ba5ab8f1795985357a3a;Mon Dec 30 07:57:25 EST 2002;Committer;nobu;1;3;3;6;0
c39a8e326a67138238b25b9eeaff587a3ed13d4d;Mon Dec 30 07:55:17 EST 2002;Committer;nobu;2;10;2;12;0
3d2ddca6b2d859c66fdd2498c564a86740969ded;Sun Dec 29 20:14:51 EST 2002;Committer;nobu;2;11;3;14;0
f0371138ee1b81ac8ac2af211f5f0b0427870eee;Sun Dec 29 18:14:22 EST 2002;Committer;nobu;2;3;1;4;0
6189cefb408fd248ae18478de79b285faf89bcb7;Sun Dec 29 14:52:02 EST 2002;Committer;nobu;1;3;3;6;0
05b990b7c1aa0403e01c8a2f1da59392731d1f84;Sun Dec 29 14:51:22 EST 2002;Committer;nobu;6;35;44;79;0
0569c8422c566d77f33843a5e11d87b0066e93a5;Sun Dec 29 06:32:09 EST 2002;Committer;aamine;1;2;1;3;0
8b034b5f3d4751be5646979943db9fd32d46201e;Sun Dec 29 06:29:52 EST 2002;Committer;aamine;1;4;0;4;0
4ff3371f882230ad0253fe2428e3bf8bdfcefee1;Sun Dec 29 06:24:56 EST 2002;Committer;aamine;1;0;3;3;0
4a1c7e5f6df70168b030ef9143f66f8daff0d666;Sat Dec 28 20:11:35 EST 2002;Committer;usa;2;5;1;6;0
2672d0cc28ad4a927065097f90e75efa5d950102;Sat Dec 28 10:32:05 EST 2002;Committer;eban;4;12;1;13;0
025723b978290e57825df9b981ef4f05650b8178;Fri Dec 27 18:12:36 EST 2002;Committer;wakou;2;8;0;8;0
96d8d4862fe405975cb388ddf4e9149d5d7fc647;Fri Dec 27 17:00:29 EST 2002;Committer;eban;2;14;3;17;0
39020643147e4df0d40cb763952fbed1d3bbf4a0;Fri Dec 27 16:28:10 EST 2002;Committer;eban;1;6;11;17;0
c40c0f726b8f4a1aabdbc88ebf8958747af685cf;Fri Dec 27 16:13:56 EST 2002;Committer;eban;4;14;10;24;0
212d3ebfff502238f032e5ff9160c1ef1b4b4412;Fri Dec 27 12:42:06 EST 2002;Committer;nobu;3;15;8;23;0
e0006c665daa215810ab7f50bf1881b9f02b011f;Fri Dec 27 08:55:31 EST 2002;Committer;uema2;3;140;141;281;0
46f9785468c678e11c96db73d37ec54c0ce523c2;Fri Dec 27 04:23:52 EST 2002;Committer;aamine;2;5;1;6;0
585cf46325ab65bea074151c8c58cb28a2d146be;Fri Dec 27 04:21:27 EST 2002;Committer;aamine;2;54;46;100;0
888b9a9739966f2fc50e7b2ef7dc03d3d2fb357b;Thu Dec 26 18:01:34 EST 2002;Committer;nobu;2;35;57;92;0
2c5e792dd24afd0fbb30491de2e63e2c0f423be5;Thu Dec 26 17:48:29 EST 2002;Committer;wakou;3;35;22;57;0
564b20a38e62c5e970bda2627804035a893fd964;Thu Dec 26 16:55:14 EST 2002;Committer;eban;1;3;3;6;0
cdefda39b460e04fc7a918b49233d9b329953b6d;Thu Dec 26 15:15:44 EST 2002;Committer;eban;1;8;0;8;0
c7976a64fc8f6f9d08b1ab30bbcfbcb419f816ab;Thu Dec 26 15:12:06 EST 2002;Committer;eban;1;2;3;5;0
220a9926c5cbe6694d2bf85d78f8eec359726fa0;Thu Dec 26 14:59:35 EST 2002;Committer;eban;2;8;11;19;0
b90bdc3e250b5cabcacc48558b19c2f0767ccf7e;Thu Dec 26 10:27:57 EST 2002;Committer;usa;2;6;1;7;0
c66a0f7cc68d71954bf34e919b24e6ef1b438cc5;Wed Dec 25 17:22:58 EST 2002;Committer;gotoken;1;2;13;15;0
1b07582fcc575e21b6fc3d5166492783b1bdcf35;Wed Dec 25 07:44:33 EST 2002;Committer;matz;3;24;6;30;0
25fa63dc042c14021276c80ee3f9ff9613bd7bff;Wed Dec 25 02:08:24 EST 2002;Committer;nobu;2;6;2;8;0
8b79dd5e82ea3bc54611811b16b65edc9d7b5822;Wed Dec 25 01:49:27 EST 2002;Committer;usa;5;45;21;66;0
e08fca8bc0d390454826ed03840e6b1c14c6dc10;Tue Dec 24 17:36:08 EST 2002;Committer;knu;1;2;8;10;0
58e53cddef901c86dde09869a89eb2e59b9d7456;Tue Dec 24 14:50:10 EST 2002;Committer;knu;2;5;1;6;0
36dbbb1b6a4a254feadf8cbbd30a02bda5c2b2d8;Tue Dec 24 14:42:38 EST 2002;Committer;knu;3;8;2;10;0
96737482af95074829afd897a987bee4f72337d5;Tue Dec 24 10:20:29 EST 2002;Committer;usa;2;5;1;6;0
ee9d5d41d178c21594891c9d876f228dc509ce0b;Tue Dec 24 08:53:56 EST 2002;Committer;matz;5;69;16;85;0
e274c3ab76ca95dd089b6ef467700b4a0576dfad;Tue Dec 24 08:02:00 EST 2002;Committer;matz;6;32;8;40;0
2b334012fc6feb1f6158943bbd9f15fbb262fc01;Tue Dec 24 05:29:04 EST 2002;Committer;knu;1;119;216;335;0
51c4390f685bc7a77dc4308c3c2c8532c1f4edc4;Mon Dec 23 17:13:25 EST 2002;Committer;knu;2;11;4;15;0
9ec0a96ad4235f2054976eab6c04efbe62b3c703;Mon Dec 23 17:07:49 EST 2002;Committer;knu;4;696;0;696;0
80a319d347b04e7cbbc8833768ca58c40dbdc8ae;Mon Dec 23 14:48:14 EST 2002;Committer;knu;1;2;2;4;0
ec827b7112082bcdc13ade092376630b0a1b499d;Sat Dec 21 19:08:50 EST 2002;Committer;usa;2;6;3;9;0
b469f3155a2067c5313f1dadddcdb8ea8d9d939c;Sat Dec 21 18:02:01 EST 2002;Committer;usa;15;32;4;36;0
a36b7eea8a62142ebbbd1f64d3fe52b12c3affa1;Sat Dec 21 15:42:10 EST 2002;Committer;eban;2;28;18;46;0
d0527b05d87cb62b50dc9757266caf1a3a830486;Fri Dec 20 22:27:30 EST 2002;Committer;nobu;2;7;0;7;0
85ce703fabc94df19aedf130baad81cb4870fa88;Fri Dec 20 11:30:13 EST 2002;Committer;nobu;3;12;16;28;0
3780ede6ef2248effe7f1725cbab052391aefd3f;Fri Dec 20 11:23:40 EST 2002;Committer;nobu;12;22;15;37;0
5b615c70eb68177075bf033384499a2eb4b765e6;Fri Dec 20 09:29:41 EST 2002;Committer;nobu;4;45;24;69;0
96d28f71d93bd654a7a01d496ad43e1be6fcfe1f;Fri Dec 20 09:02:16 EST 2002;Committer;eban;1;2;2;4;0
71ef585f4e9f0fb4e98fe0567a6af5670b25d2f9;Fri Dec 20 09:00:10 EST 2002;Committer;matz;4;73;63;136;0
bc49bc7c6b6a16d725cd1279e9021465b1307f3d;Fri Dec 20 08:33:17 EST 2002;Committer;matz;16;194;127;321;0
b702ab5d6cf585ac0ff0cad3cd5aebbc40e82de0;Fri Dec 20 04:51:13 EST 2002;Committer;knu;1;1;1;2;0
02a8d06fa8833db3c266663f31a82deb6e89b2d9;Thu Dec 19 20:56:37 EST 2002;Committer;knu;6;13;23;36;0
c37140b3519fd8028d3b720bbb76c14af2c4e093;Thu Dec 19 20:45:24 EST 2002;Committer;knu;1;1;1;2;0
63406c49712703ca63d610e75bba4ed0078c0f16;Thu Dec 19 20:42:50 EST 2002;Committer;knu;2;9;11;20;0
354af9da36eaeec70d4fdaddab78a8ecb11101a0;Thu Dec 19 20:39:26 EST 2002;Committer;knu;1;1;1;2;0
913bc18761b5019492c30c0df9af7c5860a23bc3;Thu Dec 19 20:30:05 EST 2002;Committer;knu;1;4;2;6;0
d46e835344bc4d43c804d7b2d66145b80ef0c7e3;Thu Dec 19 20:26:16 EST 2002;Committer;knu;3;20;18;38;0
c3cd615aa4a2e52d8943df72a9a55d2607792fe9;Thu Dec 19 20:08:43 EST 2002;Committer;knu;5;6;27;33;0
e34137b5cbe49ce082c5231097a46a99df02ed5f;Thu Dec 19 20:03:06 EST 2002;Committer;knu;1;0;1;1;0
9c95229c73f2246b627ce4376cd7893920002e4f;Thu Dec 19 20:00:19 EST 2002;Committer;knu;2;62;41;103;0
8451053741771a8daf5503061266c2ce9036c878;Thu Dec 19 19:01:59 EST 2002;Committer;knu;2;32;7;39;0
d9fbdddb59ec1a240f4eecc3d9995320ae3298af;Thu Dec 19 18:55:32 EST 2002;Committer;knu;4;5;6;11;0
5f4f0807e90ad9513333a68836e9dfcf01e9df48;Thu Dec 19 15:21:01 EST 2002;Committer;nobu;2;15;7;22;0
32145b065247829d30ddad2616f796625ca37d9c;Thu Dec 19 13:56:28 EST 2002;Committer;usa;2;5;1;6;0
98ecd65d9a9a6fec29fbd3db9a26cc62259182bf;Thu Dec 19 13:39:48 EST 2002;Committer;nobu;1;1;1;2;0
cf5ecdfcbba21b8d2e39d9e091d0619eb3a3a0ef;Thu Dec 19 13:38:47 EST 2002;Committer;nobu;2;5;0;5;0
f506e11e10f1230e6cb63e379347e2e4bfccaac0;Thu Dec 19 12:28:09 EST 2002;Committer;nobu;1;2;2;4;0
baa00aa2506745308a598ce91e65a727ba25f30f;Thu Dec 19 09:20:20 EST 2002;Committer;matz;18;158;47;205;0
a0a14ed14a86b7204ba3e9d557a296ca08a8bb8d;Thu Dec 19 08:29:18 EST 2002;Committer;knu;1;4;0;4;0
057de726876a2ecfbd469d31fd6c20187abf33cc;Thu Dec 19 07:56:14 EST 2002;Committer;akr;1;1;0;1;0
b54b4b79ecde43365f69874cc06133e05a1551a6;Wed Dec 18 19:22:46 EST 2002;Committer;knu;2;5;1;6;0
f8c8a38d30f6e23211f7ab1ca11b84d1ab85972f;Wed Dec 18 11:50:49 EST 2002;Committer;nobu;2;8;3;11;0
f4b8bbb143c952e5dc6887fbf51af87d96c00d97;Tue Dec 17 18:20:46 EST 2002;Committer;nobu;2;29;9;38;0
49fc21f31e84663c02660bdbfee72adcf4040947;Tue Dec 17 12:15:45 EST 2002;Committer;nobu;2;5;3;8;0
dd8a919a006794be7d88b9701724f784b9d9eb95;Tue Dec 17 10:54:41 EST 2002;Committer;nobu;1;1;1;2;0
1b6b119e2c65fae13cf419c40c04e6679007e662;Tue Dec 17 10:43:52 EST 2002;Committer;nobu;1;2;2;4;0
86db656415a2e05b573d95d813d6ca5a26b55d07;Tue Dec 17 10:34:30 EST 2002;Committer;nobu;5;45;3;48;0
3a20ed532b57da1e58287a5c53abe14400a085f4;Mon Dec 16 19:06:36 EST 2002;Committer;akr;3;395;0;395;0
d46991c6de029dbec0033be1dcb7fde23edada26;Mon Dec 16 15:30:00 EST 2002;Committer;usa;2;7;0;7;0
6b5525de2c8aaf75205439f8175d45b80463a0db;Mon Dec 16 06:56:41 EST 2002;Committer;nobu;1;2;2;4;0
65f3eef1ee8087f301b7556ff94957754aa022ac;Mon Dec 16 06:56:33 EST 2002;Committer;nobu;2;6;1;7;0
77d007dc05d07d2167e083d39b3afa6ca1562e9f;Mon Dec 16 00:52:32 EST 2002;Committer;akira;2;5;8;13;0
46586b2096c31422d835c18cc82e3fdbf7193c8d;Sun Dec 15 21:15:58 EST 2002;Committer;knu;1;74;21;95;0
0e1b92874b7ce28f8208f455bc41fe1a5580e750;Sun Dec 15 12:20:34 EST 2002;Committer;eban;2;16;13;29;0
b44352521505ae054e4f333122bbaf77b9a8d5d0;Sun Dec 15 06:18:27 EST 2002;Committer;nobu;1;2;2;4;0
b19e36a214a864572baee3643ddb369cfeb94d77;Sun Dec 15 03:18:08 EST 2002;Committer;uema2;31;134;133;267;0
c476b6e05c1cae6de5d24b823e676566ae27de6c;Sun Dec 15 02:48:40 EST 2002;Committer;nobu;2;21;7;28;0
009f78761d729b18ac34749136f1474d89d54a69;Sat Dec 14 05:27:35 EST 2002;Committer;uema2;11;377;18;395;0
c79e87783658aa264c3939497a1855942b0e6c5b;Fri Dec 13 17:14:18 EST 2002;Committer;eban;2;10;0;10;0
3d4298a3c43e1ea5b97c0240a62191d036c17ce6;Fri Dec 13 14:54:24 EST 2002;Committer;eban;2;6;1;7;0
1d15fa691a7c417bf5b330b94cdf82b1bce3d8a1;Fri Dec 13 11:18:32 EST 2002;Committer;nobu;1;2;2;4;0
a35365d96d7a3a73b4113d9c1b760b9011a9ba30;Fri Dec 13 03:35:03 EST 2002;Committer;nobu;2;7;0;7;0
b60172917f0403a4ac83d4862530509b3935ad7b;Thu Dec 12 10:21:41 EST 2002;Committer;eban;4;35;10;45;0
f744cfd8d7cc51d90ae863589ded64c60030b220;Thu Dec 12 09:17:32 EST 2002;Committer;matz;2;28;0;28;0
d307881fe48b126830dd1f57ef3d494d783a0db4;Thu Dec 12 07:29:30 EST 2002;Committer;nobu;1;2;2;4;0
e6c77e4c4cc56f98a1a19573693e7d30444f5da7;Thu Dec 12 07:29:14 EST 2002;Committer;nobu;2;8;0;8;0
d1f015f92ed06d93d9a5e0b90e4d35df3e6de1d3;Thu Dec 12 06:42:42 EST 2002;Committer;akira;1;9;9;18;0
3d70ef2648b5bc0463903fe17301733392c0d688;Wed Dec 11 15:12:52 EST 2002;Committer;eban;2;5;1;6;0
0733a70c0987cf9a1ec918a48213f747496f62df;Wed Dec 11 09:55:11 EST 2002;Committer;nobu;1;2;2;4;0
2498da0ea0598e30208bcf533e6215169caf5cd7;Wed Dec 11 09:32:41 EST 2002;Committer;matz;4;60;21;81;0
1b19c063b8517a4b1c9c31029c49023fa74fb3bd;Wed Dec 11 02:31:59 EST 2002;Committer;nobu;3;11;5;16;0
9be47132afd80a4b0f54c178f7237bd197fadf46;Tue Dec 10 08:32:54 EST 2002;Committer;akr;2;5;1;6;0
60b2446bea0297c47f56deb308c29a5c1af64cc9;Tue Dec 10 06:23:44 EST 2002;Committer;matz;18;136;122;258;0
4dcd8a95c7acf13a87283c11f72f7a8a7ad15019;Tue Dec 10 06:20:56 EST 2002;Committer;nobu;1;2;2;4;0
df8833203edfb8d7c43044d6a06fd038c0fa4779;Tue Dec 10 06:19:21 EST 2002;Committer;nobu;2;6;0;6;0
f51bd1d018f16c0da82f05973879e2080d9cc783;Mon Dec 09 04:08:22 EST 2002;Committer;ttate;3;34;11;45;0
f9e069336095b3dbcb6826177d3437f410c9a310;Sat Dec 07 09:11:53 EST 2002;Committer;knu;1;1;1;2;0
248d27d4fde62be29d7788a50d80095a59acec27;Wed Dec 04 13:25:38 EST 2002;Committer;nobu;1;2;2;4;0
a526e3fe0251880978baee867f72d59de4b3e84e;Wed Dec 04 07:39:32 EST 2002;Committer;matz;6;41;12;53;0
96f82b243fce324b33e71357564a15b51f6aa949;Mon Dec 02 16:16:05 EST 2002;Committer;akr;2;84;68;152;0
232fda523767d5f91eff4ab8c38d84f30e356e6d;Mon Dec 02 15:01:03 EST 2002;Committer;matz;1;37;0;37;0
0327c4a3ab072222fba4334fad3a6e620e3caf74;Mon Dec 02 13:22:27 EST 2002;Committer;nobu;1;2;2;4;0
b480079083ea29466bae5a06811c2abcc7b127af;Mon Dec 02 09:40:44 EST 2002;Committer;nobu;1;9;9;18;0
90c4dae08fea47797b3ae574e5dfe35dc66f5631;Mon Dec 02 07:57:17 EST 2002;Committer;matz;48;5461;68;5529;0
e193fd8d665567c7f3b827c21a1b77af43e2c391;Mon Dec 02 07:13:56 EST 2002;Committer;matz;3;66;15;81;0
96986a7a9019ff063e2ef3ecbe223c0b23c68d52;Sun Dec 01 14:10:51 EST 2002;Committer;nobu;2;28;7;35;0
8783c9ffcd22e5ab06896b8b13bd4beb6e797309;Sun Dec 01 13:49:14 EST 2002;Committer;nobu;1;2;2;4;0
c405dbf6927080f54300006b7b5a0e17c5c8a68c;Sun Dec 01 13:47:06 EST 2002;Committer;nobu;2;9;5;14;0
59d4702438117396de9f899a0c96fe64654b0262;Sun Dec 01 09:08:14 EST 2002;Committer;knu;1;2;0;2;0
5d6af6910d583a717abf6db67c2bff9156f71ecd;Thu Nov 28 03:12:23 EST 2002;Committer;knu;2;13;8;21;0
06a97326740909b7ffbef29173473998358ba5f1;Wed Nov 27 20:07:48 EST 2002;Committer;knu;1;2;2;4;0
ba9627f0da0d07974e77df1ed684cd0f1ad2c0ac;Wed Nov 27 17:51:27 EST 2002;Committer;knu;2;9;2;11;0
0cf319ce5495fd8a52bbfdbadc11a7a6e23bc13d;Wed Nov 27 09:11:55 EST 2002;Committer;matz;2;11;17;28;0
34558b71c7395913ae095313e150530d1c3d2ec0;Wed Nov 27 08:44:04 EST 2002;Committer;knu;2;54;27;81;0
ad42685bf4e2e5f1062c2f42b23a6c96566b56f8;Wed Nov 27 08:36:22 EST 2002;Committer;knu;2;29;10;39;0
ce0fd8c52311fef0a95ce9d3d72c756ca6f5b742;Wed Nov 27 07:28:45 EST 2002;Committer;knu;2;6;11;17;0
688f0d6c8e9cd4a42de78a88fb4441b8fb0d41b1;Wed Nov 27 07:15:37 EST 2002;Committer;knu;2;29;30;59;0
2c463325aeca51ed431f2dea9108f98c050b93f1;Wed Nov 27 07:14:00 EST 2002;Committer;knu;2;18;17;35;0
31a57b49dbe9859596a1f6b3d03e06b2a4858900;Tue Nov 26 23:05:01 EST 2002;Committer;nobu;1;2;2;4;0
dc9986f447e8010977ceef3bd58fb8119d5b5486;Tue Nov 26 22:44:44 EST 2002;Committer;nobu;1;1;0;1;0
5bf245eeb90bf77bdee86c147789a1288e2648b4;Tue Nov 26 22:32:11 EST 2002;Committer;nobu;3;40;9;49;0
dc260404fe1287517ce1fca8e41f2f7935ccfe01;Tue Nov 26 10:53:11 EST 2002;Committer;ttate;1;2;0;2;0
ee8addc13ffbacd66a4847d5adb917b5d1fc0601;Mon Nov 25 11:00:03 EST 2002;Committer;eban;2;5;1;6;0
7ceb37d715d25cf40ffbff7123985db477d70c39;Sun Nov 24 16:17:56 EST 2002;Committer;eban;1;1;1;2;0
a1250adef3d79e67cdbb9cc85d5c0493f1b59700;Sun Nov 24 16:11:53 EST 2002;Committer;eban;3;15;5;20;0
0dcbeda434ef05f5725e176008fae05ad27ebcb9;Sun Nov 24 12:36:01 EST 2002;Committer;eban;3;9;6;15;0
7f62113f4d4e29795561df9a0d52a6960e207252;Fri Nov 22 14:30:33 EST 2002;Committer;matz;3;55;9;64;0
0b2c50f3a7c952a518330ac22c16a72089e613a8;Fri Nov 22 10:22:29 EST 2002;Committer;knu;2;25;4;29;0
0c717903770a1e9c99e18f25e2b9abad15534400;Fri Nov 22 09:50:02 EST 2002;Committer;eban;1;2;2;4;0
f047de71e6f3c9dabc58a5914550bc5f0f634601;Fri Nov 22 09:32:50 EST 2002;Committer;matz;2;5;1;6;0
e2d384d628c8e4bd59300844e9111645d1070d5a;Fri Nov 22 09:14:24 EST 2002;Committer;matz;14;103;91;194;0
8347974c9fd6fcfd6af8d06f5c8ceca3bce76057;Fri Nov 22 05:10:42 EST 2002;Committer;keiju;1;6;0;6;0
4352461b9c3643a9eddea982b44c6caff2fa61cf;Thu Nov 21 14:39:26 EST 2002;Committer;seki;1;2;2;4;0
e97af583f711f138605a22d88e6d04b017257ec8;Thu Nov 21 14:38:37 EST 2002;Committer;seki;1;3;5;8;0
f80af5150a37dee92efea2c24d32701fcd95cfe6;Thu Nov 21 11:50:09 EST 2002;Committer;aamine;4;131;118;249;0
15911a95bfeae92384da2c4aad4ea4af6358c50d;Thu Nov 21 11:13:17 EST 2002;Committer;aamine;2;226;221;447;0
4a66fdcad39b1420670b1690e5128bb4713a0dbc;Thu Nov 21 11:09:22 EST 2002;Committer;aamine;1;0;1;1;0
c157dff02607951c97e4fbd7d1b3b70010bc0408;Thu Nov 21 11:07:17 EST 2002;Committer;aamine;1;11;0;11;0
3eea2999e7af05521c57794f49014d8fb67d1be3;Thu Nov 21 11:01:22 EST 2002;Committer;aamine;1;1;1;2;0
87239525c176090d1de32ad4aac5341f330a5a63;Thu Nov 21 10:59:50 EST 2002;Committer;aamine;1;63;7;70;0
4de16dfb245db76d3192ed57a38c50635d8b7015;Wed Nov 20 14:41:05 EST 2002;Committer;seki;2;136;0;136;0
5315f0d66741aa8caca75d30953b35733474bf87;Tue Nov 19 08:07:51 EST 2002;Committer;matz;6;73;34;107;0
710e25422b099e8ce2c13d868effaefa10366378;Tue Nov 19 07:45:10 EST 2002;Committer;akira;1;2;2;4;0
86a5ba2b011836ff97e4224dd1e65869fd2b7362;Tue Nov 19 02:00:18 EST 2002;Committer;matz;2;2;2;4;0
3dc5049a49914b8662d5db556d98dc3e6c504ad2;Mon Nov 18 23:15:01 EST 2002;Committer;matz;1;6;1;7;0
12e312c5e4cabb3416b41affde4683a277a26333;Mon Nov 18 20:16:54 EST 2002;Committer;knu;2;5;0;5;0
c52339881c949810f1e1e7a3f2172d25ebd50191;Mon Nov 18 20:09:46 EST 2002;Committer;nobu;3;12;9;21;0
7da58dad33a266e668e74c3b59f750706efaab58;Mon Nov 18 17:40:09 EST 2002;Committer;knu;1;1;1;2;0
c15d3e6bffc3cf838ad30b10e9655f85ccff1c38;Mon Nov 18 17:26:03 EST 2002;Committer;knu;2;27;10;37;0
c3a31863c58147a6b55741d72d0749865e2835ee;Mon Nov 18 17:08:55 EST 2002;Committer;knu;1;1;1;2;0
c04ef9321c664a18eb8452635848b801c7e3dbbf;Mon Nov 18 16:57:36 EST 2002;Committer;knu;4;35;22;57;0
734665d3a963ebb76a6d6710a636b7d8b0d4ecb9;Mon Nov 18 07:26:44 EST 2002;Committer;knu;1;14;11;25;0
34413718ac83afe13b7f3f6d2f55f01dc10d2898;Sun Nov 17 18:01:17 EST 2002;Committer;knu;2;67;29;96;0
e6251100cc8bceb16bf8dfbe4521f9d4730c02ef;Sun Nov 17 16:11:40 EST 2002;Committer;seki;2;259;0;259;0
a1ca199baedd0b9964ad2607f93b0689696504ca;Sun Nov 17 14:02:02 EST 2002;Committer;nobu;1;2;2;4;0
f87abaadcc91b775a5e3c7ee3292d5316e985893;Sun Nov 17 14:01:57 EST 2002;Committer;nobu;2;5;2;7;0
8a442aa52ada40011e314676380a0e7c0011927e;Fri Nov 15 16:12:43 EST 2002;Committer;nahi;1;1;1;2;0
3491b8a2cae670c020c83a9b8ffb73a75c080e3a;Thu Nov 14 22:58:42 EST 2002;Committer;nahi;2;5;1;6;0
c0e98a13849403f3fbdb7e10b8f88d7e4e20552c;Thu Nov 14 22:46:00 EST 2002;Committer;nahi;3;11;3;14;0
e66faf84ce8ca9091a9a988c0221209d00bc48d8;Thu Nov 14 13:51:40 EST 2002;Committer;nobu;1;2;2;4;0
604689628dc64d050a68f1ebe5e06f9105474936;Thu Nov 14 13:51:19 EST 2002;Committer;nobu;9;80;27;107;0
a1c02ee495d945f943fedc3f11fcb323289dc756;Thu Nov 14 06:18:59 EST 2002;Committer;matz;9;112;97;209;0
e60d5563210cccef2e9da17970ab3ea1906a8185;Wed Nov 13 08:55:49 EST 2002;Committer;nobu;1;2;2;4;0
8699e3e52574afaed1fcbed17198009498110ad4;Wed Nov 13 07:30:24 EST 2002;Committer;nobu;3;17;3;20;0
2cfae9b60fd08717d22b55e9b4f3ede91b532324;Sat Nov 09 18:52:04 EST 2002;Committer;knu;2;140;17;157;0
237229e2016bfc28d2935c7c8994fd9fb83203f2;Sat Nov 09 15:34:20 EST 2002;Committer;nahi;1;1;1;2;0
977bf97db340c4f8ec63a43b780d91b1e9ab4443;Sat Nov 09 08:05:27 EST 2002;Committer;eban;2;5;0;5;0
ba565bd6b393d2b11961e16b6f00d1e5ce2c397d;Sat Nov 09 02:52:55 EST 2002;Committer;nahi;2;5;14;19;0
a61871bea26c8b5dc2e7bc364883163a61a93395;Thu Nov 07 23:01:45 EST 2002;Committer;matz;1;0;4;4;0
54fdacb12545f40e83b013e7c8207fb5416b1403;Thu Nov 07 19:18:16 EST 2002;Committer;matz;9;48;22;70;0
8e3721dfa828464981b5e9f77eff79b815c288d5;Thu Nov 07 16:42:07 EST 2002;Committer;ttate;7;143;157;300;0
56cddaf082cc33d38b646f3145c9ce2dd806f1df;Thu Nov 07 01:03:29 EST 2002;Committer;nobu;1;2;2;4;0
2b82367a470f9d40eb2d83b3e73416ade084e8f7;Thu Nov 07 01:03:08 EST 2002;Committer;nobu;2;13;4;17;0
3a86596df156d85ed58cd8e51b94d045021b731e;Tue Nov 05 13:11:29 EST 2002;Committer;ttate;1;2;0;2;0
0d572fc9b78d7f7e59f18cc80c700c06d2926809;Mon Nov 04 15:47:35 EST 2002;Committer;knu;2;6;0;6;0
cf1575f17d67f685806b7cad8118436798510de0;Mon Nov 04 11:06:03 EST 2002;Committer;usa;3;7;2;9;0
6cff858589bed107ac6a1ec8db07cd654a4dbe07;Sun Nov 03 23:16:52 EST 2002;Committer;knu;1;1;2;3;0
cdce29bf0f4278ff254656895ed49ff6d5000cf4;Sun Nov 03 21:42:14 EST 2002;Committer;knu;5;40;27;67;0
db9126b073a3297d03ccb84cadb26b09fbaa08e6;Sun Nov 03 19:05:33 EST 2002;Committer;knu;2;16;2;18;0
aae36756dcc4d5debcaabd03379796bc41360bc4;Sun Nov 03 11:04:35 EST 2002;Committer;matz;10;173;166;339;0
c960141333a9bc384bafbcfaa49672e48677d6dd;Fri Nov 01 21:44:47 EST 2002;Committer;knu;1;2;2;4;0
5918d2a9148381e649cb664a2c4895e7d7757c18;Thu Oct 31 08:37:16 EST 2002;Committer;ttate;1;2;2;4;0
ed1881510950af3d8599c1a7dca14d53c35eb348;Wed Oct 30 08:04:32 EST 2002;Committer;matz;6;124;10;134;0
a2868ff65166b27acbbda4af1b9df84ed3171541;Tue Oct 29 21:35:28 EST 2002;Committer;knu;10;32;26;58;0
454abc5185a4a6425f1140d5c0e2157f8d3f75e1;Tue Oct 29 19:11:29 EST 2002;Committer;nobu;1;2;2;4;0
088276ac843067132a94889a139fe96bfe3021a7;Tue Oct 29 19:11:17 EST 2002;Committer;nobu;3;39;8;47;0
97eafefb4ad0ca1477a5a596362fc8616bd4bc25;Mon Oct 28 17:01:23 EST 2002;Committer;nobu;3;68;67;135;0
e51578fd72d4327db1d9a329e41c855655aec1af;Sun Oct 27 16:32:26 EST 2002;Committer;eban;2;5;1;6;0
c2ea598cf59caa67124e7f91caf36c0d3ac2ad23;Sun Oct 27 15:13:34 EST 2002;Committer;eban;1;9;0;9;0
ccfb459b7d30b13e8f37a07ae82eae4161bb83d4;Sun Oct 27 14:05:25 EST 2002;Committer;H_Konishi;3;11;1;12;0
c87332937b33f40c8ece6e88c69ba5ef1d025761;Sun Oct 27 09:04:55 EST 2002;Committer;eban;7;132;78;210;0
8a49ac945bbe888251f845020a5a48d4faed9e79;Sun Oct 27 05:05:02 EST 2002;Committer;eban;1;2;2;4;0
32ffd36c6f597ba213b1cc84e38005cb4ccf2318;Sun Oct 27 02:16:55 EST 2002;Committer;nobu;1;1;1;2;0
4f5f65b4f718bec77688876a7b6031cbba5ff4f1;Sun Oct 27 02:09:23 EST 2002;Committer;nobu;1;4;3;7;0
20a8fa174c1b419fe37609784c9ed6afba3aaf35;Sat Oct 26 15:51:59 EDT 2002;Committer;knu;2;5;1;6;0
2bda19cc0de01449c58792f9e3e70339171d3cac;Fri Oct 25 19:33:05 EDT 2002;Committer;knu;1;2;2;4;0
9e4cfb5da467f0e088436ebe8b70a857bfcfea2f;Fri Oct 25 19:31:55 EDT 2002;Committer;knu;3;12;4;16;0
3da9449263c587415756bcea44b9e1ec5a3643dd;Fri Oct 25 18:39:30 EDT 2002;Committer;knu;3;31;15;46;0
057f1f3020cf73dd79a1945578bb496a9aa82018;Thu Oct 24 18:23:52 EDT 2002;Committer;aamine;1;1;0;1;0
42e292ae3301039216ec5173adb4d6571101b8b6;Thu Oct 24 17:54:53 EDT 2002;Committer;aamine;2;9;1;10;0
57d2e81af5f615e8c1a977096aa239e2541f126c;Thu Oct 24 12:59:07 EDT 2002;Committer;nobu;1;2;2;4;0
d45f226da9d3833d7351125b07ebaa9510622804;Thu Oct 24 12:58:42 EDT 2002;Committer;nobu;5;18;10;28;0
9c33e18ca03dd5fc0421e182f07e9dd2c9ee9c52;Thu Oct 24 05:31:25 EDT 2002;Committer;nobu;2;6;1;7;0
709c9e1cb572e950165fd82bd3cfde59f41c2f75;Wed Oct 23 18:52:29 EDT 2002;Committer;nobu;2;6;5;11;0
236323b77c15894fdbb1b39ebc2d04c9a8e377c9;Wed Oct 23 18:21:54 EDT 2002;Committer;nobu;2;5;1;6;0
6009002c58669b93da8aca43001444a10d8cdda6;Wed Oct 23 17:40:36 EDT 2002;Committer;nobu;4;16;4;20;0
087671e87c9d4566f34544f4a7ccd32bd533d380;Wed Oct 23 10:17:51 EDT 2002;Committer;nobu;1;2;2;4;0
d4f2f6a7f708b010d9777f12bdcb84a449f61aa9;Wed Oct 23 10:17:30 EDT 2002;Committer;nobu;8;103;9;112;0
9562813d338b5f2870408e95747d71502590c14f;Wed Oct 23 08:20:35 EDT 2002;Committer;matz;2;170;167;337;0
d66da40534d3bc87a974430a8a8e6aec1c0ebbc4;Tue Oct 22 14:58:59 EDT 2002;Committer;eban;2;6;1;7;0
57a6839081506c29a4c1b3eb0c512d4fa5c9562f;Tue Oct 22 10:54:11 EDT 2002;Committer;H_Konishi;3;16;7;23;0
6073c68242fd21c37396523ad699068d230c68ac;Tue Oct 22 06:24:19 EDT 2002;Committer;nobu;2;4;2;6;0
db1c27bb3752307d6a0cd3d1f2cc9a69b5e715ab;Tue Oct 22 04:19:26 EDT 2002;Committer;nobu;6;130;81;211;0
79c8b98fac05a37cd4d83982e9ad2820a15de420;Mon Oct 21 16:09:09 EDT 2002;Committer;eban;4;17;15;32;0
b9ecdfaa3d8bb6c318c2299f020a0583bcdfe88c;Mon Oct 21 14:17:44 EDT 2002;Committer;nobu;4;238;70;308;0
8209f4fb71cb1ec86f9e24b3aa7a2e54b3d215bc;Mon Oct 21 14:11:54 EDT 2002;Committer;nobu;1;2;2;4;0
1a9c1339873f6395db6c1b97cd2303e3fec03920;Mon Oct 21 14:09:28 EDT 2002;Committer;nobu;1;2;2;4;0
e7ce523bb172c36b61cd5fc8d141a4488323bd84;Mon Oct 21 14:03:46 EDT 2002;Committer;nobu;9;877;1127;2004;0
76e8a9e82870393e5cef137526e811a878404096;Sun Oct 20 10:54:19 EDT 2002;Committer;akira;1;3;2;5;0
8232622071b61db04cd6f0e3a32b7608360e6b25;Fri Oct 18 14:13:41 EDT 2002;Committer;nobu;3;40;7;47;0
6dfb5aa6ac5c9432ad7a7b8bebda4916004051b6;Thu Oct 17 16:13:44 EDT 2002;Committer;knu;4;28;7;35;0
9dce0d8f0b1cd52fee0a9ddad61fa63d8c83c829;Thu Oct 17 12:35:48 EDT 2002;Committer;suke;1;8;3;11;0
020caa3fc8b2ce78591eaa04e674907b48e5b7b0;Thu Oct 17 10:20:52 EDT 2002;Committer;nobu;2;84;30;114;0
55068f94f2ce47e70bc9deba68f741f2a8da456c;Thu Oct 17 07:30:47 EDT 2002;Committer;eban;1;2;2;4;0
66d1582c07db57b4a1a1cd0ab7d79f042be80faa;Thu Oct 17 07:27:00 EDT 2002;Committer;matz;6;60;24;84;0
e6c0ea3e097fb5b23e6ec3e909474063eba21306;Thu Oct 17 06:24:42 EDT 2002;Committer;aamine;1;6;0;6;0
370e4a2c474dd64ff1ec25f468871730ee464a7c;Thu Oct 17 03:54:25 EDT 2002;Committer;aamine;1;54;44;98;0
67f14c022b34df77a0cda498024a2f6195d91f40;Wed Oct 16 13:44:19 EDT 2002;Committer;nobu;2;36;15;51;0
b879196e328f1d6c73a285ffd285cb4fc35a76f0;Wed Oct 16 04:43:40 EDT 2002;Committer;nobu;1;2;2;4;0
2ba2dba5bef7ac397bda797c77ad3e824a5210c3;Wed Oct 16 04:43:28 EDT 2002;Committer;nobu;2;9;2;11;0
eddaabb1654e4b599a981a2f8bf0b65547b6d51e;Sat Oct 12 15:49:57 EDT 2002;Committer;nobu;1;2;2;4;0
1de50c518b9a5244bef0473eab46d4b892fe817d;Sat Oct 12 14:47:07 EDT 2002;Committer;nobu;2;13;3;16;0
31ab445fead6824a54f8162d19d5681dd85ebbf0;Thu Oct 10 21:07:16 EDT 2002;Committer;nobu;3;80;29;109;0
539428b0f497c03d87b50a8a1b58e0795e94a3bd;Thu Oct 10 17:11:18 EDT 2002;Committer;nobu;1;5;5;10;0
a3b6e114b4b01e069136be3ee9383ecc6891ca8f;Thu Oct 10 15:48:06 EDT 2002;Committer;nobu;1;1;1;2;0
4cdd83f6866529cadaa9cdbce57d82bf5b27c653;Thu Oct 10 15:26:58 EDT 2002;Committer;nobu;2;61;0;61;0
129d05ae8d727952c01a6de74682630f3dc009ba;Thu Oct 10 08:30:52 EDT 2002;Committer;eban;3;13;7;20;0
99ebeaee0a6acb48a5c65618aecdecb3bbfaabbc;Thu Oct 10 07:00:07 EDT 2002;Committer;nobu;2;16;11;27;0
ca7549b203e07bb32915f57bef2d3a4ef573be96;Wed Oct 09 06:12:54 EDT 2002;Committer;nobu;4;31;10;41;0
2ececa42915e74fb33e4c79bdb40f4477649f7a4;Tue Oct 08 06:07:45 EDT 2002;Committer;eban;1;2;2;4;0
00882bfe350ed172c5d19c1299b626671e70d194;Tue Oct 08 05:34:45 EDT 2002;Committer;nobu;2;9;6;15;0
e2d1e7cfe4873acb518a8265a222307a90d6298a;Tue Oct 08 01:58:34 EDT 2002;Committer;akr;3;57;4;61;0
b06720481e8f004565b55d7862a8a653d40f19d8;Mon Oct 07 08:15:57 EDT 2002;Committer;eban;1;2;2;4;0
df2d56c03fd60d63fa5c2336186d4d80e08eb65c;Mon Oct 07 07:44:18 EDT 2002;Committer;matz;2;6;2;8;0
7da40cbcb8861029d2bd5e5b3454b29a86631a01;Mon Oct 07 07:16:12 EDT 2002;Committer;matz;2;8;1;9;0
840f8bcb9e9571fc44c02d8deb925c2e7ce76d0f;Mon Oct 07 01:09:50 EDT 2002;Committer;ttate;2;5;5;10;0
4e30ebe351facf1390c4f7585901be1bcad5b7ca;Sun Oct 06 16:27:56 EDT 2002;Committer;nobu;1;2;2;4;0
0944a05fb95f262ca58242849936f99bf658506f;Sat Oct 05 15:46:24 EDT 2002;Committer;aamine;2;7;0;7;0
a2c9020808417572521c711cf4ad9a3c7b556575;Fri Oct 04 17:54:29 EDT 2002;Committer;matz;3;13;2;15;0
1e3062ede1765f21c501068b3489c390c914e55f;Fri Oct 04 11:32:16 EDT 2002;Committer;nobu;2;19;6;25;0
05e476c941e41132d40b4bcbfcc7eea90cae7318;Fri Oct 04 06:26:45 EDT 2002;Committer;akira;5;76;37;113;0
396c29d1952642868874cace40615c2f1aae153b;Fri Oct 04 05:46:45 EDT 2002;Committer;eban;1;2;2;4;0
5c57848093d4bc4ffc6140365707a879c7a7838c;Fri Oct 04 05:18:05 EDT 2002;Committer;eban;4;26;3;29;0
e6bb432c83584f174d9ccc24f6433a781aa9364d;Thu Oct 03 11:24:24 EDT 2002;Committer;nobu;2;5;4;9;0
4b6dffad02114175e59729eeb38b5db19c01e571;Thu Oct 03 11:20:31 EDT 2002;Committer;nobu;6;91;21;112;0
29cef5f795043a048a58874d90de0dfe01aa12ea;Wed Oct 02 16:45:35 EDT 2002;Committer;nobu;22;91;93;184;0
8815306dc5aadd777c887bbd8de7057598ad709c;Wed Oct 02 15:37:07 EDT 2002;Committer;nobu;1;1;1;2;0
38db4d23c5dcd469e489f159fa03f9077d4e2a41;Wed Oct 02 15:34:09 EDT 2002;Committer;nobu;1;1;1;2;0
55af6c2f96ca1052d779f6bb46d72e48f250bc73;Wed Oct 02 15:32:45 EDT 2002;Committer;nobu;2;8;3;11;0
3a76a401967aca5a5386e980f26a7bd925da64b6;Wed Oct 02 14:59:25 EDT 2002;Committer;nobu;4;108;9;117;0
0c767620cd00ec0739debea2b2a33f0f3e3ab65f;Wed Oct 02 14:28:40 EDT 2002;Committer;ttate;1;5;6;11;0
71c41cf5a5a72e2f7f1f7b7ac1a14213f1fb52cc;Wed Oct 02 14:13:58 EDT 2002;Committer;nobu;5;90;66;156;0
ab6b4786152b663215f05841f7d131d1a7f43db7;Wed Oct 02 06:02:17 EDT 2002;Committer;matz;8;59;24;83;0
8c0cbb735000465ca0e07526efb4489e4fe5e414;Wed Oct 02 05:58:52 EDT 2002;Committer;matz;1;7;0;7;0
06886efa952e1931aaf86868ae8ee48dbc98904a;Wed Oct 02 04:28:01 EDT 2002;Committer;eban;2;7;1;8;0
395737b7328d8ab04714ae2cb6a0855e92083078;Tue Oct 01 15:27:51 EDT 2002;Committer;nobu;1;2;2;4;0
c691d09dc17c2a01e03767257e85743345a095fc;Tue Oct 01 15:26:39 EDT 2002;Committer;nobu;4;9;44;53;0
e4f26da2d96c77d815e2c3e8ce0f02a3cf46bb75;Tue Oct 01 08:14:03 EDT 2002;Committer;matz;2;28;1;29;0
734506e96dd2e77610c8e2f82b8a0b23d1831b17;Mon Sep 30 11:59:37 EDT 2002;Committer;matz;2;6;4;10;0
7627d0cea7f93193aa97d8ffe8d94fb2f8c69ebd;Mon Sep 30 11:35:40 EDT 2002;Committer;nobu;2;4;3;7;0
a7a8ea12dae2022de1d899998b6d076ce99bd940;Mon Sep 30 11:31:28 EDT 2002;Committer;nobu;2;6;2;8;0
443ed1783dcfa6a35bf5947295417b339ff42058;Sun Sep 29 13:25:58 EDT 2002;Committer;nobu;1;2;2;4;0
7345d0efd44555c62ba3ce0737e20e5a711ca7e8;Sun Sep 29 09:31:58 EDT 2002;Committer;nobu;3;136;137;273;0
62280094cddf1f39c51dee094d943893a6401708;Sat Sep 28 21:39:57 EDT 2002;Committer;usa;2;142;85;227;0
f5ab4eb8597cdfb6d6ef93897a7d95b785365268;Sat Sep 28 14:11:30 EDT 2002;Committer;eban;1;2;2;4;0
1577424bdf92db5f895099fb9df2b582dfb67b6c;Sat Sep 28 11:08:59 EDT 2002;Committer;nobu;3;84;80;164;0
4d23d9e7d8bda4f1231b5696a714fee735cdad90;Sat Sep 28 04:21:31 EDT 2002;Committer;nobu;2;6;1;7;0
70dc199fdde6a70205410e0a8cfe4aff4c50344f;Sat Sep 28 02:41:05 EDT 2002;Committer;matz;3;15;1;16;0
56201383cdf5ac4055d2eda136336624b4febde7;Sat Sep 28 00:53:05 EDT 2002;Committer;H_Konishi;2;5;1;6;0
07188bbee24504be6fbf7086610601718c2a0345;Fri Sep 27 13:36:11 EDT 2002;Committer;knu;4;37;10;47;0
5c57a96f81a313b89677dc0523d03210e7d6a39f;Fri Sep 27 13:21:19 EDT 2002;Committer;knu;4;12;0;12;0
f1d7a7783a718137557bed26c1004f96d68c4550;Fri Sep 27 09:56:59 EDT 2002;Committer;knu;1;2;2;4;0
cfeb0c30c4193d67bb780a2cd97ca8bacaba03db;Fri Sep 27 09:42:24 EDT 2002;Committer;nobu;2;30;7;37;0
af181db7846b3ca38b443bdf7d65e6d26f87da6a;Fri Sep 27 04:26:21 EDT 2002;Committer;matz;3;12;5;17;0
35e4d1319b86f9a2899a0fc1bb6ffafd7f26840e;Thu Sep 26 17:55:16 EDT 2002;Committer;knu;1;8;2;10;0
7a6adb89246e1829e6da1666e2894b6bd3322539;Thu Sep 26 17:44:33 EDT 2002;Committer;knu;6;84;5;89;0
15d643f44cf786f1b71f837f3d020cbad02ae2f2;Thu Sep 26 17:26:46 EDT 2002;Committer;knu;6;88;5;93;0
965393cbb848ddb869543a5ca8f6e7fba1d0f130;Thu Sep 26 16:27:23 EDT 2002;Committer;knu;6;63;4;67;0
b00af5f83acfe4c8fd76f1e5c13c1b0cd469daad;Thu Sep 26 13:49:40 EDT 2002;Committer;knu;2;10;5;15;0
7c4d1fe5e04cee519322a02d6e54801b0b118ea0;Thu Sep 26 00:48:33 EDT 2002;Committer;matz;4;5;9;14;0
12852c2e9ad0b25395d32c4ee147eb770408cf41;Wed Sep 25 14:52:37 EDT 2002;Committer;nobu;5;20;26;46;0
44b2f1609ca6a4732066c70f06499e46ab5b6bf9;Wed Sep 25 08:49:17 EDT 2002;Committer;usa;2;9;2;11;0
4b9a7eac05e10555d3ee700e5c4c7a1c6938c279;Wed Sep 25 07:03:05 EDT 2002;Committer;matz;10;83;36;119;0
8a1e574cdbd7a02692bc6bca8ba9a5690b6ecf10;Tue Sep 24 06:01:31 EDT 2002;Committer;michal;1;0;2;2;0
f3376759aba9921ea0d995bc459c4c3b18135c5e;Tue Sep 24 06:00:03 EDT 2002;Committer;michal;2;63;71;134;0
53178fc7db9f899dfdac4f67ace9f72d80d4b50b;Mon Sep 23 15:48:42 EDT 2002;Committer;nobu;5;35;26;61;0
849b1000b082186b17b851df8fb3b1654fd58cd3;Mon Sep 23 11:01:49 EDT 2002;Committer;eban;3;144;113;257;0
1eab34576a2578a0542d6c8b28a6538150818ead;Sun Sep 22 15:34:13 EDT 2002;Committer;nobu;1;2;2;4;0
742283385fc8539e76581ad2482ad62ed8a12c76;Sun Sep 22 12:52:18 EDT 2002;Committer;nobu;4;23;6;29;0
f3cdd50125b9a66b18766dc1eaaff10fbc92a29d;Sat Sep 21 13:30:48 EDT 2002;Committer;nobu;1;0;4;4;0
5c6ede680b84fc7fa9473cec58a28a18a8e27cb0;Sat Sep 21 13:30:00 EDT 2002;Committer;nobu;3;11;3;14;0
f0434309688c439c1723261677f7a82a5e1b2e51;Fri Sep 20 15:47:06 EDT 2002;Committer;nobu;1;0;1;1;0
749dea9e7c2a39d095c70023d1ee2c76f1c3e3c7;Fri Sep 20 14:03:45 EDT 2002;Committer;nobu;3;83;125;208;0
f5b9282f056774d1beaa181a9de70742d22c4a14;Fri Sep 20 10:46:52 EDT 2002;Committer;knu;2;398;36;434;0
5ce589c25d0e096bc6931602763678c13e9f7afa;Wed Sep 18 06:02:38 EDT 2002;Committer;nahi;1;1;1;2;0
c7e16e94e41164b9d409142a536dd80d00572dab;Tue Sep 17 13:52:45 EDT 2002;Committer;michal;6;13;54;67;0
9d298253558e899e85e4363358a30f41db95aafb;Tue Sep 17 12:07:36 EDT 2002;Committer;nobu;2;18;6;24;0
dd8e5a9d317ed06237c493edb3954487507ff431;Tue Sep 17 09:41:36 EDT 2002;Committer;eban;1;2;2;4;0
73a47246f27d7967ec8af5fb7ce43064d4a64d40;Tue Sep 17 09:36:05 EDT 2002;Committer;matz;4;20;7;27;0
50cc115b7e29418bf8cc1713717e72912f45e74a;Mon Sep 16 15:56:31 EDT 2002;Committer;aamine;3;10;4;14;0
94e5dc3416d579b0659bbcad5bf161025e96f45c;Sun Sep 15 13:02:09 EDT 2002;Committer;H_Konishi;2;30;18;48;0
ce296ec7fc8fc02b1b95bac13b763100c66eb909;Sun Sep 15 12:57:21 EDT 2002;Committer;eban;7;72;17;89;0
aa904b2050026a0fa6bc7d3e1869dc471c1b0749;Sat Sep 14 11:17:32 EDT 2002;Committer;H_Konishi;2;4;3;7;0
a1ea7b6d5625cf3fe3dca9d0f64294211a9f644a;Fri Sep 13 14:46:44 EDT 2002;Committer;nobu;2;11;4;15;0
a28c0eecbb4110bc770b328561f02515db81f4ae;Fri Sep 13 11:57:59 EDT 2002;Committer;nobu;1;2;2;4;0
026e1858383555ede7b307dc9484a11d71dd5e1d;Fri Sep 13 09:36:28 EDT 2002;Committer;nobu;3;15;3;18;0
449f885d62984e2893bcb30258cf04cd67f07559;Fri Sep 13 08:26:35 EDT 2002;Committer;michal;1;8;8;16;0
8b598af61138988487bef40800ea419cbc74149c;Fri Sep 13 04:30:27 EDT 2002;Committer;eban;2;6;0;6;0
df3368c1dd4ca9bfbd537913954ee730a134b75d;Thu Sep 12 14:27:02 EDT 2002;Committer;H_Konishi;3;22;13;35;0
66d9f5498b4da0febfc251ae8f1915a6f9df124f;Thu Sep 12 09:11:12 EDT 2002;Committer;nobu;2;4;2;6;0
563885cad6b8b6e3485a676c06d53acec1e93afc;Thu Sep 12 08:48:57 EDT 2002;Committer;nobu;2;6;0;6;0
b031fdbc0e58d5845b071e80efd5d7ee7595c82c;Thu Sep 12 06:27:15 EDT 2002;Committer;matz;4;158;83;241;0
e78e79e10f37921c7fe82354d1caf9ad14f0fb57;Wed Sep 11 15:45:43 EDT 2002;Committer;knu;1;2;2;4;0
368e015170a6492c6ccfa416c0b6ee5f78261fd9;Wed Sep 11 15:13:10 EDT 2002;Committer;nobu;2;84;24;108;0
c47f24027a3473fbdf9510cc300565fb1e6f1db8;Wed Sep 11 12:29:17 EDT 2002;Committer;akr;5;36;17;53;0
bfb17752441e7d0106dff08c74a6fcd01131a6f8;Wed Sep 11 09:58:02 EDT 2002;Committer;nobu;2;9;4;13;0
d0c6f63804a01618e8f86b3a49fcb85253636964;Wed Sep 11 08:50:13 EDT 2002;Committer;usa;3;17;1;18;0
b9e3aa30f78a7734273c83748841776fec2ba7be;Wed Sep 11 04:05:36 EDT 2002;Committer;knu;2;26;17;43;0
0eb196f281259b77efe550044c05a213122a2b91;Wed Sep 11 02:38:51 EDT 2002;Committer;usa;5;25;14;39;0
c0d0125bc70d7fbde34bea82f9c06bf6cb57b2eb;Wed Sep 11 01:25:52 EDT 2002;Committer;nobu;1;2;2;4;0
f34534c52afc423e3b48b54c1b127c26098b59de;Wed Sep 11 01:09:04 EDT 2002;Committer;nobu;2;107;21;128;0
a82da9463f1a878c9f92c117e645b77425ab2b08;Wed Sep 11 00:39:35 EDT 2002;Committer;usa;2;9;2;11;0
a043f0f6cb4d1deb87d3e34a391252085208c131;Wed Sep 11 00:24:07 EDT 2002;Committer;usa;1;32;32;64;0
bb34d7163ddccabb1a3b0553330ee56ef77d2291;Tue Sep 10 15:44:36 EDT 2002;Committer;nobu;2;6;0;6;0
fe06b5a0e92bf7c0bb15c274a5daf26b2f18cd3b;Tue Sep 10 14:38:27 EDT 2002;Committer;nobu;1;2;2;4;0
64bdb0c395d0e7c21a833dcba6df33a7e89fc33c;Tue Sep 10 14:38:20 EDT 2002;Committer;nobu;2;15;0;15;0
3374d203c176f95a254cfe817fe571c905fd9389;Tue Sep 10 09:53:04 EDT 2002;Committer;eban;1;4;2;6;0
d54331b0afe5800093b4a2b89e7b5a07b483f45e;Tue Sep 10 09:30:50 EDT 2002;Committer;eban;3;22;9;31;0
97c0e2c0cda73a23229ae493662ee4a239e1483b;Tue Sep 10 08:28:51 EDT 2002;Committer;usa;1;4;3;7;0
a3faa7e2e27c74b8f412de3f4b7d7e7e2c4881b8;Tue Sep 10 08:24:11 EDT 2002;Committer;usa;5;108;59;167;0
b3a426e70a662184f587396e8fe2cd2544b24242;Mon Sep 09 14:48:21 EDT 2002;Committer;eban;2;7;3;10;0
6f92767afcacbf2c82d1116329360aee7d5b522b;Mon Sep 09 10:26:02 EDT 2002;Committer;michal;1;2;2;4;0
23fb79a290a4d7e2232546db2fc25663d0220de5;Mon Sep 09 02:27:01 EDT 2002;Committer;nobu;2;36;11;47;0
73d4f4b0bbe7918134fc2d687298af0181a5030d;Sun Sep 08 12:59:08 EDT 2002;Committer;eban;4;17;12;29;0
58d69379c19db540c4a9692c0d6dba75668e7629;Sun Sep 08 11:08:48 EDT 2002;Committer;eban;1;2;2;4;0
43241ab269c3aaddf7923f4540c8a95605f56a74;Sun Sep 08 10:33:12 EDT 2002;Committer;usa;2;4;0;4;0
d1a4bf7d3a479a335e26f879098ac9f2d7421092;Sun Sep 08 10:06:40 EDT 2002;Committer;usa;4;49;2;51;0
b8ff4a843e4dbf1fab1f033a660f80cccf6a095d;Sun Sep 08 10:00:43 EDT 2002;Committer;eban;5;76;94;170;0
d76fdc013bea0cd7881fb2d49e94264c834f374b;Sun Sep 08 09:08:30 EDT 2002;Committer;eban;1;0;544;544;0
4f26f3b8902a59ec27070f8cf1fd038561894f4d;Sun Sep 08 09:08:15 EDT 2002;Committer;eban;35;679;60;739;0
275d1a12e6eeae346731bd9373aeff934d270db0;Sun Sep 08 05:46:29 EDT 2002;Committer;H_Konishi;5;11;4;15;0
75821a5afba9c19a3eedeb4a092aade1ad21209a;Sat Sep 07 14:37:26 EDT 2002;Committer;nobu;2;48;15;63;0
9d64fd035aa2ec89dde826e27e9163f476477966;Sat Sep 07 13:50:27 EDT 2002;Committer;eban;1;2;2;4;0
e1488bd2435bb6b691f0f12220c9a017c8e0823f;Sat Sep 07 10:58:02 EDT 2002;Committer;knu;1;2;5;7;0
d29143b99ea0fb2ea4821a804d489447cf92ed68;Sat Sep 07 10:48:14 EDT 2002;Committer;knu;2;38;4;42;0
6954ba398acc925443711f93c1f3f83136c99fe9;Sat Sep 07 10:32:23 EDT 2002;Committer;knu;2;332;292;624;0
7622095d174d3251c2b0ef3f22bd95fe90b4a787;Fri Sep 06 23:41:43 EDT 2002;Committer;aamine;2;4;2;6;0
a449f78c896b2559e1d2cbcef673b3aca68b5fc1;Fri Sep 06 11:23:14 EDT 2002;Committer;nobu;2;82;13;95;0
7881363731eb4695c745b49ad67652ae8062f995;Fri Sep 06 08:59:41 EDT 2002;Committer;matz;6;13;24;37;0
3edb155cd1bab6d1c66ae2c786cfdb71d5d8113d;Fri Sep 06 05:20:53 EDT 2002;Committer;eban;1;2;2;4;0
95d65e34e10060aec33764f6b1928880bd78b2cd;Fri Sep 06 03:09:07 EDT 2002;Committer;aamine;2;10;3;13;0
e389d3d1530e22be209afa7925deeb8409e225ae;Fri Sep 06 02:44:51 EDT 2002;Committer;aamine;2;12;5;17;0
5ef74b512cd7e8878dfadb8cc2cebc45466aeb0a;Fri Sep 06 01:58:32 EDT 2002;Committer;aamine;2;6;1;7;0
4ebc9ec226d7aa80db5bcb182fcd895212ee2447;Fri Sep 06 01:24:41 EDT 2002;Committer;aamine;2;21;21;42;0
458673dd8abf2a26f3308873c1d83c6dfa273964;Thu Sep 05 20:53:31 EDT 2002;Committer;nobu;2;10;1;11;0
4464544e052d1dd2632779a66807ad0bd597e216;Thu Sep 05 20:09:52 EDT 2002;Committer;aamine;1;1;1;2;0
7ac3b71611d7e3e29c9a1a489c20a1c58e01328e;Thu Sep 05 20:00:52 EDT 2002;Committer;aamine;4;19;0;19;0
49cd091cf24ba06d2cd019289815cd3f41c28d1f;Thu Sep 05 09:42:56 EDT 2002;Committer;matz;5;120;49;169;0
61ec0281a4327ef3d48eafa5f2b7eabffd9114e0;Thu Sep 05 09:17:48 EDT 2002;Committer;michal;2;25;14;39;0
5a53593f818fcdef000409799d8d1616c5964f8d;Thu Sep 05 04:17:31 EDT 2002;Committer;nobu;1;2;2;4;0
1ec2805c4f79e741d5be8ec0d74b93585179d0be;Thu Sep 05 04:15:50 EDT 2002;Committer;nobu;2;5;6;11;0
c7b20263a2f49de507a8009ba8490fdbfe634d1f;Thu Sep 05 02:24:40 EDT 2002;Committer;eban;1;1;1;2;0
3a0f79267e5a424904146fe95b678b6581512373;Thu Sep 05 02:11:41 EDT 2002;Committer;matz;1;1;1;2;0
8ed2c6fc8a141b07d2b7a024b5ec1ffa4d9250e2;Wed Sep 04 16:52:53 EDT 2002;Committer;eban;3;37;30;67;0
0e7b1e2632570b33aa957b9db966c09b290671a5;Wed Sep 04 11:25:27 EDT 2002;Committer;arai;1;2;2;4;0
a103d128cdb67dd87b5501e71e7a95876afd17ca;Wed Sep 04 09:23:51 EDT 2002;Committer;michal;1;6;4;10;0
869159006a16e3d5bfded997ab273de8d30f752b;Wed Sep 04 09:21:07 EDT 2002;Committer;michal;1;2;3;5;0
ec43854aa6be4a295ec76334843748a0ef0059b4;Wed Sep 04 07:15:17 EDT 2002;Committer;knu;1;2;2;4;0
64901cd69beb7b965b7d9e685b5fcdb835362c50;Wed Sep 04 06:37:39 EDT 2002;Committer;matz;8;68;66;134;0
056817564e8fcf98a35a1f52a4d4d1d0ca6a9fe4;Tue Sep 03 10:00:45 EDT 2002;Committer;michal;1;2;1;3;0
c10890f6d82b0ee0bd80f5bb28927e09915a79d9;Tue Sep 03 08:40:47 EDT 2002;Committer;eban;3;126;419;545;0
6f484e4930be69c58462dd11c97663e6c8488b8e;Tue Sep 03 05:20:14 EDT 2002;Committer;matz;22;277;239;516;0
20254d4e133331e69e6aa7514e1e72ad7d14d496;Mon Sep 02 14:04:19 EDT 2002;Committer;nobu;2;9;6;15;0
10c4364287e67e8d74d28f90c72b667aa8d8be3b;Mon Sep 02 12:19:30 EDT 2002;Committer;aamine;5;29;3;32;0
d92e76de6451d13ae4d22be61f3a9e21bebfa775;Mon Sep 02 08:09:13 EDT 2002;Committer;eban;1;2;2;4;0
438ea009692d69c5c5bbc60822d3577ebd5f330f;Mon Sep 02 08:05:39 EDT 2002;Committer;michal;1;1;1;2;0
844de6b24b8152dc2f11ef3636e1dae91978a6f3;Mon Sep 02 08:02:56 EDT 2002;Committer;michal;1;4;1;5;0
674f0aa4782afec2748900c601f9288e56a91bae;Sun Sep 01 08:14:11 EDT 2002;Committer;suke;1;28;11;39;0
4c3dc77fe6b53331dc4573d3d313fa9554a3155f;Sun Sep 01 06:58:09 EDT 2002;Committer;eban;2;6;2;8;0
e16187701296bdc7f1acc9397b14cf015fdefbde;Fri Aug 30 14:34:57 EDT 2002;Committer;eban;1;1;1;2;0
fb00e309f66c4e00d07373fec46e36620bfda6fa;Fri Aug 30 13:47:49 EDT 2002;Committer;knu;3;786;0;786;0
417231cdfe7fc97a6fa8b7e853428ecb795db586;Fri Aug 30 12:02:04 EDT 2002;Committer;H_Konishi;2;5;1;6;0
7dd7d1709147d816600e1aa877e6d838450379bf;Fri Aug 30 10:48:06 EDT 2002;Committer;nobu;1;2;2;4;0
6e4ed1ffd3226ac53161f6c085d84f6f890ba502;Fri Aug 30 10:46:37 EDT 2002;Committer;nobu;2;5;1;6;0
09a27c5a9040ce2176de075569dc6690f893a193;Fri Aug 30 10:43:41 EDT 2002;Committer;nobu;1;11;5;16;0
e8550265002a53f0a7e736aeb6b9b711b6bacfab;Fri Aug 30 10:42:09 EDT 2002;Committer;nobu;6;22;14;36;0
f5f30e580f90e2022f2c32935d5ba0e1eb00f1ed;Fri Aug 30 08:22:09 EDT 2002;Committer;michal;1;17;36;53;0
b4ea040b312ac86bbe8973b23844ea749956a17f;Thu Aug 29 14:36:29 EDT 2002;Committer;H_Konishi;2;5;0;5;0
ee9f1463df43a75963a5f49497dab0a4d795d8f9;Thu Aug 29 13:00:22 EDT 2002;Committer;ttate;1;7;5;12;0
40bc4f5ae4ffe325c36a49e0d3280dbee2a39cee;Thu Aug 29 09:08:18 EDT 2002;Committer;matz;14;203;164;367;0
3bf972993f689965c857540ec1ccc729477e8e66;Thu Aug 29 04:38:37 EDT 2002;Committer;eban;3;7;3;10;0
3badfbf1d51e38785c387ad4fdbbaf2858fc0b4a;Wed Aug 28 16:00:34 EDT 2002;Committer;nobu;1;1;0;1;0
9208c7471849a137297c262177cce70ef8c28de1;Wed Aug 28 15:58:35 EDT 2002;Committer;nobu;2;20;8;28;0
5c70716bdc3796ec62400b939dc2f5450def6b87;Wed Aug 28 14:59:01 EDT 2002;Committer;michal;3;16;7;23;0
b961db7587376bf451775d3654c19a9da5d3a73d;Wed Aug 28 14:36:38 EDT 2002;Committer;nobu;2;19;3;22;0
343f505fb8a6162d2a3ecbef360813eec81f221c;Wed Aug 28 10:14:06 EDT 2002;Committer;nobu;2;24;6;30;0
4c59a65d045313fd6233b71fcec126f8d4b81575;Wed Aug 28 09:41:58 EDT 2002;Committer;nobu;1;1;1;2;0
29966e099c9004e1cc83b40750eb95cb13c4dbc4;Wed Aug 28 09:25:07 EDT 2002;Committer;michal;2;8;1;9;0
8790d9b76e103af734496fb85911daff9330cfa1;Wed Aug 28 08:56:25 EDT 2002;Committer;nobu;2;23;9;32;0
0d0ae37e508788ea52e2e2cf477877ee58fa79dd;Wed Aug 28 08:05:23 EDT 2002;Committer;michal;13;95;97;192;0
3685a85b3d60bb6bdee18b3634ec8e264d8031c5;Wed Aug 28 07:38:25 EDT 2002;Committer;eban;2;7;1;8;0
1a44a463af542ca3f5692d1e99cc2a42881c05dc;Wed Aug 28 06:01:58 EDT 2002;Committer;matz;4;31;5;36;0
c1454b3acbc28ea629b49ea758a1ba43b6fa01ee;Wed Aug 28 02:39:29 EDT 2002;Committer;usa;3;15;7;22;0
a13ebdb8364025f15352670431d1f6db34f9df30;Tue Aug 27 11:00:24 EDT 2002;Committer;nobu;2;10;4;14;0
087f010ddbbfaf6f16a18c4ab00500005b633d8d;Tue Aug 27 10:24:24 EDT 2002;Committer;eban;1;1;3;4;0
c45908e41f47c88674b73a754ecd0535449b667a;Tue Aug 27 08:31:08 EDT 2002;Committer;matz;18;262;249;511;0
cd3d4a01f248fad1a73ff0b66b7a8d1653f64c19;Tue Aug 27 08:27:11 EDT 2002;Committer;michal;1;1;1;2;0
a36a445f2c08c640c6ea2e25e44f0649b0db84f2;Tue Aug 27 08:05:06 EDT 2002;Committer;michal;1;8;8;16;0
eaf7368732330b4f3d42442e2b6730366ff4abdb;Sun Aug 25 20:15:54 EDT 2002;Committer;wakou;2;11;3;14;0
87c2982847b38d511c418eb79818cc8c3d2cbab2;Sat Aug 24 14:17:45 EDT 2002;Committer;nobu;1;2;2;4;0
941e43aacf9299ffdeb3761a1625d76a4fcdc947;Sat Aug 24 06:32:40 EDT 2002;Committer;nobu;2;16;3;19;0
9c4a4822296e43b3722f203418a005b7651a1e94;Sat Aug 24 05:18:08 EDT 2002;Committer;akr;3;47;12;59;0
4b0f91401cf2a5084c71d6678e98242c44c6aa51;Fri Aug 23 15:24:03 EDT 2002;Committer;eban;2;4;1;5;0
f34a26bf9036a385abd0922bb4c3cc61be6991bf;Fri Aug 23 15:04:27 EDT 2002;Committer;michal;1;3;1;4;0
de6c650f442ead03b7b4485b07f719a35e67524b;Fri Aug 23 15:01:13 EDT 2002;Committer;nobu;2;10;13;23;0
cb8f50c4b521aef13bf9b989a3add94b0ccd9cce;Fri Aug 23 09:10:04 EDT 2002;Committer;eban;1;2;2;4;0
fc8f412488c94e5dae483cc52d44bb952d7c927e;Fri Aug 23 08:18:19 EDT 2002;Committer;eban;6;36;15;51;0
8b201310541362b5ce2384501121be77342ed445;Fri Aug 23 07:48:48 EDT 2002;Committer;michal;1;21;24;45;0
d576f30068605a4ed4b29db82fb71b440b06a9e9;Wed Aug 21 15:53:07 EDT 2002;Committer;michal;1;8;0;8;0
ffc13a6525c7c72cbb858380e6870106bf5a7dfa;Wed Aug 21 15:47:54 EDT 2002;Committer;michal;26;147;157;304;0
022d1f123c6149915970b4cac9664f66d8d5875c;Wed Aug 21 08:32:09 EDT 2002;Committer;eban;1;2;2;4;0
c7c1384e60a9f3dcc65b3516cdde6dcb7be17f60;Wed Aug 21 08:30:09 EDT 2002;Committer;matz;5;57;9;66;0
a7ed0fe4f939de5e0a35de57706c14dd1334d4d9;Wed Aug 21 08:27:29 EDT 2002;Committer;eban;1;1;1;2;0
35ef113acf219980c36108abe91b6173677627a8;Wed Aug 21 07:17:55 EDT 2002;Committer;eban;2;9;1;10;0
5738d629122260c6ba0f99ac4cb9dfa486c17b7b;Tue Aug 20 13:03:22 EDT 2002;Committer;H_Konishi;3;12;3;15;0
514aa4d97632f85d5dbd589d6bb37a49e8d1dbc4;Tue Aug 20 10:47:49 EDT 2002;Committer;eban;1;2;2;4;0
80caadabe9ff062d5da286a2447674ed34d5f56c;Tue Aug 20 10:42:57 EDT 2002;Committer;eban;2;11;4;15;0
c8c55db68ae5d78d6926b160f5472712cf68993f;Tue Aug 20 07:36:01 EDT 2002;Committer;matz;4;17;21;38;0
e0c5eed65c3b6c4cfb2a922286b1be792ddac58b;Mon Aug 19 10:07:06 EDT 2002;Committer;nobu;2;71;7;78;0
e7b7d28b65922b3c83ba0509182414b46bcc408b;Mon Aug 19 06:44:09 EDT 2002;Committer;matz;1;1;1;2;0
b818cdfaf390e0d721bb3e3809280b35fbcf1985;Mon Aug 19 06:41:02 EDT 2002;Committer;matz;2;10;4;14;0
ae23000c0e0e4f4af1b4462147d950549b3abdbe;Mon Aug 19 05:56:09 EDT 2002;Committer;matz;11;104;59;163;0
71a202fc01c3284608f486dd8ebb95bc57203221;Mon Aug 19 03:41:00 EDT 2002;Committer;nobu;2;13;11;24;0
6d9d1a9bb4086c5ef7208d2c95ac0be6231b7df8;Mon Aug 19 03:18:33 EDT 2002;Committer;eban;1;7;2;9;0
3b2209d4101e241a12534a2c8b8742973b63d203;Mon Aug 19 00:38:51 EDT 2002;Committer;nobu;1;2;2;4;0
11e7d457d6b86f5ca53440c7caadf679f4abff34;Mon Aug 19 00:37:16 EDT 2002;Committer;nobu;2;65;0;65;0
4f60a534cd006a72f4b4b0cdf7b1f4cc205a81bd;Fri Aug 16 07:23:04 EDT 2002;Committer;eban;3;13;1;14;0
c27d662f503d101b26a3897436bb58e8a0253660;Fri Aug 16 06:39:27 EDT 2002;Committer;nobu;2;35;10;45;0
2229b70615ce502c567d6c27357ac2ccfa70eefd;Fri Aug 16 02:52:25 EDT 2002;Committer;nobu;4;20;6;26;0
3d923fb9285b4bae77925d362118a463e00867e4;Thu Aug 15 23:00:10 EDT 2002;Committer;nobu;1;0;2;2;0
800452957dc65c4daf2c6b527706593b995618c7;Thu Aug 15 22:59:10 EDT 2002;Committer;nobu;1;2;2;4;0
e3f753650119c99f15ddd9dce2d22c6157f60769;Thu Aug 15 22:58:45 EDT 2002;Committer;nobu;2;11;3;14;0
92ca6c7773101a425bdc721cf56b281f08d64222;Thu Aug 15 11:49:40 EDT 2002;Committer;nobu;7;125;109;234;0
b604386fad8d7b26df87efd19134b3a6ac171fb3;Thu Aug 15 07:36:35 EDT 2002;Committer;keiju;1;1;1;2;0
8d330378cae29238587528ba84daf7858c8fea35;Tue Aug 13 12:07:33 EDT 2002;Committer;suke;1;20;2;22;0
cf5d04f663e9e7a61da4dda66e78097aefe66919;Tue Aug 13 09:21:18 EDT 2002;Committer;matz;9;122;41;163;0
510c93caacad0911261f3adeed73b43fc5fca57f;Mon Aug 12 13:39:22 EDT 2002;Committer;knu;2;5;1;6;0
1f99d95729fd18bf3dc98cf9eea62df6b8353e40;Mon Aug 12 07:39:12 EDT 2002;Committer;matz;11;86;43;129;0
66f8f8691b2f63428c2e0fbf95f794443ce89e18;Mon Aug 12 07:21:25 EDT 2002;Committer;nobu;2;10;5;15;0
91d884b86e3cd51962360eea8db2307c0ad61678;Sun Aug 11 00:36:38 EDT 2002;Committer;nobu;4;23;11;34;0
d1bdb139ea33ba0248c15c62eb4e18ecb491bd12;Sat Aug 10 12:19:16 EDT 2002;Committer;suke;1;172;115;287;0
e402358a33be63dd03c2821cead140c2275db477;Fri Aug 09 04:36:46 EDT 2002;Committer;eban;2;5;1;6;0
8f6b1e000a340020bfe16800ad2a45fb1b582758;Thu Aug 08 00:38:28 EDT 2002;Committer;nobu;2;5;6;11;0
8a7fbc6fec40d77175caa412994e406305769c5a;Wed Aug 07 23:48:47 EDT 2002;Committer;nobu;3;15;7;22;0
11cfb7e0f458971deca325c1d3032d1665d74bef;Wed Aug 07 13:13:44 EDT 2002;Committer;nobu;2;5;3;8;0
e20d6139f40887a05348357753b55867bf5153ad;Wed Aug 07 13:00:10 EDT 2002;Committer;nobu;2;15;8;23;0
0a85c658591d8b0763423a419dd96a9b957c3918;Wed Aug 07 00:47:41 EDT 2002;Committer;nobu;2;8;12;20;0
30bc60cfe4fed09e714621d2564b7edc4fb6eafa;Tue Aug 06 23:42:04 EDT 2002;Committer;aamine;2;50;46;96;0
fc2a1ad79f98544b46d07a18da48b27b75aef581;Tue Aug 06 06:20:43 EDT 2002;Committer;usa;3;7;2;9;0
616a47c5790887f6901801008ebbdce6705a1ca1;Tue Aug 06 06:20:07 EDT 2002;Committer;nobu;1;17;17;34;0
20479bfd81893025245b9560e6766f4c9f23e177;Tue Aug 06 04:35:00 EDT 2002;Committer;eban;1;1;1;2;0
cceff0f4b485a37616fc244d420cf672e3b192a5;Mon Aug 05 13:38:49 EDT 2002;Committer;aamine;4;452;385;837;0
9dab5bc3b0404fe183f13c0b1c3351eab1bf257a;Mon Aug 05 01:24:13 EDT 2002;Committer;ttate;3;9;0;9;0
45a08a4296b57df13190cb9065ee44974f44c7ce;Sun Aug 04 13:49:13 EDT 2002;Committer;ttate;5;83;49;132;0
14859cdf948e6f9ebbb272867f9969fe95c91faa;Sun Aug 04 13:32:15 EDT 2002;Committer;nobu;2;39;23;62;0
dfa40855bd42b469da2b4c96bf2cd654fbc53217;Sat Aug 03 12:27:33 EDT 2002;Committer;nobu;2;10;4;14;0
ebe2d10c430f1cce0fa7b022510c77bb142ea72c;Fri Aug 02 15:14:02 EDT 2002;Committer;eban;1;1;1;2;0
61eaf40b4a355e55fa036e3a37035dc8320a8447;Fri Aug 02 00:10:19 EDT 2002;Committer;aamine;2;212;109;321;0
a38b04836e7a375a24620463e4937c78434c528c;Thu Aug 01 14:00:00 EDT 2002;Committer;nobu;1;2;2;4;0
5e6634ce67281e7142e61fa5ba18265ff894c9e5;Thu Aug 01 09:42:38 EDT 2002;Committer;matz;5;23;6;29;0
2b98e10419af64787e8fd9ab5c0ff9ece7d23c50;Wed Jul 31 05:18:43 EDT 2002;Committer;matz;4;12;7;19;0
2a31a00fd9a0bd8f44e4931a6f7fac445a696a90;Tue Jul 30 22:55:51 EDT 2002;Committer;ttate;1;1;1;2;0
d4b764c2cff83eb0dac0d19cfeb5092be21f1a31;Tue Jul 30 11:11:53 EDT 2002;Committer;nobu;1;2;2;4;0
c67865a2b783892d6a3f40aac2444631694096b7;Tue Jul 30 11:01:52 EDT 2002;Committer;nobu;1;2;2;4;0
f94534efbc44762158208632b1ce7f1bc83dba75;Tue Jul 30 10:54:33 EDT 2002;Committer;nobu;2;11;3;14;0
af7ca8b51b5980329a1d01274f6f447266afead3;Tue Jul 30 10:22:32 EDT 2002;Committer;michal;1;8;6;14;0
e1b56ea4293c091ecd143d82e949b698cc734dcf;Tue Jul 30 08:23:31 EDT 2002;Committer;nobu;2;13;4;17;0
7f2348488f5de0abcddd37f54fa95f5ffe70c9a2;Tue Jul 30 06:34:27 EDT 2002;Committer;eban;3;16;0;16;0
fd98af4c65166b5e111fe3fb0a72922e20fd213b;Tue Jul 30 00:13:56 EDT 2002;Committer;aamine;2;6;1;7;0
62395a335da4623d3fcb70dd6535e25119c8aa94;Mon Jul 29 23:34:43 EDT 2002;Committer;aamine;2;5;0;5;0
e38f8b5cdc74d96585965bb3e598978ca560a636;Mon Jul 29 07:06:34 EDT 2002;Committer;eban;2;8;6;14;0
ff954d7e17387de34f2d129d857add9d51fecaec;Mon Jul 29 06:50:26 EDT 2002;Committer;eban;1;2;2;4;0
89dbf99bacac40fa17045c8322f20fc4c9c8d070;Mon Jul 29 06:14:10 EDT 2002;Committer;matz;7;31;19;50;0
448610abec3558780d541606261a090d279e26be;Mon Jul 29 05:59:46 EDT 2002;Committer;gotoken;1;1;1;2;0
ce84517f2cec1cc36ad767c073dd38dda32b88dd;Fri Jul 26 14:12:26 EDT 2002;Committer;nobu;2;6;2;8;0
5384316f5b765fb7793a4ddfade98093325ab17d;Fri Jul 26 09:33:39 EDT 2002;Committer;nobu;2;10;3;13;0
52ecaae5b68384132da88f798c9282e64eca4e77;Fri Jul 26 07:47:50 EDT 2002;Committer;eban;2;4;2;6;0
d365d1f568af2a0651959a9eb928435d3a733acb;Fri Jul 26 07:05:40 EDT 2002;Committer;eban;2;5;1;6;0
e301edc1c502f40806001938c74b90bcf9416766;Fri Jul 26 06:56:30 EDT 2002;Committer;eban;1;3;0;3;0
afb222575d81dac4eb68b4fe2b2f9e0e42758df4;Fri Jul 26 06:17:44 EDT 2002;Committer;matz;1;25;10;35;0
7194b66fb24db63dc2a23d3141ce25ad85d89777;Fri Jul 26 06:12:39 EDT 2002;Committer;matz;14;462;207;669;0
1d132e648dff057f0a5b42ddbc3704e7816213fc;Fri Jul 26 03:31:58 EDT 2002;Committer;nobu;1;2;2;4;0
d5dc032e33c149daa38e1e9b6b3cef3e580355e1;Fri Jul 26 03:13:06 EDT 2002;Committer;aamine;2;10;6;16;0
abfbbcf8e3c49d0f6890973a13affc643e17ef07;Thu Jul 25 00:09:03 EDT 2002;Committer;nobu;2;308;247;555;0
5fdec7d96bf366bb703ce6798e78fc07e598ee34;Tue Jul 23 03:25:18 EDT 2002;Committer;nobu;1;4;0;4;0
03b60c706890e64b6d4fd7d35220e524ca2625c3;Thu Jul 18 02:52:48 EDT 2002;Committer;shugo;2;14;1;15;0
55a65fd4e99c0f83f66aeb1ee9f8aef463e92fd2;Wed Jul 17 21:49:40 EDT 2002;Committer;aamine;2;6;2;8;0
141d0c380f87dc738c472d691af3879d49ecb636;Mon Jul 15 01:33:36 EDT 2002;Committer;aamine;2;7;3;10;0
702dee81adb3dfa255295b112699b496b9ab83d8;Sun Jul 14 21:32:17 EDT 2002;Committer;nobu;1;4;0;4;0
5c1ef150d2bf2a37e52142f43986bbc4c9f7d25e;Sat Jul 13 11:31:42 EDT 2002;Committer;nobu;1;2;2;4;0
9b198b3d85c6523c3afa9bcbcb1c8737339f107f;Sat Jul 13 00:32:46 EDT 2002;Committer;nobu;2;5;2;7;0
d554a55d9b98dc832fe0257f8696dc93b211789d;Fri Jul 12 16:40:06 EDT 2002;Committer;nobu;3;31;0;31;0
6af4aebc954f548298559e49719aec84e8653adc;Fri Jul 12 16:34:02 EDT 2002;Committer;nobu;3;1652;17;1669;0
6ad9e205044e75400c68331956927b5e091e7403;Thu Jul 11 21:35:32 EDT 2002;Committer;aamine;1;205;0;205;0
fa848fb6fdaab3e65b1aace32593424a9b07bff8;Thu Jul 11 21:33:38 EDT 2002;Committer;aamine;3;565;24;589;0
d16897fa572b1588a6bbd519c21f40de0db9a935;Thu Jul 11 19:25:45 EDT 2002;Committer;aamine;1;5;0;5;0
ad9d3f96558c66efd49782fa14fc02de20035865;Thu Jul 11 17:17:14 EDT 2002;Committer;nobu;2;5;2;7;0
bc8d214f761f9a23e6229c8ee386b6a128a7d895;Thu Jul 11 15:10:43 EDT 2002;Committer;nobu;1;2;2;4;0
a9efb02c18d3ceba4d4593b95d4ca952a01280bd;Thu Jul 11 15:04:23 EDT 2002;Committer;nobu;2;7;2;9;0
be1d2c5f685d56e10239565e5eefba191de0e0be;Thu Jul 11 08:22:18 EDT 2002;Committer;matz;14;141;75;216;0
da72e5a64442c9649689f347e2cc237ec3f41bf8;Thu Jul 11 04:02:08 EDT 2002;Committer;shugo;2;11;0;11;0
daba1fcdc045b97e9fd61f0a978867f36f200d4e;Wed Jul 10 12:47:38 EDT 2002;Committer;keiju;1;5;11;16;0
1f6f2325f8985271d9c36d75b70852a30f1ecd6a;Tue Jul 09 11:22:04 EDT 2002;Committer;keiju;2;75;34;109;0
af064b04b1622897995fe1177aabfb60db90e6f7;Tue Jul 09 11:17:17 EDT 2002;Committer;keiju;37;1488;699;2187;0
93602810e93b5da1c7161fb4b5c1a4025434a9ce;Fri Jul 05 10:31:47 EDT 2002;Committer;nobu;1;2;2;4;0
722c202b9af413662aaf2744e66c7f25d2ff3647;Fri Jul 05 08:58:57 EDT 2002;Committer;michal;2;60;52;112;0
ad9af3738b6236d33690d99dbaa175ab8d204277;Fri Jul 05 05:04:25 EDT 2002;Committer;wakou;2;10;1;11;0
02b589fd43b6f83efed31cf59679c421ce17f019;Thu Jul 04 14:41:36 EDT 2002;Committer;aamine;2;4;18;22;0
8e346d8cb19641c2246f52699552f0d8da3a9e0b;Wed Jul 03 05:28:01 EDT 2002;Committer;shugo;2;35;6;41;0
9620b20227a60b30ed405f7fd3299f7567fc61ad;Wed Jul 03 04:59:24 EDT 2002;Committer;shugo;2;9;2;11;0
f930648ae55e14e268197c6e0e2626d231c4038a;Wed Jul 03 04:49:54 EDT 2002;Committer;shugo;2;20;49;69;0
4e85b28085b1869867de9abaa29061bff797d74f;Wed Jul 03 02:49:42 EDT 2002;Committer;akr;1;130;130;260;0
8a95f1257fefd77d72fabeb49419109b4ff18e32;Wed Jul 03 02:36:46 EDT 2002;Committer;wakou;2;5;0;5;0
e5ae0debe331794f3e9c7d598f4d2a786a18bbf3;Tue Jul 02 14:19:51 EDT 2002;Committer;wakou;2;5;1;6;0
d8fdb2bfdef4ba112e0c3b301c256d1abbeb17de;Tue Jul 02 10:45:14 EDT 2002;Committer;nobu;1;2;2;4;0
46934759bca1d214e70ee1ed7db781202dba953a;Tue Jul 02 09:58:13 EDT 2002;Committer;michal;3;8;20;28;0
39e205994c917907055615146d14b3ce3054c140;Sun Jun 30 09:07:54 EDT 2002;Committer;eban;3;9;2;11;0
ba8174d11e05a96da71b1de659e659b6c7d513e9;Sun Jun 30 07:30:26 EDT 2002;Committer;akr;1;1;2;3;0
788181a4eb5b6e50d9a28aeab274dff4f170dbe6;Sat Jun 29 16:21:18 EDT 2002;Committer;akr;1;1;1;2;0
2f2143a2bef3d2e3d93fbb044c5f066b57cefc2b;Fri Jun 28 18:26:01 EDT 2002;Committer;usa;5;214;139;353;0
cd6cffa7b6b4828016f5ff0cffdde732a0548a92;Fri Jun 28 14:53:03 EDT 2002;Committer;usa;3;23;18;41;0
f0221db4626bb589f230bf239a7f9df83d7e444f;Fri Jun 28 14:42:46 EDT 2002;Committer;matz;14;117;63;180;0
ee852ed46d1a2a0f894e20e939b079c31e1cdb4b;Fri Jun 28 08:55:10 EDT 2002;Committer;akr;2;15;7;22;0
eb5ea93c7c094be468ee3b6ae6f75487f845c41c;Thu Jun 27 17:16:39 EDT 2002;Committer;nobu;1;1;0;1;0
98007267bce98147a1259ded452e0c5109580877;Thu Jun 27 15:09:47 EDT 2002;Committer;ttate;1;55;39;94;0
ad8c8144d4abcfa3c263add80b1b33013a1cb8ba;Thu Jun 27 14:57:10 EDT 2002;Committer;usa;2;5;1;6;0
571ff1d6b974eab38d4707d41f071a176960704b;Thu Jun 27 12:01:07 EDT 2002;Committer;akr;3;297;258;555;0
48fbacb11ca896024b23ffdb7f5c5e24bbe7456f;Thu Jun 27 09:30:47 EDT 2002;Committer;akr;1;25;10;35;0
e50f2d285fd88913fc34caef6f0ad8232d3b386b;Thu Jun 27 06:27:20 EDT 2002;Committer;akr;3;294;290;584;0
264d2e4da91c6c8fe04442b447647726710e0cde;Wed Jun 26 23:29:10 EDT 2002;Committer;nobu;2;8;2;10;0
0fdfc0bbef8f28882ec2f8946a76ee31497ee5c6;Wed Jun 26 08:01:00 EDT 2002;Committer;nobu;4;149;125;274;0
6037d1cf3d92a2f5fc76818263343b582d0228b6;Tue Jun 25 09:59:03 EDT 2002;Committer;nobu;1;2;2;4;0
a97ba8c7f7a497d70c9c285b4bf223a79d940935;Tue Jun 25 09:56:36 EDT 2002;Committer;nobu;2;17;10;27;0
fb0eb3ccd91cebc82a8315ebc1c795bd0c401a73;Tue Jun 25 09:44:57 EDT 2002;Committer;H_Konishi;2;4;1;5;0
60eadd77e8b039558af49e8d56de1fc69b4f3911;Mon Jun 24 15:26:17 EDT 2002;Committer;H_Konishi;2;5;1;6;0
e8e3f56b8174efde3262040d6095b535da0e3512;Mon Jun 24 15:18:00 EDT 2002;Committer;nobu;2;11;6;17;0
05b4ec8683884ac9bd6ccde53e351ffe6562dc3d;Mon Jun 24 07:59:02 EDT 2002;Committer;matz;4;23;9;32;0
9020b60483daf3712fde61e8b07e3eadb85a4bee;Mon Jun 24 07:34:30 EDT 2002;Committer;nobu;2;6;2;8;0
33061b45b4555de324b63c53a7151cc5ad599384;Mon Jun 24 07:20:42 EDT 2002;Committer;nobu;8;665;617;1282;0
0e866a2e516d5b7bea0a602d1048b5bdc22a2f98;Sat Jun 22 15:26:58 EDT 2002;Committer;tadf;6;185;135;320;0
47993929c4727ec1e7e7af4b2d2177d0058b84f8;Thu Jun 20 12:14:33 EDT 2002;Committer;nobu;2;8;0;8;0
8d8af5225d0e01e2c433b49d8d477c641bace1a3;Thu Jun 20 10:25:11 EDT 2002;Committer;eban;3;8;3;11;0
75c89b7eefd32e609b8141541a3cc22bb1c5d6f7;Thu Jun 20 08:59:59 EDT 2002;Committer;eban;1;2;2;4;0
e97d0b7764969431782fadf6c074ee867583efa0;Thu Jun 20 08:21:00 EDT 2002;Committer;eban;2;15;26;41;0
fa1f7befa95c930a68f4b7ace4a4e6e1dd221773;Wed Jun 19 05:54:24 EDT 2002;Committer;eban;4;16;6;22;0
772f420a18ba30a5e7a0cf03827fc958cf25db95;Tue Jun 18 15:53:57 EDT 2002;Committer;nobu;2;8;1;9;0
de9251e2c752c9a7bab11615cc54ebab3648b0c8;Tue Jun 18 15:46:24 EDT 2002;Committer;nobu;2;6;0;6;0
eecf7fdcdeb5607fe1dd93886cac328d0764aae8;Tue Jun 18 10:23:31 EDT 2002;Committer;usa;2;5;1;6;0
1b8b699d9fe2e1d3dddf3caee71d1cb95f294b6d;Tue Jun 18 07:01:46 EDT 2002;Committer;nobu;1;0;2;2;0
1979d9ae1f7e6c2f0d3016a40064bda0a64d09f1;Tue Jun 18 06:29:07 EDT 2002;Committer;matz;6;77;17;94;0
12c00312aaa4831f0ce820d9addce8f27c4f50b4;Tue Jun 18 03:53:23 EDT 2002;Committer;nobu;3;65;38;103;0
9c44d6a05c26f252a46830a138f60c8c6dd6773c;Mon Jun 17 13:42:15 EDT 2002;Committer;eban;1;1;1;2;0
7ed607e902d8370abbc16f2bc079d197e2600dd2;Mon Jun 17 02:00:56 EDT 2002;Committer;nobu;1;2;2;4;0
7138dfa32523071b91d030e14f5fcd808f0af869;Mon Jun 17 01:54:51 EDT 2002;Committer;nobu;2;18;3;21;0
3a6168af5b3a78b28b1829ce72bb2af51341c2b7;Sat Jun 15 10:25:08 EDT 2002;Committer;knu;1;2;2;4;0
7297827ec660e4a15059e7d31dc18697d85ae217;Sat Jun 15 10:24:38 EDT 2002;Committer;knu;2;7;1;8;0
42c59aa31785793dd365c70bac10d807c0329a34;Fri Jun 14 12:21:50 EDT 2002;Committer;H_Konishi;4;31;40;71;0
9e1473541d906808d31671bf0dc614f361c843df;Fri Jun 14 06:48:32 EDT 2002;Committer;nobu;1;2;2;4;0
aa79984980d8dd741b441543bddb4cf1de6816ec;Fri Jun 14 06:27:18 EDT 2002;Committer;nobu;3;19;0;19;0
561c59bf64a4d6c2ed40451e7483c4c036965bab;Thu Jun 13 06:44:00 EDT 2002;Committer;eban;1;2;2;4;0
8a6092725d5e54f1be68edb6098dcd08c68f939d;Thu Jun 13 04:53:39 EDT 2002;Committer;matz;3;8;7;15;0
b3ecbfaa01e7c75bfea9c895bb7476c58e998131;Thu Jun 13 03:55:44 EDT 2002;Committer;matz;5;36;8;44;0
a2020f907a942f09c651b1006151c932cdf7e77e;Thu Jun 13 02:21:53 EDT 2002;Committer;eban;1;1;1;2;0
698e61aaa7ef3b617ba810bb37378b2caa05d790;Wed Jun 12 12:23:10 EDT 2002;Committer;suke;2;10;11;21;0
5838e5bc4ee1a66f169b977d2ef907ceae211ecf;Wed Jun 12 09:33:40 EDT 2002;Committer;eban;1;2;2;4;0
b8be8d535a32c9f0ab54482cbf09fdcd9e0abee8;Wed Jun 12 09:32:35 EDT 2002;Committer;akira;4;28;11;39;0
91511afa9ca2b4ebaa751bc1f53e89faab6b3701;Wed Jun 12 09:22:20 EDT 2002;Committer;matz;2;71;31;102;0
94f86651d6bef5b2ce67da290ded50adf9d2e7ca;Tue Jun 11 17:39:38 EDT 2002;Committer;nobu;2;5;1;6;0
28b8274e511a14581f46842945ed8c4e069b3586;Tue Jun 11 14:59:43 EDT 2002;Committer;ttate;1;1;0;1;0
2690939122bdf4af84ebd0207272442b8ce34ef3;Tue Jun 11 14:54:51 EDT 2002;Committer;ttate;1;2;0;2;0
5434d73ef7fada1c75499f18a7b7b0ca5c79a39b;Tue Jun 11 14:44:53 EDT 2002;Committer;ttate;3;7;5;12;0
176542da7f415dd4709ea3b1c38f39e3f58ba567;Tue Jun 11 11:16:56 EDT 2002;Committer;ttate;2;4;4;8;0
7f80a1800f7b13e63227fb6202bee55a81cd506b;Tue Jun 11 10:26:13 EDT 2002;Committer;eban;3;24;10;34;0
65caf01223b8bdd538d52d3075573a9a2f006741;Tue Jun 11 07:27:22 EDT 2002;Committer;eban;1;2;2;4;0
6e01d2e2f5899c016a951c5e4468f94ac28d781d;Tue Jun 11 07:26:03 EDT 2002;Committer;eban;1;0;1;1;0
22010642b24f2b3f2bfef1324c61764dcd8cc2fd;Tue Jun 11 07:02:23 EDT 2002;Committer;matz;8;162;88;250;0
a5fd4cec841d2ae50d2aaff8f564da4842d0984c;Tue Jun 11 04:20:11 EDT 2002;Committer;shugo;2;15;0;15;0
ec16af81733434c2be946c72bd56744229716844;Tue Jun 11 04:16:58 EDT 2002;Committer;usa;3;12;0;12;0
0b67be50a514386fb3f7ac9c4488f7e2c2e3f744;Tue Jun 11 03:41:52 EDT 2002;Committer;H_Konishi;2;5;1;6;0
d0b3651906aa943423e430a61437a42f7dd39422;Tue Jun 11 01:27:48 EDT 2002;Committer;H_Konishi;27;1174;88;1262;0
ceade7b9268e9620b123843afeb25a7136f8a576;Mon Jun 10 18:23:39 EDT 2002;Committer;ttate;3;19;1;20;0
5c1bdda10cc0febcac126532cf6f3aac51c08271;Mon Jun 10 17:47:48 EDT 2002;Committer;ttate;1;47;9;56;0
be87030ea87e5a9c47a3dcec3b851d5fdcc27bb8;Mon Jun 10 13:02:00 EDT 2002;Committer;akr;1;1;1;2;0
10d0deaa99c640e86e561d1ed2ca9171577d31bb;Mon Jun 10 10:18:24 EDT 2002;Committer;nobu;1;2;2;4;0
d94aa8874942f20bcfa9dcb37e5d13d580d68400;Mon Jun 10 10:16:13 EDT 2002;Committer;nobu;1;2;1;3;0
31de74167305fd4b3850d4cbc39c6e20b5468f4e;Mon Jun 10 10:06:12 EDT 2002;Committer;nobu;3;20;2;22;0
abca067fb6d572ee45c585a43dbdfc153ce9f14f;Mon Jun 10 07:52:10 EDT 2002;Committer;ttate;1;4;4;8;0
48bd82e993ed91d011bea2c9b2815488c4b9574b;Sun Jun 09 17:56:34 EDT 2002;Committer;ttate;1;0;2;2;0
2d5b7f736518fb343469cd2bee721120309d8dca;Sun Jun 09 17:47:34 EDT 2002;Committer;ttate;8;217;243;460;0
d5ceb6ef829a4913e045015ea0deb2269eef9093;Sun Jun 09 02:44:32 EDT 2002;Committer;aamine;1;1;1;2;0
96654ce04102a8d7337c56ef635cfaca7f0caffe;Thu Jun 06 11:14:04 EDT 2002;Committer;H_Konishi;2;7;1;8;0
564edcce1817c52b0e8ec5d282896d68bca35d70;Thu Jun 06 03:06:11 EDT 2002;Committer;usa;2;6;1;7;0
a7a2b1d8f312e3fbbf4412de5266034fc530d9e7;Thu Jun 06 02:46:18 EDT 2002;Committer;nobu;1;1;1;2;0
d760f97172fd9e00c21b12e93ccdf9908f144be0;Thu Jun 06 02:43:02 EDT 2002;Committer;nobu;2;11;15;26;0
6956135b4b174c02221b62b2f0017d9fb3520c9c;Wed Jun 05 06:10:57 EDT 2002;Committer;michal;1;2;0;2;0
a9f672c47b9482b922a5df2b8800fd8a22f67680;Wed Jun 05 01:56:47 EDT 2002;Committer;nagai;1;42;26;68;0
160a9f79ef3f106786a3a97552e23a0fd840899f;Tue Jun 04 09:52:28 EDT 2002;Committer;eban;2;8;5;13;0
9ba6e0738a1455d4a9079c391953148df9316065;Tue Jun 04 09:33:39 EDT 2002;Committer;eban;2;8;3;11;0
1320f85fb0afffddfcded7c726ac4d1fa41a64e7;Tue Jun 04 08:03:43 EDT 2002;Committer;eban;1;7;6;13;0
4a470051b6740a57e3b05eb2d68f4fcefdfc0338;Tue Jun 04 07:48:30 EDT 2002;Committer;eban;1;1;1;2;0
c0eea523265a9b003c4a377f71c69c3e69804780;Tue Jun 04 07:35:48 EDT 2002;Committer;eban;1;2;2;4;0
b7bc0cae539617af4dfac5b44b0ebd700efe2084;Tue Jun 04 07:34:19 EDT 2002;Committer;matz;10;54;33;87;0
4cb164ee2a30ecb59ce93670e569f384c7da7521;Tue Jun 04 07:03:33 EDT 2002;Committer;nagai;10;721;171;892;0
dc010ff5157787b80ed35410587d0b988d55dda4;Mon Jun 03 16:02:16 EDT 2002;Committer;nobu;2;2;2;4;0
5df72288f8ec3d6f2047273281fb6abfff47cc97;Mon Jun 03 15:52:28 EDT 2002;Committer;nobu;4;135;51;186;0
a52442f27ea7892be7491cf692b4f64462c83155;Mon Jun 03 11:44:08 EDT 2002;Committer;suke;3;7;3;10;0
2263dbe022c600fb0a1db2bbf968bfce5de65aa2;Sun Jun 02 22:16:55 EDT 2002;Committer;nobu;3;21;5;26;0
f14180707d83a9e15106952102d1853b441edabd;Sat Jun 01 12:34:30 EDT 2002;Committer;suke;32;14163;0;14163;0
95a5a671426b974f5a394e8a5acddb5fecd72c69;Thu May 30 06:14:02 EDT 2002;Committer;eban;1;2;2;4;0
34f5c4061c6583fe854bdf8c792a6ffc226e3986;Thu May 30 06:12:29 EDT 2002;Committer;matz;5;117;183;300;0
21b2953030930e634da9aced44f71f019a599ad9;Thu May 30 00:21:05 EDT 2002;Committer;wakou;2;17;5;22;0
d7c1784297573be7419861e7f077923e6e911bdd;Wed May 29 10:22:19 EDT 2002;Committer;H_Konishi;8;177;163;340;0
1715197c37383ddeb077e96cb8c18a0d7d890087;Wed May 29 08:42:18 EDT 2002;Committer;eban;2;6;0;6;0
4b3a6c7aecca7eeb7dd52ff7b22cbe6c3bbbcc07;Wed May 29 05:39:09 EDT 2002;Committer;wakou;1;2;2;4;0
4ab1577db3bb1358af5fd387a59c541621f5df1e;Wed May 29 05:20:39 EDT 2002;Committer;matz;19;166;59;225;0
99551555c8c957aca4ad01a776252acf3aa37775;Wed May 29 04:48:32 EDT 2002;Committer;wakou;2;29;22;51;0
bab153b24385e3a27847707720837b4c749960ec;Tue May 28 18:11:07 EDT 2002;Committer;michal;9;21;21;42;0
ff3d6d201d72eaa0f21dc376d59f4ba2a3acad92;Tue May 28 03:20:04 EDT 2002;Committer;nobu;4;30;4;34;0
1fe8b3742528ccfabee751d7f42317f53d6fdda7;Thu May 23 07:41:53 EDT 2002;Committer;nobu;2;6;2;8;0
6e87a54aecec13d500f90ed4a19ffebc6883794b;Thu May 23 05:35:32 EDT 2002;Committer;matz;7;109;16;125;0
730d8f1d326a62d86e41faa0482f9a3c329832cb;Wed May 22 12:32:15 EDT 2002;Committer;nobu;2;6;1;7;0
f625a175027e037aa49536e156e73c6e3212f1cc;Wed May 22 11:23:11 EDT 2002;Committer;eban;2;7;1;8;0
3caee29585a97cb84da7f3390c93e8e0c557122b;Wed May 22 09:40:17 EDT 2002;Committer;aamine;2;7;0;7;0
ce3ea1911ad63c43747734858e6d73ab214029cc;Wed May 22 07:51:15 EDT 2002;Committer;nobu;1;2;2;4;0
a84982e1292e8e854ab289d3d3c2ae86a195e1b3;Wed May 22 05:57:08 EDT 2002;Committer;matz;2;3;5;8;0
edbe98d848e4872654bb5273a6a8250492026c18;Tue May 21 05:39:19 EDT 2002;Committer;matz;9;216;192;408;0
9402cbeec54f5a4de56588a1b980f53e5d50c04e;Tue May 21 04:35:31 EDT 2002;Committer;nobu;2;6;1;7;0
221e3c4c071b0c4938c90a1c1c76c80475e5d8a3;Mon May 20 19:56:52 EDT 2002;Committer;wakou;2;8;2;10;0
dbdd56faf8304da995562ed9939f441e51323504;Mon May 20 16:22:23 EDT 2002;Committer;nobu;2;6;1;7;0
15ac468a2454c41d4917fe463a496949eae8f961;Mon May 20 15:50:28 EDT 2002;Committer;ttate;1;0;1;1;0
77aad8b2f3fa7311fa08aedb56183abb903bfcd3;Mon May 20 15:47:59 EDT 2002;Committer;ttate;1;2;7;9;0
4bf76b4e6c85db9177f1501843b8161ddfae222b;Mon May 20 15:35:48 EDT 2002;Committer;ttate;6;29;20;49;0
a2db8e72c10c5e5506f18314ac805cd8206a4181;Mon May 20 09:38:23 EDT 2002;Committer;ttate;4;37;48;85;0
077d92a044cb22bfa88f39bfef43ea77e89440db;Mon May 20 04:39:50 EDT 2002;Committer;nobu;1;2;2;4;0
b241a0680c4bcd0948ac501473be3a39839ebe87;Mon May 20 04:33:59 EDT 2002;Committer;nobu;2;6;2;8;0
a61dbb92315b71013ce29f5289b3c229998ccbe6;Sun May 19 12:13:51 EDT 2002;Committer;tadf;1;8;0;8;0
e592b8f28652b197c978f015bf222b8f6e9524ce;Sun May 19 10:28:36 EDT 2002;Committer;tadf;1;1;0;1;0
c1f213f4d0d1a438eb3ce10ca5d9deb11cb1418c;Sun May 19 01:07:41 EDT 2002;Committer;tadf;1;1;0;1;0
5c2e3a8821c3d6346d45fd5981cf2ef68f2bf79e;Sat May 18 15:15:00 EDT 2002;Committer;tadf;1;1;1;2;0
a0a9227b71820de6198446e7c5ff62b04e01b2a7;Sat May 18 12:57:54 EDT 2002;Committer;tadf;1;1;1;2;0
dc9cd6a8c22ad04baa7498fd0cbc5d519ed73be0;Sat May 18 12:41:51 EDT 2002;Committer;tadf;6;897;340;1237;0
62f83f9f13164cb2bfca7e18977620f649365e43;Sat May 18 12:19:05 EDT 2002;Committer;usa;2;9;0;9;0
7ee0812aee77599f963379040aea38052080e76c;Fri May 17 07:29:47 EDT 2002;Committer;eban;2;14;2;16;0
d8a615ed3d9a87656ad2bc4f4b03ade5d8da5a6e;Thu May 16 06:17:05 EDT 2002;Committer;eban;1;2;2;4;0
3b89da683fc6387fa1707a2caf5d4842a0ab3d46;Thu May 16 05:53:14 EDT 2002;Committer;nobu;2;9;18;27;0
849fb05bb1511330b13732f54b2473659d277e87;Wed May 15 06:23:05 EDT 2002;Committer;ttate;4;69;60;129;0
09f26aaba1e00f3a1d64ce759031f6e209dbdc0e;Tue May 14 09:22:22 EDT 2002;Committer;nobu;3;240;144;384;0
eb6118992b77df9ddd3f95692d357e09b353c358;Tue May 14 06:22:31 EDT 2002;Committer;matz;34;377;70;447;0
c5d6a1ba48306652bb96bf0bf081c8c66cb45ef5;Tue May 14 05:59:35 EDT 2002;Committer;eban;4;15;5;20;0
6ed7cf2f1bc6c312fb8bfaf3cb5cf06412785b26;Mon May 13 05:42:47 EDT 2002;Committer;eban;3;64;16;80;0
88cc3b3954760d5e2f826310bf021f8e88335eab;Sun May 12 19:54:10 EDT 2002;Committer;ttate;2;6;7;13;0
be122d47beca0e3b448276f1208850a96bf62b35;Sat May 11 23:30:40 EDT 2002;Committer;ttate;2;7;3;10;0
22b07f548866252372cb0b4a705ee9c6daf8807d;Sat May 11 23:13:34 EDT 2002;Committer;ttate;3;122;38;160;0
64db3a3251a1fa03a1c5aade0182b80d95349576;Sat May 11 19:34:13 EDT 2002;Committer;eban;1;1;0;1;0
caba4b3d945828e5f0f0dc18a8c770b599e111e0;Sat May 11 19:32:59 EDT 2002;Committer;eban;1;2;2;4;0
ddee6e7c06119391a8214f70dd964abba5f7d46d;Sat May 11 19:31:18 EDT 2002;Committer;eban;4;182;37;219;0
592f838016886eeb2749707f14d16cb49f24687b;Sat May 11 13:21:57 EDT 2002;Committer;nobu;1;2;2;4;0
65ea437148169673823a09d4bf66d97a1187d8dd;Sat May 11 01:53:48 EDT 2002;Committer;nobu;2;8;2;10;0
8473a8293457ab60679bee0aaa44fc4fae945224;Fri May 10 10:05:30 EDT 2002;Committer;nobu;2;10;1;11;0
868d104b49438c3e476c4e39c2f105ac47c2b56f;Thu May 09 17:02:36 EDT 2002;Committer;nobu;1;2;2;4;0
9029decfe4ed6e275d63b15ec0996f3c7efde5df;Thu May 09 17:01:38 EDT 2002;Committer;nobu;3;40;6;46;0
253581c432a4d2dccfe9f12102bafd9d8cc12c5a;Tue May 07 08:32:01 EDT 2002;Committer;matz;4;7;2;9;0
d303a22fccd1ce4bc59e3c98862ee4a87b4715b3;Tue May 07 08:17:14 EDT 2002;Committer;eban;1;2;2;4;0
c8cfcf00203e01d548362e24c46de9b8ff2917a6;Tue May 07 08:15:25 EDT 2002;Committer;eban;2;6;2;8;0
ba9094308899ad9a6891e9739c2d7a51a851e7e0;Tue May 07 07:09:02 EDT 2002;Committer;nobu;2;15;7;22;0
58284a74e9edee85e18b652bd6a62f23f2dd50a8;Tue May 07 06:28:06 EDT 2002;Committer;aamine;2;5;1;6;0
bc66ac228c9e1ab8f0f8335a386c75bb6c1d92d2;Tue May 07 00:20:49 EDT 2002;Committer;aamine;2;9;2;11;0
40225b8cb53b3bcd79b2b30ad93f87197b8da31c;Sat May 04 22:01:55 EDT 2002;Committer;knu;1;2;2;4;0
323af7e264f6044652bd7a585dada15633da68ba;Sat May 04 21:57:32 EDT 2002;Committer;knu;2;9;4;13;0
1e0830c1985e00da3a6bb4e03e7cc7acd1b5612a;Sat May 04 00:06:19 EDT 2002;Committer;knu;2;1;6;7;0
5c7b8af9374fde22c9f229265c4e52298293aedb;Fri May 03 22:40:52 EDT 2002;Committer;knu;1;2;2;4;0
df05c380d6fe0e067ff031db9d07ddc2420271ef;Fri May 03 22:39:40 EDT 2002;Committer;knu;2;6;1;7;0
74c37c00b0a58a53d55cfcc22eed91dc2837e545;Fri May 03 13:12:10 EDT 2002;Committer;eban;2;4;0;4;0
e37c67b73f60944f8eeaf516ae8e1f880e61c708;Fri May 03 11:24:30 EDT 2002;Committer;eban;2;6;1;7;0
4213a33aa47b67b29bda00ed526ffe863bf661c8;Thu May 02 09:31:37 EDT 2002;Committer;eban;1;2;2;4;0
2b4ad0cc229b1a429b7f8b302be853367e088067;Thu May 02 09:31:29 EDT 2002;Committer;eban;3;7;2;9;0
20ed1f8d1a7ff59b884ff5d878b4fc99d0723f93;Thu May 02 07:50:36 EDT 2002;Committer;matz;7;36;33;69;0
b5a8ba178ffa5ba106a893a958db05e1dd4abd82;Wed May 01 15:21:34 EDT 2002;Committer;ttate;1;6;0;6;0
1d64100b2ae162adebe52f29fddfd309721f597e;Wed May 01 13:23:01 EDT 2002;Committer;eban;1;2;2;4;0
4fa0cdea7838a12afac492ee58af7f30660c6a8f;Wed May 01 09:41:50 EDT 2002;Committer;matz;7;155;104;259;0
ca55fe4f0d1477f9b2b14793468c370ebbb96ea7;Wed May 01 04:13:28 EDT 2002;Committer;ttate;1;1;1;2;0
c85ab121ff4259be4620c8521d082346dd24d95f;Sun Apr 28 09:15:02 EDT 2002;Committer;eban;2;7;2;9;0
076a82105af546c139014b58cf8995c548121681;Fri Apr 26 07:03:32 EDT 2002;Committer;ttate;3;36;14;50;0
cc3b6901b2178ef82dc4b05416e6c0cb0e0e3d46;Fri Apr 26 00:40:28 EDT 2002;Committer;nobu;1;1;1;2;0
b664645ddc5dc0d1dceb0b0f4a9710f0ce5a0c29;Fri Apr 26 00:38:44 EDT 2002;Committer;nobu;4;17;2;19;0
67c8ca36f22e1023eeaa1de7221bdaf294ef6bde;Thu Apr 25 14:33:15 EDT 2002;Committer;nobu;1;2;2;4;0
b134b912780e0fd84fbc107a9362e45f04391b47;Thu Apr 25 13:57:01 EDT 2002;Committer;matz;10;47;48;95;0
4ec25bdd63c8cb9acf70880666c1d113ae0cb51e;Wed Apr 24 19:14:59 EDT 2002;Committer;gotoken;1;4;3;7;0
565fec45b9adc20f868b6a40c7e5bf1fd410efd0;Wed Apr 24 05:58:34 EDT 2002;Committer;nobu;2;21;5;26;0
0efc6365aa00cbfb8873744ac21b4df5717fb7f8;Wed Apr 24 05:27:41 EDT 2002;Committer;eban;2;6;1;7;0
936ad409ad96607159bef4042f1e860ffe027fcc;Wed Apr 24 05:08:04 EDT 2002;Committer;matz;2;34;11;45;0
a117cec653030f1e1e33d2c10b057c044fad4618;Wed Apr 24 05:07:07 EDT 2002;Committer;eban;1;1;1;2;0
e3a8c626308cb8546baaf75e6133df304142f0c8;Wed Apr 24 04:54:16 EDT 2002;Committer;matz;24;485;434;919;0
b596fbbc375ea58aa2b869cb6025b2bb101f96b9;Tue Apr 23 16:22:25 EDT 2002;Committer;nobu;4;15;5;20;0
ad8dbab8887bccb5dc997071d5d11d3d36dd62b4;Tue Apr 23 15:43:26 EDT 2002;Committer;usa;3;11;2;13;0
3fe3e72b17927276843f7ffee31f76d71d6f1645;Sun Apr 21 16:05:52 EDT 2002;Committer;eban;1;1;1;2;0
73331b45e0f81df08f9af6bf229d8a09aec1ff5f;Sat Apr 20 16:09:44 EDT 2002;Committer;ttate;3;97;0;97;0
9a8bcafe554449f9de5f7b0690434a81721f3ec8;Fri Apr 19 13:06:12 EDT 2002;Committer;usa;3;10;4;14;0
5164f39cbd0f13c006189742f1090bcf218e0ee5;Fri Apr 19 07:52:21 EDT 2002;Committer;eban;1;1;1;2;0
512db243d77c19187db266087ec4927258a242c1;Fri Apr 19 07:39:40 EDT 2002;Committer;eban;4;16;17;33;0
5898798b80d96395378ef64de98c59c926bddb22;Fri Apr 19 07:33:18 EDT 2002;Committer;eban;2;5;0;5;0
c46d1cdb1e3d609322a20b10b603c70bdf508999;Fri Apr 19 07:30:30 EDT 2002;Committer;eban;1;2;2;4;0
71e36853ee248929fe5a16a6fd08f906a42a034d;Fri Apr 19 07:29:59 EDT 2002;Committer;eban;2;23;9;32;0
e7daa72a6a51539121c28a67ed5e7687f1e52a93;Fri Apr 19 05:59:45 EDT 2002;Committer;nobu;2;10;20;30;0
8c3157e43fb507dfefe71949d619115644aa0927;Fri Apr 19 04:14:07 EDT 2002;Committer;matz;6;96;49;145;0
75ebf3910794079ca1ade31ac4a79e58f0827e03;Fri Apr 19 04:05:54 EDT 2002;Committer;ttate;2;4;39;43;0
9021157411ab02797f75f204e3a9324c506eb046;Thu Apr 18 09:10:54 EDT 2002;Committer;nobu;1;2;2;4;0
e63a9901412d465cd90143d658fda8fa938d7f8c;Thu Apr 18 08:46:18 EDT 2002;Committer;matz;23;146;98;244;0
8a7b08bb787c2d8d531e0b84974fb2a4bec30d87;Thu Apr 18 08:04:57 EDT 2002;Committer;akr;2;46;1;47;0
a411f0365be364e71d2086d21b8ca5d8aa434e11;Thu Apr 18 06:13:43 EDT 2002;Committer;nobu;4;8;0;8;0
53641c5118005bcc276557b566e8069972ca4cbc;Thu Apr 18 05:11:31 EDT 2002;Committer;akr;2;6;3;9;0
59c8d11b83d689a9228e0f111cfdbceaaf0515d2;Wed Apr 17 15:00:23 EDT 2002;Committer;knu;13;5;5229;5234;0
23288f8674dda92d106816c8379fad839909ea75;Tue Apr 16 00:02:49 EDT 2002;Committer;nobu;3;7;3;10;0
7edb39fbfa9ab3bf1419628f77ed38b4c9bcc244;Mon Apr 15 09:29:47 EDT 2002;Committer;nobu;1;2;2;4;0
9a24232fd28baa60a4a460b2fc70a538b746bca0;Mon Apr 15 07:48:47 EDT 2002;Committer;matz;7;18;13;31;0
cb944528b6e73eb220d31f487d350e752aef5027;Sun Apr 14 17:19:44 EDT 2002;Committer;ttate;1;8;8;16;0
66484faf1b48ac523628597e77a7758382a1764a;Sun Apr 14 15:21:23 EDT 2002;Committer;ttate;1;7;2;9;0
cd948e46002a8e7fb8ff906e18a92da549669d81;Fri Apr 12 08:45:02 EDT 2002;Committer;matz;3;12;3;15;0
29b36962fe4b3cf08048c9b8e3a6dad258838eb0;Fri Apr 12 04:05:08 EDT 2002;Committer;eban;1;1;1;2;0
1ba42d4508ec90a94f325793e17fdf9563ab2186;Fri Apr 12 03:55:04 EDT 2002;Committer;usa;3;12;2;14;0
b28943587270fcb4c6e4b555c13cf996b072858a;Fri Apr 12 03:32:52 EDT 2002;Committer;nobu;1;2;2;4;0
be5524ae411e0e3165eef05142f65055f16a9837;Fri Apr 12 03:24:52 EDT 2002;Committer;nobu;5;119;11;130;0
1aa67cb1d357af287d9ea7e764ca3c2bae2f56a8;Thu Apr 11 11:39:25 EDT 2002;Committer;nobu;1;1;1;2;0
07c69983ac1cffb1e26f8db7c7d284428089ef56;Thu Apr 11 11:00:02 EDT 2002;Committer;eban;2;5;1;6;0
65a269376f7262212512f29f5ace7d8702b3edf4;Thu Apr 11 10:11:53 EDT 2002;Committer;eban;2;4;3;7;0
2628f376c9eba77fa7c214bd1bfd68a34dc524da;Thu Apr 11 10:06:01 EDT 2002;Committer;eban;1;2;2;4;0
5527b3b961a76f2de03a5e42b80a99d8f9b44bdf;Thu Apr 11 10:03:01 EDT 2002;Committer;matz;8;68;27;95;0
3a202ff2b4b39e910c7b99e2993ac5e5e12f2ad1;Thu Apr 11 09:38:26 EDT 2002;Committer;ttate;4;19;19;38;0
3bd7404423c8a89297b52ff9496fa10b86d64046;Thu Apr 11 08:07:01 EDT 2002;Committer;ttate;2;53;68;121;0
2990a0015324117f847bd2089ce945215cb23b4f;Thu Apr 11 07:09:33 EDT 2002;Committer;ttate;3;268;8;276;0
27a30bbf18c4a266fcbbe13f95bce8c352604afa;Thu Apr 11 06:55:12 EDT 2002;Committer;ttate;3;12;433;445;0
96d0ef6670ca18f94fa14057a36e32e3712ad85b;Thu Apr 11 06:35:48 EDT 2002;Committer;ttate;1;4;0;4;0
38698dbbe365c3ca2955ce4ecdc4dca340806fef;Thu Apr 11 05:32:22 EDT 2002;Committer;ttate;1;4;0;4;0
1ee89595bc28f8bcfcaa34b817d6c4fe31b6a019;Thu Apr 11 03:06:33 EDT 2002;Committer;ttate;1;7;2;9;0
bd074c1f0355ff8ddca2a8fd5f5abc4c816769d5;Wed Apr 10 17:02:47 EDT 2002;Committer;wakou;2;5;0;5;0
061ed0d389890baf089147c2f76fcf353c0494b4;Wed Apr 10 14:45:22 EDT 2002;Committer;ttate;1;3;1;4;0
8bd818494dd3a5080d4a939f1868e741ee2ab41c;Wed Apr 10 14:13:39 EDT 2002;Committer;ttate;1;6;1;7;0
b010cccc900a12160fc6aa95c80259d6622af8fe;Wed Apr 10 09:58:39 EDT 2002;Committer;matz;2;9;5;14;0
19c42c0740145dec1be93c332647f4310ea19918;Wed Apr 10 08:45:26 EDT 2002;Committer;matz;14;209;146;355;0
ff0abdc55e57f42f75204429c9eca471df48d835;Wed Apr 10 05:24:47 EDT 2002;Committer;nobu;2;6;1;7;0
afc4cd48d12f4b2f829eb969f9c126abb731941a;Tue Apr 09 04:43:12 EDT 2002;Committer;nobu;2;12;3;15;0
e223518948e56589fe0a7dcdc2d1e775ed04dd66;Tue Apr 09 03:52:39 EDT 2002;Committer;nobu;3;29;6;35;0
f240fc637cb9d83463ae221c4294837c21f56395;Mon Apr 08 20:21:14 EDT 2002;Committer;knu;2;6;1;7;0
2a255514a1262476147c4665d8fe87cd970bafb2;Mon Apr 08 07:09:58 EDT 2002;Committer;nobu;1;2;2;4;0
7c96563256d909114ffb500501b72259275e6f64;Mon Apr 08 07:09:45 EDT 2002;Committer;nobu;2;11;3;14;0
dbdde236cb73b0508c8bc0733d98ba21d39b9ee6;Fri Apr 05 17:12:48 EST 2002;Committer;ttate;1;4;0;4;0
f027ab80dcfc1d5507aecaa553a629d2149c8528;Fri Apr 05 16:33:01 EST 2002;Committer;ttate;1;5;1;6;0
8d08d9f5134a07af00f9e2ef8a4938e40503f873;Fri Apr 05 05:11:11 EST 2002;Committer;ttate;4;292;141;433;0
289fe2b8ee966544d09e2fc00a7365fa7ecc920d;Thu Apr 04 14:17:19 EST 2002;Committer;ttate;2;52;17;69;0
5f8d02cbbc1686390d6965adfa12100ddd586109;Thu Apr 04 11:29:56 EST 2002;Committer;ttate;1;1;1;2;0
556556e450b2864c07c22ffa0370262c76d8ff1c;Thu Apr 04 11:17:23 EST 2002;Committer;ttate;1;1;1;2;0
07e54ed140194a387646c8e52cb69f67053ae00e;Thu Apr 04 09:22:13 EST 2002;Committer;nobu;1;2;2;4;0
1502ea7c0c91d1384caeefee46b61f8e2fd1567f;Thu Apr 04 08:27:48 EST 2002;Committer;ttate;2;16;22;38;0
b5856f738a1dc9e89f9cbc492192c8668780e1c3;Wed Apr 03 15:43:12 EST 2002;Committer;ttate;3;94;68;162;0
74b4c8139695c52123e8db0761c78bb071a61271;Wed Apr 03 11:59:01 EST 2002;Committer;ttate;10;180;167;347;0
493c57f65a3cde9c0268584aacd93a55782484ef;Tue Apr 02 17:04:33 EST 2002;Committer;nobu;2;6;2;8;0
e34e13c0c490c31c1dfed45da7d71686aa69027b;Tue Apr 02 13:16:00 EST 2002;Committer;ttate;6;8;166;174;0
736b081e92a081ffe274a62fe420a4b178540f04;Tue Apr 02 12:06:23 EST 2002;Committer;ttate;1;1;2;3;0
bb092343b44204e57c9bd3035f05503a3e68f5f0;Tue Apr 02 11:10:12 EST 2002;Committer;ttate;1;4;0;4;0
688c3836a4a9ec5285bde58d3856545e355f31fd;Tue Apr 02 10:58:19 EST 2002;Committer;ttate;1;7;0;7;0
7d711b817e62eb6c8dee01ea2283fcb1ad90f8ac;Tue Apr 02 10:56:13 EST 2002;Committer;ttate;30;5872;0;5872;0
64b6406445e53f187d2982f87becff8065edd0cc;Tue Apr 02 08:52:55 EST 2002;Committer;nobu;1;2;2;4;0
1c6a8e4debc677e9729352015c4f264cf293c5e7;Tue Apr 02 06:48:45 EST 2002;Committer;matz;5;18;9;27;0
1cfece051cc64106c5ce18dfa75496633ac97069;Tue Apr 02 06:12:04 EST 2002;Committer;eban;2;5;0;5;0
edf4c88f796a521c45318a6b7011f8af0f6d5733;Mon Apr 01 17:42:32 EST 2002;Committer;ttate;1;1;1;2;0
46a7493b6c02a7b3340d082c0d7a4d7bb0b50415;Mon Apr 01 15:01:56 EST 2002;Committer;ttate;2;92;50;142;0
de373b1b6cddf602cad483b7ede7b378666d837c;Mon Apr 01 08:31:49 EST 2002;Committer;matz;5;23;5;28;0
360453ce14e637e653005232aab50e6294a3fa48;Mon Apr 01 08:07:10 EST 2002;Committer;nobu;1;2;2;4;0
d79c23b0db41e1a5568c9aba018136fc92f6caca;Mon Apr 01 07:58:09 EST 2002;Committer;nobu;3;10;5;15;0
1550277b3458f2981dac537bd55ee52f5ad5b0e3;Mon Apr 01 07:39:09 EST 2002;Committer;matz;4;41;15;56;0
1ecdc6a115f48c880dff0cbc04f4de831480c748;Mon Apr 01 06:21:24 EST 2002;Committer;usa;4;20;0;20;0
564222ba27f71b38c3db9b4e047e006f350b4202;Fri Mar 29 14:50:09 EST 2002;Committer;matz;2;20;22;42;0
76f963d0770a8f3dac68adfcc6cfbe91f9b88e21;Fri Mar 29 11:52:09 EST 2002;Committer;nahi;1;3;8;11;0
014c5da90318607354159ed8f0f919a199dc2b51;Fri Mar 29 11:25:01 EST 2002;Committer;nobu;2;7;3;10;0
bf1f97ae3f243a1ba1fedac986683b709e229ff8;Fri Mar 29 09:04:05 EST 2002;Committer;nobu;1;2;2;4;0
09651f04313f679e9eaa604c64d7e62a6ce58eab;Fri Mar 29 07:42:20 EST 2002;Committer;nobu;2;49;17;66;0
8e565c612d6b6d6c3e1ece97554f910c9576d100;Fri Mar 29 06:49:58 EST 2002;Committer;usa;2;9;4;13;0
766762300b278cb6e02335cf1dc104dbd59141c6;Fri Mar 29 03:05:11 EST 2002;Committer;nahi;1;1;1;2;0
1c023c0cbf54e4bbcdd1db7a6a9a7ec5b4eb4107;Thu Mar 28 09:59:49 EST 2002;Committer;usa;2;6;1;7;0
cc38f5f090797b332633f8ead2dc1d34601fb03e;Thu Mar 28 09:17:54 EST 2002;Committer;matz;3;51;29;80;0
ff95039936708914c3f973ce26f1991382b2c358;Thu Mar 28 08:53:24 EST 2002;Committer;aamine;2;180;121;301;0
e1eee80893672a8c51b1fca13952dad505af23e9;Wed Mar 27 05:55:01 EST 2002;Committer;eban;2;5;4;9;0
4ae4525ca40471c5726466f02b62bd28a17f236b;Wed Mar 27 05:52:36 EST 2002;Committer;nobu;1;1;1;2;0
cf06d8b20becccb7b5b8bcdbbad25ae239d83a40;Wed Mar 27 05:28:00 EST 2002;Committer;matz;5;50;13;63;0
24e4c9a0fbbbba11ee1d21f80fbe04ee334327bd;Tue Mar 26 11:27:50 EST 2002;Committer;aamine;1;2;0;2;0
1ea1fbe85da2067aab4bc3f5fe0133a509515ac5;Tue Mar 26 11:18:02 EST 2002;Committer;aamine;3;292;191;483;0
04168e7e3e4bc412c16c68f565b84dca5cdf93a7;Tue Mar 26 11:17:13 EST 2002;Committer;aamine;4;6;953;959;0
ce0de3f67b573957d15e8945784a0d4413c32734;Tue Mar 26 10:46:30 EST 2002;Committer;eban;2;4;2;6;0
b427d9e85990c37458ec3f64c540d3bd88b02d1c;Tue Mar 26 10:14:44 EST 2002;Committer;eban;2;6;1;7;0
8d6981cfcb8e28169acd561d442db4ce01b38114;Tue Mar 26 06:44:52 EST 2002;Committer;eban;1;1;0;1;0
f60b87038d19d244446a5d0908ca4c7111857640;Tue Mar 26 06:18:51 EST 2002;Committer;matz;5;186;84;270;0
2244b5fabf15f25166bc6a433f4d3c765856a777;Tue Mar 26 05:08:56 EST 2002;Committer;usa;2;5;1;6;0
409f3a3b6b83e1482a83c43a10bb9208f5a7699b;Tue Mar 26 05:05:27 EST 2002;Committer;knu;2;8;21;29;0
59060ca1a4ee67352aa99bfabcd34f457abb467f;Tue Mar 26 03:01:30 EST 2002;Committer;eban;2;2;2;4;0
a4428fb01969d3c3fc7d539bd6002a38451751ea;Tue Mar 26 02:06:50 EST 2002;Committer;aamine;1;1;0;1;0
fb54b37850b29c0f789531a1c9126b53d9f1edd7;Tue Mar 26 02:03:04 EST 2002;Committer;aamine;4;811;2;813;0
4795daf1bce88cca8c3b14dc5c75a349838ee98a;Mon Mar 25 18:24:46 EST 2002;Committer;akr;3;10;2;12;0
c4af72cd46e468374362e9d78bd7f969e560bc62;Mon Mar 25 16:51:22 EST 2002;Committer;knu;3;65;2;67;0
6696999417e5e11aeeb2eca28011362b3280a2fd;Mon Mar 25 15:37:44 EST 2002;Committer;akr;2;5;0;5;0
dfaf41d759a700458e900051ddcbe54d65834ae1;Mon Mar 25 14:50:40 EST 2002;Committer;nobu;3;239;161;400;0
45ca4d69aa75994d8a96632529b69ae747b6639d;Mon Mar 25 10:37:30 EST 2002;Committer;eban;2;6;0;6;0
40ceea0a75487f26a4a84986a84a918609abdf7b;Mon Mar 25 09:08:15 EST 2002;Committer;nobu;3;16;12;28;0
6dfd299dec7fa9b9a10857d170156ac4f17da9a2;Mon Mar 25 08:21:01 EST 2002;Committer;nobu;2;6;1;7;0
0f95eb4659422596b658b4a7c0cb4c9b790dbdb6;Mon Mar 25 06:21:24 EST 2002;Committer;eban;1;2;2;4;0
e748f56a6bea5b17339d70b767311897769a7c97;Mon Mar 25 06:18:07 EST 2002;Committer;matz;6;119;124;243;0
a42bf2edd007da6ae32a4162236eca21b5c9d365;Mon Mar 25 02:09:16 EST 2002;Committer;nobu;2;6;2;8;0
76cdd41111c40b9658243b885296bfd45f8b14b7;Mon Mar 25 01:08:45 EST 2002;Committer;nobu;2;6;2;8;0
5efa6b2e48907328cea7d6713db116d01a7b8aef;Sat Mar 23 16:07:55 EST 2002;Committer;eban;2;6;1;7;0
258725716b9cd0ce6188bebc3b6ddbab75670728;Fri Mar 22 07:45:23 EST 2002;Committer;usa;1;2;2;4;0
f534b398a5c90be4ad68c40a0e4fe37151a2c7d1;Fri Mar 22 07:39:02 EST 2002;Committer;aamine;2;6;1;7;0
2c8151010ea62e4c274798e993e77bcbb3f2d386;Fri Mar 22 07:35:02 EST 2002;Committer;matz;1;0;28;28;0
9ef87823fa8d26baffabaac855321102f9e0291c;Fri Mar 22 07:34:00 EST 2002;Committer;aamine;1;8;0;8;0
2bd0c2bf73acd0841619f67e3448573e5b6e3064;Fri Mar 22 07:26:42 EST 2002;Committer;matz;16;259;93;352;0
890521d11783ac21503052e2a5f86c4ddfc6a9d8;Fri Mar 22 07:20:31 EST 2002;Committer;aamine;12;1268;0;1268;0
d444859d4a2664de66b53d33c29fbf6cd6ddef81;Fri Mar 22 06:45:34 EST 2002;Committer;aamine;1;0;5;5;0
983d42030030f6648d306793eed16cb907749e10;Fri Mar 22 06:38:27 EST 2002;Committer;aamine;10;679;0;679;0
b90b70d734bcc0067ad0e4f412398aba199e977d;Fri Mar 22 05:24:00 EST 2002;Committer;aamine;2;5;1;6;0
0c41c1fc226f59184a2f5784496943bbb369b32c;Fri Mar 22 05:15:44 EST 2002;Committer;akr;2;7;2;9;0
e9d9cda13b96a2827190998ba2683f524c8bc67a;Fri Mar 22 05:08:16 EST 2002;Committer;knu;5;33;15;48;0
c1c52ef76d893fe39d6c645cae917d4b6a63c0b0;Fri Mar 22 04:55:03 EST 2002;Committer;knu;1;5;0;5;0
44643180f241ac31d46f9d97cc3fd8ac0b728160;Fri Mar 22 04:52:19 EST 2002;Committer;knu;3;12;0;12;0
89646912c2310e46b87d1c028d7960e08e80dbad;Fri Mar 22 04:48:57 EST 2002;Committer;knu;4;5180;0;5180;0
27aff972386daf4daed02b43581d59d6231d3ef5;Thu Mar 21 20:11:49 EST 2002;Committer;knu;1;4;0;4;0
fef7169d1675bde434f35814a9d14faba945250f;Wed Mar 20 16:12:15 EST 2002;Committer;usa;2;5;1;6;0
952b46a617236fa380f7871230efbd711b29a0b2;Wed Mar 20 16:04:08 EST 2002;Committer;nobu;2;5;1;6;0
999971b07c1871710064b5e4ee72cf1afca2ef55;Wed Mar 20 13:19:36 EST 2002;Committer;akr;2;7;0;7;0
f5626ad6d28d050124d88f0f9c2255b1471cd63f;Wed Mar 20 13:02:03 EST 2002;Committer;nobu;1;0;67;67;0
0a14574933aa70bb05f585b3a85b019783fed36c;Wed Mar 20 13:00:34 EST 2002;Committer;nobu;1;5;2;7;0
4322acd004dd350cefadb9bad002a6b0348c5ca9;Wed Mar 20 12:59:21 EST 2002;Committer;nobu;1;80;80;160;0
c92a934c110b6759f3d6b4a547f2987fac293e0b;Wed Mar 20 11:21:19 EST 2002;Committer;nobu;4;174;15;189;0
3adfc84e73c492b7f19e65e5578b21e673273afe;Wed Mar 20 11:15:19 EST 2002;Committer;nobu;2;5;0;5;0
879a5e46a5f3ec87714514d38727416a4a33f012;Wed Mar 20 10:44:31 EST 2002;Committer;akr;2;7;1;8;0
f596cfc1d980688a4dbf98378d5ff8d9091cfa2e;Wed Mar 20 10:31:37 EST 2002;Committer;nobu;1;2;2;4;0
59993515a42803267e592a9b6fa07d3313d0c3b3;Wed Mar 20 10:21:23 EST 2002;Committer;nobu;1;1;1;2;0
760878b4242ae20a7b10f7a8f49d3875e0201aad;Wed Mar 20 09:43:15 EST 2002;Committer;matz;4;18;6;24;0
faac53f7baec4a2919bb941c0b7c0fcb62985381;Tue Mar 19 15:45:53 EST 2002;Committer;knu;2;6;1;7;0
6d2e56ce7c3e7e53745105ed2d1011e522bcbbbe;Tue Mar 19 09:03:11 EST 2002;Committer;matz;10;86;20;106;0
7632b48a7dc19870c04f6769f473dfb13abe2410;Mon Mar 18 13:21:01 EST 2002;Committer;nobu;2;6;2;8;0
51364ab05a8003d46a73738411de8add6aa43e60;Mon Mar 18 09:26:01 EST 2002;Committer;eban;1;1;0;1;0
5979f0e28835434b327fb4e98f48cfab3a9f22ab;Mon Mar 18 09:24:39 EST 2002;Committer;nobu;17;58;2;60;0
7dc66370cbce78e6f616cf19a88c419356548d48;Mon Mar 18 08:21:40 EST 2002;Committer;nobu;3;9;2;11;0
2059c382a6262c72f3761e6a5988f3b4e6146fda;Mon Mar 18 03:54:10 EST 2002;Committer;eban;2;5;1;6;0
22270b6d4b233c5426e7e40870106f82ead8636a;Mon Mar 18 02:04:23 EST 2002;Committer;nobu;3;33;14;47;0
e3235029adb8d14c8c7ff2c8f235b688059bd9a5;Mon Mar 18 01:48:56 EST 2002;Committer;nobu;2;28;7;35;0
cecb9cae01206d069b4d19ad12850d57b1b7ba7a;Mon Mar 18 01:46:33 EST 2002;Committer;nobu;2;34;7;41;0
b4e74d4038a21124542756ea255974e88dd6ea9f;Sun Mar 17 11:09:31 EST 2002;Committer;nobu;1;6;0;6;0
0f8eea046c7867f381a0c6b20122b996af72b11d;Sun Mar 17 11:07:53 EST 2002;Committer;nobu;1;2;0;2;0
cdb6be67ca9206b9f7a3d36530c5b82a2a0b58c8;Sun Mar 17 11:07:46 EST 2002;Committer;nobu;1;2;0;2;0
ef6534477d1fea8a581bc516cc02757a11e24259;Sat Mar 16 14:07:06 EST 2002;Committer;eban;2;5;0;5;0
2a86587d957143b258ac38010fbdd96bf8a89b81;Fri Mar 15 10:49:05 EST 2002;Committer;nobu;2;4;3;7;0
b400afbc5bed2f121fb87b2ca07be0b2cb9c5039;Fri Mar 15 08:59:43 EST 2002;Committer;eban;1;2;2;4;0
6ba0d31e8ffe03c6372ab41cae24770d71a54017;Fri Mar 15 08:51:31 EST 2002;Committer;usa;5;48;30;78;0
23beb1a9dd6654262d17d9dde4f8566d8c4277cc;Fri Mar 15 05:05:34 EST 2002;Committer;nobu;2;10;4;14;0
390ae31a6f03330dcb5f91dde03e70382a679b2b;Thu Mar 14 13:26:28 EST 2002;Committer;nobu;2;8;0;8;0
5fab414c0247baf72d0a8fb1748d2f9f252a39d6;Thu Mar 14 13:10:57 EST 2002;Committer;nobu;3;745;0;745;0
c4d80ad690ef25f381a2d9b3f0b3518de7ea095d;Thu Mar 14 07:20:34 EST 2002;Committer;eban;2;9;7;16;0
997b69cb6ac9eb97ea644276f1af886a49c1de03;Thu Mar 14 06:23:46 EST 2002;Committer;matz;14;955;24;979;0
4f0870f74b530cdb2de4306d55e966a924a9149c;Thu Mar 14 03:35:52 EST 2002;Committer;nobu;2;51;14;65;0
bce7601f73fa72465b65c3dacaddc21ac904ac92;Thu Mar 14 00:10:49 EST 2002;Committer;nobu;2;6;0;6;0
f963fa6956c915e267546a177aea89a748592370;Thu Mar 14 00:04:05 EST 2002;Committer;nobu;1;1;1;2;0
e4f4b0c87c144dca043659a21a4b781c6b608a77;Thu Mar 14 00:01:04 EST 2002;Committer;nobu;1;2;2;4;0
a1f4ea2127eea422a514c9d9ec646c98269e67ae;Wed Mar 13 23:59:41 EST 2002;Committer;nobu;2;5;1;6;0
d5938dd1c4ab8cad1fedc5dea28a32f5c58e6bd6;Wed Mar 13 12:05:49 EST 2002;Committer;nobu;1;2;2;4;0
b9522c168763806cf119c57acdd6293efe60fe0e;Wed Mar 13 10:11:09 EST 2002;Committer;knu;3;87;44;131;0
14461ddae6530c5574e9899a42c92817b180d3d2;Wed Mar 13 09:44:59 EST 2002;Committer;knu;3;18;2;20;0
8b6ad9131e62339f2805b0846282252775358ea7;Tue Mar 12 09:47:29 EST 2002;Committer;nobu;1;2;2;4;0
43b18e733d836df19b106786d0025f604542e74a;Tue Mar 12 09:28:50 EST 2002;Committer;matz;4;9;24;33;0
230034b7ab4abe17df4e0804531c7279c55bbc7b;Tue Mar 12 08:12:32 EST 2002;Committer;akr;2;35;30;65;0
9651a9db92b75f797ca10863257d5195d3973416;Mon Mar 11 16:10:54 EST 2002;Committer;knu;1;0;12;12;0
e23025a694932a4d72e59ea397b7a8271c2ab3f9;Mon Mar 11 15:29:50 EST 2002;Committer;akr;1;2;2;4;0
d7594a43cb6fd0620d134c6b3ad901a1efbe6441;Mon Mar 11 15:22:24 EST 2002;Committer;akr;1;4;0;4;0
8b9823a23d10edc089750b5ae9a736e40bcb5e63;Mon Mar 11 14:09:11 EST 2002;Committer;akr;4;295;0;295;0
8579ace7b4f48536c908bf65a84338554f07993a;Mon Mar 11 12:55:52 EST 2002;Committer;nobu;1;4;0;4;0
7ff805d46bd3157b23119967c4e594a32bdbcfb7;Mon Mar 11 12:47:19 EST 2002;Committer;nobu;1;2;2;4;0
5152350dc8f2cb0d6216ecc0e2205a67223f0777;Mon Mar 11 12:39:23 EST 2002;Committer;nobu;1;4;0;4;0
7435953055479a7733b1435f7e58454476702126;Mon Mar 11 11:58:07 EST 2002;Committer;nobu;2;890;0;890;0
86c6af5873ae218a3fa92aed419de5b92653b9fb;Mon Mar 11 08:02:04 EST 2002;Committer;matz;10;65;28;93;0
81930da895afee14918490b072593860cb12d09b;Fri Mar 08 23:47:36 EST 2002;Committer;akr;2;9;4;13;0
301fec6ac93f2f6f5611e1b327b9e1364ec551eb;Fri Mar 08 07:11:56 EST 2002;Committer;eban;1;2;2;4;0
d497898c231f124ba187e2650be8af20b47b1a97;Fri Mar 08 07:03:09 EST 2002;Committer;matz;14;180;88;268;0
d41f53d0b6ceaec8b9fffc9f79ee9335b2a25175;Fri Mar 08 03:19:53 EST 2002;Committer;akr;2;10;1;11;0
effd8230ea7f34fac60cca80d4a50c7975bd9f22;Thu Mar 07 11:19:37 EST 2002;Committer;nobu;7;82;8;90;0
6dc931e59f7f0099909a077dfbd6be5e4326ae09;Wed Mar 06 09:00:32 EST 2002;Committer;eban;3;7;4;11;0
d99f6d7ff6c3506658c63b7ab3533522daf1de29;Mon Mar 04 21:29:11 EST 2002;Committer;knu;1;10;9;19;0
f2dfae7ea0258fcde14d9938c00dc894b7b3ec39;Mon Mar 04 21:15:47 EST 2002;Committer;knu;2;75;75;150;0
ab1b4b5869efbcd3fa323698ad3a28466b07fe62;Mon Mar 04 04:24:26 EST 2002;Committer;knu;2;11;13;24;0
8c85fc1ec9b1c4d137b66b43aed79180825b6ea5;Mon Mar 04 04:11:22 EST 2002;Committer;knu;13;14;0;14;0
9496c3776d4348f8f7a7fc868c7eec3e64be8e3c;Sun Mar 03 11:03:05 EST 2002;Committer;akr;1;1;1;2;0
6012f4faf317deb700f63954bf1d14f30e14585c;Fri Mar 01 02:38:46 EST 2002;Committer;eban;1;2;2;4;0
1188f3f1d947a9fe7d87c15ef226d383347b107a;Fri Mar 01 02:32:21 EST 2002;Committer;eban;3;13;2;15;0
a5ecc30e7d3570398dfa7b7d89b520989f61f75f;Fri Mar 01 02:30:08 EST 2002;Committer;shugo;1;1;1;2;0
4a58b0fd7c7aadb307a8b40dc653e89abff60a14;Fri Mar 01 02:27:37 EST 2002;Committer;shugo;2;176;9;185;0
7806b0ae28fab86e025f1412485c12e3133de2ed;Thu Feb 28 22:05:01 EST 2002;Committer;akr;2;3;1;4;0
4efd36bbd99cfc45997cd173cd543c369f386bc4;Thu Feb 28 21:31:35 EST 2002;Committer;akr;3;247;0;247;0
bf7037833dc9b17a4f1cf14cee44f9327b85189e;Thu Feb 28 13:12:14 EST 2002;Committer;eban;1;2;2;4;0
e88d2cec1f896a5f23550dcdd5d1f7994e687b79;Thu Feb 28 06:53:33 EST 2002;Committer;matz;9;397;398;795;0
3fc04d9361549d5bb15f869c22d7ce9591a0ac8c;Wed Feb 27 04:52:21 EST 2002;Committer;matz;9;405;201;606;0
2fcd221fecabe3e6acaa21c54ae6d1ccbe8c0204;Wed Feb 27 04:30:20 EST 2002;Committer;eban;6;15;5;20;0
4e840877aa9b8ac179cc86202367eaaf8b78b77e;Tue Feb 26 22:09:49 EST 2002;Committer;knu;2;12;3;15;0
9b137dcb9057dee3517f06234c52f5bf73b89948;Tue Feb 26 12:38:05 EST 2002;Committer;usa;1;2;2;4;0
210ebe1acf1647f3096828b66313b8131778f5a0;Tue Feb 26 12:36:26 EST 2002;Committer;usa;2;5;1;6;0
8d456d453c5caa7b664ae906421f5d79dcf295af;Tue Feb 26 06:48:59 EST 2002;Committer;matz;4;56;37;93;0
3916df613eb46f54e4ba91834fa920ac6f612d1b;Tue Feb 26 02:36:05 EST 2002;Committer;akira;3;22;2;24;0
6e2ad002ed08b64a58fa655cb378261ebde6c7fa;Mon Feb 25 15:30:31 EST 2002;Committer;nahi;1;704;704;1408;0
09290070e8f812e72e3b20156d51bbd2a744d383;Mon Feb 25 12:23:47 EST 2002;Committer;knu;2;9;1;10;0
b700e189bd60f68de89d5785f57edf84588b0a4a;Mon Feb 25 12:13:30 EST 2002;Committer;knu;4;136;166;302;0
959a99078ea3494fc5ae57b05579b4a2a21fc993;Mon Feb 25 10:46:48 EST 2002;Committer;nobu;1;1;1;2;0
0778120490e4e1bf7edd9971217d5b07b5dab295;Mon Feb 25 10:43:13 EST 2002;Committer;nobu;2;11;1;12;0
7974acf6c580a1ded4ad50a8d496afd9fc4793ce;Mon Feb 25 09:20:05 EST 2002;Committer;eban;1;2;2;4;0
6d47b8a9cc988bb210fc44ce991a0212d97296e4;Mon Feb 25 09:16:25 EST 2002;Committer;matz;6;63;27;90;0
aaa30fd040781355739b5cceb372df46851a2f5b;Mon Feb 25 04:35:12 EST 2002;Committer;nobu;2;5;1;6;0
3dc9d269e2c24cd408828f39bc74d4c80a8811a2;Sun Feb 24 08:25:09 EST 2002;Committer;knu;1;5;0;5;0
d9479e72a682af54db9a802b3085670de719a4a8;Sun Feb 24 08:20:50 EST 2002;Committer;knu;4;64;4;68;0
018c5191bfc13be1c002f4fff64b572a031a4a7a;Sat Feb 23 09:40:58 EST 2002;Committer;nahi;1;16;13;29;0
d80b8cd59eea063deb82b28abf7fd94f4ad0d432;Fri Feb 22 12:54:11 EST 2002;Committer;aamine;1;1;1;2;0
56438ac66d50da83978e3469fd85dd87b12b1a62;Fri Feb 22 12:43:05 EST 2002;Committer;akr;1;1;1;2;0
d3b66ccf45b30ad1d7210a30fd05e6aa5f12f216;Fri Feb 22 12:10:58 EST 2002;Committer;aamine;3;48;39;87;0
9093e4a4a52c5a0827b1263added83f1116d8810;Fri Feb 22 11:24:56 EST 2002;Committer;nobu;1;2;2;4;0
9ca5b918eb9c9fcf6dbe97be6cf6dd918f4f479a;Fri Feb 22 10:59:46 EST 2002;Committer;usa;2;5;1;6;0
088d04d88e8948812038e1297d449ba12224066e;Fri Feb 22 10:28:47 EST 2002;Committer;matz;5;49;22;71;0
9ce732561568d940e9ddf2cf6cf798b3dc65ccd7;Fri Feb 22 02:31:46 EST 2002;Committer;akr;3;188;54;242;0
5024bd594de298ae1772d9224c6164aff42ff1fb;Thu Feb 21 12:42:32 EST 2002;Committer;usa;2;6;1;7;0
ce9ce9ad633dbb123e612dc2d8c177aaeb62555a;Thu Feb 21 10:21:09 EST 2002;Committer;eban;1;2;2;4;0
a08cea360d69e6a7c42154f2032590ea3e77a386;Thu Feb 21 07:15:06 EST 2002;Committer;matz;5;16;10;26;0
7f97e8948d88cb9ce431bd8b4f1c260639ec46a7;Wed Feb 20 06:45:07 EST 2002;Committer;nobu;1;2;2;4;0
0eb1a2ff6dc8e6f7adb0d56a114eaacc40d8fa50;Wed Feb 20 06:35:37 EST 2002;Committer;nobu;3;21;6;27;0
4fd111f0c131d02187f75793de04e2cbc6fd0be3;Wed Feb 20 04:42:49 EST 2002;Committer;usa;2;5;1;6;0
c46468d77315475c25d68f30dacfccdf1b08498f;Wed Feb 20 04:31:50 EST 2002;Committer;matz;5;36;10;46;0
dc7f9c1f896977412c1cbca9bbdeca8dc7942c3d;Tue Feb 19 13:16:23 EST 2002;Committer;nobu;1;19;0;19;0
19f7f6ea122df49a54c0fe40791feab1a53f6cd9;Tue Feb 19 12:33:52 EST 2002;Committer;aamine;6;597;521;1118;0
c1bfef949450c0ad55024670af2245a7833a59b4;Tue Feb 19 08:13:26 EST 2002;Committer;nobu;2;9;3;12;0
9eae31d5696cb796821929ff289869e94d87c840;Tue Feb 19 07:47:07 EST 2002;Committer;matz;4;22;5;27;0
87dfb89d2e15b031432ae09225340331a8259a1c;Tue Feb 19 06:50:22 EST 2002;Committer;matz;1;1;1;2;0
e60deb155585c410b85d417002d1f4f32062de19;Tue Feb 19 06:43:58 EST 2002;Committer;matz;4;21;11;32;0
87bf8b1dc31de2eaeafe5e75eaa04571926302ea;Tue Feb 19 05:39:06 EST 2002;Committer;matz;2;92;27;119;0
d1ca5e6d6a03b87ab58b496a2691fa55eaf36ea0;Tue Feb 19 04:49:27 EST 2002;Committer;matz;4;7;307;314;0
1a7929a9696b98f355415edc1d62cd2f9425fcac;Tue Feb 19 04:25:39 EST 2002;Committer;eban;2;7;3;10;0
0cbfe8c52474ebf6911a6c1e3f0b8c82885cc07f;Tue Feb 19 04:19:06 EST 2002;Committer;nobu;3;7;3;10;0
e58ec21435c4a0bd6942f8f80e19f4903ece211b;Mon Feb 18 11:54:50 EST 2002;Committer;nobu;1;2;2;4;0
7ef48b40badefe862f3b96ec7d2f687406876d81;Mon Feb 18 11:51:10 EST 2002;Committer;nobu;2;8;5;13;0
7de72c4858a8240ae025aecb3599291f0bf90e34;Mon Feb 18 09:52:48 EST 2002;Committer;matz;10;246;188;434;0
3432cecf246414d63d55e70aeb5697e62198618f;Mon Feb 18 05:17:53 EST 2002;Committer;nobu;2;11;2;13;0
4dd348b2b49a668172fe9cd2e93a1e054682f773;Sun Feb 17 15:31:37 EST 2002;Committer;nobu;2;8;3;11;0
21d0c3b815b16713b31522c14ebb52e815224ec3;Sun Feb 17 14:46:44 EST 2002;Committer;nobu;3;29;24;53;0
11829a5368447bf4829fc040498457763d52a9b3;Sun Feb 17 14:44:14 EST 2002;Committer;nobu;2;14;0;14;0
b1544b7d5dc2f88c0be9499bd62896632f295d12;Sun Feb 17 13:01:56 EST 2002;Committer;nobu;1;2;2;4;0
c4449fd4c4247da5e97a449b81326cde710274ef;Sun Feb 17 12:43:44 EST 2002;Committer;nobu;5;19;8;27;0
0d8551b3a986a07e16cd66e703f8984e0738778f;Sat Feb 16 02:23:49 EST 2002;Committer;nobu;1;2;2;4;0
beb24c5888aaee9374f1c44413f9e06a24a1f91e;Sat Feb 16 00:58:51 EST 2002;Committer;nobu;2;5;1;6;0
1e5d404935dfe5bdedff5c857b1ec77ac6587387;Fri Feb 15 06:14:26 EST 2002;Committer;matz;5;23;39;62;0
289430e8eceaa8a9f541e455f0ffb8186ba06acd;Fri Feb 15 04:43:58 EST 2002;Committer;matz;4;26;1;27;0
9bd2c2681f9de7d68cae20116ad790b85e655667;Thu Feb 14 08:49:21 EST 2002;Committer;nobu;1;2;2;4;0
9ae27073fa4fcff584d55441cc222192b9fc98da;Thu Feb 14 08:47:58 EST 2002;Committer;nobu;2;6;2;8;0
aac5ff00319e2d215c3dcba557f60595da24bc8d;Thu Feb 14 07:49:27 EST 2002;Committer;matz;3;7;2;9;0
5db5aa2edbd20bb95f3c75f5147e2cc8ae7b56cb;Wed Feb 13 16:39:37 EST 2002;Committer;matz;1;1;1;2;0
6d75d138093e582e00871e937578cf697f3808be;Wed Feb 13 09:53:17 EST 2002;Committer;matz;1;18;2;20;0
99facfbdf8dd1324d317857588eba15c0c8cf948;Wed Feb 13 09:32:24 EST 2002;Committer;eban;1;2;2;4;0
ba8fc117c58e66672b4638450e76911e42a80f7b;Wed Feb 13 09:01:11 EST 2002;Committer;matz;12;289;106;395;0
1995213e4bb0b6411a4a4da60c53e37bec3ba4ec;Sun Feb 10 07:55:40 EST 2002;Committer;nobu;3;7;2;9;0
b1f086d01492e4cc69f38d965775144f92cd5506;Sat Feb 09 15:57:27 EST 2002;Committer;nobu;1;2;2;4;0
f2f74e91bf9c4fb9f839ea7ad3330053484b62bf;Sat Feb 09 14:47:52 EST 2002;Committer;matz;3;30;21;51;0
3d44db882bc40c5258f340bb770f30c6ada98bbd;Fri Feb 08 07:34:34 EST 2002;Committer;nobu;1;2;2;4;0
0a396e3ebb93f26c771b7f3d3721052bffad44ea;Fri Feb 08 05:20:34 EST 2002;Committer;matz;3;13;1;14;0
ffc3c4b401424aae94e45462acbf3fc585b13e0c;Thu Feb 07 20:22:39 EST 2002;Committer;aamine;3;62;43;105;0
96a172e70134f8bafa87f086ab05716a10b73a7a;Thu Feb 07 15:48:22 EST 2002;Committer;nobu;1;2;2;4;0
91a3db0afc159e855312c4cd5c79fe925c65fd10;Thu Feb 07 04:51:11 EST 2002;Committer;akira;4;27;4;31;0
90991d9889a7b95d85c13bdea3eb246d27e466ac;Thu Feb 07 04:18:08 EST 2002;Committer;matz;3;32;4;36;0
65806ccb721251cdae290fa000be4185ff466398;Wed Feb 06 08:25:00 EST 2002;Committer;nobu;2;10;2;12;0
d77119bfe463a3eeb7b3b6995dec697ebb6be85d;Wed Feb 06 07:30:13 EST 2002;Committer;matz;5;144;90;234;0
6bebc82c03b6eb196280bbdd54eed6d7cb25a9c1;Wed Feb 06 04:39:00 EST 2002;Committer;shugo;2;63;14;77;0
cc2ab3aca6015950ce1e91fec2bceaae36000ba9;Tue Feb 05 17:10:54 EST 2002;Committer;nobu;2;16;7;23;0
8210c254bee19294af67bcee0e8f5e02ebb39a60;Tue Feb 05 07:56:31 EST 2002;Committer;matz;6;81;45;126;0
49c720ff67cbca36cac3a6a4775c5522ea7d93b2;Mon Feb 04 13:49:05 EST 2002;Committer;nobu;2;5;0;5;0
b175c4be3c5eb5c381c86502b6a092837788b8bc;Mon Feb 04 08:22:21 EST 2002;Committer;eban;1;2;2;4;0
43f68272c7fc50ba33c58f7e22923bac6fc204ac;Mon Feb 04 08:09:14 EST 2002;Committer;matz;6;52;33;85;0
c2269d5b4f60829a523f3479492267ef99e1c5fb;Fri Feb 01 10:23:22 EST 2002;Committer;nobu;8;183;91;274;0
d9b49e39b2f3380cb6c4bb68a175a230c4702b58;Fri Feb 01 08:49:02 EST 2002;Committer;nobu;2;84;78;162;0
dad91ce6d8974ed959146ce252749a9fa0d7ebfe;Fri Feb 01 06:13:37 EST 2002;Committer;nobu;1;2;2;4;0
9f0d9bd7111ecfbc087cc4dfe6b4d46e8b98800f;Fri Feb 01 06:03:03 EST 2002;Committer;matz;6;23;10;33;0
3d51761abd3bbda185410dd980e2e064b848ad02;Thu Jan 31 12:03:08 EST 2002;Committer;nobu;2;14;18;32;0
097c41755d32601d0c1fb4e956d81d9acefe802c;Thu Jan 31 04:57:54 EST 2002;Committer;akr;1;1;1;2;0
caa76f71fb8e5d260ee29cfb8c8458a2be909713;Thu Jan 31 04:24:04 EST 2002;Committer;akr;2;12;2;14;0
33158860f4650d7221e80ff0ae7eb376f31b2394;Wed Jan 30 07:12:55 EST 2002;Committer;nobu;1;1;1;2;0
ae2d54d91dc805ea7c8e4af82e8a434d722eab33;Wed Jan 30 07:00:58 EST 2002;Committer;nobu;2;25;7;32;0
7ddde51c68b572b2a94a4946d2bf9b7d0e12a65a;Tue Jan 29 19:33:11 EST 2002;Committer;nobu;3;127;24;151;0
9a8935fc65850894d412e783e3bcfb220b9285ae;Tue Jan 29 19:24:43 EST 2002;Committer;ttate;2;32;1;33;0
46d98fe87b33796f4299985f962ae615bd363bbd;Tue Jan 29 10:01:41 EST 2002;Committer;akr;2;5;3;8;0
94acb9c6bc5927b118510d0d4f0c8700748c0abf;Tue Jan 29 09:15:59 EST 2002;Committer;akr;3;12;1;13;0
86298123d748030ec9dcbb64ba3bf86816de9de7;Tue Jan 29 07:16:09 EST 2002;Committer;matz;5;283;104;387;0
e9d17f8a226bcfcf234def5d0ba77fb77a48a534;Mon Jan 28 10:18:14 EST 2002;Committer;nobu;2;5;1;6;0
8a95f7f981c5e25ca26de2b112c4979627a72a02;Mon Jan 28 09:33:56 EST 2002;Committer;nobu;2;65;44;109;0
4f38c453b4fccfbc529909781c2c1659f256697b;Mon Jan 28 08:44:45 EST 2002;Committer;matz;14;110;28;138;0
ae6afaaedbe2c88abbfc315a66685e6b99e4050c;Fri Jan 25 09:00:51 EST 2002;Committer;eban;1;1;1;2;0
a0bf3b3bb98c04ca25c8b3bf670b2d4edc52e81a;Fri Jan 25 09:00:50 EST 2002;Committer;eban;3;11;4;15;0
f547c1150cf0cb9fe2477e6aeb4ff7b724fc44c7;Fri Jan 25 08:22:11 EST 2002;Committer;matz;11;87;22;109;0
eb9708f38671aa6446a89acc755f3341f5cb59b6;Wed Jan 23 07:30:43 EST 2002;Committer;matz;13;102;42;144;0
b6cc058c53fde7442253c44e688ff8541050572d;Wed Jan 23 07:25:40 EST 2002;Committer;nobu;1;2;2;4;0
9ffccf47620d4c7333354c7ca155b9b0c0963e38;Wed Jan 23 07:24:26 EST 2002;Committer;nobu;2;8;0;8;0
68f67044787b51d60860ccd3d6dfaee9816f06e2;Mon Jan 21 13:59:41 EST 2002;Committer;nobu;2;6;1;7;0
59d3fd1832859272bff57bbc00d23bb73a15cc45;Mon Jan 21 09:36:45 EST 2002;Committer;eban;1;2;2;4;0
b03bdcd64f8c010717f014dd58025655bf7b6c51;Mon Jan 21 07:44:06 EST 2002;Committer;matz;6;76;27;103;0
0de16b913bcc91cf944ec1f72af6848ecd51a089;Sat Jan 19 14:32:50 EST 2002;Committer;usa;1;2;2;4;0
d102ce6d09908fef31b2728abfa81de05aa4239b;Sat Jan 19 14:22:27 EST 2002;Committer;matz;6;20;9;29;0
e664d467a92df0e7655c453c0eda9bc7fd1e1884;Fri Jan 18 14:56:05 EST 2002;Committer;nobu;1;2;2;4;0
a7a7324ea645b881658fb78d2e7e049f48970afd;Fri Jan 18 14:24:01 EST 2002;Committer;matz;8;116;109;225;0
9bb82109f75a89f5e43df066e60a1f2ee7977401;Fri Jan 18 01:13:58 EST 2002;Committer;usa;2;5;1;6;0
36192dfa4aa5e93d281b5dededc2bcfbfed0b117;Thu Jan 17 08:05:01 EST 2002;Committer;matz;5;191;79;270;0
57432f52b43e31939fdb12b7eee2720c08c54262;Wed Jan 16 10:37:37 EST 2002;Committer;nobu;1;2;2;4;0
e173962181dafbab3f8d850ab765e88f640a9d39;Wed Jan 16 09:32:51 EST 2002;Committer;matz;1;2;0;2;0
f21bc9261a2db100765ca0281c88ef1c71cee425;Wed Jan 16 09:27:54 EST 2002;Committer;matz;1;0;3;3;0
c0a636b6f94d7f95ed95a7abf7c2936bbd3fc5a7;Wed Jan 16 09:25:59 EST 2002;Committer;matz;7;76;29;105;0
17e1cfef8cae430ecce87ea3338b29992bd12665;Wed Jan 16 03:37:23 EST 2002;Committer;akr;3;15;4;19;0
5fe2879fd5b2b5db264f4bdbbc1181482b70e339;Wed Jan 16 02:20:25 EST 2002;Committer;nobu;4;23;6;29;0
a2fc17bb81a7ade35dc775516867c82e00e39074;Fri Jan 11 15:36:11 EST 2002;Committer;eban;1;1;1;2;0
806d838cb07639501a850c03c25a9de45364b8ec;Fri Jan 11 11:48:01 EST 2002;Committer;usa;1;2;2;4;0
31e6676624aab96f108b312a619df24136f1946a;Fri Jan 11 11:24:11 EST 2002;Committer;aamine;1;24;25;49;0
e1ac9c6a0f6a1c24571b0f33897c24b2f77fbf58;Fri Jan 11 10:54:23 EST 2002;Committer;aamine;1;223;230;453;0
2f8cdb7978138742bd560e22d88d7c84e5d9a6b5;Fri Jan 11 09:22:04 EST 2002;Committer;matz;1;1;1;2;0
85e32dd2212bc6e5bb2b48c5b6c94e048e84afeb;Fri Jan 11 09:18:54 EST 2002;Committer;matz;21;77;45;122;0
5915dc245e5efac34d676ad29ebd38d6b46f16cf;Thu Jan 10 20:18:39 EST 2002;Committer;nobu;6;59;19;78;0
399bb7e73953bc7fbeb74e2712d931f44d7553b8;Thu Jan 10 13:31:20 EST 2002;Committer;nobu;1;2;2;4;0
1b4be57f7e00a7f53eb51e530bceb5154b19e74d;Thu Jan 10 13:30:17 EST 2002;Committer;nobu;2;21;11;32;0
a5ef2da1a11af82a44a0ca81f94953a8aa793802;Thu Jan 10 08:06:57 EST 2002;Committer;akira;1;8;0;8;0
8a277783abde4824ab9f92a083dc6221c5fa4098;Thu Jan 10 08:00:51 EST 2002;Committer;akira;9;2302;0;2302;0
d92e9de3b862af630aea7583bd4d45709c5d9085;Thu Jan 10 02:43:06 EST 2002;Committer;usa;2;5;1;6;0
dffbc4d7f169648db7663c28d183a5e5bd16b5d6;Wed Jan 09 17:52:12 EST 2002;Committer;nobu;2;23;7;30;0
1a101d775a8c42f36c5a16978914ae2ac070e8a4;Tue Jan 08 07:02:26 EST 2002;Committer;nobu;3;8;3;11;0
dcbb422253ebd766d44810ab17b8705d04297ccf;Mon Jan 07 07:03:55 EST 2002;Committer;eban;1;2;2;4;0
347c7d4723d957143c98a418e8b7272489864a28;Mon Jan 07 06:58:54 EST 2002;Committer;eban;2;2;0;2;0
41dd4d2b6af247f982f2b622cad3b67d4faea275;Mon Jan 07 06:48:48 EST 2002;Committer;akr;1;1;1;2;0
c9f4686694542543864895d6c61c1ef58d58a564;Mon Jan 07 05:27:01 EST 2002;Committer;matz;5;20;21;41;0
6a100f3ce470fe659a88e46138068b7a8611f650;Mon Jan 07 03:56:55 EST 2002;Committer;akr;2;32;7;39;0
427237f8891e9a22cf9ce6e64aed9a249f18879a;Sat Jan 05 16:09:46 EST 2002;Committer;nobu;1;4;4;8;0
1cc7986a113e9eb330f5f3579c75e0ccd817ddf8;Sat Jan 05 04:19:58 EST 2002;Committer;nobu;2;6;1;7;0
8090c2f214e6c4f8981ccb4e6a1213bd1284fa08;Sat Jan 05 03:25:02 EST 2002;Committer;nobu;2;98;78;176;0
0ad520443c6cb44eb9f6866e79d4ed8f5489fe33;Fri Jan 04 15:29:42 EST 2002;Committer;eban;1;2;2;4;0
bb8805c9f8256e35e125385c55f5d0be8e3e37fb;Fri Jan 04 15:23:26 EST 2002;Committer;nobu;2;4;2;6;0
df3e2499a7391671b85d41f0c95b0dc244bac277;Fri Jan 04 15:18:54 EST 2002;Committer;eban;1;2;2;4;0
06261c1b0fb42ef32344907411ebef50f0f162fa;Fri Jan 04 15:18:16 EST 2002;Committer;eban;1;2;2;4;0
459031e5d94baf72c8e30a48922d57c6cff5a2ae;Fri Jan 04 14:15:33 EST 2002;Committer;matz;16;98;104;202;0
a7685a6b877631dbb4ea9538311c124b5822677a;Fri Jan 04 09:03:11 EST 2002;Committer;knu;2;2;26;28;0
2c2694e8464f7ef281219ec801eec94fd01f2f4d;Thu Jan 03 16:01:35 EST 2002;Committer;matz;1;39;0;39;0
167dd9c93308a2d1389fc8c6e4d13be10aa258d7;Wed Jan 02 14:42:01 EST 2002;Committer;eban;2;19;7;26;0
7fa449a44a15a97ead3af6728a144cf91d004e08;Mon Dec 31 17:48:33 EST 2001;Committer;eban;3;11;16;27;0
c8911896936224415bc120b2996a347d5f7f6ba5;Mon Dec 31 05:26:24 EST 2001;Committer;nobu;3;11;3;14;0
f3d9a0cc213f8b09155f063e057afb576178557e;Sun Dec 30 19:18:45 EST 2001;Committer;aamine;7;632;582;1214;0
653f326bb108108b82890e37400b4ca6e851e7ed;Sat Dec 29 17:27:11 EST 2001;Committer;eban;1;1;4;5;0
69b463d9a32e523aa918ec74ed908ec490a4d4d0;Sat Dec 29 16:34:01 EST 2001;Committer;eban;2;8;2;10;0
b8c26d48bcf47b9a5cff16e9177af20e5e8f3bfd;Sat Dec 29 16:10:24 EST 2001;Committer;eban;3;7;0;7;0
a59cf8edc58d46e9cf5d39d2f1999e27939304a8;Fri Dec 28 05:42:23 EST 2001;Committer;nobu;3;8;4;12;0
3b4641a4bf1fafce6f91295f4340aa3d900faddc;Thu Dec 27 09:53:54 EST 2001;Committer;nobu;3;9;14;23;0
d0c78c8567a009626191ea1383599624e169966a;Wed Dec 26 17:01:20 EST 2001;Committer;nobu;3;20;13;33;0
36e891304c0f1619808ff2d3afaf0920e23470c8;Mon Dec 24 20:34:04 EST 2001;Committer;akr;1;3;0;3;0
cecb258bdf82ba76e96d696b161be7708a78cbf2;Mon Dec 24 18:10:20 EST 2001;Committer;akr;1;4;0;4;0
a2ba32fab9b2bc0d968cfd77f62385beff67042d;Mon Dec 24 17:38:33 EST 2001;Committer;akr;3;1232;0;1232;0
428269821916bf8ed7c058340640edd8105cf599;Sat Dec 22 16:58:16 EST 2001;Committer;matz;2;11;5;16;0
0a45dee5a529461b0e6eb69f14ef4e32eb2ccc9b;Sat Dec 22 02:51:00 EST 2001;Committer;matz;3;7;0;7;0
63b6b9c43003cd5071748efca0a6d9b066834c5b;Fri Dec 21 09:23:28 EST 2001;Committer;matz;8;108;43;151;0
e93b8f1c892672a06bd6861859373e7bec49c3f6;Fri Dec 21 07:20:23 EST 2001;Committer;nobu;4;33;3;36;0
6d9e4a20e107805da30dc6d4e4e80bebcb46bdb5;Fri Dec 21 04:16:22 EST 2001;Committer;eban;1;2;2;4;0
c29a112e14749cb9fb21bc21139c1b390bf2952d;Thu Dec 20 18:19:42 EST 2001;Committer;nobu;2;7;6;13;0
b7a58b06502d4ddceff9b1cfc0f9e62381442b6b;Thu Dec 20 16:23:27 EST 2001;Committer;nobu;3;23;11;34;0
5a4187f2c28b1025d47a85b7728509a1b907eda0;Thu Dec 20 05:00:20 EST 2001;Committer;aamine;2;8;4;12;0
a76e21e612719201799384fff39dfb160b03bc99;Wed Dec 19 08:02:55 EST 2001;Committer;shugo;2;234;0;234;0
ee87eb1367f14fe43e58dfb9c528de4fd992a260;Wed Dec 19 07:48:32 EST 2001;Committer;matz;6;104;59;163;0
8e8c76bd5f52ed3974448900ce7056628d64c092;Tue Dec 18 18:14:08 EST 2001;Committer;akr;3;41;13;54;0
ab34f43ae82e6254086a3296092c6ba5955ba64b;Tue Dec 18 09:37:34 EST 2001;Committer;nobu;1;2;5;7;0
b487727ea43de143996d0a802813bbf39ee2b043;Tue Dec 18 08:56:51 EST 2001;Committer;eban;2;7;3;10;0
35f851bcfe7e42ddf1b44606d2df4d4be9de9976;Tue Dec 18 08:47:06 EST 2001;Committer;matz;14;135;77;212;0
cd956b3114c1b59de6660e1c70be192c6ee29235;Mon Dec 17 07:52:35 EST 2001;Committer;nobu;9;43;8;51;0
4f8b1c8f64b2ec44401d7726fa74fa2a812c03f8;Mon Dec 17 07:29:19 EST 2001;Committer;eban;2;3;3;6;0
bb6c116c6352fbea23ce84012409b0de19abd823;Mon Dec 17 07:22:03 EST 2001;Committer;akr;2;12;71;83;0
b48e38c5268007029ff573fadc99a8448cf9c09c;Mon Dec 17 06:45:37 EST 2001;Committer;akr;4;180;27;207;0
39c0252e048e56aa4a8f0429b95ac236b0f7856c;Thu Dec 13 19:15:21 EST 2001;Committer;aamine;8;156;133;289;0
d8c75ddad376abf83a4d6dd9d4c8eb1736db497c;Thu Dec 13 08:19:09 EST 2001;Committer;matz;5;51;22;73;0
a59c599209a11d4ab0dc0d7626ab3d5ca43a78c2;Tue Dec 11 03:48:08 EST 2001;Committer;matz;10;203;6;209;0
8a91c99905c1bfbf441ec890161538acc8e34120;Mon Dec 10 18:21:31 EST 2001;Committer;nobu;2;7;0;7;0
8ef5e308e7ebf5ab1220e80812f6628fd42b3c28;Mon Dec 10 14:43:37 EST 2001;Committer;usa;2;6;1;7;0
55471ed610fca88cb8e06432cdfaf781349299dc;Mon Dec 10 10:08:58 EST 2001;Committer;eban;1;1;1;2;0
6c8a7c3592b948692f9895d9ac7db8dc8923d104;Mon Dec 10 07:25:10 EST 2001;Committer;akr;1;1;0;1;0
c79368b6a3fa2305592392aed806739b1db79dec;Mon Dec 10 07:24:00 EST 2001;Committer;matz;2;5;3;8;0
2f8d3bdc21b37f0d6881b817c8fd9c5b4b351cd4;Mon Dec 10 07:18:16 EST 2001;Committer;matz;19;653;336;989;0
3493ea5c7acfeaf187873d4986181a5fda446aa3;Mon Dec 10 06:52:47 EST 2001;Committer;akr;1;628;0;628;0
8adfdde6b7f38ac66179667a23995b46e97e0ed9;Sun Dec 09 18:10:13 EST 2001;Committer;nobu;1;2;2;4;0
68ed743d99b3a94ce165694adaad05c72311f6f2;Sun Dec 09 14:11:30 EST 2001;Committer;keiju;2;6;2;8;0
ca1a9450fbdcff96bdee09a14933a1ecf324489a;Sun Dec 09 13:47:54 EST 2001;Committer;nobu;2;5;1;6;0
fa6dc283cd81445d4220018f49f5c82a572101fe;Sun Dec 09 08:58:30 EST 2001;Committer;aamine;8;301;191;492;0
a20863ff41b0493da0d16597b693e88b54731c03;Fri Dec 07 10:04:25 EST 2001;Committer;aamine;5;47;44;91;0
4ed1344bd7a2527e54002e4ecb59833b99f30b43;Fri Dec 07 06:52:31 EST 2001;Committer;usa;2;6;1;7;0
22d2d65d6f3133999673e0f52aeb234e07bdf41d;Thu Dec 06 09:55:31 EST 2001;Committer;usa;3;12;0;12;0
e0ed1214e42669ca294463c4fca8fb6a55c597c7;Tue Dec 04 05:27:26 EST 2001;Committer;ttate;1;1;1;2;0
f514f94a5103a3b1cab621289eb1d90e5e8342c2;Mon Dec 03 10:12:10 EST 2001;Committer;eban;1;2;2;4;0
b3144a7a0e08500d212c9f30e889dfcff631fbc4;Mon Dec 03 10:07:48 EST 2001;Committer;matz;3;117;77;194;0
9e8553e5cccd1507597b7726da15a13fcae192af;Mon Dec 03 09:38:35 EST 2001;Committer;eban;2;5;1;6;0
f4bef0acfd2307a8d0f7b5819228362e1c7fdf02;Mon Dec 03 07:09:01 EST 2001;Committer;eban;2;4;1;5;0
8abe10b3daa10c2d1f81fdf7d20ad148f77b42b1;Mon Dec 03 07:06:28 EST 2001;Committer;usa;2;6;2;8;0
a2ec07f1d11c1279cc9f05e010518d0b481ba4d7;Sun Dec 02 18:33:10 EST 2001;Committer;usa;2;16;14;30;0
dd17e103f4cb45f1fff2458d9797d113591f79cc;Sun Dec 02 14:10:27 EST 2001;Committer;eban;4;18;12;30;0
bec6d909e76d95bd9b02bf19caf6720f06a6aa5a;Sat Dec 01 14:07:02 EST 2001;Committer;knu;1;1;1;2;0
31e15f76063304e4bcffb3c6c5e7b28d26cc44e5;Sat Dec 01 14:07:01 EST 2001;Committer;knu;5;14;21;35;0
3dfb98cea26048453641e0f3e5f795d9568420d4;Fri Nov 30 09:21:46 EST 2001;Committer;eban;1;2;0;2;0
3691d88f3630ab0eb3ecfb77a1f3ac416b43380e;Fri Nov 30 09:17:30 EST 2001;Committer;eban;2;7;1;8;0
be020d6c05157df3d1d3a35abf7dce727a6d5dac;Thu Nov 29 23:59:15 EST 2001;Committer;ttate;1;2;2;4;0
23303b8a63df927cd81b9947dd48e1b416e2a39c;Thu Nov 29 15:57:25 EST 2001;Committer;matz;5;31;3;34;0
080aa35bbaa08513e47ef4e7952da5fb4cc0b685;Thu Nov 29 15:30:54 EST 2001;Committer;usa;3;8;2;10;0
6ab0ff977d84d816cefa7a92c15aacd5b6694087;Wed Nov 28 14:56:32 EST 2001;Committer;matz;6;89;54;143;0
186c8b592a8b5badfd42ff7295c5edb44ef1abdd;Tue Nov 27 10:00:35 EST 2001;Committer;matz;9;301;83;384;0
09a4937b2fcf883fa57af1dfa5d12f605f812970;Mon Nov 26 12:00:40 EST 2001;Committer;knu;12;723;0;723;0
43271e97abb9b70be32aabe5acaa6f087ebb079f;Mon Nov 26 07:59:01 EST 2001;Committer;usa;2;82;26;108;0
5444b117f2cfa8aff586cf1c057a72f0afc0034c;Sun Nov 25 12:10:13 EST 2001;Committer;usa;1;2;2;4;0
412f5709ef657afba47a25639f629ea83d581fac;Sun Nov 25 12:09:36 EST 2001;Committer;usa;2;7;2;9;0
6228c0439697d2a42f179b45f395baaa238f6f72;Fri Nov 23 09:53:54 EST 2001;Committer;ttate;2;11;3;14;0
e9abbf6a422de6675d600350086e2015509e3a82;Thu Nov 22 05:17:06 EST 2001;Committer;eban;1;2;2;4;0
f1fdbf080efdf954a4773baf2dd088eddb7c03ef;Wed Nov 21 15:42:12 EST 2001;Committer;matz;10;181;56;237;0
e15f65b004eaa43a013f8d069479c55e70563177;Wed Nov 21 03:30:22 EST 2001;Committer;shugo;2;8;1;9;0
505e295fd6e06bfd01be9d471fde49b33b20057c;Tue Nov 20 03:54:04 EST 2001;Committer;eban;1;2;2;4;0
24b3a3e7489181bb2fa1fd86bd93793a8cef6829;Mon Nov 19 16:20:24 EST 2001;Committer;matz;3;14;1;15;0
04f27f5e8ddbbc06544d96df4097e0300685a1cc;Mon Nov 19 14:42:45 EST 2001;Committer;matz;6;36;11;47;0
df96f994f1a224070ffaa61eb2bcb969d0109246;Mon Nov 19 05:03:03 EST 2001;Committer;matz;25;348;297;645;0
d550569264a16e96121d05423f7516ce726d96c9;Sun Nov 18 20:08:14 EST 2001;Committer;wakou;2;9;0;9;0
5ca24aa3e816759b838673743aed54b541c8d8e4;Sun Nov 18 10:49:28 EST 2001;Committer;nobu;3;12;9;21;0
050a1687d2ff1c75727f163dc730ca79883eb435;Thu Nov 15 15:57:49 EST 2001;Committer;nobu;1;2;2;4;0
35008e2087fd1ef07ad749a75db5417721ef8c69;Thu Nov 15 15:56:08 EST 2001;Committer;nobu;2;8;2;10;0
a79f85e6cf3911d0f5df62a954eaa963d6bb6558;Wed Nov 14 18:41:46 EST 2001;Committer;usa;4;49;345;394;0
d51279d8627e069b9308bcfab3933e188a5277fc;Tue Nov 13 16:14:42 EST 2001;Committer;usa;2;11;5;16;0
fffeb611217ffd16f9aad5d89741f84082ee06d1;Tue Nov 13 10:53:20 EST 2001;Committer;eban;2;7;3;10;0
9d59b0d1a1883222ab62d3d8671650296776c816;Tue Nov 13 08:53:15 EST 2001;Committer;matz;1;1;1;2;0
7422ccdd9e2fb2b28844879d5117d8fdc000c944;Tue Nov 13 08:19:52 EST 2001;Committer;matz;14;327;269;596;0
948ff2456bc7839817ea043b42b6423538ab873c;Tue Nov 13 08:14:27 EST 2001;Committer;matz;5;41;23;64;0
90ff4f01abc702b1f3376682bbaf8f4a8f6d2690;Tue Nov 13 07:50:20 EST 2001;Committer;usa;2;12;5;17;0
beeda6eef09b19f0775df8859757e7b75b310b9d;Tue Nov 13 04:03:55 EST 2001;Committer;usa;1;2;2;4;0
c5ca1bc929a933daefabab9f1be18c5653c7927d;Tue Nov 13 03:59:20 EST 2001;Committer;usa;4;468;449;917;0
8fed738ffa538c10c424664466cb8b66ccf5ce1e;Fri Nov 09 04:52:54 EST 2001;Committer;usa;2;5;1;6;0
49655c4295fd45dd9d87329adf749f0231135add;Fri Nov 09 00:10:10 EST 2001;Committer;matz;1;2;2;4;0
76204d7a5288fa8237c95674bd77d682e2fe284b;Thu Nov 08 12:42:39 EST 2001;Committer;nobu;2;15;1;16;0
a3d0d9953049bb149a2fdae7f85d3c4148ef0288;Thu Nov 08 09:39:45 EST 2001;Committer;matz;1;37;20;57;0
cf4451e8c27936dcd71b5eac7105ff52e02f1e95;Thu Nov 08 09:21:59 EST 2001;Committer;matz;6;83;47;130;0
dc98adf839d0d68c4c18647a1db2fb3dc9be8cc4;Thu Nov 08 06:43:14 EST 2001;Committer;matz;17;201;109;310;0
ab827130d3f563535abb7404230f5b5e63bf0946;Wed Nov 07 09:05:08 EST 2001;Committer;matz;1;22;0;22;0
2fc66e2841618682bcfaa4e2fd44460916732f24;Tue Nov 06 05:20:25 EST 2001;Committer;shugo;2;10;4;14;0
edaf0477a5b58460dab76a30288578f42b5db3c8;Sat Nov 03 13:41:57 EST 2001;Committer;keiju;3;12;6;18;0
7ef9fbb35fe2bc6efebefaa3bf656133efd4a939;Fri Nov 02 07:20:58 EST 2001;Committer;matz;2;114;33;147;0
bbb608ad790db8495e092eede59df4bf3453f157;Thu Nov 01 05:11:24 EST 2001;Committer;matz;5;337;37;374;0
a313c30d9c05d125b035a546bd3aa835bb7b88be;Thu Nov 01 04:51:22 EST 2001;Committer;matz;2;7;10;17;0
a8c4400d1a6c96710fb0253b96113f9a9bdf86b7;Wed Oct 31 08:00:18 EST 2001;Committer;matz;2;5;0;5;0
c0fe73989d3027f0d7c196d01951ece6d112d98b;Wed Oct 31 06:53:22 EST 2001;Committer;matz;6;169;67;236;0
4c9362b74fe837475fe0ab647ba48eee07d69f9f;Tue Oct 30 17:48:24 EST 2001;Committer;wakou;2;6;3;9;0
8d321e3fd4b05b092f5cd41ceb583f0534f7b251;Tue Oct 30 09:23:14 EST 2001;Committer;usa;2;6;2;8;0
54d534f04313a0437a613516169cb243b695ccaf;Tue Oct 30 08:43:28 EST 2001;Committer;matz;9;158;52;210;0
864bc4f18beb189c07a22e605810bb8d6eef5645;Mon Oct 29 06:16:01 EST 2001;Committer;usa;5;24;10;34;0
88abd791f522c7097141753c3480a456340215f8;Mon Oct 29 05:07:26 EST 2001;Committer;matz;20;174;77;251;0
429f7ed113dc862b121ab63c73170e4169853581;Mon Oct 22 16:28:51 EDT 2001;Committer;nobu;2;19;5;24;0
96baf2c092678471248b5e00b2d1e32a44dd8676;Mon Oct 22 16:20:14 EDT 2001;Committer;nobu;2;113;100;213;0
c4712cbc5029cba9850899c8dd41feb844f5f3f4;Mon Oct 22 06:59:57 EDT 2001;Committer;eban;1;2;2;4;0
959d5febcf0cdd2f4d81a1bb91bcd8d9fee83f2f;Mon Oct 22 06:48:18 EDT 2001;Committer;matz;7;59;41;100;0
d0129370f07f3fcdcb18b9788161abdbbf230325;Sun Oct 21 13:22:54 EDT 2001;Committer;nobu;3;11;4;15;0
eaab0aa79ab884328fc698aaf0b696e656dc5188;Fri Oct 19 14:32:51 EDT 2001;Committer;nobu;3;12;4;16;0
78592877b77a829ceea230ec194c0cb43430dd9c;Wed Oct 17 05:29:47 EDT 2001;Committer;nobu;1;2;2;4;0
e725a1a6abf0e1157d377b77d59869aa349638f3;Wed Oct 17 05:28:02 EDT 2001;Committer;nobu;2;68;4;72;0
7d9c2a6733144e1f10678c59018f540f61d4c6c0;Tue Oct 16 15:17:10 EDT 2001;Committer;nobu;3;20;3;23;0
1c7cf852bdcf37bbd7e4faa1424f1c2ad1116f70;Tue Oct 16 05:21:16 EDT 2001;Committer;nobu;1;5;0;5;0
5f877e84316496556b05287e298f3d3924fc4f00;Tue Oct 16 03:27:23 EDT 2001;Committer;matz;9;47;21;68;0
9be798477425579cd73e5d0884435fce1f38502b;Mon Oct 15 15:18:24 EDT 2001;Committer;nobu;1;2;2;4;0
093595801f7d8d3f31d87b2a1dd8ea6f8553feda;Mon Oct 15 15:15:45 EDT 2001;Committer;nobu;2;9;0;9;0
da23c37a3144448805135fcacee7ca9c4a6550da;Wed Oct 10 11:32:43 EDT 2001;Committer;eban;1;2;2;4;0
8098dd6c802db53a0e879efb7e48e75981f043d3;Wed Oct 10 08:21:13 EDT 2001;Committer;matz;7;51;7;58;0
14129c8fa30055b25036e490c0b8d87ffcfa34b2;Tue Oct 09 14:56:15 EDT 2001;Committer;matz;1;6;28;34;0
9383505c4070e33bc2589b4d023890cb6ccdc109;Tue Oct 09 09:46:42 EDT 2001;Committer;matz;2;35;9;44;0
681b54c0bd1a63cbcb09b0729334bacc4803c809;Tue Oct 09 09:42:47 EDT 2001;Committer;eban;3;7;4;11;0
192b82bf4b6b02e7cc9e699ab2c4e8db27d3a791;Tue Oct 09 08:19:46 EDT 2001;Committer;nobu;2;32;17;49;0
ef52ffdf61f7ed1042d8dae2f7c98385b6f7f990;Fri Oct 05 06:30:42 EDT 2001;Committer;matz;4;23;19;42;0
809a9c5b6d1454e623e929afdf5a878bdb4023dc;Fri Oct 05 05:49:02 EDT 2001;Committer;nobu;2;21;1;22;0
8ff29f818c490db36474dd332efd3298320a5464;Fri Oct 05 03:18:30 EDT 2001;Committer;eban;1;2;2;4;0
85013a7915e9a3a6af142e93f109fd2043db59e2;Fri Oct 05 03:04:52 EDT 2001;Committer;nobu;1;6;5;11;0
3358b44f6e7ef666ea593a4651225e33973a2b6e;Thu Oct 04 09:30:13 EDT 2001;Committer;matz;1;4;0;4;0
ffcdd05412e8120d604810f2f0936c58c825ab97;Thu Oct 04 05:32:09 EDT 2001;Committer;eban;3;9;4;13;0
822f1a5a59fda892bb33020c6e3fdcdb25a6a8c0;Wed Oct 03 07:52:09 EDT 2001;Committer;nobu;2;5;1;6;0
1fe40b7cc5e92105f636d670d77b059fe4a4c50b;Wed Oct 03 07:19:19 EDT 2001;Committer;matz;25;345;338;683;0
d902111a57dfcf3c9b017b0ebd1b49f19142168c;Tue Oct 02 10:36:34 EDT 2001;Committer;eban;2;5;6;11;0
75eee0bafdaa5adf30dc87cbb01b5f2e24ac8a01;Tue Oct 02 04:31:23 EDT 2001;Committer;matz;17;254;150;404;0
34a31235c9eeaa9c1d1bcacd7470d2b37429a19f;Mon Oct 01 23:28:57 EDT 2001;Committer;nobu;2;5;1;6;0
810d9fcdbf01f743f111a29902118f88d2f237b0;Wed Sep 26 17:09:47 EDT 2001;Committer;ts;2;5;1;6;0
906d9cc83b2094f1c9e33c0b1a186de381741692;Tue Sep 25 01:47:47 EDT 2001;Committer;usa;2;19;12;31;0
c5da55fbddd299efc5f755fbe89deab79b2e2838;Thu Sep 20 14:54:34 EDT 2001;Committer;nobu;1;2;2;4;0
a8f1dd8d9fa090c919221f1217a0c8b8b36bba2c;Thu Sep 20 12:51:58 EDT 2001;Committer;nobu;2;5;1;6;0
9fb8ea1fc709f3edb6f765d2333211e02cc610c0;Thu Sep 20 06:25:42 EDT 2001;Committer;nobu;1;35;0;35;0
9d61bdff146535718eb94f434c525074a031e470;Thu Sep 20 06:23:50 EDT 2001;Committer;nobu;4;101;53;154;0
6767cd760a8f5274e238fca4567071a78ac43968;Wed Sep 19 06:54:11 EDT 2001;Committer;matz;9;94;50;144;0
67245eec7192abdc1dd0dc2510c1f6c77df89bd0;Sat Sep 08 14:17:53 EDT 2001;Committer;matz;16;143;69;212;0
1bcc5eb9223fae41acd88ecacef0aee0d2087e56;Fri Sep 07 22:17:13 EDT 2001;Committer;wakou;2;6;1;7;0
6e2490beb56a2c6498393517d61eaf3d777ed2e5;Fri Sep 07 00:56:10 EDT 2001;Committer;wakou;2;7;2;9;0
749f0f9255f22a1971d885ed174b71a5f743b658;Thu Sep 06 22:18:11 EDT 2001;Committer;wakou;3;72;77;149;0
aebf069adfdc08abfd53f854f36abd6d72f69972;Thu Sep 06 08:48:07 EDT 2001;Committer;nobu;2;23;11;34;0
fce2bf70a2ef7129b68f8660ce6fdb2a4296667a;Thu Sep 06 08:12:24 EDT 2001;Committer;eban;1;11;8;19;0
970dbfde6f041de3660f5822bd486663742aeef3;Thu Sep 06 05:29:27 EDT 2001;Committer;knu;2;6;1;7;0
99ae768645511373a0282f360d089bcca1549a09;Thu Sep 06 05:14:06 EDT 2001;Committer;shugo;3;104;17;121;0
4c9a9a620af6a026773f1339dedec12d66af7867;Thu Sep 06 05:02:29 EDT 2001;Committer;knu;2;17;0;17;0
d878585e5f3bc9d23df7704a817a7a10f7427e7f;Thu Sep 06 04:34:36 EDT 2001;Committer;eban;2;18;12;30;0
0530ceb2b964e974ad7e25dd041b54a3ef577677;Wed Sep 05 22:31:07 EDT 2001;Committer;nobu;3;8;2;10;0
a09435ec209eba2111f6cad6a191b2b0a43d4e30;Wed Sep 05 22:18:56 EDT 2001;Committer;nobu;2;4;23;27;0
3c8ac802026553677c7565fa3e6d45e86d6e5c63;Wed Sep 05 08:50:19 EDT 2001;Committer;eban;1;1;1;2;0
2a67d0b9f93269a7234c017879cd0b3654baba0c;Wed Sep 05 08:45:47 EDT 2001;Committer;eban;2;5;3;8;0
2e2786ccab636dd82de640bd771f2cc9fc20ab31;Wed Sep 05 06:54:57 EDT 2001;Committer;matz;9;232;47;279;0
393f665e33782d4a91813abe599b1b28d675127d;Mon Sep 03 11:30:58 EDT 2001;Committer;nobu;2;5;1;6;0
5a5bc9e7db09b6490ffd353b0e5ef8f202c4cdad;Mon Sep 03 09:59:57 EDT 2001;Committer;eban;1;3;1;4;0
0f35b58a2fbae58a20979de77a3a642c42f41899;Mon Sep 03 05:37:42 EDT 2001;Committer;matz;12;134;158;292;0
c9d1be6327640aa5bc01f8c6c8846e4e3fb31337;Mon Sep 03 05:31:36 EDT 2001;Committer;matz;1;1;1;2;0
50dcbc8cc6c53ec4c47b513dcbcfe597d174d78c;Mon Sep 03 05:18:02 EDT 2001;Committer;knu;2;6;1;7;0
f2accb2fe358671da79b0cb77bec860556293934;Sat Sep 01 15:47:31 EDT 2001;Committer;nobu;1;2;2;4;0
69866a4b972d1d2a12bddc4b2aa18e988b5e8249;Sat Sep 01 03:34:04 EDT 2001;Committer;nobu;1;1;1;2;0
d1ad995dfd6969d1140cfabe0c86a85fe8fbe63e;Sat Sep 01 01:25:09 EDT 2001;Committer;nobu;2;25;16;41;0
b47a99485bf9937ceb5f137916bc1fd85cc2304f;Wed Aug 29 06:28:51 EDT 2001;Committer;matz;15;100;60;160;0
5f224f686990e9c913b4f00daf93cf1a541dfb6c;Fri Aug 24 06:32:40 EDT 2001;Committer;eban;1;2;2;4;0
3a42901a8092933ed8d700812e919a994319ec44;Fri Aug 24 05:45:55 EDT 2001;Committer;usa;3;10;2;12;0
4ffb36163018fdc2b6045b63ab9d0ed460a9588d;Thu Aug 23 17:49:08 EDT 2001;Committer;nobu;2;5;1;6;0
1289a7a11fe55a4e37d923fc6b0af2c228e83175;Thu Aug 23 06:02:15 EDT 2001;Committer;matz;15;176;42;218;0
e15efe7733f5e6e9377ae1bd2fc5f6029c919f1d;Mon Aug 20 10:56:03 EDT 2001;Committer;eban;3;9;9;18;0
ba294ad0601e84a4c64e31ac03bebf5e964c3029;Mon Aug 20 06:15:53 EDT 2001;Committer;matz;2;5;1;6;0
c7868668121470b56f173a596b750e8a27fe9e18;Mon Aug 20 04:29:58 EDT 2001;Committer;matz;16;101;52;153;0
772ed5507e569d7697841492a37d7607adbc9385;Fri Aug 17 03:08:45 EDT 2001;Committer;aamine;8;49;37;86;0
1414cebea8ac4e04d3f5d7c258bc7c26258bc4be;Thu Aug 16 08:13:54 EDT 2001;Committer;knu;1;5;22;27;0
9665191df9c7e1f7d75be4500bb0fd149d258cf0;Thu Aug 16 07:24:20 EDT 2001;Committer;ttate;2;39;32;71;0
66104a8c3d7c819e0c2e012739c6ca05732a0dfb;Thu Aug 16 04:59:07 EDT 2001;Committer;eban;1;2;2;4;0
9ba7324ceb4298773f1d87a22015ed9a7cff5e1e;Thu Aug 16 04:54:31 EDT 2001;Committer;usa;2;6;2;8;0
429ad453f8b014056e7bdc4fb128a0cd37a152e7;Thu Aug 16 00:54:54 EDT 2001;Committer;usa;2;6;0;6;0
e5de410caf23f00ab3e12d2cd1d20b5d5ac1b48b;Wed Aug 15 18:51:58 EDT 2001;Committer;usa;3;8;2;10;0
6ce313006791b2e804c6de79c349076b370022e5;Tue Aug 14 20:05:21 EDT 2001;Committer;knu;5;15;10;25;0
ad4c17c021111d194e63178c61579cf0df853f9d;Tue Aug 14 19:05:37 EDT 2001;Committer;knu;2;6;1;7;0
6a581e6317295271495607ea7488f49957d93994;Tue Aug 14 17:04:00 EDT 2001;Committer;knu;3;20;6;26;0
5b63fc556fd06f8c6c170df359a854d3e504806f;Tue Aug 14 12:15:21 EDT 2001;Committer;knu;2;13;0;13;0
04a8e85bc5d305d1c227ca9d3ccc0794e07fafc1;Tue Aug 14 08:13:31 EDT 2001;Committer;matz;11;182;64;246;0
0aa005f8e96ff032229d1e90a0ac209eb90e4168;Mon Aug 13 05:56:30 EDT 2001;Committer;knu;1;5;0;5;0
dd246c36b9604fbf869018be34c71fd3d73618bb;Mon Aug 13 05:32:59 EDT 2001;Committer;knu;1;4;0;4;0
62bf905d4e26d8038da2d469dcbf92b515c51262;Mon Aug 13 05:17:38 EDT 2001;Committer;knu;3;6;2;8;0
56f454f77d70385f703469e54b8f9a3d604d5787;Mon Aug 13 02:13:06 EDT 2001;Committer;ttate;1;4;2;6;0
9eded5fa137fc0d25c1096890a706c4437043227;Sun Aug 12 23:42:44 EDT 2001;Committer;ttate;6;1168;28;1196;0
7e97ab23f81b94b93dca9fec9ea8997c46a59e11;Sun Aug 12 09:41:39 EDT 2001;Committer;nobu;2;12;5;17;0
dfaaa55199638cd56edb05b22b11730920cb653d;Tue Aug 07 00:21:40 EDT 2001;Committer;usa;2;11;1;12;0
f141f2e543ec02c8e43e7617bce9ac988ba22b46;Mon Aug 06 15:05:50 EDT 2001;Committer;nobu;3;29;5;34;0
d94dbed46deaa325a43b92c5005585b3fbb20766;Mon Aug 06 06:10:10 EDT 2001;Committer;matz;1;16;12;28;0
2270c16ff9b0c2076e09ab6c83f4f20a83d204e8;Mon Aug 06 05:33:17 EDT 2001;Committer;usa;2;5;1;6;0
14cd9473173b69482adb1b4422f72d95d25b2ff7;Mon Aug 06 03:08:57 EDT 2001;Committer;matz;2;18;2;20;0
f33a61c28dadf8ff2bb86d36d6428f487b671708;Mon Aug 06 03:05:23 EDT 2001;Committer;matz;18;331;243;574;0
439b453e3aa244e7b824a55aa11768dca3d4a6f4;Wed Aug 01 16:49:11 EDT 2001;Committer;nobu;2;6;9;15;0
cc6d8c466ce623afed92b63db8d55ebc707c4c5e;Wed Aug 01 06:45:13 EDT 2001;Committer;usa;2;5;1;6;0
30637ef7e903479dc2a0a00d3dd490848723926f;Tue Jul 31 08:33:17 EDT 2001;Committer;usa;2;6;2;8;0
4b7c92fa90047ba6d3d2a479dda9fe0c83f0f424;Tue Jul 31 08:04:13 EDT 2001;Committer;nobu;3;16;10;26;0
c8a7361e45e3a149b970ae9cd74cbbcfbfd1d501;Tue Jul 31 06:24:45 EDT 2001;Committer;matz;9;73;13;86;0
645170199ca8d9f7eaa8f928519897d2d1ed709d;Mon Jul 30 22:41:59 EDT 2001;Committer;nobu;2;55;32;87;0
67d433a5e62fdbfa73f688c59af111bd67aefa24;Mon Jul 30 02:15:13 EDT 2001;Committer;shugo;2;84;0;84;0
0abedcd80770841475006342c96d348d78f91ab8;Fri Jul 27 09:12:12 EDT 2001;Committer;matz;3;69;15;84;0
980f8164797ce17f77be3e1ad9b5e4e96fdab4a3;Thu Jul 26 12:43:10 EDT 2001;Committer;eban;1;2;2;4;0
f30288ebf6c38936f4523c51047ea2ebc26e8a74;Thu Jul 26 03:54:48 EDT 2001;Committer;eban;2;10;2;12;0
51efc221c15a958dc019087d3bb2ac0a80163dc7;Wed Jul 25 11:31:59 EDT 2001;Committer;knu;1;1;1;2;0
eb0f1ab7839b5cce514c41a25712b9c31f280cff;Wed Jul 25 08:19:49 EDT 2001;Committer;knu;2;9;0;9;0
4a74d867afe583cbe73d4b482f1430cb92ad1a18;Tue Jul 24 15:11:02 EDT 2001;Committer;nobu;2;54;17;71;0
e54216b7409d9e4d7d56f089703ea0d79f57ea1c;Tue Jul 24 10:29:17 EDT 2001;Committer;knu;3;15;4;19;0
ea82a51a15f25293812c2641cbe620b0ec998ab6;Tue Jul 24 10:19:46 EDT 2001;Committer;knu;1;12;0;12;0
15ffbb1f820be7c798a7eb0aa2be11b5d4207460;Tue Jul 24 09:07:33 EDT 2001;Committer;matz;12;150;56;206;0
9e214f30c4f2bb6e6529c1bb988be1e46026919f;Sun Jul 22 12:24:12 EDT 2001;Committer;knu;3;10;4;14;0
33c679ba9a5af00cc7243ace1d899e221df8a719;Fri Jul 20 15:20:25 EDT 2001;Committer;knu;2;8;1;9;0
f50be7cba7be55294031b92cb24471958d3d1759;Thu Jul 19 05:49:51 EDT 2001;Committer;knu;1;39;0;39;0
eaddc4a94bf1dfb95ef889e2dd5521b657845675;Thu Jul 19 05:44:26 EDT 2001;Committer;knu;30;2753;2752;5505;0
2d84b42b0072d7bbff8846348b8469d0fc34fd82;Thu Jul 19 02:46:28 EDT 2001;Committer;usa;3;9;3;12;0
2c85be7df37f7c5a291c74f9929490aaba11b2c2;Wed Jul 18 21:34:53 EDT 2001;Committer;aamine;1;3;0;3;0
2812249141830aea72046fd4aaf651df30bb343d;Wed Jul 18 20:59:03 EDT 2001;Committer;aamine;1;1;1;2;0
b84329fb539b03e535b4c9f343f53efe7fbcd306;Wed Jul 18 20:45:55 EDT 2001;Committer;aamine;4;886;0;886;0
f35971afdfd05304d0b5d2b0e3042a0c739f877f;Wed Jul 18 05:56:05 EDT 2001;Committer;matz;11;71;24;95;0
c068201c50bea13d3d48ab7460cdc407946af0ba;Tue Jul 17 05:25:15 EDT 2001;Committer;aamine;1;1;1;2;0
9078b695921b5f5e306b7763557564a3f4a3d552;Tue Jul 17 02:13:13 EDT 2001;Committer;usa;3;9;2;11;0
affcf615dc236afc73b054f01e4ae20cb825070a;Mon Jul 16 04:22:46 EDT 2001;Committer;usa;2;13;9;22;0
03d1c9cd8238af6f1063ea4eb98d17fa2a511107;Sat Jul 14 15:17:19 EDT 2001;Committer;matz;18;961;448;1409;0
f4b516777be7c1403deba3cfc653dcfb56f3d7f4;Sat Jul 14 03:29:50 EDT 2001;Committer;knu;5;9;4;13;0
a2193f50e80823d34e3d283effb2b4539c15b6f2;Fri Jul 13 21:20:41 EDT 2001;Committer;aamine;3;7;3;10;0
76d7dae26ab8b56dbafcec710fc42a5fb7d79840;Fri Jul 13 20:06:14 EDT 2001;Committer;knu;62;3971;1197;5168;0
6ecd6fe37bf6395850d3825bab3fb88d5d345c82;Fri Jul 13 18:02:10 EDT 2001;Committer;knu;3;23;9;32;0
9cf764b8ffa5154393fd61b0f5619cb944a7fb01;Fri Jul 13 16:22:39 EDT 2001;Committer;knu;1;2;2;4;0
c93741c6eb1af725ced243096a56e0af52635a9a;Fri Jul 13 16:18:29 EDT 2001;Committer;knu;1;13;0;13;0
c0a9b71aeb96e5f9fd0c33c849bee236be828a84;Fri Jul 13 14:19:28 EDT 2001;Committer;knu;3;14;6;20;0
c4ef00b158e49999c147e5a2f779b5a3498277e3;Fri Jul 13 11:10:20 EDT 2001;Committer;knu;1;58;3;61;0
11bba0f7dc09a2516a1a77356f840fd3e948194b;Fri Jul 13 08:54:47 EDT 2001;Committer;knu;1;1;1;2;0
317da12757535ef7e0ec15c8dfbe926c20aee174;Fri Jul 13 08:54:46 EDT 2001;Committer;knu;1;33;0;33;0
5179d34d795e422acb6e10ffe30348a4887a9e16;Fri Jul 13 08:48:56 EDT 2001;Committer;knu;1;1;0;1;0
f01061b22a91e4a518021b057029030aa6690ccf;Fri Jul 13 08:23:18 EDT 2001;Committer;knu;1;1;0;1;0
c5a7e3570690f1a6570cc3cb1876f5f77a20fe3c;Fri Jul 13 08:21:55 EDT 2001;Committer;knu;2;5;6;11;0
b3c88c4330ccac5ea8e13ce4dcd14f2cdcef403b;Fri Jul 13 08:17:59 EDT 2001;Committer;knu;1;171;0;171;0
cb63b3813739da5e0d6cc9d4eab0c84bc02e43a0;Thu Jul 12 14:25:50 EDT 2001;Committer;eban;1;2;2;4;0
4439ee97cbda4d33a3bbed29a4534621fb2e953c;Thu Jul 12 12:02:34 EDT 2001;Committer;knu;1;1;0;1;0
69b7b77ceb3abaaa8e810a54237a540741fe7ebe;Thu Jul 12 12:02:08 EDT 2001;Committer;knu;1;1;0;1;0
18efb38b210db318380f92d549cbf9400fb88ad8;Thu Jul 12 06:16:49 EDT 2001;Committer;eban;2;20;6;26;0
cbc3756009999e58d717af4fc82ba6c33bd3e7e6;Wed Jul 11 19:25:52 EDT 2001;Committer;knu;10;956;921;1877;0
d0cf53ffb494469d40be95eb97decdb86c95f653;Wed Jul 11 18:59:02 EDT 2001;Committer;knu;1;1;1;2;0
a6928189d315a5c0f710fa9d1e111316a3b9b5c6;Wed Jul 11 18:48:06 EDT 2001;Committer;knu;2;2;2;4;0
f1b3c517015e0eb1c7f6358ea9cc52f745464fca;Mon Jul 09 08:10:26 EDT 2001;Committer;eban;2;5;3;8;0
4d134d47d6d39e68ff8178f2726c0289b4b825f7;Mon Jul 09 07:54:49 EDT 2001;Committer;eban;2;7;3;10;0
e45f8f994337131f9329e0780a64aa75c3586a7f;Sun Jul 08 11:54:55 EDT 2001;Committer;knu;2;5;1;6;0
2b67bb576af535744c303baf289386d910df49c8;Sun Jul 08 07:00:23 EDT 2001;Committer;aamine;5;67;23;90;0
7f326a3988c74073619689f51481093885f5c203;Thu Jul 05 17:19:28 EDT 2001;Committer;knu;2;5;1;6;0
d59652ef251ce544d9a59e2b651fe1945a94fee5;Thu Jul 05 16:07:53 EDT 2001;Committer;knu;1;0;5;5;0
eab46f5fc61b08cdcef60954dc6e71b4bee0a201;Thu Jul 05 15:47:03 EDT 2001;Committer;knu;2;13;11;24;0
afb3a0cff187cee400c4249f22422a56ad6156f4;Tue Jul 03 19:18:17 EDT 2001;Committer;aamine;2;6;2;8;0
9e79454b3d6476ff0da11ae7917b25edd8057f1d;Tue Jul 03 19:03:16 EDT 2001;Committer;aamine;5;29;11;40;0
fa20d931bcd07a5f7d8ab80edc79419cae1d25fd;Tue Jul 03 18:13:13 EDT 2001;Committer;aamine;5;152;114;266;0
fc1f22d5a8c0ba8dc04bfda6a14d910de1e04333;Tue Jul 03 15:02:20 EDT 2001;Committer;knu;2;5;1;6;0
f7ac4f227d4705b2bd5370e0ba8bb8984039f94f;Tue Jul 03 09:37:08 EDT 2001;Committer;matz;2;25;7;32;0
08eef47e5b0ce77d457fca8a0f5e1fa257d984c6;Tue Jul 03 07:29:00 EDT 2001;Committer;matz;4;26;3;29;0
604a8f18836e7779b2859bab86e3eb0f77bdfb55;Tue Jul 03 05:57:16 EDT 2001;Committer;shugo;2;11;4;15;0
066cfdc1337b9195ba2114b6b377f4b867fdda40;Tue Jul 03 05:52:20 EDT 2001;Committer;shugo;2;5;1;6;0
ffe1cf575ecd5f9215a75728947520e9e668fb8a;Mon Jul 02 08:46:28 EDT 2001;Committer;matz;24;373;163;536;0
cc13bb43bcb1e6b6798bb3190eeb65494dd2d320;Wed Jun 27 15:35:04 EDT 2001;Committer;keiju;7;27;13;40;0
cf376264011dbeb9c2de1aa17e505abcd5803056;Wed Jun 27 00:59:08 EDT 2001;Committer;aamine;3;195;179;374;0
37b3f674a72db8d37735747e06db9e44b232c965;Tue Jun 26 23:51:16 EDT 2001;Committer;aamine;1;2;1;3;0
c664027a342785089cc09169ff167350e840baa9;Tue Jun 26 23:49:21 EDT 2001;Committer;aamine;5;749;382;1131;0
10e80b2402f7c0fd79df86767a11ba4e4b1bfa95;Mon Jun 25 01:52:59 EDT 2001;Committer;eban;1;1;1;2;0
0869399cbf26c16c3226f338661da87882418ff8;Sat Jun 23 15:14:28 EDT 2001;Committer;matz;6;88;52;140;0
c0648ecc85c307388895bc420b2eb61ab46966b2;Sat Jun 23 09:30:42 EDT 2001;Committer;knu;2;6;0;6;0
3aa7e4f741c1846b5d71a70812572e389243e7cb;Fri Jun 22 15:49:08 EDT 2001;Committer;eban;1;1;1;2;0
2cf4fce053779fea72d34656ff43886acf7e5a93;Fri Jun 22 14:44:44 EDT 2001;Committer;eban;2;13;0;13;0
cdabb04b442dcbe58e201c18aa8aec80b2d63a02;Fri Jun 22 14:16:25 EDT 2001;Committer;keiju;2;18;15;33;0
def42c9a0cd274202da56531c19e0a4bee3364e3;Fri Jun 22 09:12:24 EDT 2001;Committer;matz;10;155;96;251;0
ef8e0b4dffaec6789a1582d841ddb563cac2115d;Tue Jun 19 15:42:00 EDT 2001;Committer;eban;2;22;18;40;0
37af62f08390813dd2be964d5da22d34a841d35d;Tue Jun 19 09:49:24 EDT 2001;Committer;eban;1;2;2;4;0
0c92a85e6ab61e5b20b7ba5a60121302a791725d;Tue Jun 19 09:21:38 EDT 2001;Committer;knu;4;56;3;59;0
058888bd38fb6ff3f32423390e0d62732f79e5a6;Tue Jun 19 07:33:10 EDT 2001;Committer;matz;3;89;97;186;0
a74a6b0d911fd586f5e9cc5d1f2831d3521e4ae9;Tue Jun 19 05:28:10 EDT 2001;Committer;knu;1;5;0;5;0
9d51cf8a6a5d651c1c4dd363dbf3f4905e3f307d;Tue Jun 19 04:35:17 EDT 2001;Committer;matz;10;249;104;353;0
6aa71d4c800d11d9735007cf3b063e5ea2fc5941;Wed Jun 13 10:51:39 EDT 2001;Committer;knu;3;51;4;55;0
68ebfef615c0f4cda0aaa6837c92b03d47a6c8db;Tue Jun 12 05:34:03 EDT 2001;Committer;knu;1;4;0;4;0
39fb2a27abbb585fa27e87720025c297b081acb7;Tue Jun 12 05:31:47 EDT 2001;Committer;matz;5;54;9;63;0
83b2db9ea7e5a2510e88cb9846d0db35ec8c47f2;Tue Jun 12 05:25:04 EDT 2001;Committer;knu;2;22;16;38;0
c88531e4b9210eb66bd07431563006bd52855484;Mon Jun 11 05:31:17 EDT 2001;Committer;eban;2;7;0;7;0
a5c0e5a382d577b900c9a49fa09547dbf602e16c;Sat Jun 09 07:41:44 EDT 2001;Committer;usa;5;142;75;217;0
53a2b14909a271e54c1e5d771075be608e37fb15;Sat Jun 09 06:00:52 EDT 2001;Committer;knu;1;4;0;4;0
3f658870fe15b2d5878b219732aceb185532c6cc;Fri Jun 08 16:15:03 EDT 2001;Committer;matz;1;0;1;1;0
46e8ae110469cc8da8d1aad01dec7cd0a83eaae1;Fri Jun 08 14:20:58 EDT 2001;Committer;matz;9;170;21;191;0
1b6b6ef2d645e99b66e775c9a5ee97e201e141a1;Thu Jun 07 08:40:54 EDT 2001;Committer;matz;1;2;1;3;0
4c6b76c1e42ebc63bf3452ba3c76b2c1fca73c27;Thu Jun 07 08:29:59 EDT 2001;Committer;matz;3;14;7;21;0
85d105cf8c7c664d34bf86b8d72c728cb5b6e7ab;Wed Jun 06 14:19:33 EDT 2001;Committer;keiju;3;54;53;107;0
b2658a3d839916db0cde8e810212932d1dc63cd5;Wed Jun 06 09:13:14 EDT 2001;Committer;keiju;1;21;8;29;0
f0ccffd530ff4faafe6f07df94818e807b96f851;Wed Jun 06 07:40:31 EDT 2001;Committer;matz;4;12;23;35;0
7c9c33e9add999d2c9a9073de5130936e4124c9c;Wed Jun 06 06:42:23 EDT 2001;Committer;matz;5;82;55;137;0
dd9074111245b4c57f071a11275df34ae67192dc;Tue Jun 05 08:17:25 EDT 2001;Committer;knu;1;32;0;32;0
b12904e85f5a9cc6c82f0fd06783ba219f334932;Tue Jun 05 07:50:59 EDT 2001;Committer;matz;4;33;12;45;0
d6c60dbf6d42f411a31a1c2e768a5a986a270a8c;Tue Jun 05 07:19:39 EDT 2001;Committer;matz;10;399;228;627;0
21524a3fc00d0e894d0ca0b8fcb7d9c7413c5917;Tue Jun 05 04:54:52 EDT 2001;Committer;eban;2;9;19;28;0
ac376af4f42ca83fc178a0f8911f542e1bc5e8f1;Tue Jun 05 04:43:17 EDT 2001;Committer;eban;2;6;11;17;0
9307e0402b62bdb1bede1960bb21662d6fd8771d;Mon Jun 04 06:21:02 EDT 2001;Committer;eban;1;1;0;1;0
9b650354b460373df478f92ac737a427b36325b5;Mon Jun 04 05:30:25 EDT 2001;Committer;knu;1;261;0;261;0
bfd441db8f5a17a9896257887eaffccbbf066541;Sun Jun 03 19:25:07 EDT 2001;Committer;wakou;2;5;1;6;0
7dc25230bea45adeda8f82ac5fe333a225250803;Sat Jun 02 14:19:37 EDT 2001;Committer;shugo;2;4;1;5;0
3c024ba5e26c86bc628d1b008e64c2043cd05234;Fri Jun 01 15:26:47 EDT 2001;Committer;keiju;5;8;4;12;0
23f89a8932d8941d0d64308dec1e324dba8d7113;Fri Jun 01 09:38:30 EDT 2001;Committer;matz;2;8;1;9;0
da548b67f5edc5f876ec5e8a21c491963d2bd670;Fri Jun 01 07:52:34 EDT 2001;Committer;matz;2;9;4;13;0
353650e6b486482a256250611d73b668f3fa8dbc;Fri Jun 01 06:47:32 EDT 2001;Committer;matz;5;30;12;42;0
df2c6aef1e202ff263090009f782324dd74b5417;Fri Jun 01 02:27:45 EDT 2001;Committer;eban;1;2;2;4;0
e8fb16c70fabe9a7a9eef8837d0811112d394de0;Fri Jun 01 02:25:28 EDT 2001;Committer;eban;3;9;2;11;0
ac41cd68443ba522b48a09d8347a486df68a887e;Thu May 31 04:40:37 EDT 2001;Committer;eban;3;9;5;14;0
a0047c7d8959f62e89fdb8ee1845db473d7579b9;Wed May 30 23:02:54 EDT 2001;Committer;usa;2;24;0;24;0
2c537562df814fb4613e3a1f68e9d78ab9b4ef3a;Wed May 30 16:29:32 EDT 2001;Committer;knu;2;6;1;7;0
abfaac7a6cbdbfad9e7c05bc5ebcb4df57906fcb;Wed May 30 09:12:34 EDT 2001;Committer;matz;24;922;420;1342;0
4cd1cd7201757185e63a5a33181932a6670887ad;Wed May 30 09:10:30 EDT 2001;Committer;matz;8;1415;29;1444;0
032825472be96143de44bc0ee9795735d03dfbf4;Mon May 28 16:07:34 EDT 2001;Committer;eban;8;43;20;63;0
e83171c4c4f71093a64abc2c4bb9bdb6a1445e02;Mon May 28 13:25:34 EDT 2001;Committer;usa;2;19;17;36;0
e406a28a71fe6c708f5be82e321cfc51defccfaf;Mon May 28 12:45:06 EDT 2001;Committer;eban;1;2;2;4;0
4407373ef12e2afba865adc0861f0d574e78a5cb;Sun May 27 17:24:24 EDT 2001;Committer;knu;2;30;17;47;0
c764579e49fa9bd029c4face4fce155440416a73;Sat May 26 12:38:16 EDT 2001;Committer;knu;1;11;5;16;0
2dc55ffea1a7b408ed1b38cf119c4e7a2c08047b;Sat May 26 12:29:29 EDT 2001;Committer;knu;1;27;21;48;0
a5d64434dd91fa463b7130e11cf1734d0ebd0287;Sat May 26 03:38:39 EDT 2001;Committer;knu;5;584;47;631;0
32513e9dcebe6bb04c5eb239f152493c92edae34;Fri May 25 22:06:26 EDT 2001;Committer;usa;2;5;0;5;0
75fbd377c427c3908ccc21c23ab629a0a0b74585;Fri May 25 01:33:03 EDT 2001;Committer;eban;1;1;1;2;0
4e7c81084ed696518afcc4fa0ba716b486f9e0a8;Thu May 24 20:41:51 EDT 2001;Committer;knu;2;6;1;7;0
10f407b84bbb6fab63b6a4fc4d7da0c688570215;Thu May 24 16:49:08 EDT 2001;Committer;knu;2;33;4;37;0
922a7182d8a3e8bbba01275e634ca25a2143d4fb;Thu May 24 16:19:37 EDT 2001;Committer;knu;1;2;2;4;0
d6e985ad0b6d47a914cc9c2f86a14e08fff4c267;Thu May 24 16:00:54 EDT 2001;Committer;knu;3;43;12;55;0
dcd6223c648d1c6834873b69b9293e5b53258d5b;Thu May 24 15:55:40 EDT 2001;Committer;knu;2;8;5;13;0
79f2ee2f0411c1d10ceefc869a32925d39171b1a;Thu May 24 07:13:56 EDT 2001;Committer;eban;2;6;2;8;0
0fb0d42369a02071e2dec4fb3cfd137262b192f1;Thu May 24 06:10:36 EDT 2001;Committer;matz;7;224;143;367;0
2287c526be0074e3d6e8e2b2927247866c237bd0;Thu May 24 05:28:15 EDT 2001;Committer;matz;1;28;9;37;0
315cd8341823e129ba5df0f420443e9d06d62c6f;Tue May 22 08:28:11 EDT 2001;Committer;matz;6;88;48;136;0
ed6a2bd29f649369beb1b7935cf2625c60581c04;Mon May 21 04:22:54 EDT 2001;Committer;matz;5;34;21;55;0
4a14c9ceb901697ab4c0a6b3730337ec4ef1133c;Thu May 17 20:37:25 EDT 2001;Committer;knu;2;5;1;6;0
0eea0bf571f7830e5c49c00df0431c4e8b4a789c;Thu May 17 20:23:08 EDT 2001;Committer;knu;3;9;0;9;0
156b1835517cd9891d727d1f39b6593b82c9a12b;Thu May 17 18:50:50 EDT 2001;Committer;knu;2;7;2;9;0
98e79eccdf45078cee8aa1379997885e447cd4f1;Thu May 17 16:13:34 EDT 2001;Committer;knu;2;5;1;6;0
7a140a3cb00abfa9020303ab8ae38ff7c77190dc;Thu May 17 16:05:49 EDT 2001;Committer;knu;3;7;4;11;0
7c3df3e99eb44278dd55cf61462643131500568d;Thu May 17 11:04:15 EDT 2001;Committer;knu;1;58;44;102;0
491c26f3ef3fdcdc957548fdb2f773e2af6b252f;Thu May 17 10:19:45 EDT 2001;Committer;knu;4;30;30;60;0
4578a096d1b12ad7c4d988ceaee461c4a7850a89;Thu May 17 10:12:10 EDT 2001;Committer;knu;1;273;0;273;0
d9a07d550653bfb2f3d8ff93e822ece12faf3a17;Thu May 17 10:09:49 EDT 2001;Committer;knu;3;535;410;945;0
d9350f56002fde6b5640b93ae7b8885cb7811d1a;Thu May 17 10:02:47 EDT 2001;Committer;knu;9;1890;0;1890;0
c2fa753f7db4ea07c50ec8a182f78b1a263e0709;Thu May 17 08:49:44 EDT 2001;Committer;matz;3;31;13;44;0
ddb81a78f3596149758ff2e90454f30a7b90050b;Thu May 17 07:13:18 EDT 2001;Committer;knu;1;1;0;1;0
929f31409eade1393a337bda7245d6b1e481937b;Thu May 17 05:28:39 EDT 2001;Committer;eban;1;7;0;7;0
8d1201cc553823cec1bad1ce77f1556b5e3b0275;Wed May 16 23:39:28 EDT 2001;Committer;knu;1;5;0;5;0
43f76f99b73fd1b175592df285b17341f0bd2a5e;Wed May 16 22:28:40 EDT 2001;Committer;knu;3;7;2;9;0
23423d7d03378e07fd0cacbd5b29df0df2f63bb6;Wed May 16 22:25:02 EDT 2001;Committer;knu;6;12;0;12;0
a57dc21ef03a2dee9283cee68a667a28e8246ac8;Wed May 16 22:19:30 EDT 2001;Committer;knu;4;90;17;107;0
ca841613cd3a161c4d5744952d50b415b705cea5;Wed May 16 22:14:01 EDT 2001;Committer;knu;3;8;16;24;0
5348fd7d4afcc2ff5e3dba1bddc9fa50a3fb6ddd;Wed May 16 22:07:28 EDT 2001;Committer;knu;5;372;0;372;0
4202ff1a9fba06137f58c0c757ada7e5c11b3ac5;Wed May 16 21:34:18 EDT 2001;Committer;knu;3;24;12;36;0
8bd77e8db4592d786ee33e178403a092607d2a41;Wed May 16 21:14:27 EDT 2001;Committer;knu;1;5;0;5;0
f84f4aa6b375290386c0456ac02fe8f6cc2cdd2d;Wed May 16 09:05:54 EDT 2001;Committer;matz;20;139;77;216;0
59d82a928a617889c18f4da6152f11c0eb6fde06;Sun May 13 14:51:45 EDT 2001;Committer;usa;2;5;1;6;0
0f55389d96f50ec2d4a6145bde8565dfbe28f49f;Sat May 12 06:47:24 EDT 2001;Committer;usa;2;31;9;40;0
fd379cd7f0e74b21ee7bd30572ddb0fb90c36a3c;Fri May 11 17:16:54 EDT 2001;Committer;knu;1;38;0;38;0
84eff7b1424ce636b272bea8dbd6620d7b5ef146;Fri May 11 06:13:45 EDT 2001;Committer;eban;3;8;2;10;0
cc043890f8cb7c0c057fb076b30765973716c470;Fri May 11 05:24:59 EDT 2001;Committer;matz;15;133;58;191;0
076ef717ac48d8093252ed47f9b0591416f339a4;Thu May 10 18:38:11 EDT 2001;Committer;knu;1;20;1;21;0
a403487cb33d5df1d7820df93156baf681cb09b3;Thu May 10 18:37:52 EDT 2001;Committer;knu;1;9;10;19;0
3f20c804bc0aaf9aa1d7ffcc0d762771966d44dd;Thu May 10 17:42:40 EDT 2001;Committer;knu;2;10;9;19;0
3c1264113ea52594940ce970fba2dc4eb83d5075;Tue May 08 09:28:19 EDT 2001;Committer;keiju;4;61;27;88;0
6ea874604879ce674ac54fb519489d427e3749a2;Mon May 07 23:52:57 EDT 2001;Committer;knu;5;10;8;18;0
32d17e265c84973516d1717868806b324ba3052a;Mon May 07 23:38:52 EDT 2001;Committer;knu;3;257;0;257;0
6bbab099c08129c86b225dc476f950809cf58b39;Mon May 07 23:35:09 EDT 2001;Committer;knu;2;216;216;432;0
dbe06b680be2ecce3448a315b49ab0c4b738904b;Mon May 07 18:46:39 EDT 2001;Committer;knu;1;0;1015;1015;0
581f7b863b1019fb4f6cfdea26f839c8c7639e12;Mon May 07 10:56:01 EDT 2001;Committer;eban;1;8;7;15;0
13cbec33c1335c5e582360797dfce7601bf60206;Mon May 07 09:26:29 EDT 2001;Committer;matz;10;71;58;129;0
075169f071dbf6e71e91d3872c02e469d2a9ff72;Mon May 07 06:57:40 EDT 2001;Committer;eban;3;9;3;12;0
e9d89f20a966888a9c73f194fa018e2f498c8640;Sun May 06 16:37:38 EDT 2001;Committer;eban;1;2;2;4;0
1d3d27b42d1371ba6242ec217ca803f107ceb9eb;Sun May 06 15:06:00 EDT 2001;Committer;matz;36;2190;296;2486;0
94df732f8b69356626130e0ec8b2dbc9340082ef;Thu May 03 08:56:49 EDT 2001;Committer;knu;10;13;33;46;0
f0448281f577fa930c68fb900d30c20c78f75914;Wed May 02 18:35:50 EDT 2001;Committer;knu;3;15;2;17;0
eb0d3500d3879e320a37dafbc888f971201cb8d3;Wed May 02 17:09:22 EDT 2001;Committer;usa;2;5;0;5;0
e28a9a7b943d795cf2d6ffb70fb72094433b8258;Wed May 02 12:07:30 EDT 2001;Committer;eban;2;6;2;8;0
fd06a2a7fbcaf995b662575f894a0f6ecd1be175;Wed May 02 04:22:21 EDT 2001;Committer;matz;44;1712;952;2664;0
902524c35b84e6473498969ee89181052a92da5c;Mon Apr 30 20:37:16 EDT 2001;Committer;knu;2;0;92;92;0
30a7496b225cc38f0e704f780bd19c4c64bf90a4;Mon Apr 30 18:25:04 EDT 2001;Committer;knu;4;148;13;161;0
87525852509243b006d7db6a7101137424389d36;Mon Apr 30 18:17:38 EDT 2001;Committer;knu;1;185;0;185;0
71eab67953ec1ac855ddf03f75b4a000cd7db4a4;Mon Apr 30 18:11:08 EDT 2001;Committer;knu;1;9;0;9;0
11c4bcea39a459ed34bd7bd5c5962abca8d76b21;Mon Apr 30 18:05:39 EDT 2001;Committer;knu;1;0;867;867;0
50e19a0ede5d4c4e3f65be22d2df427b48f82c58;Mon Apr 30 17:55:56 EDT 2001;Committer;knu;1;1;1;2;0
859a7a92775a84f118a063e5afba4580c7d6d0df;Mon Apr 30 17:54:55 EDT 2001;Committer;knu;8;64;59;123;0
f8ab487e4d60a14dd7f807ab146168d9d034a6ea;Mon Apr 30 17:38:21 EDT 2001;Committer;knu;14;2209;0;2209;0
e32f6a82698f7909cde817ae33626660b83456d7;Thu Apr 26 13:58:10 EDT 2001;Committer;eban;2;16;1;17;0
4dfc822aecf894a4903fbeda58d618d1cc6c5d6a;Tue Apr 24 06:21:58 EDT 2001;Committer;knu;3;52;53;105;0
eccb4d021056cd77393885c5889c7ea2003f606a;Sun Apr 22 09:49:15 EDT 2001;Committer;eban;2;13;3;16;0
cc8165ad232263b8cf9b20697490564ed5e7d10f;Tue Apr 17 19:43:27 EDT 2001;Committer;wakou;2;14;14;28;0
8399471902ce719c273da3775159f69bd1e13058;Sat Apr 14 04:38:19 EDT 2001;Committer;usa;3;8;2;10;0
bacf9d9ecefe09a5d3c9b4961cc4eb11467b7be8;Mon Apr 09 02:58:56 EDT 2001;Committer;shugo;2;5;1;6;0
e2de605439f6538c95b66381c74f591eec2040bd;Tue Apr 03 01:16:14 EDT 2001;Committer;eban;3;15;4;19;0
57ca9e547b2c1edf243146ade29b0dc480e6d900;Mon Apr 02 10:38:52 EDT 2001;Committer;eban;1;2;2;4;0
619aa50e25c5cc37222cbf72159eac20c9752cf2;Mon Apr 02 05:27:49 EDT 2001;Committer;shugo;2;16;10;26;0
8eeaf69e52b648ff8d7564cd991db7409a43a941;Mon Apr 02 04:59:43 EDT 2001;Committer;shugo;2;14;11;25;0
3c0af9ca44350a5a5f6d303af9da7c5f4d7f1ea9;Mon Apr 02 03:41:35 EDT 2001;Committer;shugo;2;8;0;8;0
41aac2194491a3d174654caa12074829be631bdc;Mon Apr 02 03:03:29 EDT 2001;Committer;shugo;2;53;21;74;0
286cddd4454d40a8d4d42a725bb1b486faefad3c;Sun Apr 01 16:53:41 EDT 2001;Committer;knu;3;43;2;45;0
2ed9c79bbbb9616376f6e76409fbfecb2bb182a4;Sun Apr 01 16:22:13 EDT 2001;Committer;eban;4;11;7;18;0
8de229963c5de74b53fbdb84367f00d86c719b0a;Fri Mar 30 19:51:33 EST 2001;Committer;shugo;2;596;7;603;0
c32024a3b5d8696347256a8024a6fe88a28e1450;Fri Mar 30 13:59:26 EST 2001;Committer;shugo;2;7;3;10;0
65579c6b315efc508e41be5f42a334f2f747a557;Wed Mar 28 14:47:44 EST 2001;Committer;knu;3;37;2;39;0
03f06165b89da07b41d4bea133c55d554b3be47d;Wed Mar 28 10:35:40 EST 2001;Committer;knu;3;22;6;28;0
62261ccb47fce9c4728cfbeb84f81d23369ab910;Wed Mar 28 08:43:25 EST 2001;Committer;matz;13;114;78;192;0
6771ffa97125d57a48378daed460ec22db7dd835;Wed Mar 28 00:54:48 EST 2001;Committer;eban;2;5;1;6;0
b60a365763c4abce061a49c2e68b1105f81fe598;Tue Mar 27 07:10:58 EST 2001;Committer;matz;10;124;40;164;0
2559f0d90ddf45f6cbaadc69a7a2fd7a3bfbf8a0;Mon Mar 26 14:29:57 EST 2001;Committer;eban;2;5;1;6;0
253f65aa4ed7e67bf7f11d87dcebc4f87888a3d8;Mon Mar 26 12:32:38 EST 2001;Committer;shugo;1;5;0;5;0
2d32e4dd6dd578a2880a9d35d96d19a1635d7f4a;Mon Mar 26 12:29:50 EST 2001;Committer;shugo;2;167;79;246;0
4beca99d16ad7812a562a204ce9963b8c6a0d4f7;Mon Mar 26 09:27:18 EST 2001;Committer;eban;1;0;1;1;0
de51a663b4300777be15003388070748a974e7c7;Mon Mar 26 08:57:16 EST 2001;Committer;matz;14;568;485;1053;0
44f754bd87e4b800118c59020d67123430535b9f;Mon Mar 26 08:54:06 EST 2001;Committer;matz;1;44;2;46;0
c8e0e1114ab2ddbfe0509603c40acd12e6f8c86c;Mon Mar 26 05:11:18 EST 2001;Committer;eban;4;7;11;18;0
9c33e4e6b42c87ff51f41d1497c0056c90aae02b;Thu Mar 22 13:23:36 EST 2001;Committer;eban;2;5;1;6;0
9123ec551d6616b7e08a3be89c2dad666b034e81;Thu Mar 22 09:19:57 EST 2001;Committer;matz;2;6;1;7;0
285cb99ba493a113098b78c9989cba5a870f2435;Thu Mar 22 08:59:26 EST 2001;Committer;matz;7;36;25;61;0
22198c30b115dd69227dfa3a006c323576067fe8;Wed Mar 21 15:18:05 EST 2001;Committer;eban;1;10;7;17;0
424c3fb43d59d7e47952152ff03ba6ea6c6b3d22;Wed Mar 21 14:12:09 EST 2001;Committer;eban;2;26;3;29;0
7aaceb6d9a498f0987ef376ef06736fba4b482a8;Wed Mar 21 04:18:10 EST 2001;Committer;eban;2;2;2;4;0
9ea56f8efe520e8c4b426ad1d13c9119a40d0b8a;Wed Mar 21 03:51:23 EST 2001;Committer;matz;3;11;15;26;0
9910feef4fc251419dc31cd2e022f81375bcad23;Wed Mar 21 03:41:45 EST 2001;Committer;matz;14;100;49;149;0
98e25a542aec760aed724bd7152ba86a96b3eeb8;Tue Mar 20 23:10:05 EST 2001;Committer;usa;4;34;7;41;0
a84d087d3cb142ae76b5e257948f6bd70d7873f7;Tue Mar 20 14:50:43 EST 2001;Committer;eban;5;40;26;66;0
1f904eed442f268d9f856aa25edbc7d7e906e6ae;Mon Mar 19 03:20:24 EST 2001;Committer;matz;12;106;63;169;0
aa6fa0c75dff68dbe7a66b2fa1add778a050fb5d;Sun Mar 18 01:20:56 EST 2001;Committer;wakou;1;1;1;2;0
ad813911abac7bee0c86dfa627109abe97ae8ee2;Sun Mar 18 01:07:00 EST 2001;Committer;wakou;1;1;1;2;0
20d29693acc1e3809ad2c82cb24e1922316feb6c;Sun Mar 18 00:01:57 EST 2001;Committer;wakou;2;35;20;55;0
b842d5f571bb67206c0083f31df16aefcf43f7c1;Fri Mar 16 08:30:09 EST 2001;Committer;matz;7;53;23;76;0
7f74a38b72626051f1f6013b627f8662b2ead3a7;Fri Mar 16 08:17:44 EST 2001;Committer;knu;2;14;0;14;0
1fd502ccc1332c3766b04773370e2d5c4836ad2a;Wed Mar 14 08:39:13 EST 2001;Committer;matz;3;16;5;21;0
53ff8df72f5e2fc6318a25474bd8c3950a2c7c29;Wed Mar 14 04:45:46 EST 2001;Committer;matz;4;14;3;17;0
a22cbaa697e28789acfba1204f502d62e4db8fab;Tue Mar 13 09:00:01 EST 2001;Committer;matz;4;16;30;46;0
037dacc5102b3235c7643b021070807846a2c228;Tue Mar 13 07:58:07 EST 2001;Committer;eban;2;13;1;14;0
390a12cf4c731eae799518f262ed02ddac96e2ac;Tue Mar 13 06:01:45 EST 2001;Committer;aamine;1;0;1;1;0
3d1cd3c5b44b106055bcd2dc242492a907ba88e9;Tue Mar 13 06:00:50 EST 2001;Committer;eban;1;1;1;2;0
1a7cb01d6410dc7c56b46ef51b188bdf87b5fd4c;Tue Mar 13 05:48:58 EST 2001;Committer;aamine;4;25;8;33;0
e502549be1bea41406ccef0e819b0e9cb8cdb069;Tue Mar 13 05:45:13 EST 2001;Committer;matz;20;266;71;337;0
8fc5876485fb84bf9c93b569ff0cb57cf2b21f7d;Mon Mar 12 10:20:01 EST 2001;Committer;eban;3;10;2;12;0
118ff2766177504abbbd8dbb4dae3bd16c3772a8;Sat Mar 10 16:03:56 EST 2001;Committer;eban;2;7;1;8;0
15d67fba624df2ee5befa67a0553d29b1196bb1b;Fri Mar 09 17:49:31 EST 2001;Committer;eban;3;8;4;12;0
4dae731bbd067cd1cae8ecf42ede0a4ac7c16bc8;Thu Mar 08 08:39:40 EST 2001;Committer;aamine;3;26;18;44;0
fc07b3b0ad1415ab93352246474251dd97700423;Wed Mar 07 05:43:11 EST 2001;Committer;eban;3;12;2;14;0
93868607a2e19349e9ba3e3eba28698121d7b296;Tue Mar 06 09:03:59 EST 2001;Committer;shugo;1;35;18;53;0
a36e0c78c90917c4d5cc78f67b3808913795f264;Tue Mar 06 08:17:54 EST 2001;Committer;matz;20;177;320;497;0
4a7d313e4a263f5c2f2f42dd573fa612f0d0c0a7;Mon Mar 05 08:33:16 EST 2001;Committer;matz;3;84;44;128;0
ea201e7eb0f52c1803a3c811f1f912fc254b58cc;Mon Mar 05 08:29:30 EST 2001;Committer;eban;1;2;2;4;0
551ab77c38d451dedb09a92a72d300004d215d90;Mon Mar 05 08:29:01 EST 2001;Committer;eban;2;21;6;27;0
76fa4a821633984d4b9df2a80803a02d82983e05;Sun Mar 04 11:56:01 EST 2001;Committer;knu;1;5;0;5;0
d08f28d839731cc4cc40181c88ee6db55b6975ee;Sun Mar 04 09:46:08 EST 2001;Committer;eban;3;11;4;15;0
b3902727d538d5a55cfbda245399f3e951dbc5aa;Wed Feb 28 08:54:57 EST 2001;Committer;eban;1;2;2;4;0
b27393d6caae763ab27b259ca9588aad75758305;Wed Feb 28 06:30:03 EST 2001;Committer;matz;7;59;8;67;0
4fd84b6f2ecfdc5eb818e30db52795b4e5f7f5e2;Tue Feb 27 09:15:18 EST 2001;Committer;eban;1;2;2;4;0
64fb417473889de0f03bee0f178293ce70623a92;Tue Feb 27 07:52:11 EST 2001;Committer;matz;5;33;27;60;0
df2d69b49ab1c8b42dd6c18fb63df26aec95f364;Mon Feb 26 05:29:06 EST 2001;Committer;matz;15;88;78;166;0
69739b14a5f8950c1da8b86f90a70903ed975fee;Sun Feb 25 20:34:59 EST 2001;Committer;wakou;2;26;196;222;0
5fffb312351ea838c08497ff7858c836372471a5;Sun Feb 25 19:57:56 EST 2001;Committer;wakou;2;44;174;218;0
f3d7d9fe48148bfd38d51443912994e04c4800dd;Sat Feb 24 17:51:02 EST 2001;Committer;eban;2;10;1;11;0
9ce5d1f0f5d1c87406ba644c5f2662a6a1b843b3;Sat Feb 24 13:19:13 EST 2001;Committer;eban;3;7;3;10;0
b1cd5105d41ef468236236d8361c782dcbe5e422;Sat Feb 24 04:53:50 EST 2001;Committer;aamine;5;164;125;289;0
acce0b7ec4f5b6682b94e458675020263068d306;Thu Feb 22 23:23:57 EST 2001;Committer;aamine;3;227;146;373;0
d633fc6b5bb397893cc2943214c2600f97326976;Tue Feb 20 14:52:31 EST 2001;Committer;eban;2;23;0;23;0
88eef2d7fec7a3380f495d768c72d1292260ea18;Tue Feb 20 07:42:03 EST 2001;Committer;matz;7;65;9;74;0
86833594ff917d578aa24a4536995fa6573300a6;Mon Feb 19 09:15:27 EST 2001;Committer;matz;6;85;27;112;0
ec6e3f9ec351d2e39d8113101605361664cf7494;Mon Feb 19 07:16:46 EST 2001;Committer;eban;1;2;2;4;0
3ae4fd7258fe518327a0ceb69c292eddbabfb995;Mon Feb 19 07:03:06 EST 2001;Committer;matz;8;90;16;106;0
d63d8012f46d6a8ede9145db48be830cc114ad62;Sun Feb 18 08:19:16 EST 2001;Committer;eban;1;2;2;4;0
99ee3b00384ffcf5ef3515d92c0a3d785457491e;Sun Feb 18 08:18:47 EST 2001;Committer;eban;3;60;49;109;0
b2deafb27774ecf3c931294c5dd10e7fd1831aba;Sat Feb 17 20:40:50 EST 2001;Committer;aamine;2;16;16;32;0
92e4b1b06e10557e1cfce4962b55f4960f6ed5b5;Sat Feb 17 15:17:10 EST 2001;Committer;usa;4;212;119;331;0
e1c29a3f13a8d5ca0f9a4e491a752c73aca1d721;Fri Feb 16 07:53:21 EST 2001;Committer;matz;10;173;59;232;0
9ac8f70f3da942e8a1bc6cadc87cbeaaec2bf44f;Thu Feb 15 13:23:33 EST 2001;Committer;eban;1;2;2;4;0
011ed67616f4dd9b1ca983d32bdfca65e358e3dd;Thu Feb 15 06:01:00 EST 2001;Committer;matz;6;266;45;311;0
756dcb00342274f9fa7bb4a1e9980fac73e31f43;Thu Feb 15 02:45:09 EST 2001;Committer;shugo;2;5;2;7;0
50ce575ce4534c6c1cf2773a8044686131c7a9c6;Wed Feb 14 10:18:21 EST 2001;Committer;eban;1;2;2;4;0
2fbc71787547ba29ff6ccafd7465f708b86339bf;Wed Feb 14 08:40:49 EST 2001;Committer;shugo;2;10;0;10;0
8e5c3b23f2718af0b340659dac56f5e9454e2f49;Wed Feb 14 05:52:06 EST 2001;Committer;matz;35;98;48;146;0
22765f20155d13b6b255ad4ad7e32be1a1a052fb;Tue Feb 13 14:15:55 EST 2001;Committer;eban;2;16;7;23;0
fa3eb5373e680271e4946ff8e077f8266b3746ef;Tue Feb 13 06:05:14 EST 2001;Committer;matz;1;1;1;2;0
65428c02642f9b71e8a82b79860eb565bdda86a4;Tue Feb 13 05:24:05 EST 2001;Committer;eban;1;2;2;4;0
8be410f0653bfb22970381447acf685af4795c00;Tue Feb 13 05:09:11 EST 2001;Committer;matz;14;429;147;576;0
32ce4317d8077c926d0c00172cfac8001dd5ff98;Sun Feb 11 14:59:04 EST 2001;Committer;eban;2;4;0;4;0
c5254c68ada9bc56df27dc9d8ced9ca20c762cd6;Sun Feb 11 07:12:02 EST 2001;Committer;eban;4;50;5;55;0
08f8ab9c37e995d5a7e4060b0b1497c37a437750;Fri Feb 09 15:02:14 EST 2001;Committer;usa;6;46;6;52;0
b4ea8ddcdd86cdfaf48e3217ef02a7530827232f;Fri Feb 09 14:11:23 EST 2001;Committer;eban;3;19;12;31;0
106a65482bf17a10a48344d1f9c2d11cd8b58cf8;Thu Feb 08 13:58:38 EST 2001;Committer;eban;1;2;2;4;0
bc714fb4f510f2b6dbe3f16a48afb729b50cdf81;Thu Feb 08 13:23:48 EST 2001;Committer;eban;2;9;3;12;0
ed520cf6e96dcae2b7900127e325fcea1f4abc26;Thu Feb 08 09:19:27 EST 2001;Committer;matz;19;196;61;257;0
b576f57aa02c4983eeb081f625c45b9445c50538;Wed Feb 07 17:17:51 EST 2001;Committer;aamine;3;72;69;141;0
7e5f9d5a137848b54fe6ab33caebb2631e613bf5;Wed Feb 07 07:23:09 EST 2001;Committer;aamine;3;79;42;121;0
bf5ea589428d3a55174c773398fe49436fbac5d4;Tue Feb 06 13:04:08 EST 2001;Committer;aamine;1;2;13;15;0
5113e8923cd08f3f5e877c2153c0f44597f16402;Tue Feb 06 12:26:25 EST 2001;Committer;aamine;3;17;3;20;0
cdc7602379c9d911983db2c044d69ac417869266;Tue Feb 06 11:14:51 EST 2001;Committer;aamine;5;339;311;650;0
765255b737235a65daea6679c4672541bb67ecb4;Fri Feb 02 11:38:20 EST 2001;Committer;matz;14;159;77;236;0
e9f9915a4c305ac02d8634b14579119433bc7b43;Wed Jan 31 14:27:37 EST 2001;Committer;eban;4;23;10;33;0
35e5ddf6cf001cd57ac61453c347b40acf775f47;Mon Jan 29 06:12:56 EST 2001;Committer;matz;2;22;1;23;0
2f0faf671dcf8eadebdd0e35a567ddb8bd95bcaa;Mon Jan 29 05:10:42 EST 2001;Committer;matz;17;50;40;90;0
161e3313d20eb285c8cfc3288e92a6d2e533cf44;Fri Jan 26 05:02:19 EST 2001;Committer;matz;3;78;55;133;0
74273daffb0d9f1b17795c8b8bbe8e32e14229eb;Wed Jan 24 06:32:10 EST 2001;Committer;matz;2;29;11;40;0
0dc1a293fdcda1558f42d207ef289fd8e7b9401d;Wed Jan 24 06:01:47 EST 2001;Committer;knu;2;11;1;12;0
e111bdb9d389af5d1c23ff54749f56cc8282b825;Tue Jan 23 09:55:10 EST 2001;Committer;matz;2;27;11;38;0
2455b077df103f3ffd55474acd8af42cc4b5f709;Tue Jan 23 09:14:50 EST 2001;Committer;eban;1;2;2;4;0
7635ff6a0529ebcad1eb72d8a16af9d0ca26d126;Tue Jan 23 08:08:59 EST 2001;Committer;matz;5;121;90;211;0
9d0bba43bb79cf7d37fa93af66f2a70600f73fec;Mon Jan 22 07:37:14 EST 2001;Committer;eban;3;8;4;12;0
6aa451b9dd7f7890078dae1f69169b02155f7dc4;Sat Jan 20 14:02:28 EST 2001;Committer;matz;2;54;53;107;0
77b8745d4a80e819fe523b4a4d0dbff3e779446a;Fri Jan 19 19:00:28 EST 2001;Committer;matz;3;17;8;25;0
0232870f7d1b204974356df3c9245ea7ec6fa767;Thu Jan 18 12:36:19 EST 2001;Committer;eban;1;2;2;4;0
0b3092922d0ff12923852e64e9146f99d6191287;Thu Jan 18 08:43:14 EST 2001;Committer;matz;9;93;44;137;0
24a286efe1049d140869bb5ecd9acdc81ec833a0;Wed Jan 17 04:45:49 EST 2001;Committer;eban;1;4;0;4;0
3fff54d2a055289ea3e1247de6ae5e88ee2437b1;Wed Jan 17 04:45:38 EST 2001;Committer;eban;1;0;2;2;0
71e591aed68f2ff93d0d6be9610a641f0cd51415;Wed Jan 17 04:45:22 EST 2001;Committer;eban;1;0;13;13;0
70e3e77f3b22c0c2fa71c473a638c35f7018f9cb;Wed Jan 17 04:33:29 EST 2001;Committer;eban;2;5;0;5;0
7adcec68b19c420381369917a93e4220f3e8f551;Tue Jan 16 07:57:43 EST 2001;Committer;aamine;3;24;11;35;0
c46cf18e3b336027f9b124b31007702b7ee025ba;Mon Jan 15 08:26:34 EST 2001;Committer;eban;1;2;2;4;0
971a4d94f074916c6612edd2c3e1090ca71bc531;Mon Jan 15 07:01:00 EST 2001;Committer;matz;14;109;56;165;0
ac8a2a31c2103abc249544469910ea3ff97f883c;Sun Jan 14 09:22:24 EST 2001;Committer;usa;3;44;5;49;0
0c717d6a589579ccc1f18e1eeacfbda7d7fcf9e5;Sat Jan 13 19:07:15 EST 2001;Committer;aamine;5;490;458;948;0
e9c8b36b1e426ef478d88813218767c18702f35d;Sat Jan 13 10:47:12 EST 2001;Committer;eban;1;8;2;10;0
e63525e97efc78be80e5d20c564f0039b84e07c0;Sat Jan 13 10:46:35 EST 2001;Committer;eban;1;7;0;7;0
fdcbe32f275cacc49c4159d77fa2a08de2c80477;Thu Jan 11 08:32:54 EST 2001;Committer;eban;1;1;1;2;0
6ee84cbabe8fe433930631b15eda4460ffbf2561;Thu Jan 11 01:56:08 EST 2001;Committer;eban;3;13;6;19;0
8bbfa6fa4c548f1a02e58e8b4dfbb444c0c87d8c;Thu Jan 11 01:55:18 EST 2001;Committer;eban;1;0;3;3;0
d08c50dcc4ff2e8d96ea1a701df9868d48e1eebe;Thu Jan 11 01:21:25 EST 2001;Committer;eban;1;1;3;4;0
5a9b26eb9c14043316cc5c7ca387a63381641c02;Wed Jan 10 10:10:43 EST 2001;Committer;matz;1;2;0;2;0
3ea9ef023b6a4cc33ec22a60124c994b53a68c7c;Wed Jan 10 10:07:31 EST 2001;Committer;matz;4;14;14;28;0
4c09e12b04cfcc580b70a20c501d2c1cb6b5c799;Wed Jan 10 09:52:13 EST 2001;Committer;matz;5;6;846;852;0
fd8eadd2af0665aa1db50a554631d5ca568e9d50;Wed Jan 10 08:22:22 EST 2001;Committer;eban;1;2;2;4;0
74d0eaf6a22f86a60f37b439c65039fc277de0fa;Wed Jan 10 08:09:01 EST 2001;Committer;eban;5;35;13;48;0
81ef4309a244b78223832895d714fcaec85ed5bf;Wed Jan 10 07:52:46 EST 2001;Committer;matz;11;809;30;839;0
6b5ad7c5b203b7ffa8b86b1d0b9b15df56a90a27;Wed Jan 10 07:30:18 EST 2001;Committer;eban;7;58;39;97;0
ab9be24857d58a8300ccfb2bfbb093bcfe9807ab;Wed Jan 10 04:49:41 EST 2001;Committer;eban;2;1;5;6;0
51173d8ae4b7415fff3eb715ddccaa792a38e532;Wed Jan 10 02:30:41 EST 2001;Committer;eban;2;5;1;6;0
c7b4e9f26238aba3c67bced9c46bcf53daf87dda;Tue Jan 09 17:19:05 EST 2001;Committer;knu;1;13;12;25;0
cf4d89f23b541891ef15d969c11eff57208c5992;Tue Jan 09 17:11:36 EST 2001;Committer;knu;12;12;0;12;0
a404ead89e2f7fd805b1f21609fd0517b317032e;Tue Jan 09 16:55:50 EST 2001;Committer;matz;3;18;0;18;0
254004fd9e8ce2f2aca10a2bd5b79288101f84fa;Tue Jan 09 08:24:35 EST 2001;Committer;matz;1;1;1;2;0
d110e3f55192c0a538740153f1ba7d8adcf29a2c;Tue Jan 09 08:04:39 EST 2001;Committer;matz;4;14;6;20;0
818b4db1486b984f07a20ca3cf16b006eb0f38e2;Tue Jan 09 07:32:00 EST 2001;Committer;eban;1;1;1;2;0
87beea44969367180d255f56c4001348cf41d210;Tue Jan 09 07:26:21 EST 2001;Committer;matz;17;154;87;241;0
39711489a44a1c0ed02b0a605d3e83558b3b8dd3;Fri Jan 05 15:24:13 EST 2001;Committer;eban;2;5;1;6;0
7d10fe689cd08bb38ae4decb77ad3151f458e543;Fri Dec 29 18:23:22 EST 2000;Committer;matz;4;15;2;17;0
4c1441870edd4279699a672024332ee309a6c87e;Fri Dec 29 02:47:07 EST 2000;Committer;matz;2;28;2;30;0
2cafd39ed2bd164ece3468393300684f2da19902;Fri Dec 29 02:46:12 EST 2000;Committer;matz;5;14;11;25;0
08ec02b92b45464df3dbf79022bb15b853ab0428;Thu Dec 28 05:00:47 EST 2000;Committer;matz;13;100;85;185;0
ceec42bf8c4e350d02d11b84adf9b8ebf7b4af47;Wed Dec 27 05:59:03 EST 2000;Committer;matz;9;122;78;200;0
8369164408f2f9aa2984257f428f957876a84ced;Tue Dec 26 08:32:35 EST 2000;Committer;matz;3;8;3;11;0
a5dcc4437e3354996f8242503d678f0eb5193809;Tue Dec 26 08:08:50 EST 2000;Committer;matz;18;101;87;188;0
c101164b0225b777b2d8521fad29352087b996e3;Mon Dec 25 07:31:43 EST 2000;Committer;matz;1;143;43;186;0
4c8f968c403031a6c0705d290d79b3e1bed5340e;Mon Dec 25 06:53:24 EST 2000;Committer;matz;1;4;4;8;0
99020d6e50702eb371111d73280eb80b4b29ba5b;Mon Dec 25 06:29:27 EST 2000;Committer;matz;16;164;83;247;0
8f6673c2d4a7e6ff470b584141c590e4b066f5e2;Sun Dec 24 20:20:49 EST 2000;Committer;wakou;3;100;65;165;0
b40f3a89e39b1f2150845f32e673998d8693b294;Sun Dec 24 20:01:44 EST 2000;Committer;aamine;4;467;488;955;0
c8da204306676a9a2a8ba210784ab6e9eb6b8bb5;Sun Dec 24 19:39:15 EST 2000;Committer;aamine;5;492;471;963;0
79633d3bb8334fc58be49b6d86fcd6a40f569f75;Fri Dec 22 18:40:55 EST 2000;Committer;aamine;5;179;62;241;0
e6bf7809f399b4602c9b3a2aa4761da0e336fb83;Fri Dec 22 09:00:23 EST 2000;Committer;matz;5;25;14;39;0
7f16734d2722ae0a33125bac9c9de5a90dba3e83;Fri Dec 22 06:36:10 EST 2000;Committer;matz;1;5;1;6;0
0e47c138c9bba4396fc7d956b05e5725000012f1;Fri Dec 22 03:22:25 EST 2000;Committer;matz;15;277;141;418;0
31c53aaa7dc3da8bc9ba6b3007c183dcbeeafe11;Thu Dec 21 06:35:05 EST 2000;Committer;shugo;3;7;3;10;0
8d393f1855483314e98269980a728b44c34c8bea;Mon Dec 18 14:22:37 EST 2000;Committer;eban;2;112;193;305;0
117b7d5c47f31b02cf891c792f919afceaddd080;Mon Dec 18 09:46:21 EST 2000;Committer;matz;12;110;20;130;0
652f744cba955435d0c69f17fa42c3c7b88bcbe9;Thu Dec 14 00:26:05 EST 2000;Committer;wakou;3;74;53;127;0
3e865dceffae6245f9277af11e0422d10b01258c;Wed Dec 13 03:50:59 EST 2000;Committer;eban;1;2;2;4;0
5504b5c8769826e6dcbea7bca9f37d961ebaf2d8;Wed Dec 13 03:48:30 EST 2000;Committer;eban;2;5;1;6;0
3a7020854d43c4d29ca5cd9013e3af139f378548;Tue Dec 12 07:42:35 EST 2000;Committer;matz;9;68;27;95;0
2322a131272f705139fb1e6bbcf1d85a0205e8b0;Fri Dec 08 07:10:38 EST 2000;Committer;matz;14;95;50;145;0
a721bd628ef4ea9846e9395530752ab8e47b4eca;Thu Dec 07 08:38:39 EST 2000;Committer;shugo;2;5;1;6;0
598d8ada314704591ac6eaf2c40dd9b0602490f8;Wed Dec 06 09:10:17 EST 2000;Committer;eban;4;10;4;14;0
781ce823dcf986620464a433340d0438b6fe7cd6;Wed Dec 06 05:29:05 EST 2000;Committer;shugo;1;1;0;1;0
bc722c84cd3113a552801ae1210503ff978fd837;Tue Dec 05 11:07:49 EST 2000;Committer;eban;2;2;2;4;0
03581d5826a7f2ed7b7f9c0691220c1a5ac00988;Tue Dec 05 09:36:54 EST 2000;Committer;matz;16;305;156;461;0
afa2732b784aaac7800ba03d5617d5d395964149;Mon Dec 04 15:03:56 EST 2000;Committer;eban;2;5;1;6;0
f54418b71f57e00d4a50bd86bf7d18b8b5195287;Mon Nov 27 09:23:38 EST 2000;Committer;matz;20;907;181;1088;0
1f297b8bfc0fdacb8cfb19736cf224b2550281b3;Tue Nov 21 14:31:11 EST 2000;Committer;matz;1;1;1;2;0
a122fce4768ab91c8aab8a4ca3734554c8f1d939;Tue Nov 21 14:26:25 EST 2000;Committer;matz;8;56;76;132;0
6ffeed5c898cb5dd43d917d3f90459fbc31f8d3f;Mon Nov 20 08:26:48 EST 2000;Committer;matz;2;28;3;31;0
39563af99459820ada08e30e379c84b4560c3fe9;Mon Nov 20 07:31:55 EST 2000;Committer;matz;14;258;85;343;0
8f54a9b4704e5416290a5670519ae7bc869de0e8;Mon Nov 20 02:56:15 EST 2000;Committer;eban;1;2;2;4;0
3634fde44d3e3cedf2278f03b7c3b28b93a729c4;Mon Nov 20 01:24:28 EST 2000;Committer;eban;4;30;6;36;0
15b9494baa5be28a827a5169f27a5f884cb4518d;Sat Nov 18 05:04:36 EST 2000;Committer;aamine;2;6;3;9;0
c12c7ab1dcdffc82886b9ad5a082669cd6056843;Fri Nov 17 09:09:03 EST 2000;Committer;matz;2;7;5;12;0
eab254084682ee8b30c3c872a31848f364c08a4d;Fri Nov 17 05:59:45 EST 2000;Committer;eban;2;5;1;6;0
21efb309e7bd3985647d806b1ef7969c16afba02;Fri Nov 17 04:41:19 EST 2000;Committer;matz;5;57;19;76;0
46608d361a199ee96ce71043d03d5e2dbed3cf66;Thu Nov 16 16:56:59 EST 2000;Committer;matz;3;3;16;19;0
0d11c322d107ccb3e53d5a429c89fc954c561a93;Thu Nov 16 14:03:20 EST 2000;Committer;aamine;3;179;135;314;0
074203d270bba2046f6d272f9d01385257be9fee;Thu Nov 16 07:24:21 EST 2000;Committer;matz;9;100;51;151;0
46620a87720943120cabe6ffe2e94a2c3506c4c2;Tue Nov 14 07:10:31 EST 2000;Committer;matz;12;508;202;710;0
e9cf3b3bf56646e94df9189bfe8d6449b79ca0fb;Mon Nov 13 10:11:31 EST 2000;Committer;eban;4;16;8;24;0
2a1b0ff2326ae53c299206f983413fa00a2c7ec5;Mon Nov 13 05:39:35 EST 2000;Committer;matz;9;77;22;99;0
1db8e80b29f41a3e413626bca4b95ff6a4cfe522;Sat Nov 11 00:07:23 EST 2000;Committer;aamine;1;8;7;15;0
f5ba5e64d5584e2ceb68ce64b95345bc230ed090;Fri Nov 10 23:31:32 EST 2000;Committer;aamine;5;188;102;290;0
ae5cb89708114b7b71221ddd81d0f423a0a483f4;Fri Nov 10 08:52:23 EST 2000;Committer;matz;3;9;5;14;0
087c83d7ceed6893afff93066937fb570ae4a115;Fri Nov 10 07:16:52 EST 2000;Committer;matz;6;29;5;34;0
13f2744b2e8ac8cc3e727051b2d200fa225a733a;Thu Nov 09 02:29:45 EST 2000;Committer;eban;1;0;1;1;0
af328b152b68bb21549e52df230b17a8672795c3;Wed Nov 08 05:29:37 EST 2000;Committer;matz;13;109;43;152;0
41e41d34d14ef3595a54148368b89b6c75d0fe4d;Tue Nov 07 11:27:16 EST 2000;Committer;aamine;5;104;70;174;0
faeb1701cea992f5fb98c6d6c543e62f260b31c2;Fri Nov 03 15:08:30 EST 2000;Committer;matz;1;2;2;4;0
58e04b755a862f9dde91b0293f1998ed26ab73f4;Thu Nov 02 09:04:54 EST 2000;Committer;matz;6;21;15;36;0
4b9666b700e57c11a4443c3c2819a3c127ce93a6;Wed Nov 01 11:16:06 EST 2000;Committer;eban;1;2;2;4;0
d1bcd482a7a6a628e7402aab338b9bc57fb768ae;Wed Nov 01 08:49:40 EST 2000;Committer;matz;2;37;34;71;0
3685e2bf2c8026f9b513a8d5a58769d7388005f2;Wed Nov 01 02:48:47 EST 2000;Committer;shugo;1;5;1;6;0
fab538ba837d0a6e2b145228ce23d22cfe4515d5;Tue Oct 31 12:59:37 EST 2000;Committer;eban;1;2;2;4;0
c90b1ecaf81868ab64b014401ea75eb45da2c5d0;Tue Oct 31 08:37:47 EST 2000;Committer;matz;9;224;101;325;0
5f4d324d3b7f9f50c7c1eb2ec6d2b546e4466f0b;Tue Oct 31 07:06:47 EST 2000;Committer;shugo;1;9;4;13;0
1222537eb0417c597f817cea4b3a584e4c4d0d64;Tue Oct 31 00:43:08 EST 2000;Committer;eban;2;4;4;8;0
4960282ab351ebcd6840347f8c4403a9ed66c201;Mon Oct 30 04:17:42 EST 2000;Committer;shugo;1;1;1;2;0
24053a65d0abb4c6237a94ae24a2b1e2bc1da7c1;Fri Oct 27 07:20:02 EDT 2000;Committer;shugo;1;67;36;103;0
cac38b30e56ee30cf73cb5a654fac1ece1900198;Thu Oct 26 08:19:04 EDT 2000;Committer;shugo;1;48;6;54;0
1488b9b4583fe141004be9805d5c7e53c02a1830;Wed Oct 25 21:31:52 EDT 2000;Committer;shugo;1;946;260;1206;0
34f44ca496108c98d05cf2338e36fa66bc362255;Wed Oct 25 17:40:30 EDT 2000;Committer;aamine;3;14;2;16;0
033a4ffa4b2fc59017995f8a2856dbc73af87c82;Wed Oct 25 11:04:36 EDT 2000;Committer;eban;1;2;2;4;0
9b5c48abedd1fc81709589deeb82846c3d17eb1d;Wed Oct 25 04:48:41 EDT 2000;Committer;matz;3;52;31;83;0
52a2acbad3e0252ba3c4be59d92262d003615a72;Wed Oct 25 04:27:59 EDT 2000;Committer;shugo;1;0;1;1;0
4098e5861e4a6dadf17e6502afbc139bcff3cd3b;Fri Oct 20 16:37:01 EDT 2000;Committer;matz;9;57;33;90;0
1b2d3f81ee00c3fc5f002aaf7a646ed08e605610;Tue Oct 17 18:14:05 EDT 2000;Committer;matz;8;75;17;92;0
d51bcd20071f6f61bce0364c81fb48e2c5b7d224;Tue Oct 17 18:04:41 EDT 2000;Committer;shugo;1;66;29;95;0
8353f303e3c1109e04ef47707df3b7d84b12c5fe;Mon Oct 16 09:13:20 EDT 2000;Committer;matz;9;91;59;150;0
525836d683d8c0cc2ff2479875eb9e71bd63d151;Mon Oct 16 09:11:10 EDT 2000;Committer;shugo;1;8;7;15;0
84fbb64d7aec804c314cf0bd156a3bf078b5f9fd;Mon Oct 16 07:38:26 EDT 2000;Committer;shugo;1;1;1;2;0
de75f3c0a6f0cb73f1b2c9572af8edda4eb25658;Sun Oct 15 21:37:30 EDT 2000;Committer;aamine;2;5;1;6;0
368683723e6c4a63b91b39b81da69409a824a837;Sun Oct 15 16:47:29 EDT 2000;Committer;shugo;1;20;19;39;0
bb6d5ce17a8807841e2190dc446fd5e6f63bcc5a;Sat Oct 14 14:54:51 EDT 2000;Committer;shugo;1;12;7;19;0
cef64ee0ba659231bec5d7599a4bfacca53352f3;Sat Oct 14 14:44:58 EDT 2000;Committer;matz;4;104;68;172;0
52f90f65668e479cd712e2e3bbd0dc80925816fe;Fri Oct 13 09:01:58 EDT 2000;Committer;matz;6;48;15;63;0
12d1bc6bd53eabee9442c79d41b698b0bf3ac7d8;Fri Oct 13 08:09:27 EDT 2000;Committer;shugo;1;4;0;4;0
0f568bcf355ae7ffa7cfc95dd33b6fa424dd738b;Fri Oct 13 08:06:16 EDT 2000;Committer;shugo;1;1087;0;1087;0
76819ef99ab0986f9d5b174b68fed919e4cd9585;Thu Oct 12 09:54:32 EDT 2000;Committer;aamine;3;32;7;39;0
9dbce410e10e409f178291c1ef1007a1d9dd718c;Wed Oct 11 16:28:15 EDT 2000;Committer;wakou;2;15;5;20;0
fe10b1680961e4ad68850cd6c3f786436af0f972;Wed Oct 11 07:54:26 EDT 2000;Committer;eban;1;2;2;4;0
6c11709d4c2ca083d0c1f7c7041b5aec4efd9361;Wed Oct 11 06:29:16 EDT 2000;Committer;matz;6;47;19;66;0
a86f6a00df5c97e1e6c64d96e39e11e2df3d9053;Wed Oct 11 05:47:36 EDT 2000;Committer;aamine;1;2;0;2;0
83033ce328a2ea19c90bcd6f937291f5ed0e1623;Wed Oct 11 05:27:56 EDT 2000;Committer;aamine;3;206;170;376;0
14260932b444e36121fe8f84ad4a1fa65d5730b2;Tue Oct 10 09:24:54 EDT 2000;Committer;matz;1;1;1;2;0
c5cd237f47c6559bc23f17826ce8df2bfcd8c2ec;Tue Oct 10 09:12:43 EDT 2000;Committer;matz;1;1;1;2;0
33baccab787b05988c9b4907db0586d98d69d15a;Tue Oct 10 07:20:10 EDT 2000;Committer;eban;3;6;13;19;0
1ce6f065b519284a5ad7135a6db77fcbe1aa778a;Tue Oct 10 07:03:36 EDT 2000;Committer;matz;16;113;74;187;0
ef45458e9405c57ab4f59f648c4001ea4df30489;Fri Oct 06 06:13:52 EDT 2000;Committer;eban;6;11;7;18;0
9527d909511cf8f726cd936856adb5f98e9f433c;Thu Oct 05 09:57:04 EDT 2000;Committer;matz;6;146;129;275;0
1e1b5cdd25c87b393658e78a4cfd799ef6caf6da;Tue Oct 03 08:56:50 EDT 2000;Committer;matz;2;5;1;6;0
e07498c03f002224ca14cb55eeeaacbab300b273;Mon Oct 02 10:14:28 EDT 2000;Committer;eban;1;2;2;4;0
9a46002fc01b1b874d768b2e8372b725a9e8b298;Mon Oct 02 07:48:42 EDT 2000;Committer;matz;12;59;40;99;0
173e2f6636701f7657a0acb3dcba33e9d66b562d;Sat Sep 30 17:06:08 EDT 2000;Committer;eban;2;5;1;6;0
17ab6e7ef4f818fba1c82e12fa5297c6aac5a411;Wed Sep 27 09:44:05 EDT 2000;Committer;matz;1;4;0;4;0
6f36fedaa4788cfa956764d5b7e63fc67b444400;Wed Sep 27 09:11:13 EDT 2000;Committer;matz;5;153;7;160;0
25aa3816b173efa6889f2832c34da13021f656eb;Wed Sep 27 07:22:17 EDT 2000;Committer;eban;3;7;3;10;0
d1fb5f16d591d8f32c151152b0b0d159a5cbc4c2;Wed Sep 27 06:48:23 EDT 2000;Committer;eban;1;10;5;15;0
3df207c883f111b34b6af22c4ade7b8be357b190;Wed Sep 27 03:43:15 EDT 2000;Committer;matz;3;24;9;33;0
d917f9af979642b88cf8a4a55f7dd4520b7481fb;Tue Sep 26 09:11:47 EDT 2000;Committer;eban;2;5;0;5;0
51f9223e9c27e6b1fe92ebb340cffaca734a16e0;Tue Sep 26 07:12:45 EDT 2000;Committer;eban;1;2;2;4;0
c7a316947f8f9249afb4ed043034bdfb7fdd3951;Tue Sep 26 07:07:13 EDT 2000;Committer;matz;3;34;53;87;0
684a768ef5e1859d5e2b95031576c06017277e9e;Mon Sep 25 17:59:13 EDT 2000;Committer;matz;1;1;0;1;0
9448424dbaf7c999a9c5cfe134a35f118f3a2fea;Mon Sep 25 17:51:29 EDT 2000;Committer;matz;5;54;16;70;0
ba2b829a0f154624b1b315b98de01274343b4336;Mon Sep 25 13:39:58 EDT 2000;Committer;eban;1;6;7;13;0
b617f5270c610bf870e7267f9db3d32f93551611;Mon Sep 25 10:21:58 EDT 2000;Committer;eban;1;3;4;7;0
b9228a014ba4818cdf584e3dda63ed1aed3ad1c7;Mon Sep 25 09:15:08 EDT 2000;Committer;matz;7;50;32;82;0
40412b77305befcaffd0f3fcf85d6cd8f2d75f3d;Mon Sep 25 07:00:55 EDT 2000;Committer;eban;3;12;9;21;0
1562b35febef68ac8947a78a6eba34a83a30a0b2;Mon Sep 25 05:13:22 EDT 2000;Committer;eban;1;2;2;4;0
75ddce9a5d288c77afde8420fcc4e08505e96064;Mon Sep 25 04:33:53 EDT 2000;Committer;eban;2;11;5;16;0
aa806d78117901096bce99483ce5cf6380aba22a;Sun Sep 24 15:50:41 EDT 2000;Committer;eban;3;7;3;10;0
69543770ca16e1a8b4b7341e507a0cf154b32cf5;Sat Sep 23 18:00:28 EDT 2000;Committer;aamine;3;9;5;14;0
e4fae8da4beeb7b61a9c3b58d66a4e594f0e73fa;Fri Sep 22 18:15:52 EDT 2000;Committer;matz;7;45;10;55;0
77f8b0db8d6b95fde7ca8b7a9dcd0f42f0f97af5;Fri Sep 22 06:44:59 EDT 2000;Committer;aamine;2;12;8;20;0
5bb84ef24675ee3083ad2a0917b19420112beeaa;Fri Sep 22 05:37:52 EDT 2000;Committer;matz;2;8;2;10;0
89363f9776ef02f69d780b8449aabe75b800c954;Fri Sep 22 05:00:45 EDT 2000;Committer;eban;1;1;1;2;0
d8b6e0896e9c5f3a52cf9f8ab16943e2ac2a05e3;Fri Sep 22 05:00:23 EDT 2000;Committer;eban;2;5;2;7;0
734cbb634db687252162e8a93977d7a7c9063e90;Fri Sep 22 03:37:27 EDT 2000;Committer;eban;2;3;3;6;0
975e0fadaac292b85a6bdb44eb09c7ad5163c8ff;Fri Sep 22 02:37:13 EDT 2000;Committer;matz;3;8;8;16;0
fe7108a822f0440c2d021298bffedc68aca729b5;Fri Sep 22 01:19:39 EDT 2000;Committer;eban;2;6;0;6;0
ec1a89eeb7ef0c58cde69c4e3ee75158da6a4d3a;Fri Sep 22 01:02:44 EDT 2000;Committer;eban;2;9;6;15;0
4667f459cfb7b372f61ff67f4f31abb06d7d180f;Thu Sep 21 10:24:15 EDT 2000;Committer;eban;1;2;2;4;0
2549d8b2c65374deef129f091016aa3b48598fa2;Thu Sep 21 10:18:31 EDT 2000;Committer;eban;1;0;2;2;0
ca13525d5d52113e1ba0bb1711ab17a5215466be;Thu Sep 21 10:08:57 EDT 2000;Committer;eban;3;13;5;18;0
b35df6aae27214f831931c0174afb497218cf74e;Thu Sep 21 09:31:00 EDT 2000;Committer;matz;6;39;25;64;0
616c1cd971695ed74df6e3a98fa9d584f3783e8b;Thu Sep 21 06:58:01 EDT 2000;Committer;aamine;5;153;83;236;0
13243e5ad15f5d0d259b4850199183fdf9572f46;Thu Sep 21 06:37:24 EDT 2000;Committer;matz;5;10;5;15;0
fc57cd59ffe2cca34d6bd48962f0be47eed0f509;Wed Sep 20 09:16:32 EDT 2000;Committer;matz;5;46;11;57;0
5039daaf2e2c3c21c4b77397210b3e3cfe5e7af1;Tue Sep 19 09:03:21 EDT 2000;Committer;eban;1;0;2;2;0
c99f974aa4004ebf0f223e88dee0535e012e7a76;Tue Sep 19 08:47:51 EDT 2000;Committer;matz;1;1;1;2;0
f1bb1f584899eeec1227a6d7fcf4b7730a485821;Tue Sep 19 07:54:28 EDT 2000;Committer;matz;7;29;13;42;0
053140491c5594ee81064ef3dc19d32b3e907794;Tue Sep 19 07:01:54 EDT 2000;Committer;eban;3;4;3;7;0
c74a3b21f59af9a59e42d42e4947beab3897e208;Tue Sep 19 05:03:07 EDT 2000;Committer;eban;3;7;3;10;0
79a80729109338abe66a4448916e650c4bfbcc9b;Mon Sep 18 16:28:40 EDT 2000;Committer;matz;3;65;61;126;0
e1461461ccfc66d37bbc4823d44bb9e2b7d879ae;Mon Sep 18 09:54:47 EDT 2000;Committer;eban;1;7;3;10;0
4378cbc0235e20ccee5ecb7d8a0e3b95c418e43d;Mon Sep 18 08:47:10 EDT 2000;Committer;matz;5;56;36;92;0
bbf2ad4ed8a142c5fba8b5e56293006b359f9b18;Fri Sep 15 06:00:30 EDT 2000;Committer;matz;9;80;23;103;0
f57e5b0dc61aab42d2913029080d7e93cc75f71a;Tue Sep 12 21:23:27 EDT 2000;Committer;wakou;1;4;4;8;0
ca94f612b4c01b90a8ae89ff40793b847370a7c2;Tue Sep 12 21:16:09 EDT 2000;Committer;wakou;3;19;3;22;0
ef405dfa04ec496620f88861a31206939bf1f5b2;Tue Sep 12 13:56:52 EDT 2000;Committer;eban;2;7;2;9;0
2efe05858a41d35ff8a648ac4fbffc358203b980;Tue Sep 12 07:08:40 EDT 2000;Committer;eban;2;6;2;8;0
042bb17f55b2b82209a0f33fe5dcf4def26ebc1d;Tue Sep 12 06:41:23 EDT 2000;Committer;matz;2;7;2;9;0
fbcc6dea0c86e7e4d087f1d4b2de19b211d16647;Tue Sep 12 05:37:38 EDT 2000;Committer;matz;20;135;78;213;0
9d823983dc3e88cb7775c78908a4bb5133ad88ac;Mon Sep 11 22:37:27 EDT 2000;Committer;wakou;1;11;8;19;0
e2adc86984ba979812162645b6a447dfced6f930;Mon Sep 11 22:13:46 EDT 2000;Committer;wakou;1;6;0;6;0
a5afbd50a794a3a902ad14644cdf8b75190267e2;Mon Sep 11 22:02:37 EDT 2000;Committer;wakou;2;94;49;143;0
6fc752bf7da30898ff8e570f9354cab9419cf3cf;Thu Sep 07 06:59:46 EDT 2000;Committer;matz;11;111;78;189;0
a509e67c5a690ad83bde66299d73bcf967f84dc1;Mon Sep 04 09:39:34 EDT 2000;Committer;matz;1;2;2;4;0
764c6a285e26ba7261cb9c39d4263d2be081e481;Mon Sep 04 08:24:09 EDT 2000;Committer;matz;7;77;25;102;0
db1571b1b466d20f6a17c85ab062ad37eddb588c;Mon Sep 04 04:43:26 EDT 2000;Committer;eban;4;15;7;22;0
5c3523de765b41584cfcebb8aebbaa6ac9433c35;Fri Sep 01 09:18:11 EDT 2000;Committer;matz;5;13;10;23;0
87b67b575c4d5dc428ee1f33f0f4d546e5111c10;Fri Sep 01 08:10:49 EDT 2000;Committer;matz;2;4;1;5;0
cff9ebc8dcdab943fa7b48b97ef42e6c1fd58f1c;Fri Sep 01 07:25:25 EDT 2000;Committer;matz;3;19;14;33;0
2252d4ce028b38bb46310b215b2c98afbf224d55;Fri Sep 01 03:31:05 EDT 2000;Committer;matz;7;44;31;75;0
6001314def338002ae1dc50bcf120805bee78a44;Thu Aug 31 09:08:14 EDT 2000;Committer;matz;3;15;15;30;0
c3262595ab9267240495be797e55e610122032f2;Thu Aug 31 08:08:39 EDT 2000;Committer;matz;3;16;14;30;0
0ccc0fad33679db35de67eeaa9a4d837173761c9;Thu Aug 31 07:27:15 EDT 2000;Committer;matz;1;1;0;1;0
4cb8ce365aea2903e618d511b4300c3547987a0d;Thu Aug 31 05:32:23 EDT 2000;Committer;matz;1;2;2;4;0
e0009b6a5437c5427a6abf3ddeee3804f73b9870;Thu Aug 31 05:29:54 EDT 2000;Committer;matz;10;112;55;167;0
5b3ed19660ef4d9ea87265416a199e7dc7e940c1;Wed Aug 30 08:16:36 EDT 2000;Committer;eban;2;35;0;35;0
db3e830f84913877677bb53c4434c7ca5007fdf2;Wed Aug 30 05:34:05 EDT 2000;Committer;eban;3;32;6;38;0
91f513b52a48a16904b5b9289b05f0e8b0f6b944;Wed Aug 30 05:20:36 EDT 2000;Committer;matz;3;10;0;10;0
3c89a278e3d538dcb206753dc3b0466a9476fbc5;Wed Aug 30 02:36:07 EDT 2000;Committer;eban;2;38;25;63;0
68bc47726b8afef80885a3f698b5c0fceec48d77;Tue Aug 29 07:29:48 EDT 2000;Committer;matz;5;8;26;34;0
4e560cffd6266c08cb856d1b2c25f796522bcc9e;Tue Aug 29 02:52:41 EDT 2000;Committer;matz;9;31;40;71;0
bba6ae31371449a685f23bdd93f0f9a931e5eccd;Mon Aug 28 09:57:07 EDT 2000;Committer;eban;1;2;2;4;0
0a2f8b61d47116a2f2e17f6026fd7f17c2f15878;Mon Aug 28 09:53:42 EDT 2000;Committer;matz;17;271;82;353;0
df9d49d0881d9596b9b7d23dbd42950d5048bd9d;Fri Aug 25 08:26:06 EDT 2000;Committer;matz;8;80;47;127;0
d68d1d15843125c6ae91055feb05f08b8c70e4f6;Thu Aug 24 06:29:30 EDT 2000;Committer;eban;3;10;2;12;0
dea6ce41b404df35944ab6063c614497b1b2984e;Thu Aug 24 06:21:43 EDT 2000;Committer;matz;13;103;37;140;0
a85a9d31db29e366cce9efb9c3fab24e750ed498;Fri Aug 18 16:46:18 EDT 2000;Committer;eban;2;9;4;13;0
468df0e2d45dc4447019fb9dc15747dbf008f938;Thu Aug 17 03:14:22 EDT 2000;Committer;shugo;1;6;2;8;0
79c2d60971501ea6cb8304a9c860bac0bc2bee94;Wed Aug 16 19:26:07 EDT 2000;Committer;aamine;5;56;38;94;0
82178a552907e413a09f5dfe646fb3e876f4011c;Tue Aug 15 09:04:32 EDT 2000;Committer;matz;4;17;2;19;0
740a664bc8615656bea6e1181bf5c65ee56d8a60;Tue Aug 15 07:11:13 EDT 2000;Committer;eban;3;14;7;21;0
d90452941adf06a852ed151c2f75f7df164670b6;Tue Aug 15 06:34:48 EDT 2000;Committer;eban;1;2;2;4;0
c345257ff6c1e913125739545a40cc1b60b62611;Tue Aug 15 06:22:49 EDT 2000;Committer;matz;9;77;36;113;0
37282fa5b083375cab6780824a8941c459b59ebe;Thu Aug 10 14:23:10 EDT 2000;Committer;matz;2;6;1;7;0
1732b6fa4e0c292c30404d009dbb7cd3e2abb602;Wed Aug 09 21:27:10 EDT 2000;Committer;eban;4;12;2;14;0
db537ebae35f162e89a38672155886c080d529f1;Wed Aug 09 11:17:25 EDT 2000;Committer;matz;1;4;5;9;0
61556330682130b85c34f13d9a54ef95b8fc6529;Wed Aug 09 07:35:01 EDT 2000;Committer;matz;3;7;1;8;0
c1bbe10599dfcc2dca3823dc0784eb1835c1ed74;Wed Aug 09 04:32:24 EDT 2000;Committer;matz;12;40;43;83;0
a3edeb5fec3dfb064a1745881f5c5ec68e2abc92;Wed Aug 09 04:26:06 EDT 2000;Committer;eban;4;60;2;62;0
bc90f95def78c5c24ea605b825c5a4ee27b0ed74;Wed Aug 09 00:32:03 EDT 2000;Committer;eban;1;1;1;2;0
ce799ec3eabd2437e7cc7c64580668d239e74b7a;Tue Aug 08 05:06:24 EDT 2000;Committer;eban;6;113;9;122;0
5093c0496e4ddbb86d5a190163f54b21a4b60e39;Mon Aug 07 06:11:34 EDT 2000;Committer;matz;3;7;2;9;0
c67251edb478509b4abd9910e0b499a116112a3c;Mon Aug 07 05:05:04 EDT 2000;Committer;matz;23;244;83;327;0
14fe04bdacfb1bbe1e568c4e1dd4092a64c5ede7;Sat Aug 05 08:40:11 EDT 2000;Committer;eban;3;18;5;23;0
78141aa6c641f06fadf8b333c3fda8072bf10289;Sat Aug 05 07:32:54 EDT 2000;Committer;eban;4;95;95;190;0
87be0f1222670c5543518ff2cd509e6ad671e3f5;Thu Aug 03 09:55:54 EDT 2000;Committer;matz;16;729;1075;1804;0
5222760bc4062f4ce0f8a2c46961fb4cb26682f1;Thu Aug 03 09:50:41 EDT 2000;Committer;matz;12;213;133;346;0
d65b573aea73565ac4db34c3ab403c9f734fbfd2;Wed Aug 02 09:50:37 EDT 2000;Committer;matz;3;12;8;20;0
6689997b5eec76e1f3a0f5670f963aa8ae193417;Wed Aug 02 09:22:27 EDT 2000;Committer;matz;4;26;19;45;0
f32c76a2668cdbee36f1c6515693b41428f865e7;Wed Aug 02 04:54:21 EDT 2000;Committer;matz;7;310;155;465;0
1a9a0e7d98bd17964128b321d4dcfa18f0b05ed5;Tue Aug 01 09:33:14 EDT 2000;Committer;eban;1;2;2;4;0
d3a61700106dbb79ff2330517187ff04df63fdb7;Tue Aug 01 09:25:37 EDT 2000;Committer;matz;6;89;49;138;0
65cdbd0667ae56198e8ebd7b2b06a6a35c14b718;Mon Jul 31 09:43:14 EDT 2000;Committer;eban;1;16;1;17;0
ed474caef18e34a54010ea09d3f64896b0add5f7;Mon Jul 31 09:21:25 EDT 2000;Committer;matz;2;10;28;38;0
b2d7eaec50f070913fa71d3a8d39cf9e738f3559;Mon Jul 31 04:47:20 EDT 2000;Committer;eban;1;2;2;4;0
374ea2790eb49b60064fe720219a70b1ffc26b49;Mon Jul 31 04:36:38 EDT 2000;Committer;matz;5;24;8;32;0
7d87fac63ad2f1a798c7fed4b424f1fc5763470c;Sat Jul 29 14:05:15 EDT 2000;Committer;eban;3;13;8;21;0
77e876615da5f1482b225bd4f754b9fefcd52cec;Thu Jul 27 09:49:34 EDT 2000;Committer;matz;21;89;101;190;0
f0ba57341ac7815189f7e33c980b8cbb51571efb;Wed Jul 26 02:25:50 EDT 2000;Committer;eban;2;4;1;5;0
b17c80f6d63027d18cee2c49b4ab9116b3264b03;Wed Jul 26 01:12:31 EDT 2000;Committer;eban;2;7;3;10;0
94089e82a1276df9d222fba111d4d4763aac144a;Tue Jul 25 14:46:46 EDT 2000;Committer;eban;5;32;30;62;0
f8971ef1b1765c804477b518ae80e3b79599dc3f;Tue Jul 25 10:09:59 EDT 2000;Committer;eban;2;6;1;7;0
993204f632e9fb5d88cf51ab65f3d81df1d4a130;Tue Jul 25 07:21:54 EDT 2000;Committer;matz;4;34;20;54;0
2f7ff9d1b8a75f2f791eb2cea4883d0d1da93df4;Tue Jul 25 06:03:50 EDT 2000;Committer;matz;3;15;5;20;0
b9373b7aeaf51441cd36334635022bd4f9523a4b;Mon Jul 24 09:58:10 EDT 2000;Committer;eban;4;21;16;37;0
a4fe713cb199934e8b7870850c50fcc24fb5685f;Mon Jul 24 07:19:34 EDT 2000;Committer;matz;3;9;0;9;0
c9accd03e721f1455ccdf3f09f5251d6b93c1b4b;Fri Jul 21 08:45:34 EDT 2000;Committer;matz;6;34;4;38;0
303974887a95ca34448821e16eec339b30d25da6;Wed Jul 19 08:10:46 EDT 2000;Committer;eban;1;2;2;4;0
8053b7f3b10d686dd5296f1f5093b635bef652a6;Wed Jul 19 08:04:52 EDT 2000;Committer;matz;4;18;12;30;0
ec4e83ed5623edf8602dce45358c34d245314906;Tue Jul 18 07:42:24 EDT 2000;Committer;eban;1;2;2;4;0
4d034eda0a092801421c01f87e5f0cdf83cb6088;Tue Jul 18 07:37:02 EDT 2000;Committer;matz;3;309;602;911;0
741ca76912fc71269dce5519a360f8c186e0530f;Tue Jul 18 06:00:45 EDT 2000;Committer;matz;9;39;35;74;0
448e63d627bf3653da0b3dc0dcf93e161829dc71;Mon Jul 17 09:38:10 EDT 2000;Committer;matz;13;112;145;257;0
23dd3051c06c781b3905c993fd8fc1b3ccff6b81;Sat Jul 15 13:37:03 EDT 2000;Committer;matz;7;129;64;193;0
3f3bcc697e989078e946ac01313d5e36cfaa3d7d;Sat Jul 15 00:33:12 EDT 2000;Committer;matz;5;107;22;129;0
cc2c313903ff348f588a121238e1be532ad58fba;Fri Jul 14 08:21:30 EDT 2000;Committer;eban;3;12;8;20;0
9144491376799259d3430ad36c0c862b21c053a2;Fri Jul 14 07:18:58 EDT 2000;Committer;matz;3;46;39;85;0
ce175376b2a0460d746270831d35240595cac276;Fri Jul 14 04:34:43 EDT 2000;Committer;matz;5;27;8;35;0
1ad26ccf354816b68273e0d9c82594fbcf009f29;Wed Jul 12 09:36:21 EDT 2000;Committer;matz;2;24;18;42;0
ec9fbf3939be00d70637e59dd34cad259ce62eef;Wed Jul 12 07:33:34 EDT 2000;Committer;matz;1;1;1;2;0
b97e1cfdb1294ccf8da7c469d8075ff0c961e75d;Wed Jul 12 06:33:23 EDT 2000;Committer;matz;2;6;2;8;0
e3d3909fa0f000b3acf55a34280c144a5ed7e664;Wed Jul 12 06:11:49 EDT 2000;Committer;eban;1;2;2;4;0
b8e9c32d17b0fdafc8bfdeab7226e4bdeb1b7577;Wed Jul 12 06:06:50 EDT 2000;Committer;matz;5;81;58;139;0
beffb7f8357091b17d5783d6f1b921c4d8727250;Wed Jul 12 06:04:40 EDT 2000;Committer;aamine;5;158;129;287;0
960676a2de16f046be01f0ef54ec4efe93ce612d;Tue Jul 11 08:27:06 EDT 2000;Committer;matz;3;19;14;33;0
df803a57a903c7e005af218ca470c5241e1b38d0;Mon Jul 10 06:47:04 EDT 2000;Committer;eban;1;3;0;3;0
11930ca8ead99b308bdd70a2f8d1babda836e442;Mon Jul 10 06:30:11 EDT 2000;Committer;eban;2;9;2;11;0
c67a74570dd056569763f5015e0aafa7d454fca7;Mon Jul 10 04:49:24 EDT 2000;Committer;matz;22;566;446;1012;0
3043170b14875ce53f3a951d665279b12c2c63a8;Fri Jul 07 03:20:53 EDT 2000;Committer;matz;8;58;15;73;0
1ec4d9d3e47132a4eeacc1a45a9e0bf1159ab3c8;Thu Jul 06 09:18:54 EDT 2000;Committer;matz;1;1;5;6;0
d381c1341084cba3dac822fb720d005307ad9f54;Thu Jul 06 07:37:50 EDT 2000;Committer;eban;3;3;11;14;0
d1375688cdde3d094984f7f3a7bffe57306a0bca;Thu Jul 06 07:21:26 EDT 2000;Committer;matz;18;384;144;528;0
a60db057a2a8456f8f5b59a6c5805e25d1d47d34;Wed Jul 05 16:01:49 EDT 2000;Committer;eban;2;21;1;22;0
a26972d26f38e6c023a955a1073c2801cbf6357b;Wed Jul 05 14:12:27 EDT 2000;Committer;eban;4;32;13;45;0
70fa7705dc9ec7ca7807971a4312923555deccb0;Tue Jul 04 16:27:19 EDT 2000;Committer;eban;3;8;2;10;0
79096829406349429b32054133ab178d55ed84f1;Tue Jul 04 07:04:42 EDT 2000;Committer;matz;8;268;16;284;0
38402e0415d64e2516a72e4b9d764c675453da37;Tue Jul 04 04:22:02 EDT 2000;Committer;eban;2;6;1;7;0
4f51d814183316c3e97da1dc13cf6945b5a76f2f;Tue Jul 04 04:17:26 EDT 2000;Committer;matz;14;90;50;140;0
5a8bfc39f132708bcf3ee2970e9f55ee6d101b65;Mon Jul 03 16:51:57 EDT 2000;Committer;eban;2;4;1;5;0
e0f9bdab157daab818d51504a1cb7a30cff765fe;Mon Jul 03 09:37:17 EDT 2000;Committer;eban;2;11;3;14;0
9dd98aa46e01544afb84c64d461e5b2360b81eac;Mon Jul 03 09:20:35 EDT 2000;Committer;aamine;2;6;14;20;0
4550e078892fd210a4be65ab6b130d2fa95f26c3;Mon Jul 03 09:20:24 EDT 2000;Committer;aamine;1;8;0;8;0
fd7ed008fd320f1c5d366c97538c76680f7b54ae;Mon Jul 03 09:08:37 EDT 2000;Committer;eban;1;1;1;2;0
7c2039d04698b9247e5ba98a534c3516751f3f12;Mon Jul 03 08:29:58 EDT 2000;Committer;eban;2;5;1;6;0
ede506ef400244cbf3005e15d97a21313faf3d6d;Mon Jul 03 07:52:19 EDT 2000;Committer;eban;2;5;1;6;0
6ad90f5ad4961b26287c87c2d34056829c59755d;Mon Jul 03 05:46:36 EDT 2000;Committer;matz;5;140;124;264;0
7c4044501a7a7878d60b94361d364dc042d3d603;Mon Jul 03 01:47:03 EDT 2000;Committer;eban;3;7;4;11;0
4e4b377a8e8573961709002421d91afd37e3a9e0;Sun Jul 02 15:57:18 EDT 2000;Committer;eban;7;57;53;110;0
5eccd28bb30b5ebdc57ded504a27fbf488a65050;Sat Jul 01 18:28:24 EDT 2000;Committer;aamine;2;16;10;26;0
951d81cab818c09630e7a829931dc6719a9b7031;Sat Jul 01 18:28:13 EDT 2000;Committer;aamine;1;8;0;8;0
d07e708d35dfa6b1a00da04770c29497d29f6b13;Sat Jul 01 06:51:28 EDT 2000;Committer;matz;1;3;0;3;0
c7d499225b4d035c17acf774a3d53e20d6301df7;Sat Jul 01 06:47:47 EDT 2000;Committer;matz;5;53;18;71;0
11fef7fd630528ac1b6c55739cb1affb2208944c;Thu Jun 29 07:46:56 EDT 2000;Committer;matz;4;24;16;40;0
1e965f4f9a7ab6dc368ee256ed71fe6c2f2e62dc;Wed Jun 28 12:27:54 EDT 2000;Committer;eban;1;6;6;12;0
d988ddae8d9585c24288d04b5b4aea14b29767bc;Wed Jun 28 10:45:30 EDT 2000;Committer;eban;1;1;2;3;0
224e59c6f82c98da0d507cfae3b39c97b6769d51;Wed Jun 28 08:31:35 EDT 2000;Committer;matz;15;251;111;362;0
1261c7e05550a72f3bb33eae75660142c6ea2a4e;Tue Jun 27 13:36:17 EDT 2000;Committer;aamine;2;192;94;286;0
ad203b06f49d7730114de8513cb514b259c39e1e;Tue Jun 27 13:29:59 EDT 2000;Committer;aamine;1;16;0;16;0
7ea888f520b632a2ecf2d9a184a5871546820720;Mon Jun 26 15:16:03 EDT 2000;Committer;eban;3;19;8;27;0
977986667692d72b887a88facf77d0206c08ad15;Mon Jun 26 07:27:37 EDT 2000;Committer;matz;1;4;6;10;0
0d8f03a2c220e55909387ba04933d880c4be7323;Sat Jun 24 16:53:31 EDT 2000;Committer;eban;1;0;1;1;0
c61d63bd16699c48b9b85ffd9097f799cc4c33b7;Sat Jun 24 15:50:00 EDT 2000;Committer;eban;1;0;68;68;0
e551412777d7449898002ad43b81d93df7ba8f94;Sat Jun 24 14:06:35 EDT 2000;Committer;eban;10;204;157;361;0
552fb72159d3bb27ff40ecc121bbc52a3fff89a1;Fri Jun 23 07:05:59 EDT 2000;Committer;matz;9;59;25;84;0
44cf56d6e70dbe06a160b004494ba40dd4cfb426;Thu Jun 22 08:29:58 EDT 2000;Committer;matz;19;194;74;268;0
4b4cad81e7d2bdc4750ea5043ce44bf37adb3997;Thu Jun 22 05:37:12 EDT 2000;Committer;shugo;2;37;9;46;0
fac7f59b31b8760dcbaf20b147d1ee81f2b26768;Thu Jun 22 04:39:08 EDT 2000;Committer;eban;3;14;14;28;0
2cc44e7606ad0df1e0c276200e99d1eabafa95ca;Tue Jun 20 01:55:26 EDT 2000;Committer;eban;2;8;4;12;0
ca3afdb861c3938d4e59ee44ff7947520e7129a9;Mon Jun 19 21:18:41 EDT 2000;Committer;wakou;3;776;873;1649;0
b8148f45947eee7461986536114949556f4eda40;Mon Jun 19 08:38:11 EDT 2000;Committer;matz;12;209;70;279;0
c613f625b7c0c72771d74f86a1177e00290577df;Mon Jun 19 03:37:55 EDT 2000;Committer;eban;5;35;8;43;0
cc05dcd5fea3b6cfbb09298677f42395534a3a36;Sat Jun 17 17:52:49 EDT 2000;Committer;wakou;2;493;493;986;0
78948252826bcd508272f975b760e7ae3a26b5bc;Sat Jun 17 08:15:16 EDT 2000;Committer;aamine;1;224;8;232;0
290f4e0d8d54b21606aea11e416dd0eb3a715872;Fri Jun 16 13:47:38 EDT 2000;Committer;aamine;1;38;53;91;0
feb82209abe8b24191933410a1d915a08f807f00;Fri Jun 16 12:41:06 EDT 2000;Committer;eban;3;15;1;16;0
8d18d5b3f9d96be4120b89ff743856021de84e5b;Fri Jun 16 07:44:16 EDT 2000;Committer;matz;11;71;28;99;0
1199a7d3d6399d44662b9a8bea5f359d1fdd40c2;Wed Jun 14 08:08:50 EDT 2000;Committer;matz;5;55;20;75;0
8c4f656b6cbc088d215b0fd083611e7e6b6040a5;Wed Jun 14 05:50:32 EDT 2000;Committer;matz;2;5;1;6;0
abc49e493d6c1dc47586a7d1b616df5237bd606f;Wed Jun 14 05:30:29 EDT 2000;Committer;matz;8;75;36;111;0
00e9a8f0c33d8c7e384041e2bcce6d28d3450bb8;Wed Jun 14 05:20:09 EDT 2000;Committer;eban;2;4;2;6;0
7f46923feea165d3b6ece6b0df67ffe510441722;Wed Jun 14 05:15:08 EDT 2000;Committer;eban;3;12;8;20;0
aa2a6871ee93e5dc86f243045af91fac90f142bf;Tue Jun 13 15:53:19 EDT 2000;Committer;wakou;2;18;3;21;0
00bd38a3b16ed222af61cf523af0c180b02c1d8c;Tue Jun 13 09:57:40 EDT 2000;Committer;matz;2;173;14;187;0
9ee0cafbfe7a94a7b6a9d0e7f2dbf7c7fd229757;Tue Jun 13 09:42:40 EDT 2000;Committer;matz;6;69;18;87;0
97f8593cf8af3b44e170fee5aca9b0a521cd3ffd;Tue Jun 13 09:04:40 EDT 2000;Committer;matz;1;2;2;4;0
50cb050bd7fb61b0316eac608f69a29479b8fc60;Tue Jun 13 02:50:34 EDT 2000;Committer;matz;1;1;1;2;0
7aac416d2cb7b7393073fce6ca23c8006bd04ad4;Tue Jun 13 02:48:49 EDT 2000;Committer;matz;1;7;5;12;0
9f32fd3e9a0566e9258dda883e3ecf6f5474096d;Mon Jun 12 16:42:46 EDT 2000;Committer;aamine;4;151;109;260;0
b0ed08600a71784085b9b4621a4c4fcdbe0ae1cd;Mon Jun 12 16:34:50 EDT 2000;Committer;eban;1;2;2;4;0
1cb8c0d6fe8cded70c10b501c8aa3f754c1b2a98;Mon Jun 12 15:45:58 EDT 2000;Committer;aamine;2;5;1;6;0
c86f2148a2ba7c8117403eda288f52e9e9431289;Mon Jun 12 14:46:44 EDT 2000;Committer;eban;3;19;7;26;0
548b5143db2c3d701520671ef1413cf3c39fcedf;Mon Jun 12 07:48:31 EDT 2000;Committer;matz;19;494;92;586;0
cfdf994071fac150246d54d65a66ddeba4d53a97;Fri Jun 09 07:55:12 EDT 2000;Committer;matz;1;3;0;3;0
fdd3d8551ffbb1a805b5cd559314ed4be7e1c03c;Fri Jun 09 07:53:59 EDT 2000;Committer;aamine;2;31;4;35;0
eb4c6c241d2032ac858c481b35de72dee28bad74;Wed Jun 07 15:49:37 EDT 2000;Committer;eban;4;12;6;18;0
0dedfa849c885b52745e46ec0620cf01a1533fbc;Tue Jun 06 02:39:39 EDT 2000;Committer;matz;1;4;1;5;0
ecd1aab5266315f947b0568cb56fab4f63453c83;Mon Jun 05 08:46:59 EDT 2000;Committer;matz;9;94;24;118;0
76d09411e9db597c537bd39124db47cde2d6f3c4;Sun Jun 04 15:32:19 EDT 2000;Committer;eban;4;16;3;19;0
5a140673903d47ca75fa612e9fc267ebc8ea380b;Sun Jun 04 06:55:03 EDT 2000;Committer;eban;1;1;0;1;0
260945fe6f1ffdb692a6b8513b762670d071ca68;Sat Jun 03 18:22:23 EDT 2000;Committer;wakou;2;34;28;62;0
b62cdfe9b5ea559c335fcb8d887ffd1ee0007eca;Sat Jun 03 17:14:03 EDT 2000;Committer;eban;2;4;1;5;0
1c4c8b743eca70d4631be366f2c92e4aabcd5a21;Thu Jun 01 13:43:43 EDT 2000;Committer;aamine;3;12;11;23;0
4fcb1c47e5402c8ded1ad60a4ee66fa0756a3a0e;Wed May 31 16:41:03 EDT 2000;Committer;matz;3;74;58;132;0
0b0b2445fd9222483deb0b382b40d90f8c621837;Wed May 31 03:10:07 EDT 2000;Committer;matz;7;31;42;73;0
ed2f7f70570fd7ec43633a20932256d32be6454f;Tue May 30 19:18:06 EDT 2000;Committer;wakou;2;20;5;25;0
9a1716fdb289e7bcdabf9050bfdf051106e2cce0;Tue May 30 04:24:17 EDT 2000;Committer;matz;21;245;185;430;0
869b1efeb4eea77338863faff98da2432acb4b5d;Mon May 29 02:10:22 EDT 2000;Committer;eban;9;161;78;239;0
d7fe17edf08c1cee7f5b87251d2f09345900fcf9;Thu May 25 05:55:12 EDT 2000;Committer;matz;14;161;115;276;0
106eb09a382fa9003b67a29e33598ef4205b83b9;Wed May 24 07:42:34 EDT 2000;Committer;matz;1;20;9;29;0
21f39b43b802e4cc69d42b6e65a462e10aab9846;Wed May 24 07:36:46 EDT 2000;Committer;matz;1;3;2;5;0
9cdfe3496f45c4f8e593d4d2b4fb657b93887e5a;Wed May 24 07:10:25 EDT 2000;Committer;wakou;4;87;25;112;0
8b1de0b1ad49733abeddd8be359ae816b29de59a;Wed May 24 04:34:26 EDT 2000;Committer;matz;49;608;611;1219;0
24b9bdca25dc431aff935df7739b9c5ea0ee4077;Tue May 23 15:36:43 EDT 2000;Committer;matz;1;14;13;27;0
bdd3b79fe1ea00530c1a0d69ef1d8c5ec404b2da;Mon May 22 13:39:24 EDT 2000;Committer;aamine;2;3;3;6;0
b8f39362b29f3b2f4a34d3b4b24c05edc9612854;Mon May 22 07:29:50 EDT 2000;Committer;matz;2;15;14;29;0
e4e5edd5c30ea8b3b0f85e1469e0379e2b67e21e;Mon May 22 07:09:55 EDT 2000;Committer;matz;3;202;120;322;0
440834408c97cdc6b1533b6fa9f82bb5a147272f;Mon May 22 05:30:25 EDT 2000;Committer;matz;1;49;29;78;0
189372842d6f76605541b7c65b99745b12765a23;Sun May 21 12:23:51 EDT 2000;Committer;eban;4;13;1;14;0
b069230a3a395ee57a9874bb6667bb704c09f2a8;Sun May 21 09:25:58 EDT 2000;Committer;eban;5;34;5;39;0
b8986bfdd69e54a1cd5ac9a51ebc6fc49446f8a1;Fri May 19 03:25:00 EDT 2000;Committer;matz;1;1;1;2;0
08a0727577e23ee55ce0eb09a78826f7f7642411;Thu May 18 08:57:37 EDT 2000;Committer;aamine;4;50;22;72;0
f63956c52c796194f5a4f5178775d80582e543c1;Thu May 18 04:32:32 EDT 2000;Committer;matz;1;1;1;2;0
a62935cf06b9ee2ec72c749c732c226a18f4d389;Thu May 18 04:32:13 EDT 2000;Committer;matz;14;261;109;370;0
3e51a5b1b5a953e4705adc924355ffdc83b25472;Wed May 17 18:39:43 EDT 2000;Committer;aamine;3;9;16;25;0
35e731649da88fda916509eb1cb0a745d772f21c;Wed May 17 06:33:50 EDT 2000;Committer;matz;7;62;23;85;0
133ff3421a9867ec49a23df97aba3db63fc78755;Wed May 17 04:38:19 EDT 2000;Committer;matz;10;160;136;296;0
1fc61ca55fd736dbe63c37abde8239601ce3b2aa;Tue May 16 15:50:49 EDT 2000;Committer;eban;7;23;7;30;0
a5b607c895adfb751c273e51fea101935d94e103;Tue May 16 02:46:57 EDT 2000;Committer;matz;9;219;5531;5750;0
816779043d30d904d3c3aa32afae355d1d2569c9;Mon May 15 06:50:43 EDT 2000;Committer;matz;1;2;2;4;0
b2dc4932bf9b5b77a2def58c80ccd93396b28b13;Mon May 15 06:38:46 EDT 2000;Committer;matz;7;26;8;34;0
693599714a16c085f912dcddde16f52a18d2858b;Sun May 14 09:36:29 EDT 2000;Committer;eban;8;60;37;97;0
73667560792c0dc7bdbcd96b4ba56c65ba558506;Sat May 13 17:22:08 EDT 2000;Committer;eban;3;9;4;13;0
6d53b692ab91c8817736cdec78b388e6e4990806;Sat May 13 16:13:31 EDT 2000;Committer;eban;25;327;228;555;0
9da4f78db46764be6dae5e7e83ff48cbecb3fb23;Fri May 12 09:07:57 EDT 2000;Committer;matz;46;3491;188;3679;0
014f2164ed7031a1c31604b290d2ab0cf1deacdc;Wed May 10 02:58:41 EDT 2000;Committer;matz;7;51;13;64;0
6f4170c2a7787ab2d6b4b302a808391317bfcbf7;Tue May 09 22:08:25 EDT 2000;Committer;wakou;1;27;25;52;0
655e96fa59f62f7d31b2d9d470947f97aceb7b92;Tue May 09 04:53:16 EDT 2000;Committer;matz;40;514;347;861;0
2a34f89e354071d09c64a93bf3498dfa108f3e8c;Fri May 05 08:53:06 EDT 2000;Committer;aamine;2;12;2;14;0
fedf48986da718580062d081dda38c4ee182c254;Mon May 01 09:42:38 EDT 2000;Committer;matz;69;1836;1450;3286;0
acbb1c943457d3b8802f099ee0e34331bc78bd38;Tue Apr 25 09:23:21 EDT 2000;Committer;aamine;2;56;7;63;0
ee38413bf0a5338ba5e735d9c78c6ad9149ee00d;Sat Apr 22 07:29:53 EDT 2000;Committer;aamine;2;39;57;96;0
cb1b00b4b4e42600b0a6f30a412a7a70da878587;Fri Apr 21 07:52:05 EDT 2000;Committer;matz;1;1;1;2;0
4f0aeb3cf739b246bfae2ac8a789e1f57c582abc;Tue Apr 18 09:39:02 EDT 2000;Committer;aamine;3;82;72;154;0
c8f58f2a16c88603abe56c34b346cad5817975b3;Tue Apr 18 04:56:28 EDT 2000;Committer;matz;1;2;2;4;0
cd09e4abd8f8ba814e093bfad9519fc7c05f03d9;Mon Apr 17 15:39:37 EDT 2000;Committer;matz;1;4;2;6;0
6d77e51b17a29daf71c329cccdbaee1c140b101d;Fri Apr 14 10:41:35 EDT 2000;Committer;aamine;3;11;14;25;0
861e4ba6b396eadbf37208b92f1b64fad16314fd;Wed Apr 12 05:06:23 EDT 2000;Committer;matz;10;87;12;99;0
dc2f6b3d257b99a49b4cd258623566113c9f7f35;Mon Apr 10 06:05:19 EDT 2000;Committer;matz;1;1;1;2;0
4a67017698cc23f510d0c76fadc4104b141f4512;Mon Apr 10 05:57:37 EDT 2000;Committer;matz;2;70;46;116;0
7194267b3bdf68ad75bd6bee8e7c6377f7b0ea2f;Mon Apr 10 05:48:43 EDT 2000;Committer;matz;31;589;831;1420;0
be72d9a5da9be284d2bdb8047e50f14e014b7835;Fri Mar 31 13:02:40 EST 2000;Committer;aamine;4;332;266;598;0
9fd5174ef3aebe3d862289b4c646e65b2400b2f9;Mon Mar 27 15:52:27 EST 2000;Committer;aamine;4;350;173;523;0
0dcf7498b10c7fd4739b34236502efd8e0f8353c;Sun Mar 26 16:29:02 EST 2000;Committer;aamine;2;22;18;40;0
d8d148d81653d7be02ee2d4237b5e75856e02ee3;Sun Mar 26 08:48:15 EST 2000;Committer;aamine;4;285;347;632;0
688169fd83b24564b653c03977c168cea50ccd35;Thu Mar 23 08:37:35 EST 2000;Committer;matz;17;988;307;1295;0
5c13dd59db1ee6c04cdac4ce2ee97d5934115439;Fri Mar 17 08:58:21 EST 2000;Committer;matz;18;129;62;191;0
d8f981b972aab02d1432abe1c9cadf0507945e77;Wed Mar 15 09:09:28 EST 2000;Committer;matz;5;17;28;45;0
0d3f4a92cf4b6558f19a39d416c08db5e0b64a5f;Wed Mar 15 05:01:17 EST 2000;Committer;matz;6;58;22;80;0
31c55301e4c3c84803186d28d2764363b457532f;Mon Mar 13 07:18:45 EST 2000;Committer;matz;16;196;76;272;0
976692f8ae8377af944f09177c8e79cb94809fe9;Thu Mar 09 09:04:36 EST 2000;Committer;matz;8;135;76;211;0
5728ed4f51b6a79355a6cd517a7ae9a6928381fe;Wed Mar 08 10:40:11 EST 2000;Committer;aamine;2;4;2;6;0
035226e1fe71085c7c9c84dacd14448870fca9da;Wed Mar 08 06:25:19 EST 2000;Committer;matz;8;111;27;138;0
4d215cd9d3e0c4ea8ba802aa87773d6578c45a15;Tue Mar 07 08:37:59 EST 2000;Committer;matz;36;190;316;506;0
73d2362580ad40c267419a31cc1fd1bf550760c8;Mon Mar 06 06:32:08 EST 2000;Committer;matz;1;1;1;2;0
d7b8e448bfd29042f64ed3535dc21014b9259088;Mon Mar 06 04:15:42 EST 2000;Committer;matz;18;127;67;194;0
b014cc337ef28498311f58a7b28bdfffebc53f00;Sun Mar 05 10:25:53 EST 2000;Committer;aamine;3;94;77;171;0
4890f3a684aff94d93a5cc3f68fa8c67c1da6c19;Tue Feb 29 08:05:32 EST 2000;Committer;matz;20;241;134;375;0
0c123a83f0446204d974318b578236c949e5a01f;Sat Feb 26 01:16:48 EST 2000;Committer;matz;1;4;1;5;0
7ed66b9e1da2b1a364659562ff918afbec005004;Fri Feb 25 03:51:23 EST 2000;Committer;matz;10;107;73;180;0
e13f96f413dc40adaf1104decb10f80ddf636aa3;Wed Feb 23 05:44:18 EST 2000;Committer;matz;1;1;1;2;0
a19a2a92585cd2520022e7b2ba3750eea2a5dcb6;Wed Feb 23 05:43:57 EST 2000;Committer;matz;1;2;0;2;0
bf70582cf30ae6f715769c519f451411f5d2a577;Wed Feb 23 05:23:12 EST 2000;Committer;matz;19;130;23;153;0
6f82a67fd0035fcd2802f1564165d5211bc98ea2;Mon Feb 21 15:27:49 EST 2000;Committer;aamine;2;804;728;1532;0
3fef8bb12c0a82b49a89a29457818b28b2a000aa;Mon Feb 21 15:25:37 EST 2000;Committer;aamine;3;91;16;107;0
3d6fde336547463461180b9be5b1730194764d9c;Fri Feb 18 06:59:36 EST 2000;Committer;matz;14;247;48;295;0
f0886df4a4d017ed3655b1e1a4a4df2ebaa8c71e;Thu Feb 17 07:48:10 EST 2000;Committer;matz;1;1;1;2;0
96b40dff450df701200ea5edceb07f2ed847e3fd;Thu Feb 17 07:11:22 EST 2000;Committer;matz;27;286;171;457;0
7dd3853eac98396d3b5abee16d7f680d941eae82;Tue Feb 08 08:54:02 EST 2000;Committer;matz;1;6;6;12;0
320e99d8dda5eb5fc327fcbe20126cdd7fcd059d;Tue Feb 08 08:54:01 EST 2000;Committer;matz;33;1158;517;1675;0
25be6ce9b5dd2aabad61410068d688250c562189;Tue Feb 08 06:03:42 EST 2000;Committer;shugo;2;653;626;1279;0
d7b8616260f1012bdb011e4ac808eba9f0cf38aa;Wed Feb 02 08:10:32 EST 2000;Committer;matz;9;116;306;422;0
683839054fad9935d362e5228d1d93e78c340699;Tue Feb 01 03:18:03 EST 2000;Committer;matz;2;10;0;10;0
e4b53b22228d935847b72e8f9ab0f49a15b54215;Tue Feb 01 03:12:21 EST 2000;Committer;matz;37;1603;691;2294;0
005f12582975d8382851b740690f97dba35aaa2a;Fri Jan 21 12:52:24 EST 2000;Committer;aamine;4;39;28;67;0
e5ed1780afa9a5f29da7c63ca2b7d9c66f6936aa;Tue Jan 18 06:09:05 EST 2000;Committer;matz;7;26;51;77;0
dde62bcd2efbb3825d982326896ab774e73e4218;Mon Jan 17 08:37:53 EST 2000;Committer;matz;21;390;255;645;0
e43877719bd4bbd12e493e896a0f98c5b349937b;Sat Jan 08 05:08:40 EST 2000;Committer;matz;1;2;2;4;0
a69b9bce318b3d4717b92a8747ecdb4e71585c5d;Sat Jan 08 05:00:25 EST 2000;Committer;matz;12;385;368;753;0
a3da8465b4406e01b9b597e0af81dad3f65c5528;Fri Jan 07 03:34:02 EST 2000;Committer;shugo;1;1;1;2;0
deee7cb19f21323112075a85fab62fa87c4db117;Wed Jan 05 07:55:36 EST 2000;Committer;aamine;4;3;64;67;0
de7161526014b781468cea5d84411e23be945f79;Wed Jan 05 04:41:21 EST 2000;Committer;matz;69;1821;1051;2872;0
a1d1b1516750c1047ceb7010f8f5ca34b358c7e3;Wed Dec 29 11:14:04 EST 1999;Committer;aamine;4;371;324;695;0
0c00050f84bbf301c63d7c11ffbefabe512455bc;Wed Dec 22 13:49:13 EST 1999;Committer;aamine;4;117;44;161;0
47f58037b610ded89a4bbbc73501733558e7734e;Mon Dec 20 20:48:49 EST 1999;Committer;aamine;4;51;10;61;0
1f7ea56df09909971a3d0e585c97e020befe08e7;Mon Dec 20 03:39:42 EST 1999;Committer;shugo;1;1;8;9;0
2646675e0c94153587afc2be5208fccfdaf2397a;Mon Dec 20 03:30:48 EST 1999;Committer;shugo;1;1;1;2;0
3d15fb649346609fc840881a239a1a3648c9a296;Mon Dec 20 03:29:45 EST 1999;Committer;shugo;1;1;1;2;0
6d36661c5eb87831cc60fa416470c8459d2a16c0;Mon Dec 20 03:27:48 EST 1999;Committer;shugo;1;3;6;9;0
6f4751f5f63d177534f34e0c278967883e11c035;Fri Dec 17 15:00:13 EST 1999;Committer;aamine;4;554;319;873;0
9d228b13deccfdf23f44e2c465f723a2a7b3bcbd;Tue Dec 14 06:50:43 EST 1999;Committer;matz;34;637;496;1133;0
c18d3740a925e8752c3b93acea6087fb0e03be53;Tue Dec 07 09:25:55 EST 1999;Committer;matz;15;172;128;300;0
dee96209bfbb957538c7adeb01a65f3830749179;Mon Dec 06 09:04:03 EST 1999;Committer;matz;23;177;82;259;0
4263bb432accd9bd98654c3e8cc312414e7db906;Thu Dec 02 06:58:52 EST 1999;Committer;matz;8;26;10;36;0
a3f29338ad53c1027eeef0d3c7168d3355105d20;Wed Dec 01 09:24:48 EST 1999;Committer;matz;13;342;114;456;0
40517ecac82e4b406227bd30fd89d05c2e90bc87;Mon Nov 29 06:33:02 EST 1999;Committer;matz;7;61;13;74;0
2b49047143d1e10d6dd5d2359dba2d302fa07c66;Fri Nov 26 09:07:26 EST 1999;Committer;matz;4;25;20;45;0
ebab487fcd7633038b9272ddbe31c268cda15723;Thu Nov 25 09:03:08 EST 1999;Committer;matz;14;617;88;705;0
8e48dc16e97a783a69f0972b4882ad2faae561ea;Wed Nov 17 07:30:37 EST 1999;Committer;matz;19;366;132;498;0
943e99e62746388456955729e9f8417f3df5f8b5;Thu Nov 11 04:08:26 EST 1999;Committer;matz;5;56;22;78;0
1f13348b22c693903420ffba1d2425e2c361d927;Wed Nov 10 08:54:55 EST 1999;Committer;matz;2;62;62;124;0
04c7225b78f327aa0645d0f468e7b6d2e20a4d1e;Wed Nov 10 06:47:11 EST 1999;Committer;matz;9;102;41;143;0
28412851825d1bc7c8e885387e1f1b257cf8a0cf;Mon Nov 08 03:57:01 EST 1999;Committer;matz;12;57;55;112;0
a9e9697994a08600f5dbb46a1fe2a07233cb4890;Thu Nov 04 08:39:57 EST 1999;Committer;matz;16;2121;75;2196;0
0d684beafb4258da9606b1e3b4448511b709a2e2;Fri Oct 29 09:25:48 EDT 1999;Committer;matz;16;119;35;154;0
cd2af215d4d438bcb217ffce94c208e229dfe58a;Wed Oct 27 04:20:14 EDT 1999;Committer;matz;1;6;6;12;0
cabeaac37bd55efc9adb59dcb713295bab1e3392;Wed Oct 27 04:20:00 EDT 1999;Committer;matz;1;5;4;9;0
ad39669418c15f7a1ce6c8bae9c78a3ce1c795f7;Thu Oct 21 07:58:14 EDT 1999;Committer;matz;1;1;0;1;0
29a7a36d0631e06d3c9c35a0c422c6b3a9192932;Thu Oct 21 07:52:15 EDT 1999;Committer;matz;9;228;282;510;0
dfb65954e644fd24080edaf15d2a97da71b4ee4b;Thu Oct 21 07:08:00 EDT 1999;Committer;matz;8;9;0;9;0
58ac90ff773d7fc5107d7f2a886dd475053115f9;Wed Oct 20 07:10:23 EDT 1999;Committer;matz;8;95;104;199;0
125ca1a11a53810ac311012352f5b0773fc2bbde;Mon Oct 18 09:03:16 EDT 1999;Committer;matz;11;65;31;96;0
40a3f601e43a137e56b2c28454ffb6ce79d7ec7e;Sat Oct 16 10:33:06 EDT 1999;Committer;matz;6;53;28;81;0
3196645aee3add70a33f3d926d1d6e3820d39377;Fri Oct 15 08:52:18 EDT 1999;Committer;matz;12;252;159;411;0
826f10c6ce5cf11ba57f47f58384f4da58806c35;Wed Oct 13 09:32:16 EDT 1999;Committer;matz;2;16;3;19;0
ec8a9bba354e3bcdb7b7b004d3ce3d148bd9fc7f;Wed Oct 13 07:29:15 EDT 1999;Committer;matz;3;528;49;577;0
2e23ebc601fd5c8d7de232e470e2374df8888d11;Wed Oct 13 06:44:42 EDT 1999;Committer;matz;11;102;29;131;0
be1fea072cd0d22788ef8a931c0c6b64a2503b5d;Tue Oct 12 04:53:36 EDT 1999;Committer;matz;19;188;99;287;0
758cb647c7ac9e02a9ee0d7cb0934a5c963481e0;Mon Oct 04 04:51:08 EDT 1999;Committer;matz;20;125;65;190;0
d426749ff0ec0348e8b2f9e32724ac715aad500b;Wed Sep 22 07:32:33 EDT 1999;Committer;matz;3;791;0;791;0
8aad024e3ac6524f8bc09d839a331f926eab30ec;Wed Sep 22 04:30:11 EDT 1999;Committer;matz;11;109;35;144;0
70a444b0cc703a2fd3e05045cd1e36266221149e;Mon Sep 20 07:14:18 EDT 1999;Committer;matz;6;45;14;59;0
656cbdf2b7a0b185fe1232cf7322f5b39f47c28a;Sat Sep 18 06:46:15 EDT 1999;Committer;matz;1;2;1;3;0
7152df6b9b3b95d93607127d853c02e03e42a327;Sat Sep 18 04:48:51 EDT 1999;Committer;matz;11;107;74;181;0
12494013d2dc8597924e30581fbf55feeb3290a4;Thu Sep 16 16:11:25 EDT 1999;Committer;matz;5;21;8;29;0
9e3d9a2a009d2a0281802a84e1c5cc1c887edc71;Thu Sep 16 09:40:33 EDT 1999;Committer;matz;19;397;163;560;0
69a3aaf154948d653fa3653cd2b3c3b3af979769;Wed Sep 01 09:48:03 EDT 1999;Committer;matz;15;200;70;270;0
a1b57d0add85a248666fb55c58aa8c0c772136fc;Tue Aug 24 08:21:56 EDT 1999;Committer;matz;32;211;435;646;0
a281c996689240dc204f0c534cfe21ee6cbb6863;Fri Aug 13 08:39:25 EDT 1999;Committer;matz;1;41;0;41;0
8c17338001955f8a811997e441e2855c80a77bff;Fri Aug 13 08:24:06 EDT 1999;Committer;matz;2;4;1;5;0
942b2ba4b66a1026972e27ea7990dc08f01ec9cc;Fri Aug 13 06:09:54 EDT 1999;Committer;matz;26;0;7308;7308;0
65a5162550f58047974793cdc8067a970b2435c0;Fri Aug 13 05:45:20 EDT 1999;Committer;matz;156;21670;18083;39753;0
fcd020c83028f5610d382e85a2df00223e12bd7e;Fri Aug 13 05:43:34 EDT 1999;Committer;matz;3;0;50;50;0
0a64817fb80016030c03518fb9459f63c11605ea;Fri Aug 13 05:37:52 EDT 1999;Committer;matz;128;16029;11644;27673;0
210367ec889f5910e270d6ea2c7ddb8a8d939e61;Wed Jan 20 04:59:39 EST 1999;Committer;matz;140;25700;14102;39802;0
9c5b1986a36c7a700b4c76817e35aa874ba7907c;Wed Jan 20 04:59:32 EST 1999;Committer;matz;11;8382;0;8382;0
edf2e9b7c75d2fff380f03c9ae279e53fe05ab59;Wed Jan 20 04:45:32 EST 1999;Committer;matz;2;2564;0;2564;0
7ea2ceddb832b9973694fecac9fe3c30400735ba;Fri Jan 16 12:19:22 EST 1998;Committer;matz;79;8846;8177;17023;0
62e41d3f2e48422bbdf1bb2db83ae60b255b1a1a;Fri Jan 16 12:19:09 EST 1998;Committer;matz;56;13850;0;13850;0
3db12e8b236ac8f88db8eb4690d10e4a3b8dbcd4;Fri Jan 16 12:13:05 EST 1998;Committer;matz;225;75935;0;75935;0
